Id,Label,timeset,0,1,2,3,4,5,6,7
machine-learning,machine-learning,,3151,2984,4810,6135,9254,10945,0,1
deep-learning,deep-learning,,1791,1802,2587,3593,4649,6180,0,1
r,r,,12891,11613,23005,24504,46064,47509,0,1
classification,classification,,536,463,743,999,1343,1742,0,1
online-learning,online-learning,,5,8,6,13,14,19,0,60
recommender-system,recommender-system,,31,28,39,59,58,98,0,1
databases,databases,,21,15,26,36,43,62,0,1
nosql,nosql,,238,227,599,465,1110,1064,1,1
python,python,,62707,60425,108760,123132,192944,231892,0,1
scikit-learn,scikit-learn,,1293,1245,2139,2538,3783,4677,0,1
pandas,pandas,,10226,10638,17623,20864,28728,38487,0,4.028946
tfidf,tfidf,,6,8,11,14,14,25,0,33.333333
neural-network,neural-network,,1013,966,1802,1979,3899,3781,0,1
keras,keras,,3182,2957,4634,6139,6275,10773,0,1
unbalanced-classes,unbalanced-classes,,12,15,14,27,42,41,0,25
gradient-descent,gradient-descent,,97,91,174,188,298,362,0,1
geospatial,geospatial,,154,129,259,283,481,542,0,1
software-recommendation,software-recommendation,,2,1,3,3,9,6,0,1
data-mining,data-mining,,93,77,184,170,410,354,0,1
clustering,clustering,,74,74,91,148,207,239,0,1
text-mining,text-mining,,101,86,199,187,494,386,0,1
tensorflow,tensorflow,,4717,4295,7771,9012,13719,16783,0,1
time-series,time-series,,704,668,1056,1372,1673,2428,0,1
forecast,forecast,,68,40,84,108,44,192,0,1
lstm,lstm,,536,511,900,1047,1277,1947,0,1
optimization,optimization,,900,843,1579,1743,2932,3322,0,1
convergence,convergence,,16,16,29,32,39,61,0,1
svm,svm,,207,188,283,395,537,678,0,1
image-classification,image-classification,,51,58,79,109,95,188,0,13.72549
libsvm,libsvm,,15,8,35,23,64,58,0,1
apache-spark,apache-spark,,2744,2761,5879,5505,11729,11384,2,1
feature-selection,feature-selection,,117,124,174,241,283,415,0,5.982906
normalization,normalization,,69,77,128,146,253,274,0,11.594203
similarity,similarity,,74,77,117,151,230,268,0,4.054054
convolution,convolution,,87,94,147,181,383,328,0,8.045977
nlp,nlp,,861,835,1260,1696,2095,2956,0,1
data-cleaning,data-cleaning,,139,154,249,293,390,542,0,10.791367
scraping,scraping,,2,2,2,4,8,6,0,1
career,career,,1,0,5,1,5,6,0,1
market-basket-analysis,market-basket-analysis,,5,12,15,17,31,32,0,140
consumerweb,consumerweb,,0,0,0,0,1,0,0,1
regression,regression,,432,382,671,814,1244,1485,0,1
linear-regression,linear-regression,,320,264,509,584,854,1093,0,1
predictive-modeling,predictive-modeling,,65,66,95,131,134,226,0,1.538462
loss-function,loss-function,,162,155,187,317,286,504,0,1
convnet,convnet,,19,33,72,52,115,124,0,73.684211
training,training,,55,66,106,121,128,227,0,20
statistics,statistics,,492,404,903,896,1442,1799,0,1
encoding,encoding,,439,378,773,817,1746,1590,0,1
data,data,,78,60,97,138,140,235,0,1
text,text,,572,549,1114,1121,2218,2235,0,1
classifier,classifier,,6,3,9,9,14,18,0,1
feature-extraction,feature-extraction,,96,86,162,182,236,344,0,1
feature-engineering,feature-engineering,,59,69,79,128,100,207,0,16.949153
pca,pca,,131,121,192,252,350,444,0,1
lda,lda,,72,47,92,119,172,211,0,1
autoencoder,autoencoder,,131,133,175,264,257,439,0,1.526718
distance,distance,,108,103,187,211,304,398,0,1
dataset,dataset,,325,354,572,679,1010,1251,0,8.923077
outlier,outlier,,11,13,20,24,28,44,0,18.181818
social-network-analysis,social-network-analysis,,2,3,4,5,12,9,0,50
information-retrieval,information-retrieval,,27,18,70,45,106,115,0,1
cosine-distance,cosine-distance,,4,8,5,12,9,17,0,100
multiclass-classification,multiclass-classification,,74,80,105,154,157,259,0,8.108108
anomaly-detection,anomaly-detection,,54,47,72,101,92,173,0,1
descriptive-statistics,descriptive-statistics,,5,5,7,10,10,17,0,1
error-handling,error-handling,,573,551,1111,1124,2067,2235,3,1
reinforcement-learning,reinforcement-learning,,327,257,423,584,483,1007,0,1
q-learning,q-learning,,78,50,84,128,123,212,0,1
sequence,sequence,,143,122,295,265,470,560,0,1
preprocessing,preprocessing,,29,29,38,58,68,96,0,1
computer-vision,computer-vision,,587,564,893,1151,1570,2044,0,1
rnn,rnn,,44,48,250,92,594,342,0,9.090909
ranking,ranking,,36,38,90,74,143,164,0,5.555556
scoring,scoring,,16,8,22,24,33,46,0,1
ocr,ocr,,220,205,359,425,558,784,0,1
k-means,k-means,,156,115,229,271,412,500,0,1
cross-validation,cross-validation,,180,140,263,320,398,583,0,1
model-selection,model-selection,,23,16,20,39,31,59,0,1
categorical-data,categorical-data,,91,99,168,190,258,358,0,8.791209
feature-scaling,feature-scaling,,15,18,21,33,39,54,0,20
performance,performance,,1612,1461,3325,3073,6897,6398,0,1
mnist,mnist,,77,63,114,140,276,254,0,1
audio-recognition,audio-recognition,,4,6,10,10,14,20,0,50
algorithms,algorithms,,378,279,708,657,1285,1365,0,1
beginner,beginner,,7,11,7,18,14,25,0,57.142857
visualization,visualization,,160,135,299,295,549,594,0,1
tableau,tableau,,176,118,267,294,480,561,4,1
prediction,prediction,,163,144,219,307,387,526,0,1
matlab,matlab,,1472,1090,2667,2562,5714,5229,0,1
bigdata,bigdata,,296,241,532,537,1001,1069,2,1
embeddings,embeddings,,9,7,17,16,12,33,0,1
sql,sql,,13271,11569,24788,24840,52048,49628,4,1
orange,orange,,35,18,31,53,61,84,0,1
json,json,,8291,7768,15521,16059,34324,31580,1,1
overfitting,overfitting,,20,16,25,36,41,61,0,1
matrix-factorisation,matrix-factorisation,,4,5,10,9,15,19,0,25
perceptron,perceptron,,20,24,58,44,94,102,0,20
self-study,self-study,,5,2,5,7,6,12,0,1
sequential-pattern-mining,sequential-pattern-mining,,6,3,5,9,11,14,0,1
excel,excel,,7840,7903,14035,15743,29111,29778,5,1
game,game,,3,3,3,6,5,9,0,1
backpropagation,backpropagation,,78,89,141,167,267,308,0,14.102564
theory,theory,,38,27,58,65,107,123,0,1
graphical-model,graphical-model,,1,3,0,4,8,4,0,200
marketing,marketing,,1,6,5,7,12,12,0,500
simulation,simulation,,124,87,205,211,404,416,0,1
cost-function,cost-function,,7,8,11,15,13,26,0,14.285714
nltk,nltk,,226,216,444,442,913,886,0,1
text-filter,text-filter,,2,0,0,2,1,2,0,1
ggplot2,ggplot2,,1594,1433,2790,3027,5691,5817,0,1
gan,gan,,29,48,14,77,38,91,0,65.517241
decision-trees,decision-trees,,44,26,66,70,101,136,0,1
xgboost,xgboost,,176,157,218,333,424,551,0,1
word2vec,word2vec,,145,163,230,308,511,538,0,12.413793
estimators,estimators,,2,2,3,4,6,7,0,1
generative-models,generative-models,,5,20,8,25,27,33,0,300
random-forest,random-forest,,200,183,308,383,514,691,0,1
evaluation,evaluation,,54,48,79,102,146,181,0,1
feature-construction,feature-construction,,5,7,4,12,21,16,0,40
genetic-algorithms,genetic-algorithms,,11,19,28,30,49,58,0,72.727273
gpu,gpu,,259,249,490,508,812,998,0,1
unsupervised-learning,unsupervised-learning,,64,66,82,130,164,212,0,3.125
multilabel-classification,multilabel-classification,,52,61,98,113,136,211,0,17.307692
machine-translation,machine-translation,,31,30,21,61,37,82,0,1
information-theory,information-theory,,19,12,33,31,46,64,0,1
ngrams,ngrams,,1,3,3,4,6,7,0,200
parameter,parameter,,1,5,0,6,4,6,0,400
word-embeddings,word-embeddings,,31,29,32,60,66,92,0,1
text-generation,text-generation,,8,0,6,8,6,14,0,1
labels,labels,,12,7,36,19,182,55,0,1
activation-function,activation-function,,44,42,57,86,101,143,0,1
clusters,clusters,,7,0,2,7,7,9,0,1
image-recognition,image-recognition,,84,77,160,161,258,321,0,1
tsne,tsne,,4,2,5,6,12,11,0,1
meta-learning,meta-learning,,1,3,1,4,4,5,0,200
ensemble,ensemble,,3,2,1,5,7,6,0,1
java,java,,37969,33630,73569,71599,146122,145168,3,1
data-augmentation,data-augmentation,,42,24,39,66,23,105,0,1
graphs,graphs,,159,120,255,279,454,534,0,1
markov-process,markov-process,,3,4,8,7,10,15,0,33.333333
cloud,cloud,,284,196,478,480,774,958,6,1
correlation,correlation,,131,135,240,266,349,506,0,3.053435
ensemble-modeling,ensemble-modeling,,5,4,13,9,30,22,0,1
binary,binary,,308,229,670,537,1127,1207,0,1
missing-data,missing-data,,83,77,165,160,294,325,0,1
bayesian,bayesian,,49,68,142,117,169,259,0,38.77551
gaussian,gaussian,,53,44,125,97,181,222,0,1
pac-learning,pac-learning,,4,0,2,4,2,6,0,1
pyspark,pyspark,,1386,1472,2438,2858,4139,5296,2,6.204906
data-imputation,data-imputation,,6,5,13,11,15,24,0,1
numerical,numerical,,3,1,2,4,43,6,0,1
gensim,gensim,,143,124,214,267,439,481,0,1
logistic-regression,logistic-regression,,194,181,334,375,503,709,0,1
supervised-learning,supervised-learning,,47,43,75,90,125,165,0,1
sampling,sampling,,54,55,109,109,154,218,0,1.851852
csv,csv,,2228,2032,3781,4260,8998,8041,0,1
dataframe,dataframe,,4105,4212,7456,8317,13550,15773,0,2.606577
kaggle,kaggle,,51,66,79,117,120,196,0,29.411765
theano,theano,,42,26,79,68,219,147,0,1
probability,probability,,124,107,217,231,369,448,0,1
naive-bayes-classifier,naive-bayes-classifier,,11,7,20,18,29,38,0,1
object-recognition,object-recognition,,27,20,38,47,67,85,0,1
pytorch,pytorch,,761,767,1080,1528,950,2608,0,1
regularization,regularization,,14,14,17,28,27,45,0,1
parsing,parsing,,980,797,1863,1777,3966,3640,0,1
stanford-nlp,stanford-nlp,,82,55,157,137,321,294,0,1
topic-model,topic-model,,3,11,5,14,17,19,0,266.666667
dimensionality-reduction,dimensionality-reduction,,38,41,46,79,85,125,0,7.894737
dropout,dropout,,15,26,45,41,47,86,0,73.333333
cnn,cnn,,125,140,150,265,206,415,0,12
tranformation,tranformation,,0,0,0,0,3,0,0,1
javascript,javascript,,52908,50099,102203,103007,208790,205210,1,1
rstudio,rstudio,,335,306,633,641,984,1274,0,1
azure-ml,azure-ml,,4,2,3,6,10,9,0,1
parameter-estimation,parameter-estimation,,0,0,7,0,6,7,0,1
research,research,,16,15,29,31,61,60,0,1
scalability,scalability,,26,21,56,47,128,103,3,1
reference-request,reference-request,,25,21,50,46,115,96,0,1
hyperparameter,hyperparameter,,18,9,12,27,23,39,0,1
accuracy,accuracy,,23,16,38,39,32,77,0,1
sentiment-analysis,sentiment-analysis,,92,91,161,183,278,344,0,1
plotting,plotting,,12,5,10,17,35,27,0,1
seaborn,seaborn,,395,378,601,773,802,1374,0,1
historgram,historgram,,2,2,2,4,3,6,0,1
counts,counts,,1,1,2,2,2,4,0,1
data.table,data.table,,339,413,740,752,1591,1492,0,21.828909
forecasting,forecasting,,107,101,170,208,294,378,0,1
search,search,,656,530,1324,1186,2499,2510,0,1
methodology,methodology,,5,13,12,18,40,30,7,160
anaconda,anaconda,,747,636,1349,1383,2046,2732,0,1
weka,weka,,56,27,131,83,190,214,0,1
aggregation,aggregation,,95,97,190,192,319,382,1,2.105263
aws,aws,,12,18,19,30,38,49,6,50
batch-normalization,batch-normalization,,36,33,34,69,107,103,0,1
notation,notation,,24,18,39,42,61,81,0,1
cloud-computing,cloud-computing,,6,2,9,8,10,17,0,1
class-imbalance,class-imbalance,,19,19,20,38,32,58,0,1
homework,homework,,2,0,2,2,6,4,0,1
distribution,distribution,,77,74,128,151,214,279,0,1
numpy,numpy,,3577,3252,6258,6829,11964,13087,0,1
similar-documents,similar-documents,,6,8,1,14,14,15,0,33.333333
glm,glm,,82,78,139,160,184,299,0,1
torch,torch,,64,36,79,100,133,179,0,1
google,google,,5,5,9,10,20,19,0,1
search-engine,search-engine,,21,22,46,43,83,89,4,4.761905
regex,regex,,4898,4581,8782,9479,18808,18261,0,1
finance,finance,,66,55,101,121,233,222,0,1
keras-rl,keras-rl,,13,9,16,22,12,38,0,1
openai-gym,openai-gym,,69,52,108,121,104,229,0,1
dqn,dqn,,39,20,33,59,20,92,0,1
score,score,,3,4,3,7,2,10,0,33.333333
mini-batch-gradient-descent,mini-batch-gradient-descent,,3,2,5,5,14,10,0,1
learning-rate,learning-rate,,3,3,3,6,5,9,0,1
smote,smote,,7,13,10,20,9,30,0,85.714286
weighted-data,weighted-data,,2,5,10,7,6,17,0,150
vector-space-models,vector-space-models,,2,3,3,5,7,8,0,50
fuzzy-logic,fuzzy-logic,,8,15,40,23,44,63,0,87.5
ab-test,ab-test,,0,0,1,0,2,1,0,1
experiments,experiments,,0,0,1,0,3,1,0,1
noise,noise,,21,28,54,49,65,103,0,33.333333
apache-hadoop,apache-hadoop,,3,4,4,7,14,11,2,33.333333
scala,scala,,2491,2355,4794,4846,11133,9640,2,1
terminology,terminology,,90,76,154,166,278,320,0,1
definitions,definitions,,13,18,17,31,26,48,0,38.461538
inception,inception,,3,3,4,6,13,10,0,1
interpolation,interpolation,,176,124,249,300,485,549,0,1
association-rules,association-rules,,7,4,6,11,7,17,0,1
yolo,yolo,,127,116,110,243,91,353,0,1
ibm-watson,ibm-watson,,149,125,339,274,306,613,6,1
speech-to-text,speech-to-text,,110,103,195,213,235,408,6,1
gbm,gbm,,11,16,38,27,52,65,0,45.454545
data-wrangling,data-wrangling,,4,5,4,9,7,13,0,25
ipython,ipython,,155,140,285,295,539,580,0,1
tools,tools,,4,4,4,8,10,12,0,1
metadata,metadata,,132,150,243,282,435,525,4,13.636364
semi-supervised-learning,semi-supervised-learning,,6,6,6,12,11,18,0,1
survival-analysis,survival-analysis,,40,51,72,91,109,163,0,27.5
matplotlib,matplotlib,,2436,2224,4089,4660,6886,8749,0,1
named-entity-recognition,named-entity-recognition,,26,22,39,48,89,87,0,1
tflearn,tflearn,,13,16,42,29,154,71,0,23.076923
learning-to-rank,learning-to-rank,,2,2,2,4,4,6,0,1
actor-critic,actor-critic,,11,4,15,15,7,30,0,1
bayes-error,bayes-error,,0,0,0,0,4,0,0,1
caffe,caffe,,56,60,177,116,448,293,0,7.142857
bayesian-networks,bayesian-networks,,16,5,41,21,44,62,0,1
dbscan,dbscan,,25,18,35,43,69,78,0,1
variance,variance,,18,29,53,47,75,100,0,61.111111
linear-algebra,linear-algebra,,112,122,236,234,426,470,0,8.928571
confusion-matrix,confusion-matrix,,59,57,69,116,135,185,0,1
anomaly,anomaly,,3,0,1,3,2,4,0,1
transfer-learning,transfer-learning,,83,76,72,159,58,231,0,1
learning,learning,,3,0,9,3,6,12,0,1
grid-search,grid-search,,57,52,84,109,188,193,0,1
hyperparameter-tuning,hyperparameter-tuning,,20,12,20,32,22,52,0,1
octave,octave,,105,79,180,184,372,364,0,1
amazon-ml,amazon-ml,,0,0,3,0,1,3,0,1
jupyter,jupyter,,357,315,604,672,868,1276,0,1
history,history,,27,21,55,48,100,103,1,1
programming,programming,,5,2,8,7,9,15,0,1
software-development,software-development,,1,3,0,4,4,4,0,200
multitask-learning,multitask-learning,,2,2,2,4,7,6,0,1
sas,sas,,265,223,522,488,1092,1010,0,1
etl,etl,,210,253,403,463,745,866,4,20.47619
.net,.net,,4077,3693,8718,7770,16653,16488,8,1
randomized-algorithms,randomized-algorithms,,17,14,21,31,45,52,0,1
tokenization,tokenization,,2,2,3,4,3,7,0,1
mutual-information,mutual-information,,2,1,4,3,2,7,0,1
kernel,kernel,,178,184,374,362,632,736,9,3.370787
hierarchical-data-format,hierarchical-data-format,,2,2,3,4,3,7,0,1
map-reduce,map-reduce,,1,0,3,1,2,4,2,1
math,math,,689,568,1448,1257,2856,2705,0,1
neo4j,neo4j,,421,381,938,802,2094,1740,2,1
reshape,reshape,,125,100,197,225,414,422,0,1
redshift,redshift,,0,0,1,0,2,1,0,1
version-control,version-control,,171,151,401,322,1006,723,6,1
automatic-summarization,automatic-summarization,,5,3,1,8,3,9,0,1
scipy,scipy,,655,617,1114,1272,2265,2386,0,1
data-formats,data-formats,,4,3,1,7,7,8,0,1
management,management,,4,5,7,9,15,16,6,25
project-planning,project-planning,,1,6,3,7,9,10,0,500
twitter,twitter,,295,256,594,551,1457,1145,0,1
privacy,privacy,,24,30,54,54,98,108,3,25
markov-hidden-model,markov-hidden-model,,4,3,5,7,7,12,0,1
pgm,pgm,,1,5,17,6,8,23,0,400
recurrent-neural-net,recurrent-neural-net,,29,27,31,56,37,87,0,1
sequence-to-sequence,sequence-to-sequence,,12,10,22,22,39,44,0,1
natural-language-process,natural-language-process,,36,28,29,64,35,93,0,1
svr,svr,,2,2,2,4,3,6,0,1
probability-calibration,probability-calibration,,3,6,3,9,2,12,0,100
bioinformatics,bioinformatics,,106,82,196,188,368,384,0,1
vgg16,vgg16,,5,4,3,9,4,12,0,1
object-detection,object-detection,,252,287,352,539,670,891,0,13.888889
automation,automation,,614,603,1140,1217,2103,2357,3,1
attention-mechanism,attention-mechanism,,5,4,10,9,1,19,0,1
glorot-initialization,glorot-initialization,,0,0,0,0,2,0,0,1
faster-rcnn,faster-rcnn,,46,64,9,110,6,119,0,39.130435
nvidia,nvidia,,89,87,173,176,284,349,0,1
ensemble-learning,ensemble-learning,,18,24,43,42,68,85,0,33.333333
k-nn,k-nn,,13,12,19,25,21,44,0,1
hardware,hardware,,68,50,108,118,181,226,9,1
churn,churn,,5,6,5,11,10,16,0,20
discriminant-analysis,discriminant-analysis,,2,2,0,4,2,4,0,1
ai,ai,,4,2,10,6,3,16,0,1
alex-net,alex-net,,1,2,2,3,3,5,0,100
language-model,language-model,,15,9,20,24,31,44,0,1
colab,colab,,3,2,2,5,3,7,0,1
bias,bias,,3,6,10,9,11,19,0,100
open-source,open-source,,58,40,106,98,181,204,6,1
mlp,mlp,,33,27,26,60,17,86,0,1
data-science-model,data-science-model,,40,67,53,107,34,160,0,67.5
machine-learning-model,machine-learning-model,,68,72,81,140,74,221,0,5.882353
word,word,,41,30,87,71,73,158,0,1
expectation-maximization,expectation-maximization,,2,4,8,6,13,14,0,100
normal-equation,normal-equation,,0,0,0,0,5,0,0,1
annotation,annotation,,1,6,0,7,4,7,0,500
parallel,parallel,,0,5,3,5,5,8,0,400
pip,pip,,667,689,1351,1356,2528,2707,0,3.298351
self-driving,self-driving,,2,2,7,4,12,11,0,1
rbm,rbm,,8,3,9,11,11,20,0,1
metric,metric,,17,19,20,36,41,56,0,11.764706
c,c,,6191,4645,12008,10836,23287,22844,9,1
generalization,generalization,,7,11,8,18,29,26,0,57.142857
data-analysis,data-analysis,,178,139,283,317,451,600,0,1
distributed,distributed,,35,50,75,85,135,160,0,42.857143
google-prediction-api,google-prediction-api,,0,1,1,1,1,2,0,1
active-learning,active-learning,,1,2,3,3,2,6,0,100
markov,markov,,9,8,21,17,33,38,0,1
efficiency,efficiency,,5,9,12,14,35,26,0,80
relational-dbms,relational-dbms,,0,0,0,0,1,0,0,1
data-stream-mining,data-stream-mining,,1,0,0,1,1,1,0,1
representation,representation,,9,2,14,11,20,25,0,1
boosting,boosting,,18,25,32,43,29,75,0,38.888889
objective-function,objective-function,,2,3,9,5,10,14,0,50
processing,processing,,177,131,279,308,459,587,3,1
predictor-importance,predictor-importance,,1,0,2,1,6,3,0,1
momentum,momentum,,4,1,2,5,6,7,0,1
difference,difference,,53,47,92,100,185,192,0,1
state-of-the-art,state-of-the-art,,1,0,1,1,3,2,0,1
weight-initialization,weight-initialization,,0,5,7,5,1,12,0,400
dummy-variables,dummy-variables,,9,2,0,11,1,11,0,1
books,books,,5,1,8,6,21,14,0,1
anonymization,anonymization,,0,0,0,0,1,0,0,1
dplyr,dplyr,,1211,1137,2122,2348,4272,4470,0,1
neural-style-transfer,neural-style-transfer,,2,0,2,2,2,4,0,1
energy,energy,,4,6,7,10,32,17,0,50
epochs,epochs,,3,1,5,4,4,9,0,1
cs231n,cs231n,,1,0,1,1,1,2,0,1
gridsearchcv,gridsearchcv,,44,41,29,85,4,114,0,1
sensors,sensors,,19,13,30,32,24,62,3,1
domain-adaptation,domain-adaptation,,2,1,0,3,1,3,0,1
data-product,data-product,,2,0,0,2,1,2,0,1
methods,methods,,513,378,1071,891,2079,1962,3,1
vc-theory,vc-theory,,3,0,1,3,2,4,0,1
stata,stata,,53,46,89,99,280,188,0,1
mcmc,mcmc,,17,18,31,35,57,66,0,5.882353
probabilistic-programming,probabilistic-programming,,5,6,17,11,5,28,0,20
data-leakage,data-leakage,,2,0,3,2,1,5,0,1
jaccard-coefficient,jaccard-coefficient,,2,1,1,3,1,4,0,1
indexing,indexing,,691,610,1418,1301,2735,2719,0,1
stacked-lstm,stacked-lstm,,1,3,7,4,1,11,0,200
julia,julia,,260,238,403,498,833,901,0,1
monte-carlo,monte-carlo,,13,8,12,21,8,33,0,1
policy-gradients,policy-gradients,,13,11,24,24,6,48,0,1
pipelines,pipelines,,4,6,3,10,1,13,0,50
powerbi,powerbi,,681,672,1031,1353,1285,2384,5,1
nlg,nlg,,5,1,3,6,4,9,0,1
heatmap,heatmap,,114,138,226,252,394,478,0,21.052632
deep-network,deep-network,,11,16,21,27,28,48,0,45.454545
collinearity,collinearity,,0,2,2,2,2,4,0,100
competitions,competitions,,1,0,0,1,1,1,0,1
matrix,matrix,,780,626,1649,1406,3497,3055,0,1
spatial-transformer,spatial-transformer,,0,0,2,0,0,2,0,1
linux,linux,,3728,3450,7186,7178,16799,14364,9,1
genetic,genetic,,3,1,11,4,23,15,0,1
evolutionary-algorithms,evolutionary-algorithms,,11,8,12,19,16,31,0,1
orange3,orange3,,6,9,3,15,0,18,0,50
feature-reduction,feature-reduction,,1,1,3,2,0,5,0,1
activity-recognition,activity-recognition,,11,3,7,14,21,21,3,1
mongodb,mongodb,,4302,4100,8487,8402,14970,16889,1,1
lda-classifier,lda-classifier,,1,0,1,1,0,2,0,1
finetuning,finetuning,,1,2,1,3,0,4,0,100
opencv,opencv,,2037,2045,3444,4082,6245,7526,0,1
features,features,,10,15,12,25,11,37,0,50
genetic-programming,genetic-programming,,5,5,15,10,29,25,0,1
featurization,featurization,,0,0,1,0,0,1,0,1
ndcg,ndcg,,0,0,3,0,0,3,0,1
manifold,manifold,,3,2,4,5,3,9,0,1
rbf,rbf,,2,1,2,3,0,5,0,1
neural,neural,,6,1,2,7,0,9,0,1
library,library,,0,2,1,2,1,3,0,100
ml,ml,,11,5,18,16,48,34,2,1
dirichlet,dirichlet,,2,4,11,6,5,17,0,100
implementation,implementation,,33,34,58,67,102,125,9,3.030303
code,code,,1,0,2,1,1,3,0,1
image-size,image-size,,3,13,24,16,28,40,1,333.333333
imbalanced-learn,imbalanced-learn,,6,6,2,12,0,14,0,1
smotenc,smotenc,,0,2,1,2,0,3,0,100
dynamic-programming,dynamic-programming,,154,125,306,279,565,585,0,1
image-preprocessing,image-preprocessing,,21,32,43,53,24,96,0,52.380952
deepmind,deepmind,,3,3,4,6,4,10,0,1
wolfram-language,wolfram-language,,4,1,7,5,8,12,0,1
education,education,,2,3,4,5,13,9,0,50
chatbot,chatbot,,219,225,406,444,665,850,8,2.739726
dialog-flow,dialog-flow,,0,1,1,1,0,2,0,1
h2o,h2o,,68,91,206,159,375,365,0,33.823529
ridge-regression,ridge-regression,,2,2,1,4,0,5,0,1
fastai,fastai,,3,1,1,4,0,5,0,1
image,image,,1791,1706,3574,3497,7295,7071,1,1
discounted-reward,discounted-reward,,0,1,1,1,0,2,0,1
3d-reconstruction,3d-reconstruction,,14,10,17,24,39,41,0,1
sagemaker,sagemaker,,1,3,1,4,0,5,6,200
transformer,transformer,,29,26,14,55,16,69,0,1
gmm,gmm,,19,10,26,29,45,55,0,1
bert,bert,,14,19,1,33,0,34,0,35.714286
lightgbm,lightgbm,,31,39,44,70,81,114,0,25.806452
aws-lambda,aws-lambda,,1377,1389,2346,2766,3599,5112,6,1
density-estimation,density-estimation,,2,0,0,2,0,2,0,1
serialisation,serialisation,,1,2,0,3,0,3,0,100
lbp,lbp,,1,1,0,2,0,2,0,1
hinge-loss,hinge-loss,,3,1,0,4,0,4,0,1
mathematics,mathematics,,3,4,0,7,0,7,0,33.333333
healthcare,healthcare,,2,0,3,2,2,5,0,1
vae,vae,,9,3,0,12,0,12,0,1
web-scrapping,web-scrapping,,2,1,0,3,0,3,0,1
mean-shift,mean-shift,,3,5,4,8,9,12,0,66.666667
structured-data,structured-data,,12,12,15,24,27,39,4,1
fuzzy-classification,fuzzy-classification,,1,0,0,1,0,1,0,1
cost-matrix,cost-matrix,,1,0,0,1,0,1,2,1
rebalancing,rebalancing,,2,6,1,8,10,9,2,200
finite-precision,finite-precision,,1,0,0,1,0,1,0,1
amazon-emr,amazon-emr,,200,169,319,369,337,688,2,1
apache-nifi,apache-nifi,,183,167,314,350,494,664,2,1
sports,sports,,3,3,2,6,12,8,0,1
spss,spss,,37,47,81,84,142,165,0,27.027027
suggestions,suggestions,,1,0,0,1,0,1,4,1
categories,categories,,73,74,184,147,308,331,4,1.369863
gaussian-process,gaussian-process,,3,2,0,5,0,5,0,1
multi-instance-learning,multi-instance-learning,,1,1,0,2,0,2,0,1
spacy,spacy,,196,222,241,418,412,659,0,13.265306
inceptionresnetv2,inceptionresnetv2,,3,1,0,4,0,4,0,1
explainable-ai,explainable-ai,,1,9,0,10,1,10,0,800
softmax,softmax,,27,34,42,61,106,103,0,25.925926
open-set,open-set,,1,1,0,2,0,2,0,1
manhattan,manhattan,,1,1,0,2,0,2,0,1
coursera,coursera,,1,2,0,3,0,3,0,100
hyperplane,hyperplane,,1,0,0,1,0,1,0,1
knime,knime,,15,12,20,27,36,47,0,1
elbo,elbo,,0,1,0,1,0,1,0,1
mse,mse,,14,9,19,23,20,42,0,1
community,community,,0,1,1,1,2,2,7,1
lasso,lasso,,0,5,0,5,0,5,0,400
usecase,usecase,,0,1,0,1,0,1,0,1
pooling,pooling,,7,6,15,13,13,28,0,1
leakyrelu,leakyrelu,,0,1,0,1,0,1,0,1
latent-space,latent-space,,0,1,0,1,0,1,0,1
feature-map,feature-map,,0,2,0,2,0,2,0,100
crawling,crawling,,0,1,0,1,0,1,0,1
movielens,movielens,,0,2,0,2,0,2,0,100
label-smoothing,label-smoothing,,0,1,0,1,0,1,10,1
label-flipping,label-flipping,,0,1,0,1,0,1,10,1
allennlp,allennlp,,6,5,9,11,4,20,0,1
xboost,xboost,,0,1,0,1,0,1,0,1
tesseract,tesseract,,124,142,260,266,393,526,0,14.516129
stemming,stemming,,17,12,26,29,49,55,0,1
pickle,pickle,,139,161,265,300,480,565,0,15.827338
noisification,noisification,,0,1,0,1,0,1,0,1
infographics,infographics,,0,1,0,1,0,1,0,1
arima,arima,,90,79,141,169,166,310,0,1
rdkit,rdkit,,8,11,7,19,16,26,0,37.5
activation,activation,,12,10,14,22,12,36,0,1
nn,nn,,0,1,0,1,0,1,0,1
causalimpact,causalimpact,,0,1,0,1,0,1,11,1
counter-inference,counter-inference,,0,1,0,1,0,1,11,1
data-indexing-techniques,data-indexing-techniques,,0,1,0,1,0,1,0,1
design,design,,123,67,224,190,542,414,3,1
services,services,,1,3,6,4,16,10,3,200
c#,c#,,29114,26050,54181,55164,109101,109345,8,1
windows,windows,,3102,2848,6012,5950,11158,11962,9,1
file-systems,file-systems,,0,2,4,2,5,6,3,100
file-storage,file-storage,,16,10,12,26,26,38,8,1
object-oriented-design,object-oriented-design,,41,29,89,70,162,159,3,1
deprecation,deprecation,,0,0,1,0,3,1,3,1
class,class,,1487,1274,2740,2761,5668,5501,9,1
python-3.x,python-3.x,,17387,17273,29132,34660,43820,63792,0,1
domain-driven-design,domain-driven-design,,136,157,342,293,639,635,8,15.441176
design-patterns,design-patterns,,641,537,1168,1178,2207,2346,3,1
node.js,node.js,,15047,14352,27710,29399,49223,57109,1,1
functional-programming,functional-programming,,418,377,918,795,1976,1713,2,1
layers,layers,,4,3,6,7,18,13,3,1
wrapper,wrapper,,53,61,120,114,252,234,9,15.09434
architecture,architecture,,428,347,802,775,1419,1577,3,1
enterprise-architecture,enterprise-architecture,,5,7,22,12,43,34,3,40
client-server,client-server,,106,92,205,198,391,403,9,1
git,git,,2697,2402,5363,5099,11133,10462,6,1
project-management,project-management,,2,12,32,14,85,46,6,500
iterative-development,iterative-development,,0,0,1,0,4,1,6,1
prince2,prince2,,0,0,0,0,1,0,6,1
web-applications,web-applications,,363,344,744,707,1151,1451,3,1
webforms,webforms,,315,280,616,595,1202,1211,8,1
content-management,content-management,,0,2,2,2,6,4,8,100
dependency-injection,dependency-injection,,580,599,1160,1179,2402,2339,8,3.275862
microservices,microservices,,454,408,859,862,1258,1721,3,1
go,go,,1799,1690,3458,3489,6084,6947,6,1
protobuf,protobuf,,1,2,2,3,1,5,3,100
security,security,,826,804,1817,1630,3575,3447,4,1
authentication,authentication,,1209,1435,2267,2644,4209,4911,4,18.693135
authorization,authorization,,275,275,476,550,819,1026,4,1
jwt,jwt,,698,619,1303,1317,1981,2620,4,1
inversion-of-control,inversion-of-control,,45,52,126,97,279,223,8,15.555556
unit-testing,unit-testing,,1882,1692,3727,3574,7400,7301,1,1
mocking,mocking,,433,370,698,803,1265,1501,1,1
rest,rest,,2260,2223,4573,4483,8982,9056,3,1
api,api,,3054,2883,5749,5937,8813,11686,4,1
server,server,,870,779,1829,1649,2966,3478,4,1
client,client,,191,152,367,343,621,710,4,1
weak-typing,weak-typing,,0,0,1,0,2,1,9,1
amazon-ec2,amazon-ec2,,963,839,1884,1802,3901,3686,6,1
tdd,tdd,,62,67,157,129,373,286,1,8.064516
agile,agile,,14,25,58,39,86,97,6,78.571429
api-design,api-design,,111,105,238,216,430,454,3,1
stream-processing,stream-processing,,27,10,31,37,56,68,2,1
solid,solid,,8,7,26,15,57,41,3,1
open-closed-principle,open-closed-principle,,7,5,20,12,33,32,3,1
programming-practices,programming-practices,,11,19,39,30,99,69,3,72.727273
testing,testing,,1148,1017,2388,2165,3993,4553,3,1
single-responsibility,single-responsibility,,9,8,9,17,29,26,3,1
coupling,coupling,,5,7,6,12,28,18,3,40
bitbucket,bitbucket,,295,252,503,547,1044,1050,6,1
data-types,data-types,,4,6,4,10,15,14,9,50
date-format,date-format,,31,32,68,63,136,131,0,3.225806
spring,spring,,5381,4880,11117,10261,21340,21378,3,1
postgres,postgres,,1,3,12,4,15,16,4,200
hibernate,hibernate,,1945,1678,3828,3623,7247,7451,3,1
multitenancy,multitenancy,,0,3,5,3,9,8,3,200
complexity,complexity,,0,2,10,2,13,12,0,100
big-o,big-o,,128,110,310,238,496,548,0,1
uml,uml,,127,90,225,217,458,442,3,1
relationships,relationships,,2,1,3,3,111,6,4,1
scrum,scrum,,12,15,27,27,63,54,6,25
reporting,reporting,,62,59,112,121,195,233,4,1
jira,jira,,131,149,301,280,463,581,6,13.740458
scrum-master,scrum-master,,1,0,3,1,2,4,6,1
database,database,,3510,2896,7531,6406,15080,13937,4,1
web,web,,990,838,2006,1828,4233,3834,1,1
caching,caching,,546,575,1247,1121,2446,2368,3,5.311355
message-queue,message-queue,,88,87,189,175,321,364,3,1
concurrency,concurrency,,376,381,853,757,1762,1610,3,1.329787
pseudocode,pseudocode,,43,22,68,65,137,133,0,1
object-oriented,object-oriented,,60,44,141,104,295,245,3,1
list,list,,2988,2848,5804,5836,11608,11640,0,1
dto,dto,,54,52,97,106,147,203,3,1
immutability,immutability,,65,74,152,139,381,291,1,13.846154
initialization,initialization,,179,175,340,354,827,694,9,1
django,django,,8049,7683,13870,15732,26010,29602,0,1
lambda,lambda,,689,613,1340,1302,3060,2642,3,1
patterns-and-practices,patterns-and-practices,,3,11,12,14,52,26,3,266.666667
static-analysis,static-analysis,,30,42,82,72,145,154,9,40
web-development,web-development,,14,15,36,29,74,65,3,7.142857
mvc,mvc,,11,5,25,16,55,41,3,1
coding-style,coding-style,,55,58,116,113,327,229,3,5.454545
array,array,,4,1,4,5,17,9,3,1
real-time,real-time,,107,82,165,189,344,354,9,1
pubsub,pubsub,,2,3,4,5,9,9,3,50
development-process,development-process,,6,3,16,9,37,25,6,1
integration-tests,integration-tests,,3,9,11,12,36,23,1,200
legal,legal,,3,0,5,3,18,8,6,1
source-code,source-code,,3,4,12,7,11,19,3,33.333333
architectural-patterns,architectural-patterns,,17,15,39,32,41,71,3,1
onion-architecture,onion-architecture,,8,6,22,14,31,36,8,1
queue,queue,,263,221,496,484,948,980,3,1
cron,cron,,384,393,824,777,1630,1601,4,2.34375
static,static,,230,221,516,451,1025,967,9,1
exceptions,exceptions,,5,6,16,11,33,27,3,20
c++,c++,,12463,11180,22957,23643,50510,46600,9,1
rust,rust,,670,758,1150,1428,1784,2578,9,13.134328
functions,functions,,5,6,13,11,28,24,3,20
numeric-precision,numeric-precision,,0,2,1,2,2,3,0,100
asp.net,asp.net,,4101,3485,8128,7586,18228,15714,8,1
asp.net-mvc,asp.net-mvc,,3015,2542,5741,5557,13692,11298,8,1
entity-framework,entity-framework,,1494,1264,2775,2758,6599,5533,8,1
database-design,database-design,,340,292,715,632,1419,1347,4,1
interfaces,interfaces,,8,12,34,20,56,54,3,50
inheritance,inheritance,,673,598,1295,1271,2995,2566,9,1
dependency-inversion,dependency-inversion,,5,7,9,12,19,21,8,40
versioning,versioning,,70,40,112,110,216,222,6,1
strings,strings,,15,11,35,26,64,61,0,1
escaping,escaping,,133,132,255,265,548,520,0,1
rebol,rebol,,1,2,6,3,106,9,0,100
assembly,assembly,,893,585,1680,1478,3197,3158,9,1
boolean,boolean,,210,174,464,384,863,848,0,1
implementations,implementations,,4,1,2,5,6,7,3,1
windows-8,windows-8,,7,4,11,11,25,22,8,1
software-patches,software-patches,,0,0,0,0,1,0,8,1
sprint,sprint,,6,8,10,14,13,24,6,33.333333
software-as-a-service,software-as-a-service,,0,4,3,4,9,7,3,300
wcf,wcf,,349,295,735,644,1563,1379,8,1
garbage-collection,garbage-collection,,182,151,373,333,784,706,3,1
memory-usage,memory-usage,,0,2,5,2,16,7,9,100
monitoring,monitoring,,102,102,240,204,379,444,6,1
tagging,tagging,,13,18,23,31,44,54,6,38.461538
operating-systems,operating-systems,,10,20,54,30,82,84,9,100
event-programming,event-programming,,5,3,4,8,17,12,3,1
embedded-systems,embedded-systems,,3,3,1,6,17,7,3,1
object,object,,1677,1535,2786,3212,5206,5998,1,1
multithreading,multithreading,,2202,1945,4348,4147,9762,8495,3,1
gui,gui,,3,3,6,6,13,12,3,1
clean-code,clean-code,,8,8,38,16,71,54,3,1
reactive,reactive,,96,103,170,199,318,369,0,7.291667
memory,memory,,558,487,1218,1045,2330,2263,9,1
pointers,pointers,,903,672,1835,1575,4066,3410,9,1
azure,azure,,4115,4026,7820,8141,13747,15961,8,1
distributed-system,distributed-system,,57,45,106,102,188,208,3,1
liskov-substitution,liskov-substitution,,1,0,3,1,15,4,3,1
dry,dry,,26,32,79,58,157,137,3,23.076923
language-features,language-features,,4,4,5,8,20,13,9,1
programming-languages,programming-languages,,82,56,137,138,235,275,9,1
gitflow,gitflow,,7,2,7,9,13,16,6,1
software,software,,9,6,22,15,43,37,3,1
standards,standards,,39,46,97,85,189,182,9,17.948718
project-structure,project-structure,,8,9,30,17,57,47,3,12.5
scripting,scripting,,332,293,652,625,1288,1277,9,1
static-methods,static-methods,,33,33,89,66,191,155,9,1
globals,globals,,8,3,18,11,32,29,0,1
ruby,ruby,,2272,2160,4949,4432,11775,9381,12,1
cucumber,cucumber,,333,318,578,651,1078,1229,3,1
libraries,libraries,,64,66,118,130,279,248,9,3.125
headers,headers,,1,2,6,3,2,9,9,100
standard-library,standard-library,,14,9,19,23,46,42,9,1
comments,comments,,72,81,158,153,336,311,4,12.5
model,model,,436,343,734,779,1147,1513,4,1
tcp,tcp,,466,388,832,854,1582,1686,9,1
nginx,nginx,,1636,1513,3091,3149,5242,6240,6,1
artificial-intelligence,artificial-intelligence,,219,211,407,430,722,837,0,1
neural-networks,neural-networks,,146,159,254,305,376,559,0,8.90411
internship,internship,,0,0,1,0,1,1,6,1
gcc,gcc,,652,588,1397,1240,2757,2637,9,1
coding-standards,coding-standards,,3,4,16,7,34,23,3,33.333333
web-api,web-api,,21,18,41,39,51,80,3,1
orm,orm,,304,267,649,571,1156,1220,4,1
active-directory,active-directory,,354,350,710,704,1345,1414,8,1
debugging,debugging,,796,711,1657,1507,3275,3164,9,1
null,null,,217,207,544,424,1070,968,4,1
ios,ios,,10144,9381,21564,19525,51518,41089,13,1
push,push,,87,62,226,149,401,375,6,1
notifications,notifications,,323,281,725,604,1449,1329,3,1
web-services,web-services,,544,418,1259,962,2892,2221,3,1
anti-patterns,anti-patterns,,12,7,24,19,49,43,3,1
configuration,configuration,,318,338,624,656,1150,1280,3,6.289308
paradigms,paradigms,,2,3,5,5,20,10,9,50
enum,enum,,4,3,4,7,11,11,3,1
idioms,idioms,,7,10,15,17,25,32,9,42.857143
singleton,singleton,,122,137,282,259,539,541,3,12.295082
c++14,c++14,,239,227,458,466,1235,924,9,1
test-coverage,test-coverage,,13,7,22,20,47,42,3,1
logging,logging,,845,907,1877,1752,3206,3629,3,7.337278
websites,websites,,1,2,3,3,10,6,3,100
free-software,free-software,,0,0,0,0,1,0,3,1
test-automation,test-automation,,2,0,4,2,6,6,3,1
sdk,sdk,,242,256,510,498,879,1008,3,5.785124
template-method,template-method,,1,0,1,1,3,2,3,1
repository,repository,,143,146,354,289,617,643,6,2.097902
persistence,persistence,,87,51,146,138,297,284,3,1
continuous-delivery,continuous-delivery,,22,24,56,46,102,102,6,9.090909
docker,docker,,5169,4834,9406,10003,14849,19409,6,1
waterfall,waterfall,,7,8,20,15,26,35,1,14.285714
team-foundation-server,team-foundation-server,,1,1,6,2,9,8,6,1
php,php,,23755,20889,47255,44644,108769,91899,4,1
deployment,deployment,,507,457,905,964,1638,1869,1,1
jenkins,jenkins,,1749,1620,3581,3369,6224,6950,6,1
logical-operator,logical-operator,,0,2,0,2,2,2,5,100
iterator,iterator,,268,237,507,505,1072,1012,9,1
data-structures,data-structures,,680,596,1331,1276,2622,2607,0,1
oauth2,oauth2,,6,4,3,10,13,13,4,1
licensing,licensing,,8,18,27,26,58,53,3,125
teamwork,teamwork,,1,2,3,3,10,6,6,100
encryption,encryption,,685,563,1420,1248,2911,2668,6,1
stack,stack,,210,145,435,355,781,790,9,1
sorting,sorting,,1452,1222,2882,2674,6385,5556,0,1
algorithm-analysis,algorithm-analysis,,39,37,114,76,229,190,0,1
messaging,messaging,,34,40,100,74,162,174,3,17.647059
view,view,,329,311,680,640,1144,1320,3,1
flask,flask,,1978,2083,3415,4061,5233,7476,0,5.308392
compiler,compiler,,7,4,19,11,25,30,9,1
scope,scope,,257,231,517,488,1217,1005,1,1
code-organization,code-organization,,4,2,12,6,33,18,9,1
reactjs,reactjs,,15463,15424,26831,30887,40011,57718,1,1
react,react,,4,2,7,6,12,13,1,1
ide,ide,,171,135,340,306,716,646,3,1
junit,junit,,688,628,1300,1316,2456,2616,3,1
large-scale-project,large-scale-project,,0,0,1,0,5,1,3,1
xml,xml,,3336,2986,6350,6322,14548,12672,3,1
command-line,command-line,,399,387,826,786,1625,1612,9,1
soa,soa,,24,15,52,39,95,91,3,1
refactoring,refactoring,,149,119,285,268,503,553,3,1
professionalism,professionalism,,0,0,0,0,2,0,6,1
java8,java8,,1,0,1,1,5,2,3,1
type-systems,type-systems,,9,9,20,18,42,38,9,1
reflection,reflection,,363,319,787,682,1556,1469,8,1
annotations,annotations,,211,248,493,459,1029,952,3,17.535545
scheduling,scheduling,,79,51,120,130,197,250,9,1
http,http,,1493,1526,2984,3019,5617,6003,4,2.210315
apache,apache,,1705,1521,3460,3226,6841,6686,4,1
proxy,proxy,,477,456,938,933,1705,1871,6,1
event-sourcing,event-sourcing,,54,54,107,108,213,215,8,1
event-handling,event-handling,,194,157,358,351,684,709,1,1
read-model,read-model,,0,0,1,0,9,1,8,1
time-management,time-management,,0,0,2,0,6,2,0,1
f#,f#,,221,159,489,380,1013,869,8,1
http-request,http-request,,1,1,6,2,11,8,3,1
aggregate,aggregate,,233,218,477,451,819,928,0,1
github,github,,1220,1135,2221,2355,4469,4576,6,1
gitlab,gitlab,,612,596,1099,1208,1619,2307,6,1
protocol,protocol,,3,0,3,3,6,6,3,1
social,social,,15,16,41,31,65,72,4,6.666667
document-databases,document-databases,,1,0,3,1,4,4,1,1
audit,audit,,29,39,74,68,126,142,4,34.482759
continuous-integration,continuous-integration,,395,432,769,827,1286,1596,6,9.367089
devops,devops,,285,279,502,564,595,1066,6,1
hashing,hashing,,12,7,19,19,24,38,0,1
hashtable,hashtable,,89,66,177,155,359,332,0,1
websockets,websockets,,5,2,8,7,21,15,3,1
map,map,,0,1,2,1,8,3,3,1
hosting,hosting,,135,148,258,283,384,541,4,9.62963
web-scraping,web-scraping,,1788,1635,2828,3423,4562,6251,0,1
asp.net-core,asp.net-core,,3579,3452,5685,7031,8441,12716,8,1
html5,html5,,1921,4,4439,1925,9744,6364,1,1
backups,backups,,1,2,6,3,9,9,4,100
code-smell,code-smell,,0,2,13,2,15,15,3,100
graph,graph,,634,497,1058,1131,2289,2189,0,1
ruby-on-rails,ruby-on-rails,,3453,3048,7479,6501,16928,13980,12,1
maintenance,maintenance,,4,3,10,7,25,17,4,1
constructors,constructors,,3,3,7,6,22,13,3,1
parameters,parameters,,379,382,795,761,1552,1556,4,1
naming,naming,,33,36,83,69,155,152,3,9.090909
jquery,jquery,,11638,10281,24279,21919,63950,46198,1,1
web-hosting,web-hosting,,84,88,154,172,257,326,4,4.761905
html,html,,21658,21293,40444,42951,89109,83395,1,1
conditions,conditions,,3,1,2,4,10,6,3,1
visual-studio,visual-studio,,2594,2173,4760,4767,10439,9527,8,1
laravel,laravel,,7183,7169,13681,14352,25448,28033,4,1
relational-database,relational-database,,115,95,319,210,627,529,4,1
heap,heap,,104,47,192,151,397,343,9,1
allocation,allocation,,24,19,58,43,123,101,9,1
malloc,malloc,,163,94,316,257,641,573,9,1
workflows,workflows,,5,3,7,8,16,15,6,1
code-formatting,code-formatting,,38,29,63,67,102,130,3,1
productivity,productivity,,1,0,3,1,5,4,3,1
dependency-management,dependency-management,,83,90,131,173,242,304,3,8.433735
circular-dependency,circular-dependency,,34,40,70,74,123,144,9,17.647059
formal-methods,formal-methods,,9,8,22,17,34,39,0,1
case-tools,case-tools,,0,0,0,0,1,0,0,1
file-formats,file-formats,,1,0,3,1,6,4,0,1
factory-method,factory-method,,8,5,14,13,33,27,3,1
internationalization,internationalization,,169,170,344,339,655,683,1,1
spring-mvc,spring-mvc,,1010,880,2157,1890,5309,4047,3,1
soap,soap,,591,528,1293,1119,2057,2412,3,1
estimation,estimation,,12,5,27,17,46,44,0,1
n-tier,n-tier,,0,4,7,4,8,11,3,300
code-layout,code-layout,,0,0,0,0,2,0,8,1
sockets,sockets,,1130,892,2180,2022,4692,4202,9,1
database-development,database-development,,2,2,3,4,11,7,4,1
factory-pattern,factory-pattern,,19,23,61,42,108,103,3,21.052632
validation,validation,,985,846,1984,1831,4319,3815,1,1
synchronization,synchronization,,199,165,413,364,790,777,3,1
code-quality,code-quality,,4,2,14,6,34,20,3,1
typescript,typescript,,7448,7159,13446,14607,22882,28053,1,1
organization,organization,,16,18,26,34,62,60,9,12.5
utilities,utilities,,3,1,2,4,8,6,3,1
domain-model,domain-model,,4,13,19,17,72,36,8,225
lazy-initialization,lazy-initialization,,16,15,27,31,59,58,3,1
redux,redux,,1539,1408,3158,2947,5927,6105,1,1
abstract-class,abstract-class,,113,88,177,201,420,378,9,1
type-casting,type-casting,,0,3,3,3,7,6,3,200
abstract-factory,abstract-factory,,5,3,11,8,22,19,3,1
requirements,requirements,,13,12,32,25,49,57,6,1
development-methodologies,development-methodologies,,1,1,1,2,7,3,6,1
readability,readability,,18,13,32,31,83,63,7,1
explicit,explicit,,7,3,19,10,23,29,9,1
openid,openid,,63,57,109,120,180,229,8,1
schema,schema,,175,155,346,330,517,676,4,1
factory,factory,,63,53,135,116,218,251,3,1
networking,networking,,815,752,1561,1567,2817,3128,9,1
email,email,,856,797,1873,1653,4206,3526,4,1
ftp,ftp,,227,194,439,421,973,860,4,1
trees,trees,,34,24,49,58,116,107,0,1
low-level,low-level,,6,19,28,25,38,53,9,216.666667
bitwise-operators,bitwise-operators,,55,45,109,100,257,209,9,1
cms,cms,,0,0,3,0,6,3,7,1
cdn,cdn,,48,61,147,109,208,256,1,27.083333
application-design,application-design,,10,1,12,11,25,23,3,1
angular2,angular2,,5,2,6,7,19,13,3,1
entity,entity,,140,90,231,230,463,461,3,1
relational-modelling,relational-modelling,,0,0,0,0,2,0,4,1
final,final,,24,21,44,45,101,89,3,1
software-distribution,software-distribution,,11,13,38,24,57,62,13,18.181818
wpf,wpf,,2447,2089,4766,4536,9995,9302,8,1
changes,changes,,0,0,0,0,3,0,3,1
boolean-logic,boolean-logic,,25,25,59,50,136,109,0,1
functional-requirements,functional-requirements,,0,0,3,0,4,3,6,1
production,production,,51,53,86,104,156,190,1,3.921569
environment,environment,,75,72,134,147,222,281,0,1
delegates,delegates,,144,127,272,271,604,543,13,1
mariadb,mariadb,,485,492,963,977,1664,1940,4,1.443299
product-backlog,product-backlog,,1,0,3,1,3,4,6,1
http-response,http-response,,0,3,3,3,8,6,3,200
front-end,front-end,,5,4,5,9,17,14,3,1
backend,backend,,164,153,370,317,511,687,4,1
bdd,bdd,,75,68,142,143,239,285,3,1
actor-model,actor-model,,6,6,3,12,8,15,2,1
akka,akka,,194,150,368,344,804,712,2,1
identity,identity,,74,65,117,139,225,256,8,1
message-passing,message-passing,,6,6,6,12,28,18,3,1
offline,offline,,64,46,98,110,214,208,1,1
mysql,mysql,,10851,9177,20938,20028,47379,40966,4,1
query,query,,2,2,3,4,12,7,4,1
language-agnostic,language-agnostic,,39,42,83,81,162,164,0,7.692308
namespace,namespace,,1,3,1,4,11,5,8,200
abstraction,abstraction,,27,25,36,52,82,88,9,1
rpc,rpc,,51,42,113,93,168,206,3,1
text-processing,text-processing,,62,42,87,104,158,191,9,1
text-encoding,text-encoding,,0,0,1,0,2,1,0,1
professional-development,professional-development,,0,0,0,0,2,0,3,1
desktop-development,desktop-development,,0,0,0,0,2,0,8,1
release-management,release-management,,16,14,38,30,115,68,6,1
semantic-versioning,semantic-versioning,,25,18,43,43,70,86,6,1
parallel-programming,parallel-programming,,2,2,1,4,5,5,3,1
modules,modules,,2,0,4,2,6,6,3,1
ioc-containers,ioc-containers,,2,1,3,3,7,6,8,1
planning,planning,,9,9,17,18,17,35,0,1
css,css,,13846,13236,26902,27082,60239,53984,1,1
package-managers,package-managers,,23,38,44,61,87,105,9,65.217391
computer-science,computer-science,,81,53,153,134,343,287,0,1
definition,definition,,24,43,52,67,87,119,9,79.166667
documentation,documentation,,113,89,199,202,297,401,0,1
polymorphism,polymorphism,,195,166,373,361,770,734,9,1
virtual-machine,virtual-machine,,209,181,489,390,749,879,6,1
business-logic,business-logic,,8,6,18,14,43,32,3,1
separation-of-concerns,separation-of-concerns,,5,2,17,7,34,24,3,1
apache-kafka,apache-kafka,,1296,1266,2293,2562,3764,4855,2,1
variables,variables,,909,760,1699,1669,3743,3368,0,1
declarations,declarations,,0,0,0,0,1,0,9,1
desktop-application,desktop-application,,70,68,130,138,256,268,8,1
language-design,language-design,,12,14,31,26,72,57,9,16.666667
c++11,c++11,,1001,899,2052,1900,5382,3952,9,1
elasticsearch,elasticsearch,,1560,1572,3045,3132,5092,6177,6,1
reference,reference,,277,224,543,501,1077,1044,9,1
conventions,conventions,,34,13,41,47,69,88,3,1
cpu,cpu,,99,91,209,190,408,399,9,1
io,io,,280,233,565,513,1207,1078,0,1
computer-architecture,computer-architecture,,20,22,58,42,87,100,9,10
communication,communication,,43,48,85,91,133,176,9,11.627907
async,async,,5,5,11,10,11,21,3,1
billing,billing,,22,19,37,41,59,78,4,1
swing,swing,,837,597,1543,1434,3598,2977,3,1
dependencies,dependencies,,329,294,569,623,1067,1192,3,1
service,service,,421,445,888,866,1830,1754,3,5.700713
dao,dao,,56,48,99,104,181,203,3,1
pci,pci,,5,13,19,18,39,37,9,160
asynchronous-programming,asynchronous-programming,,3,6,5,9,15,14,3,100
copyright,copyright,,0,0,1,0,8,1,6,1
forking,forking,,0,0,1,0,3,1,6,1
reverse-engineering,reverse-engineering,,74,82,153,156,263,309,9,10.810811
merging,merging,,1,1,2,2,5,4,6,1
plugins,plugins,,474,459,918,933,1563,1851,4,1
plugin-architecture,plugin-architecture,,2,2,4,4,6,8,3,1
design-by-contract,design-by-contract,,1,2,9,3,11,12,9,100
nhibernate,nhibernate,,65,56,145,121,372,266,8,1
encapsulation,encapsulation,,36,22,77,58,138,135,9,1
graph-traversal,graph-traversal,,31,22,48,53,101,101,0,1
a-star,a-star,,26,22,55,48,96,103,0,1
game-development,game-development,,122,99,179,221,150,400,8,1
storage,storage,,152,132,324,284,524,608,4,1
.net-core,.net-core,,2006,2226,3687,4232,4739,7919,8,10.967099
mvvm,mvvm,,539,513,1123,1052,2223,2175,8,1
service-locator,service-locator,,4,5,16,9,27,25,8,25
graph-databases,graph-databases,,58,52,122,110,316,232,2,1
tomcat,tomcat,,692,628,1550,1320,3051,2870,3,1
properties,properties,,269,223,558,492,1129,1050,3,1
setters,setters,,1,1,1,2,3,3,3,1
getters,getters,,2,1,3,3,4,6,3,1
rules-and-constraints,rules-and-constraints,,0,0,3,0,2,3,3,1
sql-server,sql-server,,6825,6190,13622,13015,28643,26637,4,1
iot,iot,,188,132,363,320,490,683,8,1
users,users,,8,5,14,13,42,27,7,1
unique-data,unique-data,,1,1,1,2,2,3,0,1
templates,templates,,919,808,1756,1727,4033,3483,9,1
data-modeling,data-modeling,,74,53,140,127,233,267,4,1
time,time,,614,515,1139,1129,2211,2268,0,1
rules-engine,rules-engine,,1,0,2,1,3,3,3,1
integration,integration,,121,126,260,247,364,507,3,4.132231
type-conversion,type-conversion,,246,253,534,499,1170,1033,0,2.845528
clang,clang,,223,223,456,446,782,902,9,1
pure-function,pure-function,,10,5,9,15,18,24,2,1
specifications,specifications,,35,42,71,77,103,148,3,20
angularjs,angularjs,,1898,1467,5100,3365,17104,8465,1,1
event,event,,4,0,6,4,10,10,3,1
binding,binding,,200,200,486,400,943,886,8,1
documentation-generation,documentation-generation,,11,16,34,27,60,61,0,45.454545
verification,verification,,40,31,63,71,136,134,4,1
cmmi,cmmi,,0,0,0,0,5,0,8,1
camel,camel,,0,0,1,0,1,1,3,1
mongo,mongo,,0,1,0,1,1,1,3,1
user-interface,user-interface,,920,809,1731,1729,3308,3460,3,1
loops,loops,,2232,1824,4293,4056,8350,8349,0,1
engineering,engineering,,1,1,5,2,13,7,3,1
pricing,pricing,,1,1,3,2,10,5,7,1
cqrs,cqrs,,44,74,139,118,241,257,8,68.181818
repository-pattern,repository-pattern,,50,39,106,89,240,195,8,1
method-chaining,method-chaining,,9,19,32,28,44,60,1,111.111111
smart-pointer,smart-pointer,,0,0,1,0,3,1,9,1
mit-license,mit-license,,0,0,1,0,5,1,3,1
pipelining,pipelining,,3,1,7,4,8,11,9,1
controller,controller,,304,251,595,555,1144,1150,4,1
website-performance,website-performance,,1,0,0,1,4,1,3,1
symfony,symfony,,1415,1063,2830,2478,6446,5308,4,1
drupal,drupal,,213,173,420,386,821,806,4,1
business-rules,business-rules,,7,10,21,17,43,38,3,42.857143
cross-browser,cross-browser,,94,79,201,173,378,374,1,1
local-storage,local-storage,,226,188,436,414,799,850,1,1
return-type,return-type,,31,29,60,60,127,120,9,1
update,update,,0,0,0,0,2,0,3,1
unity3d,unity3d,,2763,2481,4633,5244,7455,9877,8,1
diagrams,diagrams,,4,2,10,6,10,16,3,1
finite-state-machine,finite-state-machine,,2,1,7,3,5,10,3,1
failure,failure,,2,0,2,2,2,4,3,1
use-case,use-case,,22,11,39,33,66,72,3,1
class-design,class-design,,23,12,41,35,62,76,3,1
composition,composition,,40,26,73,66,123,139,9,1
overriding,overriding,,128,118,264,246,531,510,9,1
android,android,,26058,25695,53952,51753,109515,105705,3,1
gnu,gnu,,46,55,126,101,182,227,9,19.565217
nuget,nuget,,279,283,641,562,1279,1203,8,1.433692
domain-objects,domain-objects,,0,0,2,0,8,2,8,1
mvp,mvp,,41,48,83,89,197,172,3,17.073171
ajax,ajax,,3528,3198,7133,6726,16990,13859,1,1
gpl,gpl,,1,1,0,2,9,2,3,1
bug-report,bug-report,,1,1,0,2,3,2,6,1
middleware,middleware,,112,117,244,229,439,473,4,4.464286
code-contracts,code-contracts,,6,1,5,7,10,12,8,1
user-story,user-story,,3,2,15,5,12,20,6,1
kanban,kanban,,9,5,16,14,39,30,0,1
forms,forms,,1633,1413,3366,3046,7583,6412,1,1
code-reuse,code-reuse,,12,15,20,27,56,47,3,25
login,login,,389,60,850,449,1664,1299,4,1
user-control,user-control,,0,1,1,1,4,2,4,1
polling,polling,,34,24,64,58,102,122,3,1
online-identity,online-identity,,0,0,1,0,1,1,8,1
analytics,analytics,,107,85,235,192,442,427,5,1
winforms,winforms,,1418,1190,2930,2608,5390,5538,8,1
ui,ui,,5,1,2,6,9,8,3,1
javafx,javafx,,1347,924,2434,2271,4637,4705,3,1
npm,npm,,1748,1592,3436,3340,5955,6776,1,1
passwords,passwords,,183,133,382,316,733,698,4,1
comparison,comparison,,156,171,278,327,529,605,0,9.615385
type,type,,1,0,2,1,3,3,7,1
logic,logic,,190,149,400,339,802,739,0,1
negotiation,negotiation,,0,0,0,0,1,0,3,1
latency,latency,,24,21,56,45,102,101,6,1
test-management,test-management,,0,0,0,0,1,0,3,1
hooks,hooks,,0,0,1,0,2,1,0,1
path,path,,344,375,679,719,1368,1398,0,9.011628
social-networks,social-networks,,3,1,1,4,6,5,0,1
tracking,tracking,,36,44,87,80,142,167,4,22.222222
backward-compatibility,backward-compatibility,,1,0,1,1,5,2,6,1
abi,abi,,27,18,55,45,76,100,9,1
translate,translate,,43,43,92,86,135,178,1,1
state,state,,306,254,484,560,699,1044,1,1
sequence-diagram,sequence-diagram,,12,15,17,27,53,44,3,25
asynchronous,asynchronous,,1128,1100,2287,2228,4782,4515,8,1
problem-solving,problem-solving,,6,2,11,8,7,19,0,1
routing,routing,,408,357,821,765,1506,1586,1,1
url,url,,758,667,1502,1425,2812,2927,4,1
web-crawler,web-crawler,,216,194,466,410,785,876,0,1
permissions,permissions,,364,362,692,726,1332,1418,3,1
access-control,access-control,,33,30,59,63,120,122,4,1
compression,compression,,141,126,311,267,560,578,0,1
frameworks,frameworks,,209,179,364,388,695,752,13,1
lamp,lamp,,28,31,73,59,147,132,4,10.714286
eventual-consistency,eventual-consistency,,10,7,18,17,42,35,3,1
runtime,runtime,,139,118,264,257,482,521,3,1
graphql,graphql,,1015,1076,1610,2091,2002,3701,1,6.009852
ranking-systems,ranking-systems,,0,0,0,0,3,0,4,1
trie,trie,,30,31,38,61,95,99,0,3.333333
modularization,modularization,,5,4,11,9,13,20,3,1
mobile,mobile,,480,455,986,935,1853,1921,1,1
serialization,serialization,,504,501,965,1005,2198,1970,8,1
applications,applications,,17,6,24,23,19,47,0,1
apache-license,apache-license,,0,0,1,0,1,1,6,1
compile-time,compile-time,,12,17,37,29,59,66,9,41.666667
value-object,value-object,,0,1,2,1,6,3,3,1
modeling,modeling,,59,40,106,99,181,205,0,1
naming-standards,naming-standards,,3,2,7,5,16,12,3,1
concepts,concepts,,1,3,7,4,23,11,0,200
lexer,lexer,,14,14,40,28,74,68,0,1
closed-source,closed-source,,0,0,0,0,1,0,6,1
copy-protection,copy-protection,,1,2,2,3,7,5,4,100
if-statement,if-statement,,1209,1109,2562,2318,5077,4880,0,1
junior-programmer,junior-programmer,,1,1,3,2,5,5,6,1
cli,cli,,3,1,4,4,3,8,3,1
unit-of-work,unit-of-work,,15,12,36,27,82,63,8,1
development-environment,development-environment,,33,43,91,76,143,167,1,30.30303
build-system,build-system,,10,9,25,19,48,44,9,1
requirements-management,requirements-management,,2,1,8,3,3,11,6,1
microsoft,microsoft,,0,0,3,0,3,3,8,1
oracle,oracle,,3478,2958,6459,6436,12751,12895,4,1
xcode,xcode,,2276,2459,4747,4735,10298,9482,13,8.040422
order,order,,1,1,2,2,7,4,7,1
builds,builds,,6,2,6,8,17,14,6,1
xamarin,xamarin,,1474,1381,3347,2855,7719,6202,8,1
certificate,certificate,,256,267,501,523,725,1024,6,4.296875
integration-testing,integration-testing,,180,193,353,373,601,726,3,7.222222
systems,systems,,0,0,0,0,2,0,3,1
file-structure,file-structure,,6,9,12,15,24,27,0,50
diff,diff,,53,55,137,108,297,245,6,3.773585
natural-language-processing,natural-language-processing,,107,35,129,142,90,271,0,1
monad,monad,,1,1,0,2,1,2,8,1
code-security,code-security,,1,0,7,1,10,8,4,1
pthreads,pthreads,,162,120,280,282,555,562,9,1
access-modifiers,access-modifiers,,23,11,42,34,60,76,9,1
class-diagram,class-diagram,,39,31,53,70,104,123,3,1
dictionary,dictionary,,1819,1707,3528,3526,7174,7054,0,1
roles,roles,,82,86,146,168,164,314,4,4.878049
image-processing,image-processing,,928,960,1685,1888,3205,3573,0,3.448276
team,team,,1,3,3,4,10,7,6,200
third-party-libraries,third-party-libraries,,2,1,3,3,10,6,3,1
binary-tree,binary-tree,,113,97,258,210,465,468,0,1
postfix,postfix,,0,0,0,0,118,0,4,1
legacy-code,legacy-code,,13,9,23,22,31,45,9,1
files,files,,3,1,6,4,11,10,7,1
settings,settings,,83,90,203,173,346,376,3,8.433735
windows-registry,windows-registry,,0,0,0,0,2,0,3,1
phpunit,phpunit,,190,190,357,380,793,737,4,1
branching,branching,,8,5,11,13,13,24,6,1
configuration-management,configuration-management,,6,5,28,11,46,39,6,1
information,information,,3,3,1,6,9,7,7,1
chess,chess,,27,19,58,46,83,104,0,1
metrics,metrics,,99,79,181,178,225,359,0,1
contract,contract,,11,7,29,18,49,47,6,1
memcached,memcached,,45,54,111,99,207,210,4,20
mixins,mixins,,48,43,93,91,155,184,1,1
functional-testing,functional-testing,,21,17,41,38,101,79,3,1
locks,locks,,13,4,24,17,30,41,3,1
jdbc,jdbc,,632,575,1253,1207,2711,2460,3,1
macros,macros,,177,180,352,357,846,709,9,1.694915
fortran,fortran,,241,224,430,465,1002,895,9,1
commercial,commercial,,0,0,0,0,2,0,6,1
report-generation,report-generation,,0,0,0,0,1,0,4,1
multiprocessing,multiprocessing,,421,467,770,888,1280,1658,0,10.926366
operators,operators,,113,118,231,231,469,462,9,4.424779
distributed-computing,distributed-computing,,68,73,111,141,294,252,3,7.352941
redis,redis,,669,647,1292,1316,2065,2608,3,1
firmware,firmware,,10,18,34,28,50,62,9,80
release,release,,75,64,143,139,249,282,3,1
technology,technology,,0,0,1,0,4,1,0,1
resources,resources,,117,99,219,216,458,435,3,1
system-architecture,system-architecture,,1,0,6,1,13,7,3,1
data-flow-diagram,data-flow-diagram,,0,1,1,1,2,2,3,1
client-relations,client-relations,,0,0,1,0,3,1,6,1
numbers,numbers,,203,145,433,348,884,781,0,1
android-development,android-development,,4,1,7,5,11,12,3,1
gradle,gradle,,1457,1561,3108,3018,5708,6126,3,7.137955
server-side,server-side,,48,44,107,92,175,199,1,1
control-structures,control-structures,,0,0,1,0,3,1,3,1
principles,principles,,4,0,1,4,7,5,3,1
transaction,transaction,,5,0,6,5,12,11,3,1
sdlc,sdlc,,2,3,2,5,3,7,6,50
legacy,legacy,,12,8,22,20,52,42,3,1
systems-analysis,systems-analysis,,0,1,4,1,4,5,6,1
rule-of-three,rule-of-three,,2,1,2,3,9,5,9,1
code-generation,code-generation,,40,45,101,85,185,186,3,12.5
self-improvement,self-improvement,,0,0,0,0,3,0,6,1
acceptance-testing,acceptance-testing,,5,9,21,14,51,35,3,80
development,development,,0,0,2,0,4,2,3,1
jvm,jvm,,229,201,471,430,910,901,3,1
multi-platform,multi-platform,,0,0,0,0,3,0,3,1
google-maps,google-maps,,921,950,2027,1871,5247,3898,1,3.148751
type-safety,type-safety,,6,7,24,13,43,37,9,16.666667
syntax,syntax,,310,266,672,576,1410,1248,0,1
parallelism,parallelism,,1,0,2,1,12,3,3,1
scaling,scaling,,49,35,106,84,167,190,0,1
webpack,webpack,,1806,1663,3675,3469,7264,7144,1,1
cross-platform,cross-platform,,104,110,210,214,391,424,8,5.769231
portability,portability,,20,8,34,28,66,62,9,1
pattern-matching,pattern-matching,,116,154,358,270,811,628,0,32.758621
networks,networks,,2,0,1,2,1,3,4,1
arm,arm,,250,203,506,453,879,959,9,1
endianness,endianness,,26,34,72,60,135,132,9,30.769231
hexadecimal,hexadecimal,,0,0,1,0,1,1,9,1
change-management,change-management,,2,3,4,5,7,9,6,50
adapter,adapter,,87,67,173,154,391,327,3,1
service-bus,service-bus,,0,3,0,3,2,3,3,200
asp.net-mvc-web-api,asp.net-mvc-web-api,,1,1,11,2,9,13,8,1
codefirst,codefirst,,0,0,0,0,2,0,8,1
svn,svn,,148,143,388,291,773,679,6,1
scm,scm,,1,1,1,2,4,3,6,1
ssl,ssl,,1164,1093,2466,2257,4732,4723,6,1
groovy,groovy,,641,644,1252,1285,2682,2537,3,1
constants,constants,,58,59,136,117,267,253,9,1.724138
vba,vba,,6119,6316,10817,12435,23159,23252,5,3.21948
issue-tracking,issue-tracking,,5,9,18,14,44,32,6,80
gtest,gtest,,1,0,1,1,2,2,9,1
bug,bug,,0,1,1,1,6,2,6,1
saml,saml,,115,127,215,242,339,457,8,10.434783
xsd,xsd,,188,173,387,361,798,748,3,1
java-ee,java-ee,,388,287,807,675,1390,1482,3,1
maven,maven,,1872,1707,3907,3579,7865,7486,3,1
data-replication,data-replication,,0,0,0,0,2,0,4,1
vb.net,vb.net,,1630,1504,3153,3134,6672,6287,8,1
financial,financial,,8,0,20,8,61,28,0,1
swift-language,swift-language,,5,2,4,7,7,11,3,1
facade,facade,,6,4,12,10,30,22,3,1
builder-pattern,builder-pattern,,9,8,9,17,25,26,3,1
socket.io,socket.io,,576,531,1208,1107,1907,2315,1,1
migration,migration,,253,240,499,493,856,992,4,1
test-scenarios,test-scenarios,,1,0,1,1,2,2,3,1
multiple-inheritance,multiple-inheritance,,53,49,93,102,213,195,9,1
benchmarking,benchmarking,,92,62,123,154,238,277,0,1
reference-counting,reference-counting,,6,9,12,15,26,27,9,50
sqlite,sqlite,,1711,1480,3468,3191,6716,6659,3,1
code-reviews,code-reviews,,4,7,12,11,14,23,3,75
pull-requests,pull-requests,,4,2,3,6,6,9,6,1
wording,wording,,3,4,6,7,13,13,7,33.333333
file-handling,file-handling,,71,67,128,138,292,266,0,1
surrogate-keys,surrogate-keys,,0,0,1,0,1,1,3,1
decorator,decorator,,122,108,210,230,409,440,0,1
pagination,pagination,,315,330,700,645,1393,1345,4,4.761905
cqs,cqs,,0,1,2,1,4,3,3,1
support,support,,0,0,0,0,4,0,6,1
default-values,default-values,,0,2,1,2,5,3,3,100
qa,qa,,48,47,101,95,122,196,3,1
turing-completeness,turing-completeness,,4,9,14,13,9,27,0,125
rewrite,rewrite,,0,1,3,1,3,4,3,1
polyglot,polyglot,,4,2,9,6,10,15,0,1
evidence-based,evidence-based,,0,0,0,0,1,0,8,1
color,color,,12,9,12,21,31,33,7,1
multitasking,multitasking,,9,11,15,20,49,35,8,22.222222
sms,sms,,122,102,262,224,423,486,3,1
recursion,recursion,,1014,748,1987,1762,3863,3749,0,1
invariants,invariants,,7,1,9,8,13,17,8,1
design-principles,design-principles,,7,5,23,12,27,35,3,1
generic-programming,generic-programming,,40,32,91,72,164,163,9,1
strategy,strategy,,0,1,6,1,9,7,3,1
common-lisp,common-lisp,,108,85,191,193,360,384,0,1
osgi,osgi,,86,77,168,163,379,331,3,1
extjs,extjs,,136,105,379,241,957,620,1,1
haskell,haskell,,674,492,1369,1166,3268,2535,2,1
non-determinism,non-determinism,,0,0,0,0,1,0,2,1
deadlines,deadlines,,0,2,5,2,6,7,3,100
esb,esb,,21,14,51,35,106,86,3,1
load-balancing,load-balancing,,132,134,273,266,449,539,6,1.515152
component,component,,7,2,1,9,18,10,3,1
random,random,,577,447,1264,1024,2699,2288,0,1
clojure,clojure,,129,122,351,251,794,602,2,1
subclassing,subclassing,,9,10,21,19,55,40,9,11.111111
x86,x86,,393,291,727,684,1333,1411,9,1
cookies,cookies,,611,575,1229,1186,2430,2415,4,1
high-performance,high-performance,,0,0,1,0,3,1,3,1
es6,es6,,0,0,1,0,6,1,1,1
cluster,cluster,,2,2,4,4,5,8,3,1
asp.net-mvc-4,asp.net-mvc-4,,192,137,419,329,1212,748,8,1
quality,quality,,0,0,1,0,1,1,6,1
startup,startup,,50,40,113,90,198,203,8,1
law-of-demeter,law-of-demeter,,0,0,4,0,11,4,3,1
callbacks,callbacks,,1,1,3,2,2,5,3,1
const,const,,91,93,198,184,417,382,9,2.197802
formatting,formatting,,224,223,464,447,969,911,0,1
powershell,powershell,,2521,2421,4582,4942,8858,9524,8,1
arithmetic,arithmetic,,4,7,14,11,22,25,0,75
project,project,,94,79,179,173,282,352,3,1
cvs,cvs,,4,6,9,10,27,19,6,50
stub,stub,,28,25,52,53,98,105,1,1
hexagonal-architecture,hexagonal-architecture,,1,5,11,6,12,17,3,400
browser,browser,,430,430,859,860,1455,1719,1,1
objective-c,objective-c,,1106,893,2374,1999,7494,4373,13,1
dispatch,dispatch,,16,29,46,45,95,91,1,81.25
dll,dll,,354,343,745,697,1563,1442,8,1
big-data,big-data,,1,1,10,2,13,12,0,1
keywords,keywords,,0,0,0,0,4,0,3,1
rdbms,rdbms,,47,46,121,93,245,214,4,1
feedback,feedback,,7,2,15,9,40,24,7,1
playframework,playframework,,186,190,439,376,1125,815,2,2.150538
pdf,pdf,,1089,1076,1983,2165,4264,4148,8,1
solo-development,solo-development,,0,0,0,0,2,0,6,1
linq,linq,,1180,1059,2328,2239,5295,4567,8,1
method-overloading,method-overloading,,1,0,3,1,2,4,3,1
unicode,unicode,,372,328,714,700,1762,1414,0,1
localization,localization,,202,183,408,385,829,793,13,1
assertions,assertions,,3,0,0,3,101,3,3,1
crud,crud,,124,105,201,229,359,430,4,1
image-manipulation,image-manipulation,,10,13,36,23,51,59,12,30
software-updates,software-updates,,0,0,5,0,1,5,6,1
qt,qt,,1484,1333,2783,2817,6613,5600,9,1
jpa,jpa,,1225,1208,2060,2433,4030,4493,3,1
nunit,nunit,,153,122,281,275,507,556,8,1
register,register,,1,0,1,1,1,2,9,1
entry-point,entry-point,,15,10,21,25,29,46,9,1
queueing,queueing,,4,1,3,5,7,8,3,1
regular-expressions,regular-expressions,,19,15,59,34,78,93,0,1
procedural,procedural,,5,6,7,11,25,18,4,20
speed,speed,,4,0,4,4,7,8,0,1
sql-azure,sql-azure,,2,1,0,3,1,3,4,1
stl,stl,,157,166,335,323,833,658,9,5.732484
programming-logic,programming-logic,,1,0,0,1,5,1,9,1
observer-pattern,observer-pattern,,26,20,54,46,111,100,3,1
3rd-party,3rd-party,,0,0,1,0,2,1,3,1
p2p,p2p,,36,37,78,73,126,151,9,2.777778
floating-point,floating-point,,262,235,513,497,1102,1010,0,1
error-messages,error-messages,,1,1,5,2,3,7,3,1
huffman-encoding,huffman-encoding,,0,0,0,0,1,0,0,1
mainframe,mainframe,,28,29,62,57,106,119,4,3.571429
text-editor,text-editor,,33,20,70,53,126,123,1,1
collections,collections,,410,378,840,788,1724,1628,3,1
e-commerce,e-commerce,,95,81,193,176,343,369,4,1
instance,instance,,97,96,197,193,364,390,9,1
maintainability,maintainability,,8,6,13,14,21,27,3,1
bsd-license,bsd-license,,0,0,0,0,3,0,3,1
command-message,command-message,,0,0,0,0,2,0,3,1
unit-test-data,unit-test-data,,0,0,2,0,2,2,1,1
session,session,,605,538,1354,1143,2802,2497,4,1
facebook,facebook,,642,619,1443,1261,3630,2704,13,1
oauth,oauth,,362,363,755,725,1334,1480,4,1
cohesion,cohesion,,0,0,5,0,3,5,3,1
iso,iso,,25,14,41,39,63,80,0,1
grammar,grammar,,60,40,109,100,201,209,0,1
languages,languages,,2,0,3,2,3,5,0,1
directory-structure,directory-structure,,32,33,60,65,97,125,0,3.125
cmake,cmake,,648,724,1363,1372,2464,2735,9,11.728395
hierarchy,hierarchy,,60,41,89,101,191,190,4,1
end-to-end,end-to-end,,17,21,23,38,62,61,3,23.529412
import,import,,591,586,1077,1177,2107,2254,0,1
process,process,,309,273,648,582,1142,1230,9,1
promises,promises,,0,1,3,1,3,4,1,1
side-effect,side-effect,,2,2,1,4,2,5,3,1
chat,chat,,96,89,211,185,412,396,3,1
code-sample,code-sample,,0,0,0,0,1,0,3,1
generics,generics,,900,739,1749,1639,3703,3388,3,1
linux-kernel,linux-kernel,,350,310,651,660,1247,1311,9,1
https,https,,586,575,1314,1161,2422,2475,4,1
dynamic-linking,dynamic-linking,,37,23,60,60,112,120,9,1
delphi,delphi,,518,438,1098,956,2225,2054,9,1
extensibility,extensibility,,3,0,9,3,10,12,8,1
linked-list,linked-list,,381,279,706,660,1410,1366,9,1
user-experience,user-experience,,30,25,65,55,123,120,1,1
bios,bios,,24,16,41,40,62,81,9,1
interpreters,interpreters,,1,1,8,2,5,10,9,1
bootstrap,bootstrap,,2,2,4,4,6,8,7,1
product,product,,175,88,345,263,672,608,4,1
subtypes,subtypes,,0,0,0,0,2,0,3,1
couchdb,couchdb,,73,75,185,148,419,333,1,2.739726
dapper,dapper,,108,93,169,201,342,370,8,1
video,video,,491,495,1060,986,2434,2046,13,1
servlet,servlet,,2,0,0,2,1,2,3,1
specflow,specflow,,63,52,90,115,217,205,8,1
selenium-webdriver,selenium-webdriver,,1450,1529,2812,2979,5864,5791,3,5.448276
blockchain,blockchain,,328,237,581,565,1092,1146,6,1
activerecord,activerecord,,292,235,667,527,1558,1194,12,1
closures,closures,,158,162,334,320,710,654,13,2.531646
geometry,geometry,,199,188,408,387,799,795,0,1
hmac,hmac,,25,31,62,56,152,118,6,24
uri,uri,,111,128,242,239,404,481,3,15.315315
backlog,backlog,,0,2,7,2,18,9,8,100
ado.net,ado.net,,109,93,207,202,482,409,8,1
iis,iis,,719,693,1407,1412,2749,2819,8,1
bit,bit,,60,52,161,112,194,273,9,1
uwp,uwp,,770,696,1734,1466,4105,3200,8,1
data-access,data-access,,3,4,7,7,8,14,8,33.333333
combinatorics,combinatorics,,62,55,122,117,283,239,0,1
posix,posix,,107,99,197,206,430,403,9,1
semaphore,semaphore,,70,45,117,115,238,232,9,1
mutex,mutex,,88,81,181,169,372,350,9,1
strategy-pattern,strategy-pattern,,7,14,24,21,47,45,3,100
react-native,react-native,,5190,5745,10322,10935,15305,21257,1,10.693642
enterprise-development,enterprise-development,,2,0,2,2,2,4,3,1
ethics,ethics,,5,2,8,7,18,15,0,1
proprietary,proprietary,,1,0,0,1,1,1,9,1
behavior,behavior,,14,14,18,28,59,46,8,1
presentation,presentation,,7,7,20,14,29,34,0,1
rabbitmq,rabbitmq,,424,425,810,849,1357,1659,3,1
cyclomatic-complexity,cyclomatic-complexity,,6,4,13,10,19,23,3,1
meta-programming,meta-programming,,1,0,2,1,2,3,9,1
operator-precedence,operator-precedence,,26,18,77,44,123,121,9,1
spreadsheet,spreadsheet,,46,46,191,92,298,283,5,1
games,games,,1,0,4,1,8,5,0,1
quality-attributes,quality-attributes,,0,0,1,0,1,1,6,1
razor,razor,,557,483,1079,1040,2190,2119,8,1
government,government,,3,0,6,3,16,9,0,1
virtual-functions,virtual-functions,,28,26,38,54,93,92,9,1
help-documentation,help-documentation,,0,0,0,0,2,0,0,1
porting,porting,,19,17,30,36,50,66,9,1
visual-c++,visual-c++,,433,339,829,772,1498,1601,9,1
path-finding,path-finding,,33,32,73,65,108,138,0,1
blob,blob,,185,181,360,366,651,726,1,1
fonts,fonts,,301,345,675,646,1467,1321,1,14.61794
development-approach,development-approach,,2,1,0,3,2,3,3,1
domain-specific-languages,domain-specific-languages,,0,2,3,2,1,5,2,100
outsourcing,outsourcing,,0,0,0,0,1,0,3,1
xunit,xunit,,136,133,204,269,285,473,8,1
seo,seo,,64,57,91,121,187,212,4,1
dogfooding,dogfooding,,0,0,0,0,1,0,4,1
activity,activity,,0,0,5,0,2,5,3,1
domain-name-system,domain-name-system,,0,0,0,0,1,0,3,1
product-owner,product-owner,,1,0,2,1,2,3,6,1
language-choice,language-choice,,0,0,0,0,1,0,2,1
defensive-programming,defensive-programming,,2,1,3,3,8,6,3,1
graphics,graphics,,258,226,663,484,1071,1147,0,1
compilation,compilation,,289,274,670,563,1220,1233,9,1
client-side,client-side,,12,19,58,31,88,89,1,58.333333
code-metrics,code-metrics,,4,4,10,8,12,18,8,1
entity-component-system,entity-component-system,,9,9,18,18,14,36,9,1
phpstorm,phpstorm,,140,106,302,246,702,548,4,1
secure-coding,secure-coding,,0,3,9,3,11,12,4,200
dynamic-typing,dynamic-typing,,7,5,6,12,16,18,9,1
poco,poco,,17,8,23,25,61,48,9,1
static-keyword,static-keyword,,0,0,0,0,1,0,3,1
windows-10,windows-10,,447,441,878,888,1671,1766,8,1
customer-relations,customer-relations,,0,3,1,3,2,4,6,200
technical-support,technical-support,,0,0,0,0,1,0,6,1
msbuild,msbuild,,234,213,509,447,1168,956,8,1
designer,designer,,13,15,24,28,41,52,8,15.384615
copy-paste-programming,copy-paste-programming,,0,1,0,1,1,1,9,1
visual-basic-6,visual-basic-6,,0,0,0,0,1,0,1,1
ninject,ninject,,35,28,57,63,174,120,8,1
beta,beta,,9,39,28,48,63,76,13,333.333333
opengl,opengl,,504,478,1091,982,1975,2073,9,1
include,include,,106,105,234,211,500,445,9,1
google-app-engine,google-app-engine,,518,456,1204,974,2532,2178,6,1
static-typing,static-typing,,11,8,24,19,42,43,9,1
golang,golang,,0,0,3,0,2,3,3,1
managed-code,managed-code,,0,0,1,0,4,1,8,1
native,native,,130,120,260,250,421,510,1,1
construction,construction,,2,1,3,3,8,6,9,1
decisions,decisions,,0,0,2,0,1,2,3,1
system-reliability,system-reliability,,1,1,1,2,1,3,3,1
clr,clr,,67,53,87,120,207,207,8,1
visitor-pattern,visitor-pattern,,7,4,12,11,23,23,3,1
selenium,selenium,,2856,2992,5477,5848,11336,11325,3,4.761905
dependency-analysis,dependency-analysis,,0,0,2,0,2,2,3,1
design-decisions,design-decisions,,1,0,3,1,11,4,3,1
efcore,efcore,,2,0,3,2,2,5,8,1
error-detection,error-detection,,2,2,3,4,10,7,9,1
static-access,static-access,,0,0,2,0,2,2,3,1
stored-procedures,stored-procedures,,556,555,1108,1111,2775,2219,4,1
reading-code,reading-code,,0,0,0,0,2,0,9,1
trait,trait,,0,0,2,0,2,2,3,1
string-matching,string-matching,,54,50,93,104,181,197,0,1
iphone,iphone,,410,405,1219,815,3426,2034,13,1
apple,apple,,0,2,1,2,3,3,13,100
meetings,meetings,,0,1,0,1,1,1,6,1
ecmascript,ecmascript,,1,0,2,1,2,3,3,1
extension-method,extension-method,,1,0,4,1,1,5,8,1
crm,crm,,61,65,96,126,196,222,8,6.557377
eai,eai,,1,0,1,1,7,2,3,1
imperative-programming,imperative-programming,,7,2,7,9,13,16,2,1
declarative-programming,declarative-programming,,8,1,4,9,2,13,3,1
division-of-labor,division-of-labor,,0,0,0,0,1,0,6,1
cross-language,cross-language,,4,1,8,5,7,13,9,1
jit,jit,,30,34,76,64,137,140,0,13.333333
mentor,mentor,,0,0,0,0,1,0,6,1
shell,shell,,1782,1685,3438,3467,7698,6905,9,1
webgl,webgl,,125,73,218,198,468,416,1,1
captcha,captcha,,43,41,104,84,144,188,4,1
data-integrity,data-integrity,,4,3,12,7,18,19,4,1
multiple-dispatch,multiple-dispatch,,0,1,4,1,7,5,9,1
character-encoding,character-encoding,,245,204,477,449,1007,926,0,1
spark,spark,,1,1,4,2,1,6,3,1
canvas,canvas,,631,500,1141,1131,2647,2272,1,1
microsoft-access,microsoft-access,,1,0,1,1,1,2,4,1
stackoverflow,stackoverflow,,0,0,0,0,1,0,8,1
downtime,downtime,,4,3,11,7,6,18,4,1
dataflow,dataflow,,41,44,98,85,123,183,6,7.317073
higher-order-functions,higher-order-functions,,40,43,75,83,138,158,2,7.5
goto,goto,,12,9,31,21,64,52,9,1
continuation,continuation,,0,0,0,0,6,0,0,1
stack-oriented,stack-oriented,,0,0,0,0,1,0,0,1
forth,forth,,0,1,13,1,27,14,9,1
virtualization,virtualization,,35,37,110,72,176,182,6,5.714286
business-process,business-process,,1,0,4,1,1,5,3,1
heroku,heroku,,964,877,1866,1841,3332,3707,1,1
industry-standard,industry-standard,,0,1,1,1,1,2,6,1
submodules,submodules,,0,1,4,1,1,5,6,1
cryptography,cryptography,,310,255,561,565,1157,1126,6,1
linking,linking,,0,0,2,0,2,2,9,1
static-linking,static-linking,,42,24,60,66,105,126,9,1
polyfill,polyfill,,0,0,0,0,1,0,1,1
bash,bash,,3133,2877,5931,6010,12828,11941,9,1
semantics,semantics,,30,26,57,56,96,113,0,1
ontology,ontology,,37,41,89,78,211,167,2,10.810811
mongoose,mongoose,,1544,1413,2888,2957,4743,5845,1,1
hateoas,hateoas,,15,9,36,24,48,60,3,1
gui-design,gui-design,,46,47,87,93,183,180,7,2.173913
yii,yii,,75,61,160,136,516,296,4,1
cakephp,cakephp,,207,163,460,370,1214,830,4,1
unix,unix,,663,573,1506,1236,3255,2742,9,1
switch-statement,switch-statement,,222,153,427,375,885,802,3,1
team-leader,team-leader,,0,0,1,0,1,1,6,1
geolocation,geolocation,,242,239,494,481,866,975,3,1
dvcs,dvcs,,1,1,11,2,18,13,6,1
single-page-apps,single-page-apps,,0,3,4,3,3,7,3,200
measurement,measurement,,5,13,21,18,30,39,0,160
non-functional,non-functional,,1,0,3,1,1,4,6,1
server-security,server-security,,1,0,2,1,1,3,4,1
high-level,high-level,,1,2,3,3,5,6,3,100
aspect-oriented,aspect-oriented,,1,0,0,1,1,1,8,1
load-testing,load-testing,,73,80,157,153,309,310,3,9.589041
stress-testing,stress-testing,,7,8,21,15,57,36,3,14.285714
team-building,team-building,,1,0,0,1,4,1,6,1
bytecode,bytecode,,30,37,59,67,173,126,3,23.333333
visual-studio-2010,visual-studio-2010,,59,61,165,120,351,285,8,3.389831
computation-expressions,computation-expressions,,1,2,0,3,1,3,0,100
service-workers,service-workers,,0,1,0,1,1,1,8,1
flux,flux,,30,18,62,48,104,110,1,1
uuid,uuid,,80,65,151,145,256,296,4,1
eclipse,eclipse,,1330,1066,2810,2396,6190,5206,3,1
manual-testing,manual-testing,,1,8,4,9,10,13,3,700
delivery,delivery,,0,0,0,0,1,0,6,1
install,install,,189,140,322,329,696,651,0,1
editor-navigation,editor-navigation,,0,0,0,0,1,0,1,1
packages,packages,,3,2,4,5,484,9,0,1
read-only,read-only,,0,0,0,0,1,0,3,1
erlang,erlang,,83,88,217,171,520,388,2,6.024096
data-binding,data-binding,,351,317,721,668,1558,1389,8,1
usage-statistics,usage-statistics,,9,6,12,15,45,27,3,1
xaml,xaml,,878,768,1735,1646,4228,3381,8,1
raii,raii,,5,8,13,13,31,26,9,60
stories,stories,,0,0,0,0,1,0,6,1
business,business,,4,0,4,4,7,8,0,1
db2,db2,,268,257,611,525,1108,1136,4,1
abac,abac,,10,9,21,19,53,40,4,1
rbac,rbac,,38,33,86,71,93,157,6,1
culture,culture,,8,8,32,16,73,48,8,1
operations,operations,,2,1,5,3,39,8,0,1
flowchart,flowchart,,19,12,31,31,48,62,1,1
automata,automata,,79,51,157,130,230,287,0,1
lgpl,lgpl,,1,0,1,1,1,2,3,1
review,review,,13,17,34,30,43,64,13,30.769231
dom,dom,,757,623,1281,1380,2616,2661,1,1
struct,struct,,570,437,1119,1007,2478,2126,9,1
apache2,apache2,,183,148,345,331,532,676,4,1
web-framework,web-framework,,1,0,2,1,1,3,3,1
codeigniter,codeigniter,,991,1070,2238,2061,5353,4299,4,7.971746
technical-debt,technical-debt,,2,0,3,2,3,5,6,1
web-servers,web-servers,,0,1,1,1,2,2,3,1
byte,byte,,150,163,343,313,567,656,0,8.666667
cassandra,cassandra,,358,308,833,666,1933,1499,2,1
app,app,,2,1,7,3,9,10,7,1
ubuntu,ubuntu,,1307,1169,2566,2476,5273,5042,9,1
burndown,burndown,,1,0,1,1,3,2,6,1
multilingual,multilingual,,51,55,110,106,241,216,4,7.843137
rate-limiting,rate-limiting,,24,43,43,67,84,110,4,79.166667
virtual-inheritance,virtual-inheritance,,7,10,10,17,27,27,9,42.857143
feature-requests,feature-requests,,0,0,1,0,1,1,6,1
sqlalchemy,sqlalchemy,,650,610,1140,1260,1862,2400,0,1
swagger,swagger,,471,513,951,984,1412,1935,3,8.917197
software-craftsmanship,software-craftsmanship,,1,0,1,1,1,2,3,1
undefined-behavior,undefined-behavior,,44,62,101,106,193,207,9,40.909091
intellectual-property,intellectual-property,,0,0,0,0,1,0,3,1
bad-code,bad-code,,0,0,2,0,1,2,3,1
interoperability,interoperability,,0,0,4,0,2,4,3,1
remote-desktop,remote-desktop,,31,25,65,56,109,121,8,1
writing,writing,,13,13,12,26,43,38,0,1
doctrine,doctrine,,276,247,534,523,973,1057,4,1
task-organization,task-organization,,1,1,0,2,1,2,6,1
task,task,,224,156,434,380,821,814,8,1
control-flow,control-flow,,16,12,19,28,65,47,0,1
paas,paas,,5,2,14,7,45,21,8,1
vaadin,vaadin,,131,97,250,228,536,478,3,1
projects-and-solutions,projects-and-solutions,,5,11,25,16,48,41,8,120
sharding,sharding,,30,39,70,69,121,139,1,30
web-browser,web-browser,,1,1,0,2,1,2,3,1
system,system,,76,62,162,138,294,300,9,1
attributes,attributes,,248,208,450,456,947,906,1,1
journal,journal,,4,7,12,11,16,23,9,75
strong-typing,strong-typing,,7,4,13,11,24,24,9,1
sso,sso,,2,0,3,2,1,5,4,1
utf-8,utf-8,,326,292,636,618,1586,1254,0,1
mac,mac,,0,0,0,0,1,0,0,1
wikipedia,wikipedia,,35,24,72,59,118,131,0,1
type-theory,type-theory,,17,25,48,42,75,90,2,47.058824
3d,3d,,315,294,673,609,1158,1282,0,1
rendering,rendering,,134,111,241,245,413,486,1,1
filtering,filtering,,190,150,337,340,637,677,0,1
recruiting,recruiting,,0,0,0,0,1,0,9,1
upload,upload,,255,200,475,455,877,930,4,1
jsf,jsf,,307,269,638,576,1395,1214,3,1
dsl,dsl,,54,34,110,88,154,198,3,1
specialization,specialization,,7,7,11,14,25,25,9,1
lucene,lucene,,138,123,309,261,694,570,2,1
solr,solr,,315,254,615,569,1197,1184,2,1
spring-boot,spring-boot,,6454,6100,11762,12554,16832,24316,3,1
structured-programming,structured-programming,,0,0,0,0,3,0,0,1
agpl,agpl,,0,0,0,0,1,0,3,1
tests,tests,,1,0,1,1,2,2,1,1
boundaries,boundaries,,0,0,1,0,1,1,8,1
payment,payment,,61,76,132,137,251,269,4,24.590164
bundling,bundling,,0,0,1,0,1,1,3,1
jsp,jsp,,725,522,1209,1247,2872,2456,3,1
wordpress,wordpress,,5032,4646,10268,9678,17826,19946,4,1
syntax-highlight,syntax-highlight,,0,0,0,0,1,0,0,1
linguistics,linguistics,,4,7,17,11,24,28,0,75
ascii,ascii,,111,113,265,224,522,489,0,1.801802
asm,asm,,0,0,0,0,1,0,9,1
mutable,mutable,,21,18,47,39,89,86,0,1
ocaml,ocaml,,95,55,298,150,470,448,0,1
producer-consumer,producer-consumer,,37,37,71,74,142,145,3,1
json-schema,json-schema,,1,0,2,1,1,3,1,1
profiling,profiling,,76,96,175,172,362,347,9,26.315789
platforms,platforms,,0,0,0,0,1,0,6,1
program,program,,0,0,0,0,1,0,9,1
llvm,llvm,,111,127,248,238,432,486,9,14.414414
scaled-agile-framework,scaled-agile-framework,,0,0,3,0,0,3,6,1
open-close,open-close,,0,0,2,0,0,2,3,1
sap,sap,,271,285,498,556,837,1054,5,5.166052
bpmn,bpmn,,36,29,62,65,89,127,3,1
coding,coding,,0,1,2,1,0,3,3,1
prototyping,prototyping,,5,1,7,6,11,13,7,1
compatibility,compatibility,,35,22,73,57,154,130,3,1
ssis,ssis,,502,476,903,978,1792,1881,4,1
duplicate-keys,duplicate-keys,,0,0,1,0,0,1,3,1
dijkstra,dijkstra,,46,26,61,72,135,133,0,1
erp,erp,,26,19,40,45,64,85,0,1
serverless,serverless,,165,171,294,336,420,630,6,3.636364
leadership,leadership,,0,0,1,0,0,1,6,1
delegation,delegation,,16,8,17,24,56,41,13,1
command-pattern,command-pattern,,2,5,12,7,15,19,3,150
responsive-design,responsive-design,,215,237,503,452,1129,955,1,10.232558
internet-explorer,internet-explorer,,391,350,789,741,1670,1530,1,1
installer,installer,,57,65,112,122,195,234,8,14.035088
notify,notify,,13,9,32,22,51,54,3,1
segmentation,segmentation,,0,0,1,0,1,1,7,1
dynamic,dynamic,,432,366,894,798,1740,1692,1,1
defect,defect,,0,0,1,0,0,1,3,1
automatic-update,automatic-update,,0,0,2,0,0,2,9,1
errors,errors,,0,3,5,3,10,8,7,200
loc,loc,,23,12,20,35,33,55,0,1
effort,effort,,3,2,9,5,8,14,8,1
usability,usability,,50,44,107,94,306,201,7,1
fault-tolerance,fault-tolerance,,11,10,15,21,25,36,3,1
drivers,drivers,,0,0,1,0,56,1,9,1
markup,markup,,10,17,38,27,60,65,1,70
upgrade,upgrade,,91,71,197,162,342,359,4,1
basic,basic,,15,9,46,24,81,70,5,1
freelancing,freelancing,,0,0,1,0,0,1,4,1
zend-framework,zend-framework,,68,54,199,122,303,321,4,1
xslt,xslt,,461,389,985,850,2275,1835,3,1
collaboration,collaboration,,6,2,16,8,19,24,6,1
user-interaction,user-interaction,,8,3,11,11,18,22,13,1
xhtml,xhtml,,41,43,89,84,160,173,3,4.878049
lookup,lookup,,70,81,166,151,350,317,5,15.714286
shunting-yard,shunting-yard,,0,3,6,3,4,9,9,200
large-scale-scrum,large-scale-scrum,,0,0,1,0,0,1,6,1
access,access,,93,64,282,157,442,439,5,1
extreme-programming,extreme-programming,,0,0,1,0,0,1,3,1
media,media,,53,52,111,105,249,216,3,1
auto-completion,auto-completion,,0,0,1,0,0,1,3,1
declarative,declarative,,9,4,14,13,24,27,6,1
duck-typing,duck-typing,,7,4,3,11,22,14,0,1
clean-architecture,clean-architecture,,33,44,66,77,72,143,3,33.333333
internet,internet,,3,2,2,5,3,7,0,1
make,make,,1,0,2,1,2,3,6,1
interview,interview,,2,0,1,2,5,3,7,1
puzzles,puzzles,,1,1,1,2,0,3,0,1
cocoa,cocoa,,273,209,579,482,1034,1061,13,1
redux-saga,redux-saga,,132,147,259,279,411,538,1,11.363636
saga,saga,,15,26,32,41,49,73,1,73.333333
lisp,lisp,,89,69,186,158,345,344,0,1
mef,mef,,19,7,28,26,50,54,8,1
retrospective,retrospective,,0,0,1,0,0,1,6,1
antibugging,antibugging,,0,0,1,0,0,1,3,1
distributed-development,distributed-development,,0,0,2,0,0,2,6,1
currying,currying,,21,28,41,49,93,90,2,33.333333
export,export,,200,171,403,371,748,774,5,1
testers,testers,,0,0,1,0,0,1,6,1
linux-development,linux-development,,0,1,3,1,4,4,9,1
javadocs,javadocs,,0,0,1,0,0,1,3,1
ip-address,ip-address,,81,60,134,141,234,275,9,1
machine-code,machine-code,,16,9,29,25,42,54,9,1
dbms,dbms,,0,0,1,0,0,1,4,1
mercurial,mercurial,,40,33,65,73,177,138,6,1
thrift,thrift,,29,33,67,62,99,129,2,13.793103
chrome,chrome,,0,2,2,2,0,4,7,100
data-warehouse,data-warehouse,,64,44,129,108,187,237,4,1
google-guice,google-guice,,0,1,1,1,0,2,3,1
kubernetes,kubernetes,,2299,2085,4159,4384,4785,8543,6,1
typeclass,typeclass,,39,31,78,70,174,148,2,1
keys,keys,,4,1,1,5,0,6,4,1
asp.net-mvc5,asp.net-mvc5,,0,0,1,0,0,1,8,1
experience,experience,,2,3,6,5,22,11,7,50
document-management,document-management,,1,0,4,1,2,5,8,1
hadoop,hadoop,,769,627,1736,1396,4080,3132,2,1
robotics,robotics,,43,34,70,77,102,147,0,1
hacking,hacking,,1,0,1,1,0,2,9,1
trust,trust,,7,6,7,13,16,20,6,1
coldfusion,coldfusion,,142,129,285,271,633,556,4,1
np-complete,np-complete,,60,33,98,93,170,191,0,1
technique,technique,,0,0,1,0,0,1,0,1
information-presentation,information-presentation,,0,0,1,0,0,1,3,1
appstore,appstore,,0,0,2,0,0,2,13,1
product-features,product-features,,0,0,1,0,0,1,3,1
64-bit,64-bit,,52,99,138,151,248,289,9,90.384615
case-insensitivity,case-insensitivity,,0,0,1,0,0,1,0,1
yaml,yaml,,335,448,689,783,1172,1472,3,33.731343
architect,architect,,0,0,1,0,0,1,3,1
analogy,analogy,,0,0,1,0,0,1,3,1
boost,boost,,399,313,733,712,1781,1445,9,1
etiquette,etiquette,,2,0,0,2,3,2,6,1
planning-poker,planning-poker,,2,0,0,2,0,2,6,1
local-variable,local-variable,,2,0,0,2,0,2,3,1
css3,css3,,1601,0,3205,1601,8371,4806,1,1
risk,risk,,1,1,0,2,0,2,3,1
forward-compatibility,forward-compatibility,,1,1,1,2,3,3,3,1
call-sites,call-sites,,1,0,0,1,0,1,0,1
azure-devops,azure-devops,,1057,1153,1925,2210,2392,4135,8,9.082308
web-design,web-design,,1,0,0,1,0,1,1,1
cocomo,cocomo,,1,0,0,1,0,1,3,1
code-ownership,code-ownership,,1,0,0,1,0,1,3,1
fragmentation,fragmentation,,1,4,5,5,8,10,4,300
pyqt4,pyqt4,,92,65,233,157,573,390,0,1
lean,lean,,2,2,3,4,10,7,2,1
diagnostics,diagnostics,,14,10,18,24,36,42,9,1
connectivity,connectivity,,14,18,16,32,40,48,3,28.571429
fail-fast,fail-fast,,2,3,4,5,3,9,3,50
w3c,w3c,,21,15,21,36,63,57,1,1
vue.js,vue.js,,4857,5024,8549,9881,11777,18430,1,3.438336
indentation,indentation,,56,39,85,95,220,180,0,1
whitespace,whitespace,,57,52,124,109,300,233,0,1
dynamic-inheritance,dynamic-inheritance,,1,0,0,1,0,1,9,1
physics,physics,,65,38,113,103,233,216,0,1
com,com,,152,137,273,289,544,562,8,1
catch,catch,,1,0,0,1,0,1,3,1
try,try,,1,0,0,1,0,1,3,1
time-zone,time-zone,,0,1,0,1,0,1,4,1
perl,perl,,584,586,1267,1170,2633,2437,9,1
camelcase,camelcase,,0,1,0,1,0,1,3,1
teamcity,teamcity,,77,100,213,177,419,390,8,29.87013
ansi,ansi,,27,11,30,38,73,68,9,1
bpm,bpm,,0,1,0,1,0,1,6,1
sql-injection,sql-injection,,58,58,133,116,292,249,4,1
gerrit,gerrit,,25,32,78,57,176,135,6,28
workaround,workaround,,0,1,0,1,0,1,3,1
smtp,smtp,,251,244,522,495,861,1017,4,1
healthcheck,healthcheck,,0,1,0,1,0,1,4,1
time-tracking,time-tracking,,0,1,8,1,8,9,4,1
file-extension,file-extension,,9,9,32,18,60,50,4,1
information-management,information-management,,0,2,0,2,0,2,6,100
tsql,tsql,,1580,1241,3188,2821,5736,6009,4,1
ssrs,ssrs,,0,1,0,1,0,1,4,1
calculus,calculus,,8,10,33,18,55,51,0,25
mfc,mfc,,172,129,257,301,556,558,9,1
future-proof,future-proof,,0,2,0,2,1,2,0,100
argparse,argparse,,86,104,198,190,351,388,0,20.930233
development-cycle,development-cycle,,0,1,0,1,0,1,6,1
one-liner,one-liner,,0,1,0,1,0,1,6,1
key-rotation,key-rotation,,0,1,0,1,0,1,4,1
containerization,containerization,,0,1,0,1,0,1,4,1
out-parameters,out-parameters,,2,5,4,7,7,11,4,150
desktop,desktop,,34,26,79,60,155,139,9,1
user-research,user-research,,14,12,31,26,74,57,7,1
psychology,psychology,,1,1,5,2,21,7,7,1
cognition,cognition,,1,0,1,1,3,2,0,1
information-architecture,information-architecture,,5,8,9,13,45,22,7,60
material-design,material-design,,262,275,566,537,1071,1103,3,4.961832
tooltips,tooltips,,2,1,3,3,10,6,7,1
dashboard,dashboard,,92,76,182,168,270,350,0,1
filter,filter,,785,759,1511,1544,2505,3055,1,1
tables,tables,,15,23,29,38,70,67,7,53.333333
data-tables,data-tables,,11,11,12,22,38,34,7,1
alignment,alignment,,137,110,239,247,551,486,1,1
buttons,buttons,,21,20,38,41,105,79,7,1
interaction-design,interaction-design,,30,28,37,58,113,95,7,1
hci,hci,,7,1,17,8,19,25,3,1
augmented-reality,augmented-reality,,221,210,392,431,540,823,13,1
white-space,white-space,,2,1,1,3,5,4,7,1
cta,cta,,3,1,2,4,11,6,7,1
viewport,viewport,,47,33,97,80,171,177,1,1
mobile-application,mobile-application,,58,45,126,103,186,229,3,1
user-behavior,user-behavior,,20,21,44,41,125,85,7,5
user-expectation,user-expectation,,37,30,54,67,160,121,7,1
interface,interface,,349,328,748,677,1452,1425,3,1
physical,physical,,2,0,7,2,11,9,7,1
cars,cars,,1,0,2,1,6,3,0,1
automotive-ux,automotive-ux,,0,0,0,0,2,0,7,1
buildings,buildings,,1,2,2,3,1,5,0,100
drop-down-list,drop-down-list,,2,2,5,4,15,9,7,1
best-practice,best-practice,,8,4,12,12,32,24,7,1
download,download,,373,326,624,699,1222,1323,4,1
delete,delete,,5,2,0,7,8,7,7,1
error-message,error-message,,7,5,8,12,26,20,7,1
info-visualisation,info-visualisation,,15,9,19,24,36,43,7,1
surveys,surveys,,5,3,3,8,11,11,7,1
tabs,tabs,,205,168,387,373,889,760,1,1
save,save,,157,139,286,296,706,582,0,1
scrollbars,scrollbars,,1,0,2,1,11,3,7,1
keyboard,keyboard,,190,194,422,384,793,806,13,2.105263
mouse,mouse,,65,58,136,123,255,259,1,1
splash-screen,splash-screen,,76,62,134,138,274,272,3,1
duration,duration,,31,29,78,60,139,138,0,1
lists,lists,,16,9,17,25,63,42,7,1
card-views,card-views,,0,1,0,1,4,1,7,1
microinteractions,microinteractions,,2,2,6,4,12,10,7,1
website-design,website-design,,41,39,61,80,186,141,7,1
popup,popup,,158,125,331,283,663,614,1,1
ux-designer,ux-designer,,8,3,20,11,36,31,7,1
alerts,alerts,,11,19,20,30,39,50,8,72.727273
modal,modal,,5,4,5,9,18,14,7,1
dates,dates,,3,1,4,4,11,8,7,1
consistency,consistency,,11,14,38,25,64,63,3,27.272727
business-application,business-application,,4,2,3,6,3,9,7,1
controls,controls,,90,70,169,160,374,329,8,1
radio-buttons,radio-buttons,,7,3,6,10,26,16,7,1
layout,layout,,312,316,728,628,1486,1356,3,1.282051
fluid-layout,fluid-layout,,2,4,10,6,21,16,1,100
audio,audio,,610,570,1161,1180,2293,2341,13,1
lean-ux,lean-ux,,2,2,0,4,5,4,7,1
copy-paste,copy-paste,,64,60,140,124,317,264,5,1
design-process,design-process,,1,3,0,4,10,4,7,200
software-engineering,software-engineering,,4,3,6,7,9,13,0,1
textbox,textbox,,141,99,308,240,636,548,8,1
user-journey,user-journey,,1,1,3,2,5,5,7,1
homepage,homepage,,1,1,1,2,8,3,7,1
categorization,categorization,,9,3,13,12,21,25,0,1
color-scheme,color-scheme,,23,18,34,41,75,75,7,1
color-perception,color-perception,,1,4,0,5,5,5,7,300
branding,branding,,4,4,10,8,20,18,7,1
logos,logos,,3,2,3,5,8,8,13,1
mobile-web,mobile-web,,7,4,9,11,24,20,7,1
call-to-action,call-to-action,,1,1,0,2,9,2,7,1
placement,placement,,2,3,14,5,22,19,1,50
minimalist,minimalist,,0,0,0,0,2,0,7,1
rearranging,rearranging,,0,0,0,0,2,0,7,1
frontend-development,frontend-development,,1,0,5,1,2,6,7,1
advertisement,advertisement,,0,1,3,1,4,4,7,1
scrolling,scrolling,,3,1,6,4,26,10,7,1
indicator,indicator,,19,6,24,25,31,49,7,1
human-interface-guideline,human-interface-guideline,,5,5,1,10,28,11,7,1
cancel,cancel,,1,0,2,1,6,3,7,1
messagebox,messagebox,,19,17,41,36,88,77,8,1
cards,cards,,2,7,6,9,11,15,7,250
maps,maps,,225,195,470,420,773,890,1,1
hyperlinks,hyperlinks,,3,7,5,10,19,15,7,133.333333
cursor,cursor,,92,78,171,170,566,341,4,1
signifier,signifier,,0,0,0,0,1,0,7,1
user-centered-design,user-centered-design,,7,8,9,15,49,24,7,14.285714
wireframe,wireframe,,5,2,12,7,24,19,7,1
style-guide,style-guide,,0,1,2,1,4,3,7,1
toggle,toggle,,85,85,187,170,371,357,1,1
dropdown,dropdown,,257,232,484,489,886,973,1,1
position,position,,129,110,258,239,545,497,1,1
typography,typography,,23,18,31,41,56,72,1,1
ux-field,ux-field,,5,3,15,8,39,23,7,1
selling-ux,selling-ux,,0,1,1,1,5,2,7,1
registration,registration,,49,40,89,89,182,178,4,1
conversion-rate,conversion-rate,,0,0,1,0,2,1,4,1
health,health,,0,0,1,0,2,1,7,1
progress-bar,progress-bar,,136,148,259,284,532,543,3,8.823529
rtl,rtl,,0,2,0,2,5,2,7,100
sidebar,sidebar,,50,41,102,91,160,193,1,1
tab,tab,,0,1,4,1,6,5,7,1
bottom-navigation,bottom-navigation,,2,0,2,2,6,4,7,1
datetimepicker,datetimepicker,,93,67,133,160,318,293,1,1
time-zones,time-zones,,0,0,1,0,1,1,1,1
icons,icons,,160,149,336,309,629,645,1,1
highlight,highlight,,51,43,117,94,182,211,1,1
flat-design,flat-design,,0,0,0,0,2,0,3,1
subscription,subscription,,62,74,151,136,200,287,13,19.354839
navigation,navigation,,304,255,570,559,989,1129,1,1
page-title,page-title,,6,3,8,9,22,17,4,1
widget,widget,,225,209,397,434,714,831,13,1
close,close,,2,1,1,3,7,4,7,1
back-button,back-button,,20,14,42,34,100,76,3,1
pwa,pwa,,0,0,0,0,129,0,1,1
accessibility,accessibility,,207,198,413,405,645,818,13,1
technical-writing,technical-writing,,0,0,1,0,3,1,7,1
typing,typing,,44,45,65,89,115,154,0,2.272727
reports,reports,,2,2,1,4,7,5,7,1
prompt,prompt,,44,40,120,84,168,204,9,1
window,window,,177,129,320,306,553,626,1,1
window-management,window-management,,3,2,2,5,3,7,9,1
lightbox,lightbox,,22,29,61,51,90,112,1,31.818182
slideshow,slideshow,,50,33,98,83,198,181,1,1
charts,charts,,589,551,1255,1140,2358,2395,1,1
checkboxes,checkboxes,,8,6,9,14,43,23,7,1
selection,selection,,65,46,126,111,247,237,1,1
password-recovery,password-recovery,,7,3,8,10,12,18,4,1
password-change,password-change,,0,1,2,1,3,3,4,1
web-app,web-app,,14,18,18,32,68,50,7,28.571429
select,select,,596,483,1225,1079,2689,2304,4,1
timeline,timeline,,24,26,57,50,99,107,1,8.333333
photos,photos,,1,0,1,1,52,2,13,1
multi-step,multi-step,,7,6,10,13,18,23,1,1
optional-fields,optional-fields,,0,0,1,0,4,1,7,1
search-results,search-results,,5,3,9,8,18,17,7,1
autofill,autofill,,58,47,110,105,139,215,1,1
animation,animation,,789,703,1545,1492,3174,3037,1,1
touch-screen,touch-screen,,3,5,2,8,8,10,7,66.666667
safety,safety,,0,0,2,0,2,2,7,1
visual-design,visual-design,,4,3,3,7,17,10,7,1
document,document,,55,64,113,119,177,232,1,16.363636
document-design,document-design,,0,0,1,0,3,1,7,1
packaging,packaging,,30,32,65,62,119,127,0,6.666667
confirmation,confirmation,,12,5,21,17,30,38,4,1
grid,grid,,204,178,451,382,811,833,1,1
drag-n-drop,drag-n-drop,,1,2,3,3,6,6,7,100
sort,sort,,0,1,1,1,3,2,7,1
messages,messages,,2,1,4,3,59,7,7,1
push-notification,push-notification,,482,440,1040,922,1951,1962,13,1
response-time,response-time,,9,4,16,13,30,29,3,1
preloader,preloader,,6,12,21,18,27,39,1,100
modal-windows,modal-windows,,4,7,8,11,25,19,7,75
infographic,infographic,,0,0,0,0,3,0,7,1
contrast,contrast,,7,7,19,14,27,33,0,1
status,status,,32,23,51,55,93,106,4,1
breadcrumbs,breadcrumbs,,32,26,54,58,92,112,4,1
input-fields,input-fields,,16,5,19,21,65,40,7,1
help,help,,2,2,5,4,13,9,7,1
product-design,product-design,,2,1,7,3,9,10,7,1
quality-assurance,quality-assurance,,0,0,0,0,3,0,7,1
telephone,telephone,,1,1,1,2,2,3,7,1
multi-selection,multi-selection,,1,3,6,4,32,10,7,200
username,username,,23,21,53,44,109,97,4,1
menu,menu,,195,174,415,369,885,784,1,1
windows-os,windows-os,,3,1,4,4,7,8,7,1
tiles,tiles,,8,6,29,14,40,43,3,1
copywriting,copywriting,,3,5,4,8,21,12,7,66.666667
ux-writing,ux-writing,,2,0,1,2,3,3,7,1
hover,hover,,119,112,276,231,602,507,1,1
shopping-cart,shopping-cart,,30,32,78,62,116,140,4,6.666667
visual-cues,visual-cues,,1,0,3,1,3,4,7,1
notification,notification,,4,4,10,8,20,18,7,1
user-profile,user-profile,,14,10,24,24,34,48,4,1
names,names,,22,16,31,38,89,69,0,1
relationship,relationship,,152,140,264,292,471,556,4,1
usability-study,usability-study,,0,1,4,1,5,5,7,1
folders,folders,,0,0,0,0,1,0,7,1
checklist,checklist,,0,0,0,0,3,0,7,1
input,input,,636,550,1392,1186,2625,2578,1,1
password,password,,8,2,10,10,15,20,7,1
application-state,application-state,,2,1,9,3,9,12,7,1
data-entry,data-entry,,2,6,11,8,15,19,5,200
data-collection,data-collection,,3,5,3,8,21,11,7,66.666667
gender,gender,,0,0,0,0,4,0,7,1
click,click,,129,127,269,256,574,525,1,1
workflow,workflow,,85,75,155,160,275,315,6,1
checkout,checkout,,116,71,163,187,346,350,4,1
tree,tree,,317,252,662,569,1192,1231,0,1
user-feedback,user-feedback,,4,1,8,5,9,13,7,1
sidemenu,sidemenu,,1,0,1,1,5,2,1,1
screen-reader,screen-reader,,1,3,4,4,7,8,13,200
heading,heading,,5,7,11,12,27,23,1,40
customer-support,customer-support,,0,0,0,0,2,0,7,1
accounts,accounts,,6,0,7,6,15,13,7,1
profile,profile,,22,25,60,47,93,107,4,13.636364
newsletter,newsletter,,10,8,32,18,42,50,4,1
share,share,,71,64,145,135,290,280,3,1
google-materials-design,google-materials-design,,1,0,0,1,4,1,7,1
carousel,carousel,,162,146,321,308,520,629,1,1
onepager,onepager,,0,0,0,0,2,0,7,1
empty,empty,,0,1,3,1,8,4,7,1
usability-testing,usability-testing,,10,8,14,18,54,32,7,1
internationalisation,internationalisation,,2,1,1,3,8,4,7,1
ordering,ordering,,1,4,3,5,7,8,0,300
longlist,longlist,,1,0,0,1,2,1,7,1
reorder,reorder,,0,0,0,0,2,0,7,1
accordion,accordion,,67,52,143,119,264,262,1,1
cognitive-load,cognitive-load,,1,0,1,1,5,2,7,1
overlay,overlay,,80,72,152,152,292,304,1,1
conversion,conversion,,2,1,3,3,9,6,7,1
onboarding,onboarding,,4,2,3,6,13,9,7,1
editor,editor,,82,107,202,189,374,391,1,30.487805
undo,undo,,14,6,20,20,52,40,6,1
redo,redo,,2,2,1,4,5,5,6,1
terms-of-service,terms-of-service,,0,0,1,0,1,1,7,1
keyboard-shortcuts,keyboard-shortcuts,,87,85,176,172,345,348,8,1
zooming,zooming,,16,0,35,16,65,51,1,1
header,header,,244,203,490,447,909,937,4,1
range,range,,215,168,457,383,916,840,5,1
device-rotation,device-rotation,,0,0,1,0,1,1,7,1
ab-testing,ab-testing,,8,10,30,18,55,48,13,25
content,content,,5,2,4,7,14,11,7,1
infinite-scroll,infinite-scroll,,39,47,87,86,187,173,1,20.512821
lazy-loading,lazy-loading,,159,161,331,320,472,651,1,1.257862
user-communication,user-communication,,0,0,0,0,2,0,7,1
verb,verb,,0,0,0,0,1,0,4,1
printing,printing,,475,397,934,872,1652,1806,1,1
relations,relations,,1,0,0,1,2,1,1,1
recommendations,recommendations,,0,0,0,0,2,0,1,1
spam,spam,,17,13,33,30,47,63,4,1
camera,camera,,237,219,504,456,1009,960,3,1
actions,actions,,3,1,7,4,12,11,7,1
warnings,warnings,,94,95,185,189,379,374,9,1.06383
urls,urls,,1,1,2,2,7,4,1,1
uploading,uploading,,7,10,18,17,31,35,4,42.857143
wizard,wizard,,12,18,35,30,85,65,0,50
task-flow,task-flow,,1,0,1,1,3,2,7,1
contact-us,contact-us,,0,1,3,1,5,4,7,1
taxonomy,taxonomy,,34,12,69,46,112,115,4,1
fields,fields,,2,1,0,3,1,3,7,1
android-ux,android-ux,,2,6,7,8,16,15,3,200
trend,trend,,18,8,15,26,31,41,0,1
google-analytics,google-analytics,,359,353,825,712,1557,1537,5,1
mac-os-x,mac-os-x,,1,0,0,1,4,1,3,1
toolbar,toolbar,,56,64,119,120,263,239,3,14.285714
color-blindness,color-blindness,,1,0,3,1,5,4,7,1
flowcharts,flowcharts,,2,0,0,2,1,2,7,1
conversational-interface,conversational-interface,,0,1,1,1,5,2,7,1
edit,edit,,55,51,132,106,244,238,4,1
avatars,avatars,,0,0,0,0,3,0,7,1
dialog,dialog,,174,124,333,298,689,631,3,1
inline-edit,inline-edit,,0,0,2,0,6,2,7,1
usability-engineering,usability-engineering,,2,0,0,2,1,2,7,1
user-generated-content,user-generated-content,,2,1,3,3,4,6,7,1
affordance,affordance,,1,0,5,1,8,6,7,1
hamburger,hamburger,,0,0,2,0,3,2,1,1
chatbots,chatbots,,2,1,3,3,11,6,7,1
screen-resolution,screen-resolution,,21,17,47,38,84,85,3,1
sliders,sliders,,1,3,6,4,15,10,7,200
heatmaps,heatmaps,,1,1,0,2,2,2,7,1
error-prevention,error-prevention,,0,0,1,0,4,1,7,1
real-time-updates,real-time-updates,,9,5,9,14,12,23,13,1
choices,choices,,0,0,1,0,10,1,7,1
calendar,calendar,,222,199,488,421,864,909,3,1
guidelines,guidelines,,4,5,8,9,14,17,7,25
emoji,emoji,,75,74,143,149,331,292,0,1
case-studies,case-studies,,0,0,2,0,4,2,7,1
questionnaire,questionnaire,,1,2,2,3,14,5,7,100
uploading-documents,uploading-documents,,0,0,1,0,3,1,7,1
personas,personas,,1,2,3,3,6,6,7,100
searchbox,searchbox,,0,0,0,0,2,0,1,1
quantitative-analysis,quantitative-analysis,,1,1,5,2,7,7,7,1
scale,scale,,75,85,151,160,292,311,1,13.333333
news,news,,1,0,0,1,4,1,7,1
newsfeed,newsfeed,,0,0,0,0,1,0,7,1
states,states,,2,0,3,2,28,5,1,1
disabled,disabled,,1,2,2,3,3,5,7,100
many-options,many-options,,2,0,3,2,8,5,7,1
page,page,,1,0,1,1,3,2,7,1
ease-of-use,ease-of-use,,0,1,3,1,3,4,7,1
required-fields,required-fields,,0,1,1,1,7,2,1,1
vision-impairment,vision-impairment,,0,0,1,0,2,1,7,1
design-frameworks,design-frameworks,,1,0,2,1,2,3,7,1
off-canvas,off-canvas,,0,0,0,0,1,0,7,1
mega-menu,mega-menu,,2,2,1,4,2,5,1,1
audience,audience,,3,4,7,7,10,14,13,33.333333
diagramming,diagramming,,1,0,2,1,2,3,7,1
bubbles,bubbles,,0,0,0,0,1,0,7,1
connection,connection,,185,192,379,377,680,756,4,3.783784
blog,blog,,1,0,1,1,1,2,7,1
blog-post,blog-post,,0,0,0,0,1,0,7,1
user-engagement,user-engagement,,0,1,0,1,3,1,7,1
voice,voice,,24,34,64,58,69,122,3,41.666667
mobile-first,mobile-first,,0,2,1,2,1,3,7,100
tutorial,tutorial,,1,0,1,1,2,2,13,1
social-media,social-media,,11,11,18,22,45,40,4,1
target-users,target-users,,0,0,0,0,1,0,7,1
font-sizes,font-sizes,,2,1,2,3,3,5,7,1
addresses,addresses,,1,0,4,1,4,5,7,1
qr-codes,qr-codes,,1,1,1,2,1,3,7,1
gmail,gmail,,270,220,508,490,812,998,4,1
title,title,,19,24,48,43,125,91,1,26.315789
language,language,,2,6,9,8,21,17,0,200
steps,steps,,0,1,4,1,2,5,7,1
loading,loading,,61,54,150,115,242,265,1,1
graphic-design,graphic-design,,0,3,2,3,10,5,1,200
responsive,responsive,,190,153,449,343,827,792,1,1
measuring,measuring,,0,0,1,0,3,1,7,1
long-forms,long-forms,,1,0,0,1,2,1,1,1
data-mapping,data-mapping,,3,3,6,6,13,12,7,1
eye-tracking,eye-tracking,,10,1,9,11,18,20,0,1
intuition,intuition,,5,0,6,5,3,11,7,1
transitions,transitions,,1,0,1,1,85,2,1,1
product-management,product-management,,1,3,2,4,4,6,7,200
displays,displays,,2,1,2,3,3,5,7,1
interactive-ui,interactive-ui,,0,0,2,0,3,2,7,1
novice-users,novice-users,,0,1,0,1,1,1,7,1
easy,easy,,0,0,1,0,1,1,7,1
search-suggestion,search-suggestion,,7,7,20,14,33,34,6,1
enterprise,enterprise,,19,18,49,37,78,86,13,1
spinner,spinner,,77,70,173,147,391,320,3,1
font,font,,3,2,8,5,6,13,7,1
legibility,legibility,,1,0,0,1,3,1,7,1
mockup,mockup,,2,0,2,2,5,4,7,1
colours,colours,,1,0,0,1,1,1,7,1
autocomplete,autocomplete,,253,253,567,506,1130,1073,1,1
options,options,,31,31,64,62,117,126,1,1
alternatives,alternatives,,0,0,0,0,5,0,7,1
multiple-products,multiple-products,,1,0,2,1,3,3,7,1
transport,transport,,3,2,10,5,20,15,9,1
listview,listview,,495,475,1230,970,3783,2200,3,1
mental-models,mental-models,,1,1,1,2,1,3,7,1
ux-integration,ux-integration,,4,1,0,5,5,5,7,1
default,default,,49,57,113,106,208,219,9,16.326531
ratings,ratings,,2,1,0,3,8,3,7,1
redesign,redesign,,2,1,3,3,2,6,7,1
skeuomorphism,skeuomorphism,,0,0,0,0,2,0,7,1
dark-patterns,dark-patterns,,0,1,0,1,1,1,7,1
hidden,hidden,,26,25,47,51,110,98,1,1
customisation,customisation,,0,1,0,1,4,1,7,1
older-users,older-users,,1,0,0,1,1,1,7,1
user-preferences,user-preferences,,0,1,1,1,9,2,7,1
natural-language,natural-language,,0,1,3,1,3,4,7,1
faceted-search,faceted-search,,3,6,19,9,38,28,2,100
reliability,reliability,,6,8,13,14,15,27,0,33.333333
wcag,wcag,,16,11,18,27,35,45,13,1
column-headers,column-headers,,0,1,1,1,1,2,7,1
updating,updating,,16,19,41,35,77,76,1,18.75
refresh,refresh,,83,69,146,152,286,298,1,1
administration,administration,,9,10,19,19,36,38,4,11.111111
flow,flow,,36,32,63,68,69,131,8,1
customer-experience,customer-experience,,0,2,3,2,7,5,7,100
business-intelligence,business-intelligence,,29,31,84,60,155,144,4,6.896552
placeholder,placeholder,,40,40,79,80,162,159,1,1
signup-signon,signup-signon,,4,1,10,5,8,15,7,1
objects,objects,,1,0,0,1,1,1,7,1
deselection,deselection,,0,0,0,0,4,0,7,1
simplicity,simplicity,,1,0,0,1,3,1,7,1
b2b,b2b,,8,7,5,15,14,20,13,1
collapsible-panels,collapsible-panels,,0,1,1,1,4,2,7,1
question-answer,question-answer,,0,0,1,0,7,1,7,1
quiz,quiz,,0,0,1,0,3,1,7,1
file-input,file-input,,0,1,0,1,2,1,7,1
404,404,,0,0,1,0,2,1,7,1
audio-interface,audio-interface,,0,0,1,0,3,1,7,1
cryptocurrency,cryptocurrency,,31,28,61,59,84,120,6,1
tap,tap,,9,10,19,19,25,38,13,11.111111
research-debt,research-debt,,0,0,1,0,1,1,7,1
tabindex,tabindex,,11,9,17,20,38,37,1,1
wireframing,wireframing,,0,0,0,0,3,0,7,1
ipad,ipad,,79,84,222,163,493,385,13,6.329114
device,device,,34,39,86,73,163,159,3,14.705882
money,money,,0,0,1,0,2,1,4,1
popover,popover,,37,42,77,79,148,156,1,13.513514
overflow,overflow,,110,95,207,205,404,412,1,1
discount,discount,,9,5,32,14,38,46,4,1
virtual-reality,virtual-reality,,76,69,156,145,222,301,8,1
context-sensitive-help,context-sensitive-help,,2,0,0,2,2,2,7,1
information-design,information-design,,9,4,3,13,3,16,7,1
children,children,,20,28,61,48,122,109,1,40
mandatory-fields,mandatory-fields,,1,0,0,1,4,1,7,1
sketching,sketching,,1,0,4,1,6,5,0,1
design-thinking,design-thinking,,0,0,0,0,4,0,7,1
location,location,,180,145,355,325,703,680,3,1
landing-page,landing-page,,0,0,1,0,6,1,7,1
content-strategy,content-strategy,,0,2,1,2,3,3,7,100
ergonomics,ergonomics,,1,0,2,1,7,3,7,1
gestures,gestures,,0,0,4,0,25,4,13,1
input-focus,input-focus,,1,2,0,3,3,3,7,100
email-verification,email-verification,,23,11,41,34,51,75,4,1
direct-manipulation,direct-manipulation,,0,0,0,0,1,0,9,1
page-layout,page-layout,,6,2,5,8,17,13,7,1
contextual-menu,contextual-menu,,1,1,1,2,1,3,7,1
grouped-list,grouped-list,,0,2,2,2,4,4,7,100
data-display,data-display,,3,1,2,4,5,6,7,1
disable,disable,,23,28,55,51,23,106,1,21.73913
sign-in,sign-in,,0,0,4,0,5,4,7,1
catalog,catalog,,11,5,11,16,30,27,4,1
location-service,location-service,,0,0,0,0,2,0,7,1
motivation,motivation,,0,0,2,0,2,2,7,1
intuitive,intuitive,,0,0,0,0,2,0,7,1
user-attention,user-attention,,0,1,0,1,1,1,7,1
content-loading,content-loading,,0,0,0,0,2,0,7,1
pattern-recognition,pattern-recognition,,17,13,23,30,65,53,0,1
spatial-memory,spatial-memory,,0,0,0,0,1,0,7,1
doors,doors,,0,0,0,0,1,0,7,1
symbols,symbols,,63,41,110,104,206,214,9,1
heuristics,heuristics,,20,22,54,42,84,96,0,10
emotion,emotion,,23,20,28,43,31,71,1,1
online-banking,online-banking,,1,0,0,1,1,1,7,1
aspect-ratio,aspect-ratio,,27,20,37,47,92,84,1,1
deletion,deletion,,1,1,0,2,5,2,7,1
mode,mode,,21,15,49,36,59,85,0,1
tablet,tablet,,10,18,33,28,79,61,3,80
moderation,moderation,,0,0,0,0,1,0,7,1
nav,nav,,43,34,118,77,197,195,1,1
tab-bar,tab-bar,,1,0,5,1,2,6,7,1
guerrilla-user-research,guerrilla-user-research,,0,1,0,1,1,1,7,1
multiple-data,multiple-data,,0,0,1,0,2,1,7,1
design-ethics,design-ethics,,0,1,1,1,3,2,7,1
use-cases,use-cases,,1,0,2,1,2,3,7,1
social-interfaces,social-interfaces,,0,0,3,0,2,3,7,1
activity-feed,activity-feed,,0,0,1,0,2,1,7,1
phone-numbers,phone-numbers,,1,0,1,1,3,2,1,1
long,long,,1,0,0,1,1,1,7,1
redirect,redirect,,628,616,1137,1244,2715,2381,4,1
combobox,combobox,,267,229,520,496,1190,1016,8,1
examples,examples,,0,0,0,0,1,0,7,1
portfolio,portfolio,,15,12,27,27,51,54,0,1
corporate,corporate,,1,1,4,2,7,6,6,1
media-queries,media-queries,,151,128,302,279,593,581,1,1
screen-real-estate,screen-real-estate,,0,0,0,0,2,0,7,1
agile-ux,agile-ux,,0,0,0,0,2,0,6,1
nps,nps,,0,0,0,0,1,0,7,1
prices,prices,,0,0,1,0,3,1,0,1
card-sorting,card-sorting,,0,0,2,0,2,2,7,1
wrapping,wrapping,,0,0,2,0,1,2,7,1
user-error,user-error,,0,0,0,0,1,0,7,1
swipe,swipe,,40,46,125,86,177,211,3,15
consent,consent,,0,0,0,0,3,0,7,1
user-behaviour,user-behaviour,,1,1,0,2,3,2,7,1
drawer,drawer,,14,10,40,24,64,64,3,1
navigation-drawer,navigation-drawer,,119,130,244,249,497,493,3,9.243697
journey-map,journey-map,,1,0,1,1,2,2,7,1
column,column,,0,0,0,0,1,0,7,1
dynamic-ui,dynamic-ui,,4,5,10,9,8,19,7,25
visibility,visibility,,44,38,93,82,196,175,3,1
datepicker,datepicker,,265,255,571,520,1434,1091,1,1
discovery,discovery,,7,10,16,17,28,33,6,42.857143
service-design,service-design,,0,0,0,0,2,0,7,1
shipping,shipping,,25,15,63,40,183,103,4,1
background,background,,189,169,373,358,798,731,1,1
panel,panel,,53,63,131,116,217,247,8,18.867925
data-tree,data-tree,,0,0,0,0,2,0,7,1
banking,banking,,7,3,12,10,13,22,4,1
aesthetics,aesthetics,,5,3,12,8,30,20,0,1
autosave,autosave,,12,3,11,15,33,26,5,1
optimisation,optimisation,,0,0,0,0,2,0,7,1
currency,currency,,34,40,100,74,198,174,4,17.647059
perceived-affordance,perceived-affordance,,0,0,0,0,1,0,7,1
feed,feed,,20,23,52,43,92,95,4,15
users-tests,users-tests,,1,0,0,1,1,1,7,1
collapsing,collapsing,,0,0,2,0,2,2,7,1
prototype,prototype,,77,62,148,139,349,287,1,1
ui-element,ui-element,,0,0,1,0,3,1,7,1
progress,progress,,24,17,42,41,122,83,3,1
simple,simple,,0,0,0,0,1,0,7,1
tags,tags,,176,170,366,346,680,712,1,1
metaphor,metaphor,,0,0,0,0,1,0,7,1
advancedsearch,advancedsearch,,0,0,0,0,1,0,7,1
native-app,native-app,,3,3,0,6,1,6,7,1
custom-control,custom-control,,0,0,1,0,1,1,7,1
mobile-text-entry,mobile-text-entry,,2,0,1,2,1,3,7,1
keypad,keypad,,10,3,6,13,23,19,9,1
shape,shape,,0,0,0,0,217,0,0,1
gdpr,gdpr,,0,1,2,1,4,3,7,1
gamification,gamification,,0,1,4,1,1,5,7,1
transactions,transactions,,243,249,526,492,1027,1018,3,2.469136
insurance,insurance,,0,0,0,0,1,0,0,1
faq,faq,,0,2,1,2,1,3,7,100
end-user-training,end-user-training,,0,0,0,0,1,0,7,1
master-details,master-details,,0,0,2,0,1,2,7,1
rating-system,rating-system,,4,3,6,7,12,13,4,1
reset,reset,,47,30,72,77,151,149,1,1
behavior-design,behavior-design,,0,0,1,0,1,1,7,1
fittslaw,fittslaw,,0,0,0,0,1,0,7,1
age,age,,0,0,0,0,1,0,7,1
perception,perception,,1,1,3,2,5,5,7,1
submit,submit,,58,50,126,108,253,234,1,1
structure,structure,,113,72,223,185,462,408,9,1
smartphone,smartphone,,8,12,28,20,29,48,3,50
ux-maturity,ux-maturity,,0,0,0,0,1,0,0,1
space,space,,24,17,48,41,105,89,0,1
scenarios,scenarios,,12,5,6,17,25,23,3,1
jobs,jobs,,71,73,144,144,248,288,4,2.816901
certification,certification,,0,0,0,0,1,0,7,1
resizing,resizing,,0,0,1,0,1,1,4,1
sales-techniques,sales-techniques,,0,1,0,1,1,1,4,1
personalisation,personalisation,,1,0,0,1,1,1,7,1
customizable,customizable,,0,0,1,0,1,1,7,1
product-details,product-details,,0,0,0,0,3,0,7,1
voting,voting,,6,6,4,12,10,16,0,1
career-development,career-development,,0,0,0,0,1,0,4,1
style,style,,1,0,0,1,2,1,7,1
themes,themes,,153,133,280,286,503,566,4,1
logout,logout,,52,39,69,91,153,160,4,1
qualitative-analysis,qualitative-analysis,,0,1,1,1,1,2,7,1
walkthrough,walkthrough,,1,0,4,1,6,5,13,1
timeout,timeout,,174,168,339,342,661,681,3,1
country,country,,9,5,9,14,30,23,4,1
special-characters,special-characters,,61,67,160,128,323,288,0,9.836066
nested-tables,nested-tables,,1,2,3,3,1,6,7,100
sharing,sharing,,28,18,33,46,77,79,13,1
material,material,,136,92,192,228,177,420,1,1
speech-input,speech-input,,0,0,1,0,1,1,7,1
gif,gif,,76,59,103,135,235,238,3,1
auto-correct,auto-correct,,0,0,0,0,2,0,7,1
floating-action-button,floating-action-button,,37,44,122,81,209,203,3,18.918919
discoverability,discoverability,,0,1,3,1,2,4,0,1
counter,counter,,85,70,237,155,467,392,0,1
countdown,countdown,,30,35,74,65,159,139,1,16.666667
pattern-library,pattern-library,,0,0,0,0,1,0,3,1
multi-column,multi-column,,1,1,2,2,1,4,7,1
workshop,workshop,,0,0,0,0,1,0,7,1
booking,booking,,0,0,0,0,1,0,7,1
travel,travel,,0,0,0,0,3,0,7,1
sitemap,sitemap,,40,31,81,71,106,152,4,1
content-audit,content-audit,,1,0,0,1,1,1,7,1
large-screen,large-screen,,0,0,0,0,1,0,7,1
competitive-analysis,competitive-analysis,,0,1,2,1,2,3,7,1
decision-making,decision-making,,0,0,1,0,1,1,7,1
instructions,instructions,,12,11,40,23,46,63,9,1
serious-game,serious-game,,0,0,0,0,1,0,7,1
pyschology,pyschology,,0,0,0,0,1,0,7,1
nodes,nodes,,176,128,319,304,565,623,9,1
remember-me,remember-me,,3,6,11,9,27,20,4,100
multiple-devices,multiple-devices,,1,0,0,1,1,1,7,1
ribbon,ribbon,,24,20,47,44,73,91,5,1
skills,skills,,0,0,0,0,2,0,7,1
wysiwyg,wysiwyg,,31,28,69,59,141,128,1,1
concept,concept,,4,5,6,9,13,15,9,25
writing-direction,writing-direction,,1,1,0,2,1,2,7,1
progressive-disclosure,progressive-disclosure,,1,1,1,2,1,3,7,1
demographics,demographics,,3,3,13,6,19,19,0,1
recruitment,recruitment,,0,0,0,0,1,0,13,1
facebook-connect,facebook-connect,,0,0,1,0,1,1,4,1
user-interviews,user-interviews,,2,1,2,3,1,5,7,1
tactile,tactile,,0,0,1,0,1,1,7,1
badge,badge,,17,12,46,29,72,75,13,1
preview,preview,,34,41,61,75,91,136,3,20.588235
segmented,segmented,,0,1,0,1,1,1,7,1
customer,customer,,14,8,21,22,32,43,4,1
modal-view,modal-view,,0,0,2,0,2,2,0,1
synonyms,synonyms,,0,0,1,0,1,1,4,1
browse,browse,,0,0,1,0,1,1,7,1
keyboard-layout,keyboard-layout,,5,5,14,10,21,24,13,1
sus,sus,,1,1,3,2,2,5,7,1
tag-hierarchy,tag-hierarchy,,0,0,0,0,1,0,7,1
drilldown,drilldown,,7,7,26,14,29,40,1,1
footers,footers,,2,1,0,3,1,3,7,1
prioritization,prioritization,,0,0,2,0,0,2,7,1
single-sign-on,single-sign-on,,234,203,386,437,606,823,8,1
design-system,design-system,,3,1,5,4,0,9,7,1
digital,digital,,11,14,32,25,25,57,6,27.272727
new-experience,new-experience,,0,0,2,0,0,2,7,1
credit-cards,credit-cards,,2,0,1,2,0,3,4,1
chronology,chronology,,0,0,1,0,0,1,7,1
inclusive-design,inclusive-design,,1,2,1,3,0,4,7,100
purchase,purchase,,0,0,1,0,0,1,7,1
size,size,,111,101,190,212,399,402,1,1
intranet,intranet,,6,7,29,13,42,42,8,16.666667
task-completion,task-completion,,0,0,2,0,0,2,7,1
testing-protocols,testing-protocols,,0,0,1,0,0,1,13,1
sound,sound,,0,0,5,0,1,5,7,1
truncation,truncation,,9,9,10,18,24,28,0,1
ethical-design,ethical-design,,0,1,2,1,0,3,7,1
lookandfeel,lookandfeel,,0,0,1,0,0,1,7,1
capitalization,capitalization,,8,6,13,14,21,27,0,1
search-redesign,search-redesign,,1,0,1,1,0,2,0,1
persuasive-design,persuasive-design,,0,0,3,0,0,3,7,1
about,about,,0,0,1,0,0,1,7,1
development-frameworks,development-frameworks,,1,0,1,1,0,2,7,1
right-click,right-click,,8,5,15,13,45,28,1,1
live,live,,19,16,48,35,64,83,13,1
hand-off,hand-off,,0,0,2,0,0,2,1,1
coachmark,coachmark,,0,0,1,0,0,1,7,1
monospaced-font,monospaced-font,,0,0,1,0,0,1,7,1
firefox,firefox,,540,565,1189,1105,2340,2294,1,4.62963
screen-orientation,screen-orientation,,26,18,35,44,77,79,3,1
viewport-orientation,viewport-orientation,,0,0,1,0,0,1,7,1
medical,medical,,25,17,37,42,66,79,0,1
appointment,appointment,,6,2,17,8,20,25,5,1
hints,hints,,3,1,6,4,1,10,4,1
wayfinding,wayfinding,,0,0,1,0,0,1,3,1
fixed-header,fixed-header,,0,0,1,0,0,1,4,1
delay,delay,,75,52,150,127,278,277,1,1
product-placement,product-placement,,0,0,1,0,0,1,7,1
installation,installation,,263,281,568,544,1122,1112,0,6.844106
ux-methods,ux-methods,,0,0,1,0,0,1,7,1
fullscreen,fullscreen,,50,46,104,96,199,200,1,1
value,value,,0,1,1,1,0,2,7,1
expert-review,expert-review,,0,0,1,0,0,1,7,1
online-offline,online-offline,,0,0,1,0,0,1,7,1
batch-actions,batch-actions,,2,1,1,3,0,4,7,1
governance,governance,,1,0,0,1,0,1,6,1
fab,fab,,1,0,0,1,0,1,7,1
salutation,salutation,,1,0,0,1,0,1,7,1
globalization,globalization,,18,14,28,32,53,60,8,1
learnability,learnability,,1,0,0,1,0,1,7,1
ethnography,ethnography,,1,0,0,1,0,1,7,1
iso-9241,iso-9241,,1,0,0,1,0,1,13,1
design-theory,design-theory,,1,0,0,1,0,1,7,1
storyboard,storyboard,,95,82,216,177,521,393,13,1
stats,stats,,1,0,0,1,0,1,7,1
tone-of-voice,tone-of-voice,,1,0,0,1,0,1,7,1
redundancy,redundancy,,7,6,19,13,35,32,0,1
informative-feedback,informative-feedback,,1,0,0,1,0,1,7,1
pitch,pitch,,7,1,12,8,13,20,13,1
design-language,design-language,,1,0,0,1,0,1,7,1
inner-scrollbars,inner-scrollbars,,1,0,0,1,0,1,7,1
bulk,bulk,,21,24,53,45,57,98,4,14.285714
font-weight,font-weight,,1,0,0,1,0,1,1,1
ux-charts,ux-charts,,1,0,0,1,0,1,13,1
onscreen-keyboard,onscreen-keyboard,,2,1,0,3,0,3,3,1
thinkaloud,thinkaloud,,1,0,0,1,0,1,7,1
diagram,diagram,,41,34,68,75,128,143,3,1
sankey,sankey,,1,0,0,1,0,1,7,1
anchors,anchors,,1,1,0,2,0,2,7,1
price-range,price-range,,1,0,0,1,0,1,7,1
kano-model,kano-model,,1,0,0,1,0,1,7,1
child-rows,child-rows,,1,0,0,1,0,1,7,1
nomenclature,nomenclature,,1,2,2,3,4,5,0,100
organizations,organizations,,0,1,0,1,0,1,7,1
visual,visual,,0,1,0,1,0,1,7,1
point-of-sale,point-of-sale,,5,7,9,12,42,21,0,40
image-format,image-format,,0,1,0,1,0,1,7,1
trigger,trigger,,0,1,0,1,0,1,7,1
haptics,haptics,,0,1,0,1,0,1,7,1
directory,directory,,314,315,640,629,1298,1269,0,1
autofocus,autofocus,,8,21,29,29,28,58,1,162.5
industrial-design,industrial-design,,0,1,0,1,0,1,7,1
toast,toast,,44,38,59,82,139,141,3,1
harm-minimization,harm-minimization,,0,1,0,1,0,1,7,1
mailto,mailto,,18,17,45,35,67,80,1,1
design-sprint,design-sprint,,0,1,0,1,0,1,7,1
hypothesis,hypothesis,,0,1,0,1,0,1,0,1
information-density,information-density,,0,1,0,1,0,1,7,1
signup,signup,,0,1,0,1,0,1,8,1
time-complexity,time-complexity,,326,287,630,613,1103,1243,0,1
branch-and-bound,branch-and-bound,,8,3,7,11,5,18,0,1
complexity-theory,complexity-theory,,205,179,385,384,717,769,0,1
decision-problem,decision-problem,,14,8,34,22,51,56,0,1
searching,searching,,1,2,5,3,23,8,0,100
modelling,modelling,,2,2,3,4,7,7,0,1
dag,dag,,8,5,5,13,9,18,0,1
graphical-models,graphical-models,,1,0,0,1,2,1,0,1
bayesian-network,bayesian-network,,4,1,3,5,2,8,0,1
formal-languages,formal-languages,,72,54,186,126,291,312,0,1
computability,computability,,52,48,97,100,223,197,0,1
undecidability,undecidability,,13,20,49,33,101,82,0,53.846154
closure-properties,closure-properties,,2,5,11,7,45,18,0,150
nondeterminism,nondeterminism,,9,8,13,17,59,30,0,1
greedy-algorithms,greedy-algorithms,,12,10,31,22,46,53,0,1
constraint-satisfaction,constraint-satisfaction,,14,10,24,24,21,48,0,1
probability-theory,probability-theory,,27,16,36,43,56,79,0,1
computer-networks,computer-networks,,13,7,12,20,21,32,0,1
communication-protocols,communication-protocols,,12,6,7,18,8,25,0,1
np-hard,np-hard,,31,23,64,54,93,118,0,1
graph-theory,graph-theory,,183,148,418,331,562,749,0,1
correctness-proof,correctness-proof,,12,12,31,24,49,55,0,1
facial-recognition,facial-recognition,,3,5,3,8,10,11,0,66.666667
discrete-mathematics,discrete-mathematics,,40,31,89,71,132,160,0,1
hash,hash,,360,294,681,654,1554,1335,12,1
byzantine,byzantine,,0,3,0,3,6,3,0,200
3-sat,3-sat,,8,7,4,15,16,19,0,1
turing-machines,turing-machines,,88,76,128,164,298,292,0,1
memory-hardware,memory-hardware,,8,4,11,12,17,23,9,1
knapsack-problems,knapsack-problems,,9,10,14,19,29,33,0,11.111111
pseudo-polynomial,pseudo-polynomial,,1,1,1,2,7,3,0,1
oracle-machines,oracle-machines,,5,6,2,11,19,13,0,20
hash-tables,hash-tables,,8,3,15,11,22,26,0,1
search-algorithms,search-algorithms,,27,16,37,43,59,80,0,1
propositional-logic,propositional-logic,,2,6,8,8,28,16,0,200
finite-automata,finite-automata,,65,24,143,89,213,232,0,1
halting-problem,halting-problem,,8,10,19,18,41,37,0,25
balanced-search-trees,balanced-search-trees,,4,3,10,7,21,17,0,1
voronoi-diagrams,voronoi-diagrams,,0,2,1,2,6,3,0,100
edit-distance,edit-distance,,11,6,14,17,26,31,0,1
network-flow,network-flow,,17,14,23,31,33,54,0,1
base-conversion,base-conversion,,8,2,8,10,18,18,0,1
compilers,compilers,,13,22,31,35,57,66,0,69.230769
partial-order,partial-order,,0,1,2,1,7,3,0,1
order-theory,order-theory,,0,0,2,0,3,2,0,1
memory-access,memory-access,,9,4,21,13,19,34,9,1
satisfiability,satisfiability,,24,11,37,35,71,72,0,1
sat-solvers,sat-solvers,,5,5,6,10,22,16,0,1
context-free,context-free,,49,35,115,84,132,199,0,1
denotational-semantics,denotational-semantics,,1,0,4,1,2,5,2,1
np,np,,46,29,75,75,115,150,0,1
complexity-classes,complexity-classes,,6,15,17,21,46,38,0,150
p-vs-np,p-vs-np,,5,3,7,8,29,15,0,1
circuits,circuits,,5,9,18,14,28,32,0,80
partitions,partitions,,3,9,11,12,21,23,0,200
term-rewriting,term-rewriting,,1,0,3,1,11,4,2,1
cpu-cache,cpu-cache,,30,36,66,66,82,132,9,20
matrices,matrices,,8,6,16,14,29,30,0,1
weighted-graphs,weighted-graphs,,18,16,12,34,41,46,0,1
binary-search,binary-search,,68,49,100,117,241,217,0,1
asymptotics,asymptotics,,37,26,68,63,131,131,0,1
integers,integers,,3,1,5,4,10,9,0,1
multiplication,multiplication,,54,26,87,80,168,167,0,1
quicksort,quicksort,,102,47,131,149,241,280,0,1
formal-grammars,formal-grammars,,33,18,79,51,98,130,0,1
linked-lists,linked-lists,,2,2,5,4,11,9,0,1
recurrence-relation,recurrence-relation,,15,7,42,22,64,64,0,1
coin-change,coin-change,,9,4,20,13,29,33,0,1
lower-bounds,lower-bounds,,7,4,16,11,18,27,0,1
data-compression,data-compression,,9,3,8,12,41,20,0,1
markov-chains,markov-chains,,30,16,38,46,72,84,0,1
reductions,reductions,,45,30,70,75,137,145,0,1
vc-dimension,vc-dimension,,0,1,0,1,6,1,0,1
smt-solvers,smt-solvers,,0,3,1,3,8,4,0,200
runtime-analysis,runtime-analysis,,29,13,62,42,111,104,0,1
threads,threads,,3,1,10,4,8,14,9,1
master-theorem,master-theorem,,9,5,24,14,33,38,0,1
proof-techniques,proof-techniques,,12,8,37,20,65,57,0,1
semi-decidability,semi-decidability,,3,6,16,9,24,25,0,100
church-turing-thesis,church-turing-thesis,,2,3,5,5,9,10,0,50
boolean-algebra,boolean-algebra,,12,12,14,24,28,38,0,1
memory-management,memory-management,,342,248,648,590,1453,1238,9,1
virtual-memory,virtual-memory,,28,19,59,47,102,106,9,1
paging,paging,,38,37,75,75,141,150,9,1
memory-allocation,memory-allocation,,3,3,2,6,4,8,9,1
digital-circuits,digital-circuits,,2,1,7,3,4,10,0,1
computation-models,computation-models,,11,6,23,17,42,40,0,1
queueing-theory,queueing-theory,,1,1,0,2,1,2,0,1
colorings,colorings,,5,4,8,9,14,17,0,1
connected,connected,,0,0,2,0,5,2,0,1
probabilistic-algorithms,probabilistic-algorithms,,10,3,15,13,20,28,0,1
shortest-path,shortest-path,,84,47,111,131,218,242,0,1
amortized-analysis,amortized-analysis,,8,5,5,13,17,18,0,1
space-complexity,space-complexity,,46,39,72,85,123,157,0,1
entropy,entropy,,19,12,35,31,68,66,0,1
distributed-systems,distributed-systems,,10,10,17,20,28,37,0,1
filesystems,filesystems,,173,166,356,339,612,695,9,1
approximation,approximation,,34,20,50,54,97,104,0,1
number-formats,number-formats,,4,1,6,5,5,11,0,1
iteration,iteration,,245,225,425,470,899,895,0,1
process-scheduling,process-scheduling,,5,2,9,7,13,16,9,1
quantum-computing,quantum-computing,,11,17,23,28,61,51,0,54.545455
mathematical-foundations,mathematical-foundations,,2,0,9,2,16,11,0,1
lattices,lattices,,0,0,1,0,6,1,0,1
arrays,arrays,,8528,7330,17034,15858,36970,32892,1,1
enumeration,enumeration,,40,31,54,71,127,125,0,1
game-theory,game-theory,,15,6,17,21,47,38,0,1
parameterized-complexity,parameterized-complexity,,3,0,2,3,10,5,0,1
regular-languages,regular-languages,,31,30,122,61,175,183,0,1
kleene-star,kleene-star,,2,2,11,4,5,15,0,1
polynomial-time,polynomial-time,,10,7,18,17,44,35,0,1
clique,clique,,8,5,13,13,22,26,0,1
cellular-automata,cellular-automata,,5,6,13,11,21,24,0,20
pushdown-automata,pushdown-automata,,11,11,37,22,59,59,0,1
program-optimization,program-optimization,,1,2,5,3,10,8,0,100
intervals,intervals,,71,43,130,114,250,244,0,1
upper-bound,upper-bound,,4,0,5,4,8,9,0,1
model-checking,model-checking,,10,5,23,15,55,38,0,1
software-verification,software-verification,,2,3,7,5,26,12,0,50
linear-temporal-logic,linear-temporal-logic,,3,0,6,3,15,9,0,1
buchi-automata,buchi-automata,,0,0,2,0,7,2,0,1
pumping-lemma,pumping-lemma,,16,13,39,29,56,68,0,1
set-cover,set-cover,,6,4,10,10,13,20,0,1
first-order-logic,first-order-logic,,12,8,34,20,38,54,0,1
bayesian-statistics,bayesian-statistics,,0,0,0,0,3,0,0,1
randomness,randomness,,6,4,10,10,23,20,0,1
random-number-generator,random-number-generator,,4,0,6,4,8,10,0,1
substrings,substrings,,8,5,12,13,13,25,0,1
board-games,board-games,,3,2,2,5,13,7,0,1
type-checking,type-checking,,4,3,10,7,6,17,2,1
proof-assistants,proof-assistants,,1,1,8,2,16,10,0,1
check-my-answer,check-my-answer,,5,4,10,9,10,19,0,1
incompleteness,incompleteness,,0,1,0,1,7,1,0,1
binary-trees,binary-trees,,13,8,20,21,60,41,0,1
subsequences,subsequences,,4,2,11,6,15,17,0,1
lambda-calculus,lambda-calculus,,26,19,55,45,97,100,2,1
evaluation-strategies,evaluation-strategies,,0,1,1,1,9,2,0,1
linear-programming,linear-programming,,129,66,148,195,266,343,0,1
integer-programming,integer-programming,,34,17,38,51,62,89,0,1
minimum-cuts,minimum-cuts,,3,2,6,5,5,11,0,1
computer-games,computer-games,,1,1,1,2,9,3,0,1
coq,coq,,83,31,108,114,260,222,2,1
2-sat,2-sat,,5,0,5,5,3,10,0,1
assignment-problem,assignment-problem,,3,4,4,7,9,11,0,33.333333
learning-theory,learning-theory,,3,1,5,4,9,9,0,1
bipartite-matching,bipartite-matching,,6,6,8,12,12,20,0,1
search-trees,search-trees,,6,8,11,14,34,25,0,33.333333
category-theory,category-theory,,13,10,23,23,72,46,2,1
landau-notation,landau-notation,,7,0,8,7,37,15,0,1
mathematical-software,mathematical-software,,0,2,0,2,3,2,0,100
knowledge-representation,knowledge-representation,,5,4,9,9,9,18,0,1
reasoning,reasoning,,6,2,11,8,34,19,2,1
decomposition,decomposition,,10,7,23,17,31,40,0,1
inductive-datatypes,inductive-datatypes,,0,0,3,0,5,3,2,1
pseudo-random-generators,pseudo-random-generators,,5,0,5,5,11,10,0,1
encoding-scheme,encoding-scheme,,2,0,6,2,8,8,0,1
algorithm-design,algorithm-design,,5,0,5,5,9,10,0,1
integrity,integrity,,4,6,12,10,12,22,4,50
heaps,heaps,,11,6,13,17,28,30,0,1
counting,counting,,49,49,98,98,187,196,0,1
queues,queues,,3,3,4,6,6,10,0,1
modular-arithmetic,modular-arithmetic,,13,13,25,26,39,51,0,1
rolling-hash,rolling-hash,,0,0,0,0,4,0,0,1
type-inference,type-inference,,63,59,99,122,215,221,3,1
data-flow-analysis,data-flow-analysis,,0,0,3,0,8,3,0,1
resource-allocation,resource-allocation,,0,1,2,1,4,3,0,1
uncountability,uncountability,,0,1,0,1,5,1,0,1
computational-geometry,computational-geometry,,73,65,126,138,272,264,0,1
bloom-filters,bloom-filters,,1,1,1,2,5,3,0,1
radix-sort,radix-sort,,11,2,9,13,35,22,0,1
random-graphs,random-graphs,,2,0,1,2,3,3,0,1
priority-queues,priority-queues,,3,2,5,5,7,10,0,1
bit-manipulation,bit-manipulation,,111,110,239,221,519,460,9,1
dependent-types,dependent-types,,1,8,7,9,14,16,2,700
hoare-logic,hoare-logic,,7,3,4,10,28,14,0,1
subset-sum,subset-sum,,12,12,32,24,60,56,0,1
syntax-trees,syntax-trees,,3,0,0,3,3,3,0,1
coding-theory,coding-theory,,7,3,10,10,15,20,0,1
error-correcting-codes,error-correcting-codes,,4,1,1,5,13,6,0,1
bit-blasting,bit-blasting,,0,0,0,0,2,0,0,1
parallel-computing,parallel-computing,,12,9,12,21,18,33,0,1
space-analysis,space-analysis,,0,1,4,1,8,5,0,1
planar-graphs,planar-graphs,,0,0,3,0,13,3,0,1
parsers,parsers,,11,16,30,27,37,57,0,45.454545
ll-k,ll-k,,0,1,2,1,1,3,0,1
stacks,stacks,,5,4,6,9,11,15,0,1
higher-order-logic,higher-order-logic,,0,0,1,0,2,1,2,1
logical-validity,logical-validity,,0,0,0,0,4,0,0,1
hamiltonian-path,hamiltonian-path,,3,6,8,9,11,17,0,100
memoization,memoization,,28,31,57,59,120,116,0,10.714286
hamiltonian-circuit,hamiltonian-circuit,,1,3,1,4,3,5,0,200
binary-search-trees,binary-search-trees,,7,2,10,9,27,19,0,1
mathematical-programming,mathematical-programming,,8,5,9,13,17,22,0,1
variable-binding,variable-binding,,1,4,2,5,6,7,0,300
temporal-logic,temporal-logic,,0,1,6,1,7,7,0,1
rounding,rounding,,104,82,201,186,408,387,0,1
sets,sets,,11,4,32,15,38,47,0,1
succinct-data-structures,succinct-data-structures,,1,0,1,1,2,2,0,1
database-theory,database-theory,,13,11,25,24,30,49,0,1
datalog,datalog,,3,2,5,5,22,10,0,1
lexical-analysis,lexical-analysis,,12,9,32,21,36,53,0,1
graph-drawing,graph-drawing,,0,1,3,1,7,4,0,1
constraint-programming,constraint-programming,,43,32,34,75,61,109,0,1
number-theory,number-theory,,16,14,27,30,70,57,0,1
computer-algebra,computer-algebra,,2,0,3,2,4,5,0,1
transducers,transducers,,0,0,1,0,2,1,0,1
busy-beaver,busy-beaver,,1,0,0,1,1,1,0,1
chernoff-bounds,chernoff-bounds,,0,1,0,1,4,1,0,1
dictionaries,dictionaries,,2,0,2,2,3,4,0,1
relational-algebra,relational-algebra,,12,3,23,15,55,38,4,1
tree-automata,tree-automata,,2,0,0,2,1,2,0,1
decision-tree,decision-tree,,116,77,175,193,303,368,0,1
polynomials,polynomials,,25,21,56,46,116,102,0,1
selection-problem,selection-problem,,4,3,4,7,6,11,0,1
operational-semantics,operational-semantics,,2,1,2,3,2,5,0,1
software-testing,software-testing,,0,2,1,2,6,3,0,100
polymorphisms,polymorphisms,,0,1,1,1,4,2,9,1
real-numbers,real-numbers,,3,1,5,4,2,9,0,1
fixed-point,fixed-point,,11,10,15,21,41,36,0,1
divide-and-conquer,divide-and-conquer,,16,13,36,29,64,65,0,1
factorial,factorial,,26,18,54,44,111,98,0,1
traveling-salesman,traveling-salesman,,27,26,44,53,79,97,0,1
hamming-code,hamming-code,,7,1,5,8,15,13,0,1
kolmogorov-complexity,kolmogorov-complexity,,3,4,4,7,13,11,0,33.333333
finite-sets,finite-sets,,1,0,1,1,4,2,0,1
algebra,algebra,,17,19,37,36,68,73,0,11.764706
average-case,average-case,,0,2,4,2,7,6,0,100
nearest-neighbour,nearest-neighbour,,2,1,5,3,6,8,0,1
numerical-algorithms,numerical-algorithms,,2,4,6,6,18,12,0,100
ambiguity,ambiguity,,10,7,9,17,26,26,0,1
matching,matching,,75,66,142,141,250,283,0,1
ford-fulkerson,ford-fulkerson,,9,1,10,10,9,20,0,1
homotopy-type-theory,homotopy-type-theory,,3,5,11,8,7,19,2,66.666667
numerical-analysis,numerical-analysis,,10,3,21,13,25,34,0,1
one-way-functions,one-way-functions,,0,1,4,1,3,5,0,1
clocks,clocks,,0,1,3,1,4,4,0,1
mergesort,mergesort,,70,48,118,118,228,236,0,1
modal-logic,modal-logic,,2,0,1,2,4,3,0,1
termination,termination,,6,5,8,11,37,19,2,1
online-algorithms,online-algorithms,,3,0,0,3,10,3,0,1
streaming-algorithm,streaming-algorithm,,1,1,2,2,7,4,0,1
computable-analysis,computable-analysis,,0,0,1,0,2,1,0,1
data-sets,data-sets,,2,2,1,4,5,5,0,1
curry-howard,curry-howard,,1,1,5,2,5,7,2,1
answer-set-programming,answer-set-programming,,4,2,11,6,16,17,0,1
automated-theorem-proving,automated-theorem-proving,,2,0,9,2,6,11,0,1
permutations,permutations,,11,7,7,18,16,25,0,1
convex-hull,convex-hull,,14,12,27,26,45,53,0,1
tiling,tiling,,5,0,7,5,11,12,0,1
church-numerals,church-numerals,,1,0,2,1,2,3,2,1
combinatory-logic,combinatory-logic,,1,1,7,2,11,9,2,1
experimental-analysis,experimental-analysis,,1,0,0,1,4,1,0,1
mutual-exclusion,mutual-exclusion,,5,1,11,6,26,17,9,1
minimum-spanning-tree,minimum-spanning-tree,,20,6,58,26,73,84,0,1
multi-tasking,multi-tasking,,3,1,5,4,9,9,9,1
primes,primes,,65,49,130,114,246,244,0,1
program-correctness,program-correctness,,0,0,0,0,3,0,0,1
tail-recursion,tail-recursion,,32,19,46,51,92,97,0,1
persistent-data-structure,persistent-data-structure,,2,0,2,2,4,4,0,1
abstract-data-types,abstract-data-types,,2,0,2,2,6,4,2,1
normal-forms,normal-forms,,1,0,11,1,9,12,0,1
types,types,,562,458,1020,1020,2021,2040,9,1
max-cut,max-cut,,0,3,1,3,6,4,0,200
loop-invariants,loop-invariants,,7,1,4,8,15,12,0,1
context-sensitive,context-sensitive,,0,8,6,8,4,14,0,700
linear-bounded-automata,linear-bounded-automata,,1,3,3,4,2,7,0,200
spanning-trees,spanning-trees,,4,2,8,6,9,14,0,1
protocols,protocols,,119,105,242,224,488,466,13,1
consensus,consensus,,15,19,29,34,68,63,6,26.666667
signal-processing,signal-processing,,129,103,243,232,467,475,0,1
programming-paradigms,programming-paradigms,,0,0,2,0,2,2,0,1
sudoku,sudoku,,25,14,33,39,75,72,0,1
factoring,factoring,,3,2,3,5,9,8,0,1
cpu-pipelines,cpu-pipelines,,4,3,8,7,10,15,9,1
kernel-functions,kernel-functions,,0,0,1,0,2,1,0,1
graph-isomorphism,graph-isomorphism,,6,2,6,8,4,14,0,1
huffman-coding,huffman-coding,,6,0,6,6,5,12,0,1
transitivity,transitivity,,0,0,2,0,2,2,0,1
primitive-recursion,primitive-recursion,,1,1,4,2,5,6,0,1
packing,packing,,12,8,13,20,33,33,0,1
polygons,polygons,,3,2,0,5,56,5,0,1
deadlocks,deadlocks,,0,5,3,5,8,8,9,400
critical-section,critical-section,,9,7,14,16,29,30,9,1
communication-complexity,communication-complexity,,6,0,2,6,2,8,0,1
continuations,continuations,,9,18,26,27,20,53,2,100
mu-calculus,mu-calculus,,0,0,0,0,2,0,0,1
search-problem,search-problem,,3,5,13,8,10,21,0,66.666667
induction,induction,,16,1,24,17,38,41,2,1
descriptive-complexity,descriptive-complexity,,1,2,3,3,3,6,0,100
quadratic-programming,quadratic-programming,,9,14,17,23,29,40,0,55.555556
constant-time,constant-time,,1,0,1,1,7,2,0,1
string-metrics,string-metrics,,0,1,1,1,3,2,0,1
chomsky-hierarchy,chomsky-hierarchy,,2,3,4,5,13,9,0,50
eulerian-paths,eulerian-paths,,0,0,3,0,3,3,0,1
rice-theorem,rice-theorem,,1,2,7,3,10,10,0,100
suffix-trees,suffix-trees,,1,1,2,2,6,4,0,1
equality,equality,,34,41,72,75,147,147,0,20.588235
fourier-transform,fourier-transform,,0,1,4,1,6,5,0,1
maximum-subarray,maximum-subarray,,3,1,1,4,4,5,0,1
oracles,oracles,,1,1,1,2,3,3,0,1
philosophy,philosophy,,15,16,27,31,35,58,0,6.666667
error-estimation,error-estimation,,4,1,3,5,4,8,0,1
unification,unification,,3,6,9,9,20,18,0,100
co-np,co-np,,1,4,5,5,6,10,0,300
splay-trees,splay-trees,,0,1,3,1,4,4,0,1
mathematical-analysis,mathematical-analysis,,2,2,4,4,2,8,0,1
backtracking,backtracking,,48,35,78,83,151,161,0,1
space-partitioning,space-partitioning,,1,3,1,4,3,5,0,200
finite-model-theory,finite-model-theory,,2,1,1,3,1,4,0,1
matroids,matroids,,0,0,0,0,3,0,0,1
adjacency-matrix,adjacency-matrix,,36,26,64,62,98,126,0,1
prims-algorithm,prims-algorithm,,4,0,11,4,16,15,0,1
prolog,prolog,,216,77,317,293,664,610,0,1
numeral-representations,numeral-representations,,0,1,5,1,1,6,0,1
shared-memory,shared-memory,,66,65,114,131,239,245,9,1
b-tree,b-tree,,18,10,28,28,49,56,0,1
word-combinatorics,word-combinatorics,,5,0,4,5,3,9,0,1
mips,mips,,161,59,279,220,424,499,9,1
transition-systems,transition-systems,,1,0,0,1,3,1,0,1
np-intermediate,np-intermediate,,0,0,2,0,3,2,0,1
lr-k,lr-k,,2,3,1,5,4,6,0,50
crc,crc,,20,23,47,43,96,90,9,15
computational-linguistics,computational-linguistics,,0,3,5,3,5,8,0,200
hidden-markov-models,hidden-markov-models,,12,15,25,27,45,52,0,25
competitive-ratio,competitive-ratio,,0,0,0,0,2,0,0,1
mu-recursion,mu-recursion,,0,0,0,0,2,0,0,1
union-find,union-find,,12,8,13,20,21,33,0,1
computation-tree-logic,computation-tree-logic,,0,1,4,1,8,5,0,1
time-series-analysis,time-series-analysis,,3,0,2,3,2,5,0,1
square-grid,square-grid,,0,0,2,0,3,2,0,1
group-theory,group-theory,,2,3,2,5,2,7,0,50
expert-systems,expert-systems,,0,0,1,0,2,1,0,1
process-algebras,process-algebras,,0,0,0,0,3,0,0,1
expanders,expanders,,1,1,1,2,1,3,0,1
generating-functions,generating-functions,,0,0,0,0,4,0,0,1
pareto,pareto,,1,0,1,1,2,2,0,1
network-topology,network-topology,,2,0,1,2,3,3,0,1
os-kernel,os-kernel,,1,3,4,4,6,8,9,200
mapreduce,mapreduce,,145,106,366,251,741,617,2,1
reference-question,reference-question,,0,0,0,0,2,0,0,1
petri-nets,petri-nets,,0,0,0,0,3,0,0,1
heap-sort,heap-sort,,1,0,0,1,2,1,0,1
relativization,relativization,,3,2,1,5,5,6,0,1
sequential-circuit,sequential-circuit,,0,0,2,0,1,2,0,1
euclidean-distance,euclidean-distance,,34,17,60,51,98,111,0,1
left-recursion,left-recursion,,4,5,9,9,13,18,0,25
turing-test,turing-test,,1,1,1,2,5,3,0,1
van-emde-boas-trees,van-emde-boas-trees,,0,1,1,1,1,2,0,1
topology,topology,,9,10,25,19,45,44,0,11.111111
evolutionary-computing,evolutionary-computing,,1,4,2,5,3,7,0,300
peer-to-peer,peer-to-peer,,0,0,0,0,2,0,0,1
memory-hierarchy,memory-hierarchy,,0,0,1,0,2,1,9,1
doubly-connected-edge-list,doubly-connected-edge-list,,1,0,1,1,1,2,0,1
integer-partitions,integer-partitions,,0,0,1,0,2,1,0,1
hypercomputation,hypercomputation,,2,0,7,2,3,9,0,1
ontologies,ontologies,,1,1,1,2,1,3,0,1
logic-programming,logic-programming,,5,6,8,11,14,19,0,20
reversible-computing,reversible-computing,,0,0,2,0,3,2,0,1
program-synthesis,program-synthesis,,0,2,2,2,1,4,9,100
ccs,ccs,,2,0,0,2,1,2,0,1
exact-string-matching,exact-string-matching,,0,1,1,1,1,2,0,1
relational-calculus,relational-calculus,,0,0,4,0,2,4,4,1
tuple-relational-calculus,tuple-relational-calculus,,0,0,5,0,5,5,4,1
suffix-array,suffix-array,,2,4,7,6,10,13,0,100
agent-based-computing,agent-based-computing,,1,0,0,1,2,1,0,1
human-computing,human-computing,,0,0,0,0,1,0,0,1
bio-inspired-computing,bio-inspired-computing,,1,0,1,1,1,2,0,1
duality,duality,,0,1,3,1,1,4,0,1
color-science,color-science,,0,0,0,0,1,0,0,1
network-analysis,network-analysis,,23,17,25,40,51,65,0,1
digital-preservation,digital-preservation,,0,0,0,0,1,0,0,1
tlaplus,tlaplus,,0,0,0,0,2,0,0,1
random-walks,random-walks,,2,1,0,3,1,3,0,1
longest-common-substring,longest-common-substring,,2,0,0,2,1,2,0,1
digital-curve,digital-curve,,1,0,2,1,1,3,0,1
symbolic-execution,symbolic-execution,,0,0,0,0,2,0,0,1
pi-calculus,pi-calculus,,2,0,0,2,2,2,0,1
sparse-matrices,sparse-matrices,,2,1,4,3,3,7,0,1
in-place,in-place,,4,10,17,14,35,31,0,150
hamming-distance,hamming-distance,,9,6,8,15,22,23,0,1
natural-deduction,natural-deduction,,1,1,0,2,2,2,0,1
neural-computing,neural-computing,,0,1,3,1,1,4,0,1
attribute-grammars,attribute-grammars,,0,0,0,0,2,0,0,1
fstar,fstar,,0,0,2,0,4,2,9,1
omega-automata,omega-automata,,0,1,2,1,0,3,0,1
interactive-proof-systems,interactive-proof-systems,,3,1,2,4,0,6,0,1
tape-complexity,tape-complexity,,0,0,1,0,0,1,0,1
predicate-logic,predicate-logic,,5,0,4,5,0,9,0,1
agda,agda,,11,13,24,24,64,48,2,18.181818
calculus-of-constructions,calculus-of-constructions,,1,3,2,4,0,6,2,200
coinduction,coinduction,,3,0,3,3,2,6,2,1
adversary,adversary,,0,0,3,0,0,3,0,1
xor,xor,,33,32,65,65,129,130,0,1
lempel-ziv,lempel-ziv,,0,0,1,0,0,1,0,1
functional-dependencies,functional-dependencies,,16,4,25,20,45,45,4,1
avl-trees,avl-trees,,5,2,4,7,0,11,0,1
soft-question,soft-question,,7,1,6,8,9,14,0,1
small-step-semantics,small-step-semantics,,2,0,1,2,0,3,0,1
karnaugh-map,karnaugh-map,,4,1,4,5,7,9,0,1
speech-recognition,speech-recognition,,157,152,276,309,442,585,6,1
cubical-type-theory,cubical-type-theory,,2,6,7,8,0,15,2,200
higher-inductive-types,higher-inductive-types,,0,0,1,0,0,1,2,1
randomized,randomized,,0,1,1,1,0,2,0,1
bipartite-graph,bipartite-graph,,3,2,1,5,0,6,0,1
vertex-cover,vertex-cover,,6,1,3,7,2,10,0,1
subtree,subtree,,4,3,12,7,9,19,6,1
diophantine-equation,diophantine-equation,,0,1,1,1,0,2,0,1
treewidth,treewidth,,1,1,1,2,0,3,0,1
page-replacement,page-replacement,,1,3,2,4,1,6,9,200
cache,cache,,3,2,1,5,2,6,9,1
a-star-search,a-star-search,,3,1,1,4,0,5,0,1
derivation,derivation,,1,2,1,3,0,4,0,100
moore-machine,moore-machine,,0,0,1,0,0,1,0,1
mealy-machine,mealy-machine,,0,0,1,0,0,1,0,1
red-black-trees,red-black-trees,,6,1,0,7,0,7,0,1
fenwick-tree,fenwick-tree,,2,2,2,4,2,6,0,1
connected-components,connected-components,,13,10,26,23,48,49,0,1
big-o-notation,big-o-notation,,15,13,0,28,0,28,0,1
visibly-pushdown-automata,visibly-pushdown-automata,,1,0,0,1,0,1,0,1
nested-word-automata,nested-word-automata,,1,0,0,1,0,1,0,1
database-concurrency,database-concurrency,,11,6,7,17,15,24,3,1
database-isolation-level,database-isolation-level,,2,0,0,2,0,2,0,1
filtering-problem,filtering-problem,,2,0,0,2,0,2,0,1
simulated-annealing,simulated-annealing,,10,5,9,15,13,24,0,1
dna,dna,,1,0,0,1,0,1,0,1
case-based-reasoning,case-based-reasoning,,1,0,0,1,0,1,0,1
recommendation-systems,recommendation-systems,,1,0,0,1,0,1,0,1
programming-contest,programming-contest,,1,0,0,1,0,1,0,1
applied-theory,applied-theory,,2,1,0,3,0,3,0,1
minmax-algorithm,minmax-algorithm,,1,1,0,2,0,2,0,1
maze,maze,,39,15,57,54,88,111,0,1
constraint-handling-rules,constraint-handling-rules,,3,4,0,7,0,7,0,33.333333
polynomial-time-reductions,polynomial-time-reductions,,1,4,0,5,0,5,0,300
junction-tree,junction-tree,,1,1,0,2,0,2,0,1
ip,ip,,182,175,322,357,671,679,9,1
empirical-research,empirical-research,,0,1,0,1,0,1,0,1
metalogic,metalogic,,0,1,0,1,0,1,0,1
nc,nc,,0,1,0,1,0,1,0,1
balls-and-bins,balls-and-bins,,0,2,0,2,0,2,0,100
pseudo-random-functions,pseudo-random-functions,,0,1,0,1,0,1,6,1
steiner-trees,steiner-trees,,0,1,0,1,0,1,0,1
probabilistic-turing-machines,probabilistic-turing-machines,,0,1,0,1,0,1,0,1
open-problem,open-problem,,0,4,0,4,0,4,0,300
multidimensional-array,multidimensional-array,,691,482,1316,1173,2785,2489,1,1
is-empty,is-empty,,12,16,41,28,79,69,0,33.333333
html-table,html-table,,400,337,1002,737,2016,1739,1,1
jms,jms,,158,130,274,288,543,562,3,1
wildfly-10,wildfly-10,,30,21,60,51,219,111,3,1
activemq-artemis,activemq-artemis,,37,40,43,77,83,120,3,8.108108
getter-setter,getter-setter,,55,39,101,94,206,195,3,1
instance-variables,instance-variables,,21,18,46,39,96,85,9,1
kill-process,kill-process,,11,13,33,24,40,57,9,18.181818
openfiledialog,openfiledialog,,15,12,24,27,73,51,8,1
deedle,deedle,,5,7,8,12,14,20,8,40
glassfish,glassfish,,93,67,171,160,399,331,3,1
astropy,astropy,,30,22,47,52,82,99,0,1
fits,fits,,14,4,22,18,41,40,0,1
csrf,csrf,,86,133,215,219,424,434,4,54.651163
zend-expressive,zend-expressive,,12,5,12,17,29,29,4,1
swift,swift,,9845,9765,19088,19610,42159,38698,13,1
uiviewcontroller,uiviewcontroller,,154,135,336,289,869,625,13,1
uiscrollview,uiscrollview,,144,102,258,246,653,504,13,1
uiviewanimation,uiviewanimation,,23,26,44,49,154,93,13,13.043478
segmentation-fault,segmentation-fault,,207,136,430,343,933,773,9,1
pyqt,pyqt,,563,565,969,1128,1843,2097,0,1
stylesheet,stylesheet,,29,18,62,47,157,109,1,1
qwidget,qwidget,,21,27,40,48,132,88,9,28.571429
twitter-bootstrap,twitter-bootstrap,,1040,911,2489,1951,8949,4440,1,1
url-rewriting,url-rewriting,,320,263,624,583,1159,1207,4,1
hugo,hugo,,43,42,78,85,156,163,0,1
blogdown,blogdown,,36,22,58,58,156,116,0,1
lodash,lodash,,243,204,497,447,1042,944,1,1
macos,macos,,2045,1994,4235,4039,7911,8274,13,1
amazon-web-services,amazon-web-services,,5035,4948,9412,9983,16761,19395,6,1
ssh,ssh,,531,564,1159,1095,2461,2254,9,6.214689
amazon-lightsail,amazon-lightsail,,31,21,62,52,60,114,6,1
django-views,django-views,,691,629,1154,1320,1904,2474,0,1
longitudinal,longitudinal,,10,8,19,18,40,37,0,1
syncfusion,syncfusion,,46,54,88,100,110,188,8,17.391304
feathersjs,feathersjs,,50,42,85,92,167,177,1,1
watch,watch,,22,42,71,64,131,135,1,90.909091
google-chrome,google-chrome,,1632,1476,3057,3108,5987,6165,1,1
console,console,,238,190,572,428,896,1000,8,1
etsy,etsy,,1,3,10,4,11,14,4,200
uikit,uikit,,175,225,394,400,614,794,13,28.571429
ios11,ios11,,17,13,93,30,1993,123,13,1
rtweet,rtweet,,7,8,12,15,29,27,0,14.285714
postgresql,postgresql,,4206,3780,7441,7986,13980,15427,4,1
string,string,,3240,2708,6407,5948,13626,12355,0,1
arabic,arabic,,48,43,83,91,174,174,0,1
macos-sierra,macos-sierra,,16,6,43,22,306,65,13,1
maxima,maxima,,11,7,32,18,52,50,0,1
facebook-graph-api,facebook-graph-api,,331,295,653,626,1851,1279,13,1
swift3,swift3,,66,38,196,104,2594,300,13,1
cocoapods,cocoapods,,255,233,492,488,866,980,13,1
swift4,swift4,,295,202,978,497,3613,1475,13,1
xcode9-beta,xcode9-beta,,0,0,0,0,40,0,13,1
android-studio,android-studio,,810,2762,6587,3572,8949,10159,3,240.987654
android-icons,android-icons,,11,4,14,15,22,29,3,1
uinavigationcontroller,uinavigationcontroller,,133,116,279,249,741,528,13,1
rubygems,rubygems,,187,170,381,357,772,738,12,1
paperclip,paperclip,,16,15,65,31,177,96,12,1
ruby-on-rails-5,ruby-on-rails-5,,473,547,1213,1020,2149,2233,12,15.64482
key,key,,147,122,358,269,705,627,0,1
revit,revit,,19,35,46,54,66,100,8,84.210526
ifc,ifc,,6,11,10,17,22,27,14,83.333333
dns,dns,,431,330,779,761,1458,1540,4,1
memory-address,memory-address,,30,28,60,58,130,118,9,1
interop,interop,,76,61,138,137,244,275,8,1
ms-office,ms-office,,96,96,189,192,448,381,5,1
asp.net-mvc-5,asp.net-mvc-5,,324,244,550,568,1307,1118,8,1
signalr,signalr,,245,239,455,484,708,939,8,1
httplib2,httplib2,,4,6,4,10,19,14,0,50
google-cloud-sdk,google-cloud-sdk,,14,15,37,29,86,66,6,7.142857
http-status-code-403,http-status-code-403,,52,49,109,101,198,210,4,1
spring-data-jpa,spring-data-jpa,,913,875,1927,1788,2870,3715,3,1
jasypt,jasypt,,10,16,27,26,24,53,3,60
laravel-5.4,laravel-5.4,,53,39,201,92,1180,293,4,1
linq-to-sql,linq-to-sql,,69,71,159,140,333,299,8,2.898551
entity-framework-6,entity-framework-6,,343,257,682,600,1400,1282,8,1
read-eval-print-loop,read-eval-print-loop,,19,19,48,38,103,86,2,1
smartystreets,smartystreets,,1,0,0,1,4,1,1,1
search-form,search-form,,4,6,9,10,18,19,4,50
serial-communication,serial-communication,,30,33,42,63,66,105,9,10
python-2.7,python-2.7,,2026,1594,4476,3620,12049,8096,0,1
embedded,embedded,,217,191,345,408,603,753,9,1
proxypass,proxypass,,30,23,65,53,103,118,6,1
android-layout,android-layout,,869,845,1827,1714,4662,3541,3,1
textview,textview,,193,165,419,358,996,777,3,1
image-uploading,image-uploading,,67,75,156,142,349,298,4,11.940299
openedge,openedge,,37,32,77,69,105,146,4,1
progress-4gl,progress-4gl,,25,24,69,49,76,118,4,1
moose,moose,,4,3,4,7,23,11,9,1
xpath,xpath,,711,721,1421,1432,3037,2853,3,1.40647
angular-routing,angular-routing,,182,163,328,345,659,673,1,1
button,button,,642,565,1223,1207,2664,2430,1,1
string-algorithm,string-algorithm,,1,1,4,2,5,6,0,1
simulink,simulink,,60,72,140,132,184,272,0,20
tcl,tcl,,91,81,183,172,438,355,0,1
cluster-analysis,cluster-analysis,,175,156,317,331,602,648,0,1
function,function,,2390,1920,4330,4310,8832,8640,0,1
libreoffice,libreoffice,,42,27,90,69,150,159,5,1
libreoffice-calc,libreoffice-calc,,16,16,36,32,73,68,5,1
actions-on-google,actions-on-google,,227,181,567,408,822,975,13,1
api-ai,api-ai,,7,2,12,9,75,21,13,1
unlink,unlink,,8,10,21,18,39,39,4,25
reporting-services,reporting-services,,459,390,853,849,1836,1702,4,1
ssms,ssms,,214,187,435,401,749,836,4,1
int,int,,189,155,392,344,803,736,0,1
ionic3,ionic3,,693,514,2240,1207,5068,3447,1,1
openerp,openerp,,0,0,0,0,512,0,0,1
odoo-9,odoo-9,,20,8,90,28,293,118,0,1
webview,webview,,549,515,1011,1064,1801,2075,3,1
typeface,typeface,,5,4,5,9,21,14,3,1
ecmascript-6,ecmascript-6,,1381,1180,2645,2561,5608,5206,1,1
babeljs,babeljs,,189,166,470,355,677,825,1,1
polyfills,polyfills,,35,39,68,74,115,142,1,11.428571
connection-string,connection-string,,70,54,90,124,300,214,8,1
three.js,three.js,,426,387,839,813,1672,1652,1,1
textures,textures,,90,70,159,160,322,319,9,1
koa,koa,,45,37,104,82,167,186,1,1
apache-spark-sql,apache-spark-sql,,809,807,1796,1616,2968,3412,2,1
algorithm,algorithm,,1948,1617,3800,3565,8110,7365,0,1
crashlytics,crashlytics,,123,75,257,198,512,455,3,1
google-fabric,google-fabric,,52,31,155,83,306,238,3,1
angular,angular,,13691,12697,26808,26388,52027,53196,1,1
streaming,streaming,,143,113,280,256,449,536,13,1
google-apps-script,google-apps-script,,1433,1603,2304,3036,3999,5340,5,11.863224
google-drive-api,google-drive-api,,272,325,602,597,1068,1199,5,19.485294
google-slides-api,google-slides-api,,11,13,44,24,75,68,5,18.181818
amazon-dynamodb,amazon-dynamodb,,542,445,859,987,1481,1846,6,1
amazon-iam,amazon-iam,,184,222,266,406,461,672,6,20.652174
gzipoutputstream,gzipoutputstream,,4,4,3,8,6,11,3,1
bufferedoutputstream,bufferedoutputstream,,0,2,2,2,3,4,3,100
swig,swig,,60,55,103,115,243,218,9,1
command-line-interface,command-line-interface,,245,285,524,530,815,1054,9,16.326531
export-to-csv,export-to-csv,,194,191,340,385,586,725,0,1
date,date,,1369,1213,2692,2582,6091,5274,0,1
datetime,datetime,,1394,1355,2646,2749,5626,5395,0,1
firebase,firebase,,5739,5158,12090,10897,22321,22987,13,1
expo,expo,,549,647,899,1196,821,2095,1,17.850638
ear,ear,,12,14,55,26,77,81,3,16.666667
glassfish-4,glassfish-4,,11,12,24,23,59,47,3,9.090909
firebase-realtime-database,firebase-realtime-database,,1751,1384,3690,3135,8549,6825,13,1
vtable,vtable,,7,9,19,16,38,35,9,28.571429
node-modules,node-modules,,280,311,475,591,803,1066,1,11.071429
umd,umd,,9,9,7,18,33,25,1,1
count,count,,371,289,763,660,1498,1423,4,1
stackexchange.redis,stackexchange.redis,,32,33,70,65,87,135,8,3.125
arraylist,arraylist,,679,472,1398,1151,2934,2549,3,1
frequency,frequency,,59,55,135,114,212,249,0,1
window.location,window.location,,16,12,20,28,37,48,1,1
haar-classifier,haar-classifier,,12,13,23,25,59,48,0,8.333333
webpack-2,webpack-2,,8,3,15,11,298,26,1,1
aurelia,aurelia,,66,35,146,101,453,247,1,1
aurelia-cli,aurelia-cli,,2,3,12,5,43,17,1,50
aurelia-i18n,aurelia-i18n,,1,0,2,1,3,3,1,1
rvest,rvest,,111,103,187,214,383,401,0,1
drag-and-drop,drag-and-drop,,256,248,496,504,762,1000,1,1
eventhandler,eventhandler,,32,19,50,51,99,101,8,1
atomic,atomic,,77,57,120,134,255,254,9,1
unordered-map,unordered-map,,41,27,62,68,101,130,9,1
mfi,mfi,,6,4,9,10,10,19,13,1
replace,replace,,479,473,929,952,2114,1881,0,1
animate.css,animate.css,,12,4,25,16,75,41,1,1
image-enlarge,image-enlarge,,1,0,3,1,3,4,1,1
oop,oop,,1029,842,1901,1871,3872,3772,9,1
visual-studio-code,visual-studio-code,,1628,1726,2924,3354,4050,6278,9,6.019656
language-server-protocol,language-server-protocol,,14,14,17,28,17,45,9,1
for-loop,for-loop,,1562,1405,3312,2967,6379,6279,0,1
vectorization,vectorization,,184,140,307,324,589,631,0,1
apache-poi,apache-poi,,247,250,531,497,969,1028,3,1.214575
report,report,,162,146,324,308,480,632,4,1
xls,xls,,40,37,65,77,157,142,5,1
jett,jett,,0,0,1,0,4,1,3,1
icloud,icloud,,23,32,93,55,138,148,13,39.130435
dropbox-api,dropbox-api,,27,29,63,56,138,119,4,7.407407
aspnetboilerplate,aspnetboilerplate,,69,65,172,134,399,306,8,1
anonymous-function,anonymous-function,,35,17,66,52,140,118,1,1
language-lawyer,language-lawyer,,262,213,435,475,808,910,9,1
lvalue,lvalue,,7,17,22,24,40,46,9,142.857143
incomplete-type,incomplete-type,,3,7,11,10,26,21,9,133.333333
express,express,,3175,3007,5710,6182,9800,11892,1,1
flask-sqlalchemy,flask-sqlalchemy,,256,240,424,496,693,920,0,1
flask-session,flask-session,,8,6,19,14,11,33,0,1
file,file,,1593,1304,2939,2897,5879,5836,0,1
mvvmcross,mvvmcross,,39,45,149,84,394,233,8,15.384615
foreach,foreach,,484,393,953,877,2169,1830,4,1
rxjs,rxjs,,915,840,1704,1755,3499,3459,1,1
cmd,cmd,,545,577,1089,1122,2417,2211,9,5.87156
facebook-ads-api,facebook-ads-api,,22,26,51,48,79,99,13,18.181818
ng-bootstrap,ng-bootstrap,,89,87,206,176,378,382,1,1
serverless-framework,serverless-framework,,154,147,251,301,408,552,6,1
comma,comma,,23,19,48,42,145,90,0,1
composer-php,composer-php,,264,277,594,541,1174,1135,4,4.924242
twig,twig,,272,186,558,458,990,1016,4,1
sonata,sonata,,26,20,60,46,123,106,4,1
connect,connect,,55,33,70,88,126,158,4,1
jedis,jedis,,24,19,65,43,102,108,3,1
png,png,,107,114,207,221,396,428,1,6.542056
google-signin,google-signin,,144,141,287,285,442,572,3,1
iframe,iframe,,550,488,1108,1038,2107,2146,1,1
youtube,youtube,,266,223,540,489,1013,1029,5,1
core-graphics,core-graphics,,35,34,76,69,195,145,13,1
core-animation,core-animation,,22,28,54,50,124,104,13,27.272727
protocol-buffers,protocol-buffers,,215,224,369,439,682,808,6,4.186047
bazel,bazel,,93,100,174,193,372,367,9,7.526882
ibm-cloud,ibm-cloud,,154,146,337,300,758,637,6,1
watson-conversation,watson-conversation,,12,0,134,12,255,146,6,1
axios,axios,,994,1042,1616,2036,2174,3652,1,4.828974
phonegap,phonegap,,164,125,366,289,745,655,1,1
grails,grails,,212,149,447,361,1014,808,3,1
test-first,test-first,,0,0,0,0,2,0,3,1
curl,curl,,943,816,1861,1759,3779,3620,4,1
jtable,jtable,,100,66,173,166,415,339,3,1
jsplitpane,jsplitpane,,1,1,3,2,6,5,3,1
cordova,cordova,,914,868,1994,1782,4404,3776,1,1
ionic-framework,ionic-framework,,1864,1689,3791,3553,7590,7344,1,1
android-emulator,android-emulator,,198,165,368,363,756,731,3,1
kotlin,kotlin,,3444,3848,6088,7292,8084,13380,3,11.730546
observable,observable,,427,375,901,802,1924,1703,1,1
android-databinding,android-databinding,,151,148,281,299,395,580,3,1
plsql,plsql,,677,571,1138,1248,2563,2386,4,1
xmltype,xmltype,,9,10,11,19,30,30,4,11.111111
google-oauth,google-oauth,,193,167,356,360,620,716,5,1
gmail-api,gmail-api,,140,95,290,235,495,525,5,1
lubridate,lubridate,,99,77,153,176,270,329,0,1
visual-studio-2017,visual-studio-2017,,866,490,1991,1356,4901,3347,8,1
kestrel-http-server,kestrel-http-server,,30,33,58,63,127,121,8,10
spring-cloud,spring-cloud,,217,188,445,405,800,850,3,1
spring-vault,spring-vault,,5,5,13,10,17,23,3,1
spring-cloud-vault-config,spring-cloud-vault-config,,4,3,14,7,21,21,3,1
xamarin.forms,xamarin.forms,,1456,1304,2891,2760,5908,5651,8,1
websphere,websphere,,121,120,273,241,504,514,3,1
boot,boot,,35,27,57,62,95,119,9,1
websphere-8,websphere-8,,14,14,44,28,104,72,3,1
vector,vector,,619,497,1161,1116,2791,2277,9,1
copy-constructor,copy-constructor,,23,27,70,50,163,120,9,17.391304
push-back,push-back,,3,6,14,9,30,23,9,100
resharper,resharper,,63,33,110,96,300,206,8,1
autolayout,autolayout,,161,134,372,295,974,667,13,1
uistackview,uistackview,,57,59,125,116,276,241,13,3.508772
stripe-payments,stripe-payments,,334,297,516,631,870,1147,4,1
photo,photo,,46,26,76,72,108,148,13,1
awk,awk,,589,531,1118,1120,2647,2238,9,1
sharepoint,sharepoint,,438,475,934,913,1474,1847,8,8.447489
python-embedding,python-embedding,,6,13,9,19,18,28,0,116.666667
amazon-s3,amazon-s3,,1563,1618,2881,3181,5154,6062,6,3.518874
netbeans,netbeans,,312,249,633,561,1387,1194,3,1
member-variables,member-variables,,5,4,5,9,16,14,9,1
php-cs-fixer,php-cs-fixer,,4,2,10,6,13,16,4,1
uiimageview,uiimageview,,91,76,191,167,536,358,13,1
uiimage,uiimage,,93,81,197,174,457,371,13,1
cllocation,cllocation,,12,7,20,19,48,39,13,1
geom-raster,geom-raster,,5,6,4,11,9,15,0,20
environment-variables,environment-variables,,347,324,608,671,1122,1279,9,1
bash4,bash4,,0,1,1,1,8,2,9,1
events,events,,555,465,1101,1020,2180,2121,1,1
ionic2,ionic2,,73,39,333,112,2752,445,1,1
ionic-native,ionic-native,,93,67,204,160,327,364,1,1
plot,plot,,864,750,1605,1614,3487,3219,0,1
enums,enums,,392,356,738,748,1606,1486,3,1
routes,routes,,351,289,611,640,1320,1251,4,1
opencart,opencart,,79,77,166,156,423,322,4,1
terminal,terminal,,538,519,1091,1057,1974,2148,9,1
indexer,indexer,,12,5,11,17,22,28,8,1
scrapy,scrapy,,616,635,994,1251,1899,2245,0,3.084416
python-2.5,python-2.5,,2,3,6,5,13,11,0,50
interface-builder,interface-builder,,52,36,111,88,264,199,13,1
radial-gradients,radial-gradients,,7,7,10,14,32,24,1,1
ui-design,ui-design,,4,1,4,5,17,9,3,1
knockout.js,knockout.js,,80,125,265,205,793,470,1,56.25
clrs,clrs,,4,4,6,8,12,14,0,1
networkx,networkx,,236,205,369,441,570,810,0,1
add,add,,64,45,151,109,270,260,0,1
constructor,constructor,,346,300,687,646,1454,1333,9,1
overloading,overloading,,94,83,237,177,452,414,9,1
woocommerce,woocommerce,,1389,1234,2865,2623,4392,5488,4,1
omnet++,omnet++,,93,49,107,142,187,249,9,1
veins,veins,,35,21,55,56,102,111,9,1
shiny,shiny,,975,1077,1900,2052,3664,3952,0,10.461538
plotly,plotly,,423,467,725,890,1237,1615,0,10.401891
windowbuilder,windowbuilder,,17,7,33,24,58,57,3,1
intellij-idea,intellij-idea,,1006,970,2161,1976,4128,4137,3,1
javadoc,javadoc,,48,34,100,82,168,182,3,1
sql-server-2014,sql-server-2014,,125,104,305,229,788,534,4,1
footer,footer,,52,29,79,81,225,160,1,1
hive,hive,,762,711,1468,1473,2873,2941,2,1
mediametadataretriever,mediametadataretriever,,6,1,2,7,15,9,3,1
hyper,hyper,,14,13,14,27,37,41,9,1
google-chrome-extension,google-chrome-extension,,676,605,1187,1281,2177,2468,1,1
breeze,breeze,,5,0,10,5,37,15,8,1
unity5,unity5,,0,0,0,0,541,0,8,1
fullcalendar,fullcalendar,,250,254,393,504,797,897,1,1.6
richfaces,richfaces,,8,13,25,21,45,46,3,62.5
weblogic12c,weblogic12c,,90,81,209,171,278,380,3,1
jsf-1.2,jsf-1.2,,6,7,9,13,16,22,3,16.666667
azure-service-fabric,azure-service-fabric,,98,87,255,185,617,440,8,1
azure-functions,azure-functions,,523,542,1040,1065,1744,2105,8,3.632887
azure-logic-apps,azure-logic-apps,,128,133,231,261,369,492,8,3.90625
jquery-ui,jquery-ui,,237,165,494,402,1329,896,1,1
ggmap,ggmap,,28,32,62,60,161,122,0,14.285714
elixir,elixir,,228,202,478,430,1302,908,2,1
phoenix-framework,phoenix-framework,,87,68,230,155,656,385,2,1
jasmine,jasmine,,364,339,797,703,1375,1500,1,1
gas,gas,,25,20,57,45,78,102,9,1
sequelize.js,sequelize.js,,569,480,878,1049,1316,1927,1,1
svg,svg,,1019,982,1933,2001,3793,3934,1,1
google-chrome-devtools,google-chrome-devtools,,245,219,528,464,862,992,1,1
chrome-dev-editor,chrome-dev-editor,,1,0,0,1,2,1,1,1
android-tablayout,android-tablayout,,68,60,128,128,342,256,3,1
illegalargumentexception,illegalargumentexception,,14,12,40,26,77,66,3,1
objectinputstream,objectinputstream,,11,5,18,16,36,34,3,1
scrollbar,scrollbar,,130,88,194,218,357,412,1,1
css-position,css-position,,97,63,184,160,430,344,1,1
pyqt5,pyqt5,,711,814,1173,1525,1859,2698,0,14.486639
qtwebengine,qtwebengine,,24,29,30,53,48,83,9,20.833333
eventfilter,eventfilter,,2,2,1,4,8,5,9,1
docstring,docstring,,19,19,44,38,56,82,0,1
parallel-processing,parallel-processing,,491,412,953,903,1818,1856,0,1
try-catch,try-catch,,163,158,310,321,652,631,3,1
plyr,plyr,,45,24,63,69,202,132,0,1
carrierwave,carrierwave,,38,29,104,67,196,171,12,1
cloudinary,cloudinary,,37,34,83,71,129,154,1,1
spotify,spotify,,84,84,187,168,288,355,4,1
spotipy,spotipy,,13,14,27,27,28,54,0,7.692308
djongo,djongo,,13,9,28,22,10,50,0,1
ffi,ffi,,39,32,81,71,137,152,9,1
protractor,protractor,,415,282,775,697,1485,1472,3,1
docker-compose,docker-compose,,1220,1182,2088,2402,3371,4490,6,1
dockerfile,dockerfile,,619,592,990,1211,1777,2201,6,1
docker-machine,docker-machine,,51,71,124,122,268,246,6,39.215686
memory-leaks,memory-leaks,,314,258,570,572,1225,1142,9,1
gsoap,gsoap,,11,9,20,20,31,40,9,1
textinputlayout,textinputlayout,,4,7,6,11,21,17,3,75
css-animations,css-animations,,208,199,390,407,658,797,1,1
removechild,removechild,,9,8,19,17,39,36,1,1
dom-manipulation,dom-manipulation,,6,11,26,17,47,43,1,83.333333
typeerror,typeerror,,169,140,333,309,642,642,0,1
apache-flink,apache-flink,,242,208,484,450,789,934,2,1
elasticsearch-plugin,elasticsearch-plugin,,14,14,22,28,156,50,6,1
flink-streaming,flink-streaming,,120,98,220,218,409,438,2,1
relay,relay,,28,23,40,51,91,91,1,1
ubuntu-17.04,ubuntu-17.04,,0,0,1,0,41,1,9,1
arguments,arguments,,203,205,437,408,828,845,0,1
zeromq,zeromq,,68,57,119,125,285,244,0,1
camanjs,camanjs,,3,1,13,4,6,17,1,1
sid,sid,,5,4,5,9,13,14,9,1
arkit,arkit,,207,205,464,412,972,876,13,1
tkinter,tkinter,,1587,1435,2484,3022,4531,5506,0,1
httr,httr,,35,40,81,75,116,156,0,14.285714
tuples,tuples,,256,243,575,499,1041,1074,0,1
statsmodels,statsmodels,,89,120,178,209,303,387,0,34.831461
kolmogorov-smirnov,kolmogorov-smirnov,,1,7,11,8,15,19,0,600
nasm,nasm,,139,75,207,214,412,421,9,1
.net-core-2.0,.net-core-2.0,,29,5,36,34,215,70,8,1
snapchat,snapchat,,11,6,15,17,30,32,13,1
ironpython,ironpython,,58,59,95,117,147,212,8,1.724138
lxml,lxml,,119,98,208,217,456,425,0,1
keras-layer,keras-layer,,109,122,207,231,294,438,0,11.926606
vert.x,vert.x,,80,95,180,175,377,355,3,18.75
optional,optional,,90,97,229,187,432,416,3,7.777778
laravel-5,laravel-5,,1571,1484,3271,3055,7518,6326,4,1
vuejs2,vuejs2,,1312,1263,2953,2575,5661,5528,1,1
gitlab-ci,gitlab-ci,,284,289,462,573,634,1035,6,1.760563
timestamp,timestamp,,301,306,564,607,1113,1171,0,1.66113
weighted-average,weighted-average,,13,12,25,25,49,50,0,1
webp,webp,,39,43,56,82,50,138,1,10.25641
checkbox,checkbox,,432,379,818,811,2207,1629,1,1
react-native-android,react-native-android,,381,544,801,925,1273,1726,1,42.782152
react-native-camera,react-native-camera,,21,16,35,37,63,72,1,1
safari,safari,,354,394,757,748,1401,1505,1,11.299435
websphere-liberty,websphere-liberty,,50,35,79,85,187,164,3,1
entity-framework-core,entity-framework-core,,784,736,1241,1520,2051,2761,8,1
asp.net-identity-3,asp.net-identity-3,,0,0,5,0,19,5,8,1
spring-aop,spring-aop,,48,63,108,111,254,219,3,31.25
proxyfactory,proxyfactory,,0,0,0,0,2,0,3,1
pug,pug,,105,103,213,208,563,421,1,1
ejs,ejs,,246,235,399,481,730,880,1,1
struts2,struts2,,56,61,145,117,288,262,3,8.928571
struts2-jquery-grid,struts2-jquery-grid,,2,0,0,2,2,2,1,1
aop,aop,,51,44,127,95,237,222,3,1
java-8,java-8,,888,742,1780,1630,3358,3410,3,1
method-reference,method-reference,,13,22,44,35,80,79,3,69.230769
rdd,rdd,,116,119,273,235,667,508,2,2.586207
load,load,,68,82,189,150,406,339,1,20.588235
tfs,tfs,,355,276,761,631,2315,1392,8,1
tfs2017,tfs2017,,27,27,56,54,363,110,8,1
build-server,build-server,,6,6,6,12,12,18,8,1
android-recyclerview,android-recyclerview,,1187,1155,2246,2342,4499,4588,3,1
android-viewholder,android-viewholder,,35,27,52,62,154,114,3,1
renjin,renjin,,0,2,3,2,7,5,3,100
module,module,,496,482,888,978,1695,1866,0,1
uitableview,uitableview,,869,678,1620,1547,4547,3167,13,1
tableview,tableview,,212,149,421,361,838,782,13,1
android-youtube-api,android-youtube-api,,14,18,46,32,75,78,3,28.571429
android-6.0-marshmallow,android-6.0-marshmallow,,15,8,39,23,118,62,3,1
android-support-library,android-support-library,,49,75,115,124,346,239,3,53.061224
noclassdeffounderror,noclassdeffounderror,,33,28,65,61,130,126,3,1
require,require,,65,53,107,118,273,225,1,1
sonarqube,sonarqube,,272,271,519,543,1307,1062,3,1
sonarqube5.6,sonarqube5.6,,0,0,2,0,9,2,3,1
cython,cython,,109,130,214,239,587,453,0,19.266055
cythonize,cythonize,,15,11,21,26,68,47,0,1
oauth-2.0,oauth-2.0,,796,713,1402,1509,2276,2911,4,1
pdb,pdb,,27,26,53,53,96,106,0,1
echarts,echarts,,36,39,73,75,69,148,1,8.333333
aws-opsworks,aws-opsworks,,5,5,14,10,51,24,6,1
amazon-linux,amazon-linux,,12,13,33,25,51,58,6,8.333333
docker-aws,docker-aws,,0,0,1,0,4,1,6,1
websocket,websocket,,804,791,1530,1595,2584,3125,1,1
phpwebsocket,phpwebsocket,,11,10,16,21,24,37,4,1
react-proptypes,react-proptypes,,38,39,80,77,148,157,1,2.631579
openstreetmap,openstreetmap,,125,122,180,247,343,427,1,1
osmdroid,osmdroid,,20,18,41,38,97,79,3,1
datatables,datatables,,637,596,1228,1233,2160,2461,1,1
intellisense,intellisense,,77,84,156,161,280,317,8,9.090909
datefilter,datefilter,,3,4,7,7,19,14,1,33.333333
batch-file,batch-file,,742,756,1494,1498,3753,2992,9,1.886792
winapi,winapi,,569,557,1007,1126,2131,2133,9,1
ms-access,ms-access,,1012,898,1976,1910,4019,3886,5,1
odbc,odbc,,230,221,397,451,720,848,4,1
uibutton,uibutton,,128,123,286,251,671,537,13,1
xcode8.2,xcode8.2,,0,0,1,0,17,1,13,1
jquery-select2,jquery-select2,,142,139,337,281,584,618,1,1
yadcf,yadcf,,5,3,14,8,33,22,1,1
rules,rules,,53,44,113,97,118,210,4,1
max,max,,165,149,376,314,681,690,0,1
colors,colors,,394,359,671,753,1566,1424,0,1
radio-button,radio-button,,165,151,348,316,784,664,1,1
modal-dialog,modal-dialog,,227,221,481,448,928,929,1,1
pyside,pyside,,36,28,90,64,230,154,0,1
pyqtgraph,pyqtgraph,,29,43,64,72,119,136,0,48.275862
merge,merge,,479,470,1007,949,2267,1956,0,1
branch,branch,,72,68,170,140,371,310,6,1
git-subtree,git-subtree,,12,7,21,19,44,40,6,1
app-store,app-store,,135,125,261,260,505,521,13,1
xcode9,xcode9,,7,2,79,9,1545,88,13,1
cakebuild,cakebuild,,13,9,24,22,61,46,8,1
myget,myget,,1,3,4,4,6,8,8,200
appium,appium,,324,302,544,626,1037,1170,3,1
datagridview,datagridview,,276,257,652,533,1367,1185,8,1
contour,contour,,55,74,81,129,145,210,0,34.545455
java-bytecode-asm,java-bytecode-asm,,12,11,32,23,80,55,3,1
javassist,javassist,,7,8,20,15,55,35,3,14.285714
bytecode-manipulation,bytecode-manipulation,,4,6,13,10,34,23,3,50
javaagents,javaagents,,9,12,24,21,54,45,3,33.333333
operating-system,operating-system,,287,243,566,530,952,1096,9,1
core-data,core-data,,241,233,477,474,1292,951,13,1
android-gradle,android-gradle,,567,418,1015,985,2280,2000,3,1
vulkan,vulkan,,52,68,90,120,156,210,9,30.769231
jsonb,jsonb,,92,80,144,172,296,316,4,1
laravel-5.3,laravel-5.3,,7,4,42,11,637,53,4,1
factories,factories,,1,2,5,3,6,8,4,100
thrift-protocol,thrift-protocol,,3,1,3,4,13,7,2,1
firedac,firedac,,14,18,42,32,126,74,9,28.571429
jsfiddle,jsfiddle,,14,16,40,30,108,70,1,14.285714
azureservicebus,azureservicebus,,113,106,184,219,416,403,8,1
tensorflow-gpu,tensorflow-gpu,,0,0,0,0,257,0,0,1
biometrics,biometrics,,29,21,43,50,61,93,3,1
localauthentication,localauthentication,,7,2,6,9,27,15,13,1
android-fragments,android-fragments,,807,687,1694,1494,3900,3188,3,1
azure-web-app-service,azure-web-app-service,,159,162,298,321,427,619,8,1.886792
abaqus,abaqus,,20,12,34,32,65,66,0,1
firebase-authentication,firebase-authentication,,836,801,1544,1637,3135,3181,13,1
firebase-security,firebase-security,,14,14,48,28,387,76,13,1
sparql,sparql,,166,112,235,278,540,513,2,1
blazegraph,blazegraph,,6,4,7,10,27,17,2,1
smart-pointers,smart-pointers,,56,81,94,137,189,231,9,44.642857
pivot,pivot,,267,229,506,496,1025,1002,4,1
spring-boot-test,spring-boot-test,,71,70,140,141,191,281,3,1
cors,cors,,393,525,821,918,1731,1739,1,33.587786
jsonp,jsonp,,8,11,53,19,145,72,1,37.5
eigen,eigen,,95,77,192,172,395,364,9,1
rcpp,rcpp,,80,61,155,141,391,296,0,1
google-apps,google-apps,,30,33,43,63,109,106,5,10
google-now,google-now,,0,0,3,0,7,3,3,1
google-voice-search,google-voice-search,,0,0,6,0,8,6,3,1
uipopoverpresentationcontroller,uipopoverpresentationcontroller,,3,3,9,6,21,15,13,1
vim,vim,,210,160,498,370,1094,868,9,1
youcompleteme,youcompleteme,,4,1,14,5,23,19,9,1
sql-server-2008,sql-server-2008,,239,140,541,379,2059,920,4,1
greatest-n-per-group,greatest-n-per-group,,79,64,115,143,335,258,4,1
bootbox,bootbox,,9,5,18,14,46,32,1,1
mysqli,mysqli,,670,459,1684,1129,3470,2813,4,1
insert,insert,,210,165,434,375,879,809,4,1
phpmailer,phpmailer,,139,110,274,249,617,523,4,1
interrupt,interrupt,,64,64,134,128,252,262,9,1
pic,pic,,50,22,67,72,88,139,9,1
uart,uart,,74,52,84,126,185,210,9,1
google-authentication,google-authentication,,79,95,168,174,250,342,5,20.253165
android-room,android-room,,390,387,697,777,1109,1474,3,1
android-linearlayout,android-linearlayout,,53,56,129,109,359,238,3,5.660377
tablelayout,tablelayout,,11,6,18,17,43,35,3,1
tablerow,tablerow,,5,9,16,14,38,30,3,80
format,format,,260,201,479,461,938,940,0,1
meteor,meteor,,148,127,425,275,1637,700,1,1
sql-server-2012,sql-server-2012,,268,204,624,472,1654,1096,4,1
alamofire,alamofire,,204,174,447,378,981,825,13,1
filenames,filenames,,55,64,147,119,287,266,0,16.363636
angular2-routing,angular2-routing,,76,64,146,140,833,286,1,1
display,display,,94,72,218,166,383,384,1,1
compiler-errors,compiler-errors,,376,316,732,692,1598,1424,9,1
crtp,crtp,,17,17,40,34,66,74,9,1
masm,masm,,54,37,94,91,169,185,9,1
masm32,masm32,,6,8,18,14,40,32,9,33.333333
oledb,oledb,,83,70,144,153,297,297,8,1
visual-studio-2012,visual-studio-2012,,39,48,93,87,325,180,8,23.076923
retrofit2,retrofit2,,344,383,763,727,1447,1490,3,11.337209
triggers,triggers,,321,289,667,610,1318,1277,4,1
zabbix,zabbix,,37,22,62,59,119,121,6,1
surfaceview,surfaceview,,18,39,63,57,150,120,3,116.666667
android-camera2,android-camera2,,108,115,147,223,285,370,3,6.481481
sqldatatypes,sqldatatypes,,39,27,60,66,104,126,4,1
large-text,large-text,,0,0,0,0,1,0,4,1
parameter-passing,parameter-passing,,165,141,336,306,694,642,9,1
listbox,listbox,,112,116,265,228,599,493,8,3.571429
clips,clips,,10,10,26,20,37,46,0,1
expert-system,expert-system,,6,7,16,13,21,29,0,16.666667
openshift,openshift,,206,171,357,377,741,734,6,1
canvasjs,canvasjs,,20,12,40,32,75,72,1,1
uiwebview,uiwebview,,53,38,113,91,308,204,13,1
asp.net-core-2.0,asp.net-core-2.0,,208,135,682,343,2893,1025,8,1
base64,base64,,281,268,566,549,1040,1115,1,1
firebase-storage,firebase-storage,,267,286,580,553,1092,1133,13,7.116105
mongodb-query,mongodb-query,,454,397,986,851,1667,1837,1,1
aggregation-framework,aggregation-framework,,355,294,793,649,1298,1442,1,1
google-places-api,google-places-api,,146,147,279,293,545,572,1,1
tomcat7,tomcat7,,57,50,128,107,270,235,3,1
catalina,catalina,,14,21,24,35,26,59,3,50
sed,sed,,542,501,1052,1043,2455,2095,9,1
systemd,systemd,,90,96,186,186,304,372,9,6.666667
openconnect,openconnect,,3,6,3,9,6,12,9,100
shapefile,shapefile,,55,48,89,103,193,192,0,1
cordova-plugins,cordova-plugins,,211,208,464,419,840,883,1,1
excel-vba,excel-vba,,0,74,2937,74,15789,3011,5,7300
userform,userform,,134,105,220,239,406,459,5,1
rpostgresql,rpostgresql,,5,5,15,10,26,25,0,1
gsp,gsp,,5,2,31,7,50,38,3,1
qsqlquery,qsqlquery,,12,10,26,22,46,48,4,1
android-gallery,android-gallery,,11,9,19,20,65,39,3,1
galleryview,galleryview,,0,0,0,0,1,0,3,1
.htaccess,.htaccess,,1010,856,2062,1866,4470,3928,4,1
ionic-view,ionic-view,,1,1,14,2,72,16,1,1
rx-ruby,rx-ruby,,0,0,0,0,1,0,12,1
chainer,chainer,,19,14,34,33,32,67,0,1
ram,ram,,52,45,105,97,165,202,9,1
beautifulsoup,beautifulsoup,,1054,1084,1783,2138,3182,3921,0,2.8463
uistatusbar,uistatusbar,,6,3,15,9,41,24,13,1
react-router,react-router,,688,690,1265,1378,2639,2643,1,1
phonegap-facebook-plugin,phonegap-facebook-plugin,,0,1,0,1,3,1,1,1
angularjs-directive,angularjs-directive,,112,63,291,175,804,466,1,1
java-websocket,java-websocket,,14,20,30,34,79,64,3,42.857143
dynamics-crm,dynamics-crm,,210,195,454,405,863,859,8,1
dynamics-crm-2015,dynamics-crm-2015,,2,4,4,6,39,10,8,100
match,match,,180,150,374,330,722,704,0,1
location-href,location-href,,1,5,4,6,15,10,1,400
ip-camera,ip-camera,,21,22,47,43,63,90,13,4.761905
symbolicate,symbolicate,,3,0,2,3,3,5,13,1
otool,otool,,2,0,7,2,9,9,13,1
nsuserdefaults,nsuserdefaults,,46,26,99,72,249,171,13,1
mono,mono,,99,75,214,174,459,388,8,1
monodevelop,monodevelop,,19,18,53,37,119,90,8,1
selenium-chromedriver,selenium-chromedriver,,593,636,1026,1229,1806,2255,3,7.251265
github-pages,github-pages,,137,127,253,264,456,517,6,1
ngtable,ngtable,,6,3,9,9,37,18,1,1
user-controls,user-controls,,103,53,197,156,375,353,8,1
uwp-xaml,uwp-xaml,,91,85,225,176,553,401,8,1
hyperlink,hyperlink,,237,264,471,501,1058,972,1,11.392405
sip,sip,,57,64,130,121,222,251,13,12.280702
slack,slack,,114,143,226,257,430,483,6,25.438596
series,series,,109,97,270,206,426,476,0,1
onclick,onclick,,274,206,486,480,1027,966,1,1
imageview,imageview,,123,122,292,245,641,537,3,1
onclicklistener,onclicklistener,,74,64,146,138,382,284,3,1
postman,postman,,482,533,925,1015,1283,1940,4,10.580913
gitlab-ci-runner,gitlab-ci-runner,,138,135,228,273,344,501,6,1
nsurlsession,nsurlsession,,38,27,93,65,237,158,13,1
alamofireimage,alamofireimage,,5,4,17,9,34,26,13,1
leaflet,leaflet,,427,426,803,853,1383,1656,1,1
r-leaflet,r-leaflet,,31,20,54,51,89,105,0,1
svnkit,svnkit,,1,1,10,2,11,12,6,1
ember.js,ember.js,,160,128,372,288,900,660,1,1
asset-pipeline,asset-pipeline,,24,17,49,41,103,90,12,1
gson,gson,,244,213,491,457,1029,948,3,1
sharedpreferences,sharedpreferences,,145,138,280,283,501,563,3,1
fetch-api,fetch-api,,101,117,216,218,474,434,1,15.841584
array.prototype.map,array.prototype.map,,15,17,31,32,44,63,1,13.333333
kettle,kettle,,17,13,69,30,148,99,4,1
phoenix,phoenix,,29,41,68,70,150,138,2,41.37931
angular-cli,angular-cli,,262,264,642,526,2020,1168,1,1
angular2-directives,angular2-directives,,31,22,82,53,376,135,1,1
android-intent,android-intent,,479,398,864,877,1759,1741,3,1
bluetooth,bluetooth,,364,296,682,660,1341,1342,3,1
android-activity,android-activity,,326,319,698,645,1529,1343,3,1
deserialization,deserialization,,194,199,370,393,643,763,8,2.57732
powershell-3.0,powershell-3.0,,71,40,132,111,331,243,8,1
token,token,,190,206,381,396,720,777,4,8.421053
access-token,access-token,,117,116,222,233,381,455,4,1
grep,grep,,325,286,652,611,1439,1263,9,1
mockito,mockito,,446,414,824,860,1419,1684,3,1
powermock,powermock,,54,48,84,102,210,186,3,1
easymock,easymock,,6,12,18,18,58,36,3,100
serial-port,serial-port,,250,225,472,475,758,947,9,1
createfile,createfile,,4,9,18,13,22,31,9,125
locking,locking,,134,133,312,267,528,579,3,1
ftps,ftps,,14,17,21,31,66,52,4,21.428571
apache-commons-net,apache-commons-net,,6,14,18,20,33,38,4,133.333333
intellij-14,intellij-14,,15,10,40,25,64,65,3,1
future,future,,105,121,186,226,334,412,3,15.238095
exit-code,exit-code,,20,17,31,37,76,68,9,1
google-api,google-api,,529,497,1161,1026,2057,2187,5,1
google-picker,google-picker,,10,6,15,16,32,31,5,1
jasper-reports,jasper-reports,,90,113,224,203,373,427,3,25.555556
servlets,servlets,,488,351,900,839,1817,1739,3,1
automated-tests,automated-tests,,459,409,877,868,1302,1745,3,1
internet-explorer-11,internet-explorer-11,,200,206,372,406,777,778,1,3
odoo-10,odoo-10,,55,51,252,106,922,358,0,1
rtf,rtf,,34,26,74,60,108,134,8,1
genexus,genexus,,6,8,9,14,26,23,3,33.333333
paint,paint,,41,27,58,68,108,126,3,1
lto,lto,,4,5,11,9,13,20,9,25
html-email,html-email,,136,108,221,244,407,465,1,1
email-attachments,email-attachments,,68,57,93,125,197,218,4,1
contextmanager,contextmanager,,15,14,27,29,65,56,0,1
spark-streaming,spark-streaming,,208,152,398,360,889,758,2,1
wcf-security,wcf-security,,8,4,20,12,35,32,8,1
react-navigation,react-navigation,,489,448,884,937,1426,1821,1,1
raspberry-pi,raspberry-pi,,578,515,1119,1093,1899,2212,0,1
shared-libraries,shared-libraries,,142,160,294,302,634,596,9,12.676056
pinvoke,pinvoke,,40,42,92,82,170,174,8,5
webpack-3,webpack-3,,5,2,15,7,107,22,1,1
typescript2.4,typescript2.4,,1,0,0,1,20,1,1,1
c#-4.0,c#-4.0,,169,107,333,276,712,609,8,1
slick.js,slick.js,,57,61,146,118,277,264,1,7.017544
android-flavors,android-flavors,,6,11,13,17,18,30,3,83.333333
office-js,office-js,,159,209,384,368,805,752,5,31.446541
outlook-web-addins,outlook-web-addins,,78,73,170,151,226,321,5,1
android-afilechooser,android-afilechooser,,1,1,0,2,6,2,3,1
google-maps-api-3,google-maps-api-3,,192,214,495,406,1566,901,1,11.458333
devexpress,devexpress,,118,103,236,221,417,457,8,1
xtragrid,xtragrid,,2,1,3,3,12,6,8,1
devexpress-windows-ui,devexpress-windows-ui,,5,1,11,6,22,17,8,1
normal-distribution,normal-distribution,,36,26,66,62,124,128,0,1
ldap,ldap,,285,270,511,555,959,1066,8,1
ubuntu-14.04,ubuntu-14.04,,55,43,122,98,338,220,9,1
replication,replication,,77,57,151,134,254,285,4,1
openldap,openldap,,56,33,93,89,156,182,8,1
angular2-animation,angular2-animation,,0,0,1,0,8,1,1,1
python-unittest,python-unittest,,113,112,208,225,385,433,0,1
django-testing,django-testing,,25,28,50,53,128,103,0,12
django-unittest,django-unittest,,10,7,20,17,35,37,0,1
spring-data-elasticsearch,spring-data-elasticsearch,,23,34,58,57,150,115,3,47.826087
elasticsearch-template,elasticsearch-template,,1,2,5,3,4,8,6,100
ffmpeg,ffmpeg,,645,518,1155,1163,2106,2318,13,1
tee,tee,,9,7,23,16,44,39,9,1
jenkins-plugins,jenkins-plugins,,231,232,556,463,991,1019,6,1
robotframework,robotframework,,174,163,367,337,671,704,3,1
spectrogram,spectrogram,,17,21,25,38,62,63,0,23.529412
librosa,librosa,,29,41,43,70,54,113,0,41.37931
multiple-records,multiple-records,,0,4,3,4,7,7,4,300
azure-pipelines,azure-pipelines,,300,368,476,668,660,1144,8,22.666667
utility,utility,,3,5,9,8,17,17,9,66.666667
redux-thunk,redux-thunk,,119,99,225,218,462,443,1,1
zlib,zlib,,40,38,90,78,151,168,0,1
jzlib,jzlib,,0,0,0,0,1,0,0,1
atlassian-sourcetree,atlassian-sourcetree,,38,46,104,84,252,188,6,21.052632
restful-url,restful-url,,26,23,60,49,111,109,3,1
kivy,kivy,,428,425,668,853,1374,1521,0,1
typo3,typo3,,285,229,529,514,998,1043,4,1
typo3-7.6.x,typo3-7.6.x,,18,15,55,33,174,88,4,1
modern-ui,modern-ui,,4,0,5,4,10,9,8,1
addeventlistener,addeventlistener,,142,136,244,278,447,522,1,1
registry,registry,,125,105,268,230,471,498,9,1
regedit,regedit,,19,13,36,32,39,68,9,1
http-redirect,http-redirect,,26,30,58,56,124,114,4,15.384615
avd,avd,,42,40,85,82,204,167,3,1
hibernate-envers,hibernate-envers,,23,24,43,47,80,90,3,4.347826
firefox-addon,firefox-addon,,91,74,177,165,250,342,1,1
xmlhttprequest,xmlhttprequest,,300,299,500,599,1023,1099,1,1
file-encodings,file-encodings,,1,3,6,4,12,10,0,200
mysql-loadfile,mysql-loadfile,,0,0,5,0,3,5,4,1
duplicates,duplicates,,335,297,679,632,1339,1311,0,1
drop-down-menu,drop-down-menu,,303,245,597,548,1269,1145,1,1
admob,admob,,261,286,554,547,792,1101,3,9.578544
system.management,system.management,,3,0,3,3,7,6,8,1
fedora,fedora,,41,34,85,75,184,160,9,1
javabeans,javabeans,,72,51,133,123,255,256,3,1
autowired,autowired,,60,68,149,128,280,277,3,13.333333
nanopb,nanopb,,1,5,2,6,6,8,6,400
hive-udf,hive-udf,,0,3,5,3,9,8,2,200
knn,knn,,98,55,109,153,212,262,0,1
mahalanobis,mahalanobis,,5,4,9,9,12,18,0,1
character,character,,128,105,266,233,560,499,0,1
decimal,decimal,,127,109,276,236,564,512,0,1
data-conversion,data-conversion,,62,40,109,102,223,211,0,1
cakephp-3.0,cakephp-3.0,,82,73,190,155,598,345,4,1
deriving,deriving,,3,6,7,9,10,16,2,100
android-service,android-service,,123,115,254,238,488,492,3,1
android-8.0-oreo,android-8.0-oreo,,87,51,292,138,777,430,3,1
subprocess,subprocess,,350,307,612,657,1193,1269,0,1
python-asyncio,python-asyncio,,238,215,460,453,659,913,0,1
file-upload,file-upload,,402,378,876,780,1715,1656,4,1
blade,blade,,0,0,0,0,404,0,4,1
angular-material,angular-material,,873,916,1821,1789,2310,3610,1,4.925544
md-select,md-select,,2,1,5,3,20,8,1,1
page-refresh,page-refresh,,21,21,47,42,99,89,1,1
xcode8,xcode8,,11,8,20,19,280,39,13,1
http2,http2,,71,57,155,128,236,283,3,1
while-loop,while-loop,,466,379,1046,845,2191,1891,0,1
host,host,,38,30,82,68,139,150,4,1
reactjs.net,reactjs.net,,7,4,14,11,28,25,8,1
laravel-blade,laravel-blade,,231,191,389,422,556,811,4,1
centos7,centos7,,220,196,505,416,806,921,9,1
httpwebrequest,httpwebrequest,,78,52,115,130,299,245,8,1
fritzbox,fritzbox,,3,0,3,3,4,6,13,1
sbt,sbt,,201,171,374,372,916,746,2,1
scalatest,scalatest,,51,50,69,101,180,170,2,1
umbraco,umbraco,,63,51,134,114,326,248,8,1
twitter-bootstrap-3,twitter-bootstrap-3,,248,204,621,452,1855,1073,1,1
bootstrap-grid,bootstrap-grid,,10,7,24,17,79,41,1,1
livy,livy,,30,22,38,52,57,90,2,1
google-tag-manager,google-tag-manager,,161,121,288,282,479,570,5,1
google-datalayer,google-datalayer,,10,15,20,25,46,45,5,50
query-string,query-string,,49,51,116,100,235,216,4,4.081633
celery,celery,,241,272,492,513,827,1005,0,12.863071
commit,commit,,48,36,120,84,241,204,6,1
magit,magit,,5,1,8,6,9,14,9,1
endpoint,endpoint,,65,46,90,111,162,201,4,1
phoenix-channels,phoenix-channels,,4,1,6,5,17,11,2,1
yii2,yii2,,267,272,673,539,2014,1212,4,1.872659
yii-rest,yii-rest,,0,0,3,0,5,3,4,1
pdo,pdo,,382,284,752,666,1864,1418,4,1
greensock,greensock,,8,8,27,16,42,43,1,1
pixi.js,pixi.js,,29,23,44,52,92,96,1,1
clob,clob,,27,17,50,44,101,94,4,1
google-cloud-functions,google-cloud-functions,,861,877,1617,1738,2571,3355,13,1.858304
vscode-extensions,vscode-extensions,,148,160,236,308,337,544,9,8.108108
typelib,typelib,,4,1,2,5,7,7,8,1
ng2-idle,ng2-idle,,0,0,1,0,4,1,1,1
clang++,clang++,,54,46,103,100,223,203,9,1
stm32,stm32,,192,183,288,375,473,663,9,1
usart,usart,,9,6,19,15,25,34,9,1
stm32ldiscovery,stm32ldiscovery,,4,6,6,10,8,16,9,50
vis.js,vis.js,,20,26,66,46,149,112,1,30
vis.js-network,vis.js-network,,5,9,19,14,79,33,1,80
centos,centos,,308,276,611,584,1049,1195,9,1
passenger,passenger,,40,35,86,75,206,161,12,1
virtualhost,virtualhost,,72,66,169,138,286,307,4,1
botkit,botkit,,12,10,22,22,49,44,6,1
css-tables,css-tables,,25,18,66,43,132,109,1,1
corda,corda,,72,68,122,140,209,262,3,1
microsoft-edge,microsoft-edge,,155,166,381,321,650,702,1,7.096774
amp-html,amp-html,,107,73,250,180,391,430,1,1
angularjs-scope,angularjs-scope,,43,16,117,59,371,176,1,1
utop,utop,,2,1,13,3,12,16,0,1
intellij-plugin,intellij-plugin,,29,40,93,69,170,162,3,37.931034
azure-application-insights,azure-application-insights,,148,128,247,276,454,523,8,1
tomee,tomee,,22,18,58,40,68,98,3,1
tomee-7,tomee-7,,10,3,13,13,28,26,3,1
jmeter,jmeter,,431,391,870,822,1798,1692,3,1
facebook-chatbot,facebook-chatbot,,14,14,38,28,102,66,13,1
facebook-workplace,facebook-workplace,,3,5,7,8,21,15,13,66.666667
autodesk-forge,autodesk-forge,,117,114,232,231,353,463,14,1
autodesk-viewer,autodesk-viewer,,55,53,117,108,198,225,14,1
uisearchbar,uisearchbar,,59,56,96,115,314,211,13,1
amcharts,amcharts,,161,91,212,252,293,464,1,1
azure-active-directory,azure-active-directory,,704,697,1225,1401,1966,2626,8,1
uigesturerecognizer,uigesturerecognizer,,39,41,77,80,196,157,13,5.128205
uialertview,uialertview,,4,10,16,14,54,30,13,150
store,store,,69,71,126,140,262,266,1,2.898551
router,router,,124,79,229,203,406,432,1,1
ngrx-store,ngrx-store,,53,73,126,126,264,252,1,37.735849
v8,v8,,68,76,120,144,233,264,1,11.764706
node.js-nan,node.js-nan,,1,0,1,1,12,2,1,1
datatable,datatable,,519,455,984,974,1812,1958,8,1
zip,zip,,199,207,370,406,696,776,0,4.020101
password-encryption,password-encryption,,32,23,53,55,106,108,4,1
cv2,cv2,,146,82,249,228,306,477,0,1
google-cloud-platform,google-cloud-platform,,1651,1778,3475,3429,4592,6904,6,7.692308
google-kubernetes-engine,google-kubernetes-engine,,297,325,586,622,757,1208,6,9.427609
google-cloud-bigtable,google-cloud-bigtable,,27,15,44,42,83,86,6,1
hadoop2,hadoop2,,51,39,148,90,321,238,2,1
sqoop,sqoop,,90,50,152,140,324,292,2,1
timemachine,timemachine,,1,1,3,2,2,5,9,1
textureview,textureview,,9,5,15,14,32,29,3,1
event-store,event-store,,2,2,10,4,16,14,8,1
webdriver,webdriver,,258,223,589,481,1328,1070,3,1
comparison-operators,comparison-operators,,13,18,31,31,61,62,0,38.461538
spring-boot-actuator,spring-boot-actuator,,84,71,133,155,259,288,3,1
emmet,emmet,,13,15,37,28,65,65,9,15.384615
typescript-typings,typescript-typings,,163,176,337,339,453,676,1,7.97546
spring-data-rest,spring-data-rest,,62,44,144,106,267,250,3,1
lombok,lombok,,89,84,147,173,260,320,3,1
aws-codepipeline,aws-codepipeline,,57,59,96,116,153,212,6,3.508772
aws-codecommit,aws-codecommit,,26,17,44,43,86,87,6,1
aws-codebuild,aws-codebuild,,60,67,106,127,124,233,6,11.666667
brightness,brightness,,5,7,15,12,23,27,3,40
wildcard,wildcard,,82,82,173,164,346,337,5,1
npm-install,npm-install,,199,182,365,381,786,746,1,1
userid,userid,,12,5,16,17,30,33,4,1
emacs,emacs,,150,79,261,229,571,490,9,1
key-bindings,key-bindings,,30,23,59,53,127,112,3,1
spacemacs,spacemacs,,15,6,18,21,57,39,9,1
remap,remap,,3,6,5,9,23,14,0,100
cypher,cypher,,244,234,498,478,1114,976,2,1
ubuntu-16.04,ubuntu-16.04,,218,240,595,458,1652,1053,9,10.091743
cx-freeze,cx-freeze,,34,43,98,77,219,175,0,26.470588
pgadmin,pgadmin,,48,33,72,81,155,153,4,1
spark-structured-streaming,spark-structured-streaming,,128,157,256,285,366,541,2,22.65625
supertest,supertest,,33,23,62,56,73,118,1,1
firebase-admin,firebase-admin,,101,122,214,223,398,437,13,20.792079
shader,shader,,162,135,318,297,519,615,9,1
opengl-es-2.0,opengl-es-2.0,,38,33,58,71,162,129,3,1
qr-code,qr-code,,128,95,209,223,349,432,3,1
qtquick2,qtquick2,,34,25,94,59,249,153,9,1
kendo-ui,kendo-ui,,326,293,609,619,1222,1228,1,1
telerik,telerik,,128,104,263,232,431,495,8,1
android-custom-view,android-custom-view,,75,86,112,161,253,273,3,14.666667
jupyter-notebook,jupyter-notebook,,1201,1068,1755,2269,2446,4024,0,1
timeit,timeit,,5,11,8,16,43,24,0,120
openlayers,openlayers,,162,146,262,308,448,570,1,1
nashorn,nashorn,,19,4,22,23,93,45,3,1
ecma,ecma,,6,9,16,15,34,31,1,50
highcharts,highcharts,,478,390,891,868,1986,1759,1,1
highstock,highstock,,0,0,0,0,207,0,1,1
azure-webjobs,azure-webjobs,,72,55,132,127,328,259,8,1
azure-webjobssdk,azure-webjobssdk,,19,11,26,30,61,56,8,1
primeng,primeng,,211,166,467,377,848,844,1,1
iqueryable,iqueryable,,27,29,55,56,87,111,8,7.407407
javascript-events,javascript-events,,0,9,221,9,606,230,1,800
mouseevent,mouseevent,,118,85,196,203,388,399,1,1
mousemove,mousemove,,14,13,36,27,55,63,1,1
lua,lua,,338,333,618,671,1328,1289,9,1
corona,corona,,25,8,34,33,98,67,9,1
servlet-filters,servlet-filters,,39,43,58,82,134,140,3,10.25641
vaadin7,vaadin7,,11,12,21,23,55,44,3,9.090909
asp.net-web-api,asp.net-web-api,,805,706,1592,1511,3578,3103,8,1
variadic-functions,variadic-functions,,40,39,79,79,195,158,9,1
xstream,xstream,,7,5,28,12,51,40,3,1
docker-container,docker-container,,48,38,97,86,188,183,6,1
docker-image,docker-image,,40,36,84,76,121,160,6,1
google-visualization,google-visualization,,175,139,327,314,713,641,1,1
magento,magento,,233,212,537,445,1189,982,4,1
addattribute,addattribute,,0,1,0,1,3,1,0,1
shiro,shiro,,20,13,35,33,108,68,3,1
aws-device-farm,aws-device-farm,,11,10,26,21,68,47,3,1
sfspeechrecognizer,sfspeechrecognizer,,8,6,9,14,19,23,13,1
salesforce,salesforce,,294,280,418,574,731,992,14,1
safearray,safearray,,1,1,3,2,5,5,9,1
eclipse-plugin,eclipse-plugin,,123,104,266,227,640,493,3,1
prestashop,prestashop,,128,102,302,230,580,532,4,1
prestashop-1.6,prestashop-1.6,,31,20,74,51,198,125,4,1
facebook-php-sdk,facebook-php-sdk,,29,32,76,61,187,137,13,10.344828
spark-dataframe,spark-dataframe,,0,0,0,0,1461,0,2,1
drupal-7,drupal-7,,69,59,182,128,506,310,4,1
couchbase,couchbase,,100,101,185,201,310,386,3,1
n1ql,n1ql,,39,30,45,69,62,114,3,1
jquery-terminal,jquery-terminal,,1,2,5,3,9,8,1,100
angular2-nativescript,angular2-nativescript,,98,45,187,143,254,330,1,1
clone,clone,,77,61,132,138,279,270,6,1
deep-copy,deep-copy,,29,27,61,56,124,117,0,1
php-5.6,php-5.6,,31,23,77,54,177,131,4,1
sympy,sympy,,160,119,220,279,468,499,0,1
qml,qml,,317,287,648,604,1282,1252,9,1
jhipster,jhipster,,207,168,409,375,787,784,3,1
parquet,parquet,,144,165,285,309,410,594,2,14.583333
django-rest-framework,django-rest-framework,,1141,1106,1828,2247,3118,4075,0,1
slug,slug,,31,19,59,50,100,109,4,1
nsdate,nsdate,,17,13,45,30,128,75,13,1
systemtap,systemtap,,2,3,4,5,12,9,9,50
sonar-runner,sonar-runner,,7,9,19,16,93,35,3,28.571429
sonarqube5.1,sonarqube5.1,,3,3,3,6,17,9,3,1
tkinter-canvas,tkinter-canvas,,98,67,108,165,178,273,0,1
tkinter-entry,tkinter-entry,,38,36,63,74,145,137,0,1
data-science,data-science,,429,396,674,825,884,1499,0,1
touchscreen,touchscreen,,18,17,30,35,49,65,3,1
elastic-beanstalk,elastic-beanstalk,,0,0,45,0,900,45,6,1
conv-neural-network,conv-neural-network,,610,506,860,1116,1176,1976,0,1
jquery-validate,jquery-validate,,45,48,89,93,270,182,1,6.666667
stream,stream,,388,337,698,725,1136,1423,1,1
citrix,citrix,,17,14,47,31,47,78,8,1
xenapp,xenapp,,4,2,6,6,11,12,8,1
mask,mask,,69,59,142,128,234,270,0,1
left-join,left-join,,127,109,303,236,688,539,4,1
syntax-error,syntax-error,,132,127,321,259,757,580,0,1
fxcop,fxcop,,5,3,7,8,17,15,8,1
typeahead,typeahead,,17,20,43,37,73,80,1,17.647059
sass,sass,,789,762,1499,1551,2719,3050,1,1
css-preprocessor,css-preprocessor,,1,0,4,1,24,5,1,1
sql-server-2016,sql-server-2016,,184,169,343,353,869,696,4,1
digital-ocean,digital-ocean,,169,128,278,297,403,575,4,1
droplet,droplet,,2,1,9,3,16,12,4,1
react-redux,react-redux,,1030,1016,2035,2046,3712,4081,1,1
reducers,reducers,,35,17,76,52,136,128,1,1
watir,watir,,17,33,56,50,193,106,12,94.117647
powerpivot,powerpivot,,60,52,108,112,211,220,5,1
dax,dax,,320,389,533,709,651,1242,5,21.5625
c++17,c++17,,496,469,876,965,1307,1841,9,1
stdstring,stdstring,,30,25,42,55,77,97,9,1
partitioning,partitioning,,91,72,167,163,331,330,4,1
django-rest-viewsets,django-rest-viewsets,,8,25,25,33,47,58,0,212.5
jsx,jsx,,299,287,545,586,968,1131,1,1
rebase,rebase,,45,47,94,92,191,186,6,4.444444
recycler-adapter,recycler-adapter,,201,197,412,398,752,810,3,1
textwatcher,textwatcher,,10,6,12,16,48,28,3,1
coerce,coerce,,0,3,3,3,5,6,0,200
imap,imap,,83,69,139,152,288,291,4,1
uid,uid,,8,17,6,25,20,31,13,112.5
mediaelement.js,mediaelement.js,,4,2,12,6,14,18,1,1
jplayer,jplayer,,6,4,9,10,9,19,1,1
kapt,kapt,,13,16,31,29,51,60,3,23.076923
github-for-mac,github-for-mac,,5,3,9,8,13,17,6,1
access-vba,access-vba,,383,310,607,693,1388,1300,5,1
sum,sum,,269,244,634,513,1229,1147,0,1
totals,totals,,4,7,12,11,32,23,4,75
google-street-view,google-street-view,,15,18,33,33,60,66,1,20
page-jump,page-jump,,1,0,4,1,7,5,1,1
failover,failover,,17,19,31,36,75,67,3,11.764706
encryption-symmetric,encryption-symmetric,,12,12,24,24,49,48,6,1
coordinates,coordinates,,132,114,246,246,459,492,0,1
matlab-figure,matlab-figure,,95,65,180,160,324,340,0,1
form-submit,form-submit,,50,52,80,102,178,182,1,4
jave,jave,,3,10,5,13,10,18,3,233.333333
android-studio-plugin,android-studio-plugin,,0,2,2,2,6,4,3,100
microsoft-teams,microsoft-teams,,108,156,143,264,190,407,8,44.444444
aws-api-gateway,aws-api-gateway,,321,272,565,593,908,1158,6,1
adal,adal,,88,58,138,146,250,284,8,1
adal.js,adal.js,,17,17,43,34,63,77,8,1
python-import,python-import,,184,241,352,425,683,777,0,30.978261
signals,signals,,134,126,276,260,517,536,9,1
flowtype,flowtype,,100,90,256,190,601,446,1,1
recommendation-engine,recommendation-engine,,42,26,66,68,91,134,0,1
gtk3,gtk3,,113,94,214,207,335,421,9,1
tt-news,tt-news,,0,0,2,0,6,2,4,1
nsjsonserialization,nsjsonserialization,,10,7,20,17,39,37,13,1
dropzone.js,dropzone.js,,66,42,115,108,251,223,1,1
datastax-enterprise,datastax-enterprise,,35,15,57,50,180,107,2,1
datastax-startup,datastax-startup,,2,0,5,2,30,7,2,1
roslyn,roslyn,,59,48,119,107,306,226,8,1
rspec,rspec,,183,177,466,360,1007,826,12,1
checkstyle,checkstyle,,33,18,42,51,95,93,3,1
callback,callback,,344,338,701,682,1545,1383,1,1
pymongo,pymongo,,177,170,346,347,592,693,1,1
mongoengine,mongoengine,,45,35,96,80,126,176,1,1
stormpath,stormpath,,0,0,0,0,1,0,1,1
express-stormpath,express-stormpath,,0,0,0,0,1,0,1,1
guice,guice,,51,51,112,102,200,214,3,1
ruby-on-rails-4,ruby-on-rails-4,,149,122,412,271,1217,683,12,1
binary-search-tree,binary-search-tree,,152,95,261,247,538,508,0,1
sybase,sybase,,60,49,110,109,213,219,4,1
laravel-5.5,laravel-5.5,,78,46,226,124,2184,350,4,1
google-project-tango,google-project-tango,,0,0,4,0,40,4,3,1
arcore,arcore,,181,138,281,319,356,600,3,1
livecharts,livecharts,,36,27,32,63,86,95,8,1
ngrx,ngrx,,221,238,406,459,747,865,1,7.692308
ngrx-effects,ngrx-effects,,57,48,105,105,206,210,1,1
marker,marker,,40,32,58,72,176,130,1,1
fork,fork,,128,67,248,195,469,443,9,1
cpu-time,cpu-time,,5,3,4,8,4,12,0,1
emoticons,emoticons,,2,3,3,5,20,8,0,50
gboard,gboard,,4,4,4,8,13,12,3,1
ryu,ryu,,5,11,12,16,16,28,9,120
css-multicolumn-layout,css-multicolumn-layout,,6,7,27,13,52,40,1,16.666667
column-count,column-count,,5,3,7,8,16,15,1,1
syslinux,syslinux,,1,1,1,2,1,3,9,1
clonezilla,clonezilla,,1,0,3,1,1,4,9,1
expression-trees,expression-trees,,30,14,55,44,112,99,8,1
gridview,gridview,,263,164,471,427,1347,898,8,1
inclusion,inclusion,,1,0,3,1,5,4,9,1
botnet,botnet,,1,0,0,1,5,1,4,1
client-side-attacks,client-side-attacks,,1,1,3,2,9,5,4,1
react-native-ios,react-native-ios,,171,227,411,398,705,809,1,32.748538
arangodb,arangodb,,43,30,115,73,236,188,2,1
hapijs,hapijs,,40,24,75,64,229,139,1,1
vps,vps,,41,51,131,92,174,223,4,24.390244
django-models,django-models,,1263,1199,2077,2462,3534,4539,0,1
django-queryset,django-queryset,,170,130,301,300,633,601,0,1
django-1.8,django-1.8,,8,8,14,16,37,30,0,1
polymer,polymer,,99,62,220,161,739,381,1,1
plunker,plunker,,0,0,3,0,31,3,1,1
jsbin,jsbin,,0,1,3,1,10,4,1,1
codepen,codepen,,24,19,38,43,122,81,1,1
python-3.6,python-3.6,,442,386,655,828,1895,1483,0,1
android-ffmpeg,android-ffmpeg,,38,24,61,62,87,123,13,1
fxml,fxml,,129,89,244,218,464,462,3,1
weld,weld,,10,11,39,21,73,60,3,10
json.net,json.net,,351,300,697,651,1369,1348,8,1
spring-security,spring-security,,714,701,1325,1415,2414,2740,3,1
wicket,wicket,,19,29,47,48,140,95,3,52.631579
long-integer,long-integer,,42,25,71,67,163,138,0,1
value-type,value-type,,5,5,13,10,42,23,8,1
autoboxing,autoboxing,,7,7,6,14,21,20,3,1
asymptotic-complexity,asymptotic-complexity,,0,0,4,0,122,4,0,1
memory-consumption,memory-consumption,,2,2,4,4,13,8,8,1
width,width,,80,70,122,150,270,272,1,1
hex,hex,,175,161,369,336,736,705,0,1
makefile,makefile,,388,355,812,743,1618,1555,9,1
gnu-make,gnu-make,,98,83,207,181,385,388,9,1
visual-studio-2015,visual-studio-2015,,198,127,445,325,1657,770,8,1
rider,rider,,35,42,66,77,122,143,8,20
exception,exception,,794,709,1180,1503,2473,2683,3,1
ofbiz,ofbiz,,1,3,11,4,21,15,3,200
apt,apt,,54,37,62,91,125,153,9,1
rust-cargo,rust-cargo,,50,43,77,93,122,170,9,1
will-paginate,will-paginate,,11,5,15,16,34,31,12,1
firebaseui,firebaseui,,76,72,147,148,464,295,13,1
openurl,openurl,,7,5,7,12,36,19,13,1
flexbox,flexbox,,786,569,1495,1355,3230,2850,1,1
android-viewpager,android-viewpager,,198,185,434,383,935,817,3,1
rx-java,rx-java,,213,190,446,403,1194,849,3,1
rx-java2,rx-java2,,253,241,606,494,1359,1100,3,1
application.properties,application.properties,,20,29,47,49,59,96,3,45
numba,numba,,67,82,133,149,216,282,0,22.38806
modelstate,modelstate,,14,9,16,23,41,39,8,1
modelstatedictionary,modelstatedictionary,,1,0,0,1,2,1,8,1
cocos2d-x,cocos2d-x,,28,18,44,46,104,90,3,1
ios10,ios10,,9,8,24,17,193,41,13,1
cocos2d-x-3.0,cocos2d-x-3.0,,4,3,6,7,15,13,3,1
servlet-3.0,servlet-3.0,,15,18,39,33,64,72,3,20
sprite-kit,sprite-kit,,152,107,332,259,1021,591,13,1
linphone,linphone,,20,15,37,35,50,72,13,1
linphone-sdk,linphone-sdk,,11,7,9,18,20,27,13,1
logstash,logstash,,289,247,504,536,906,1040,6,1
dwarf,dwarf,,5,6,11,11,21,22,9,20
having,having,,15,10,46,25,94,71,4,1
build,build,,547,494,1063,1041,1901,2104,3,1
goland,goland,,17,12,26,29,75,55,6,1
sqlyog,sqlyog,,5,1,18,6,26,24,4,1
paypal,paypal,,289,269,571,558,1047,1129,4,1
paypal-sandbox,paypal-sandbox,,73,85,156,158,248,314,4,16.438356
unity-webgl,unity-webgl,,26,30,50,56,65,106,8,15.384615
intel,intel,,95,66,168,161,296,329,9,1
android-edittext,android-edittext,,174,186,390,360,905,750,3,6.896552
focus,focus,,86,99,178,185,403,363,1,15.116279
customdialog,customdialog,,4,6,7,10,21,17,3,50
codeigniter-3,codeigniter-3,,251,247,650,498,1169,1148,4,1
angular-material2,angular-material2,,117,61,291,178,1345,469,1,1
artifactory,artifactory,,128,112,247,240,495,487,6,1
package,package,,384,392,739,776,900,1515,0,2.083333
devtools,devtools,,67,57,97,124,162,221,0,1
multiplayer,multiplayer,,14,20,75,34,92,109,8,42.857143
dlib,dlib,,48,54,105,102,191,207,0,12.5
doctrine-orm,doctrine-orm,,195,166,408,361,1086,769,4,1
fabricjs,fabricjs,,93,121,211,214,547,425,1,30.107527
babel,babel,,276,279,610,555,745,1165,1,1.086957
timer,timer,,264,241,552,505,1284,1057,13,1
ps,ps,,9,12,29,21,49,50,9,33.333333
azure-mobile-services,azure-mobile-services,,10,14,48,24,250,72,8,40
parse-tree,parse-tree,,5,7,8,12,15,20,0,40
daemon,daemon,,55,24,79,79,180,158,9,1
completable-future,completable-future,,54,66,105,120,210,225,3,22.222222
custom-keyboard,custom-keyboard,,25,14,33,39,63,72,13,1
kafka-consumer-api,kafka-consumer-api,,187,200,344,387,542,731,2,6.951872
apache-kafka-streams,apache-kafka-streams,,203,182,363,385,581,748,2,1
apache-kafka-connect,apache-kafka-connect,,156,158,271,314,365,585,2,1.282051
readyroll,readyroll,,2,0,3,2,6,5,4,1
clearcase,clearcase,,10,10,20,20,64,40,6,1
titanium,titanium,,21,7,59,28,163,87,13,1
appcelerator,appcelerator,,26,7,90,33,256,123,13,1
anova,anova,,50,41,72,91,147,163,0,1
copy,copy,,196,193,444,389,793,833,5,1
nsstring,nsstring,,20,15,31,35,111,66,13,1
worker-thread,worker-thread,,6,6,5,12,6,17,3,1
globalize,globalize,,4,4,8,8,18,16,12,1
javascript-globalize,javascript-globalize,,1,3,1,4,2,5,1,200
opencl,opencl,,82,77,149,159,403,308,0,1
momentjs,momentjs,,271,218,554,489,1056,1043,1,1
pycharm,pycharm,,618,627,1127,1245,1798,2372,0,1.456311
spyder,spyder,,221,168,394,389,622,783,0,1
boost-asio,boost-asio,,75,53,150,128,295,278,9,1
android-spinner,android-spinner,,68,66,143,134,328,277,3,1
3d-model,3d-model,,14,12,17,26,33,43,0,1
bootstrap-4,bootstrap-4,,1822,1767,3413,3589,5715,7002,1,1
stringbuffer,stringbuffer,,4,9,21,13,29,34,3,125
uibezierpath,uibezierpath,,35,29,77,64,160,141,13,1
container-registry,container-registry,,0,1,4,1,8,5,6,1
datagrid,datagrid,,197,200,359,397,860,756,8,1.522843
std,std,,84,74,179,158,343,337,9,1
cin,cin,,22,9,55,31,147,86,9,1
getline,getline,,33,17,63,50,129,113,9,1
prism,prism,,86,97,213,183,331,396,8,12.790698
.net-standard,.net-standard,,83,71,186,154,447,340,8,1
swift-protocols,swift-protocols,,47,38,86,85,171,171,13,1
libevent,libevent,,3,3,11,6,22,17,9,1
sas-macro,sas-macro,,28,24,55,52,159,107,0,1
sas-studio,sas-studio,,5,1,19,6,38,25,0,1
docker-swarm,docker-swarm,,159,145,361,304,667,665,6,1
axon,axon,,30,24,46,54,37,100,3,1
vue-component,vue-component,,463,474,965,937,1865,1902,1,2.37581
vuex,vuex,,451,424,777,875,1117,1652,1,1
handshake,handshake,,22,9,37,31,61,68,6,1
qnetworkaccessmanager,qnetworkaccessmanager,,2,4,17,6,21,23,9,100
qtnetwork,qtnetwork,,6,0,4,6,10,10,9,1
qnetworkreply,qnetworkreply,,2,2,10,4,18,14,9,1
scrollview,scrollview,,116,132,272,248,501,520,3,13.793103
azure-api-apps,azure-api-apps,,9,5,16,14,41,30,8,1
azure-virtual-network,azure-virtual-network,,34,28,68,62,142,130,8,1
textarea,textarea,,83,78,177,161,346,338,1,1
console.log,console.log,,47,49,105,96,240,201,1,4.255319
stringify,stringify,,25,19,32,44,65,76,1,1
django-templates,django-templates,,411,440,816,851,1520,1667,0,7.055961
bloodhound,bloodhound,,8,3,6,11,17,17,1,1
flat-file,flat-file,,32,32,35,64,53,99,4,1
marathon,marathon,,13,6,26,19,70,45,6,1
dcos,dcos,,12,3,35,15,84,50,6,1
angular-services,angular-services,,71,50,158,121,394,279,1,1
sinatra,sinatra,,36,20,83,56,200,139,12,1
prometheus,prometheus,,217,243,415,460,459,875,6,11.981567
uiview,uiview,,201,134,390,335,1051,725,13,1
uipangesturerecognizer,uipangesturerecognizer,,18,18,44,36,112,80,13,1
wkwebview,wkwebview,,186,174,375,360,619,735,13,1
rally,rally,,23,17,39,40,92,79,3,1
spring-data-cassandra,spring-data-cassandra,,15,16,59,31,93,90,3,6.666667
typoscript,typoscript,,57,43,76,100,196,176,4,1
fluid,fluid,,43,25,77,68,135,145,4,1
extbase,extbase,,62,38,78,100,147,178,4,1
dart,dart,,2594,3024,3813,5618,2871,9431,13,16.576715
angular-dart,angular-dart,,41,30,128,71,240,199,13,1
angular-components,angular-components,,90,72,205,162,539,367,1,1
dart-pub,dart-pub,,30,19,63,49,35,112,13,1
dart-html,dart-html,,16,7,24,23,38,47,13,1
uinavigationbar,uinavigationbar,,99,95,195,194,579,389,13,1
app-thinning,app-thinning,,0,0,2,0,10,2,13,1
xcode9beta6,xcode9beta6,,0,0,0,0,19,0,13,1
angular2-forms,angular2-forms,,30,17,110,47,705,157,1,1
angular-reactive-forms,angular-reactive-forms,,235,242,605,477,799,1082,1,2.978723
javamail,javamail,,106,72,186,178,415,364,3,1
patch,patch,,54,41,127,95,185,222,6,1
yocto,yocto,,119,136,223,255,480,478,9,14.285714
bitbake,bitbake,,41,56,84,97,186,181,9,36.585366
opacity,opacity,,23,31,71,54,117,125,1,34.782609
codeception,codeception,,25,29,76,54,194,130,4,16
symfony-3.3,symfony-3.3,,3,5,19,8,276,27,4,66.666667
symfony-flex,symfony-flex,,2,2,5,4,41,9,4,1
uilocalnotification,uilocalnotification,,13,9,31,22,120,53,13,1
introspection,introspection,,14,7,26,21,50,47,0,1
python-c-extension,python-c-extension,,0,0,0,0,6,0,0,1
sqlite.swift,sqlite.swift,,6,8,4,14,28,18,13,33.333333
bing-maps,bing-maps,,19,25,64,44,129,108,8,31.578947
bing-api,bing-api,,11,12,25,23,89,48,8,9.090909
polygon,polygon,,110,93,206,203,264,409,0,1
intersection,intersection,,44,40,85,84,171,169,0,1
amazon-sns,amazon-sns,,96,108,175,204,349,379,6,12.5
primeng-datatable,primeng-datatable,,20,21,49,41,164,90,1,5
pytest,pytest,,312,355,552,667,795,1219,0,13.782051
thymeleaf,thymeleaf,,379,316,653,695,1313,1348,3,1
html-webpack-plugin,html-webpack-plugin,,20,15,48,35,107,83,1,1
union,union,,115,112,168,227,423,395,4,1
firebird-3.0,firebird-3.0,,13,9,13,22,33,35,4,1
xamarin.android,xamarin.android,,616,543,1128,1159,2884,2287,8,1
android-multidex,android-multidex,,29,22,56,51,164,107,3,1
google-play,google-play,,259,321,532,580,837,1112,3,23.938224
snmp,snmp,,62,45,96,107,164,203,9,1
sharp-snmp,sharp-snmp,,0,4,5,4,7,9,9,300
barcode,barcode,,60,58,140,118,251,258,3,1
barcode-printing,barcode-printing,,5,6,11,11,30,22,3,20
full-text-search,full-text-search,,130,122,226,252,474,478,4,1
circular-buffer,circular-buffer,,5,8,16,13,33,29,9,60
extraction,extraction,,22,24,48,46,112,94,0,9.090909
deque,deque,,18,16,34,34,64,68,9,1
shadow,shadow,,40,36,81,76,155,157,13,1
pdfkit,pdfkit,,34,21,46,55,145,101,13,1
rake-task,rake-task,,11,5,20,16,42,36,12,1
rails-sprockets,rails-sprockets,,2,2,2,4,6,6,12,1
action,action,,87,68,160,155,285,315,1,1
sh,sh,,230,217,396,447,819,843,9,1
puppet,puppet,,48,36,120,84,244,204,6,1
bind,bind,,56,57,114,113,278,227,1,1.785714
variadic-templates,variadic-templates,,107,105,191,212,456,403,9,1
llvm-ir,llvm-ir,,30,40,55,70,128,125,9,33.333333
llvm-c++-api,llvm-c++-api,,7,14,27,21,33,48,9,100
django-sitemaps,django-sitemaps,,4,3,2,7,3,9,0,1
azure-web-sites,azure-web-sites,,177,188,461,365,1064,826,8,6.214689
azure-application-gateway,azure-application-gateway,,26,27,57,53,85,110,8,3.846154
corrupt,corrupt,,9,9,19,18,37,37,5,1
froala,froala,,15,26,44,41,77,85,1,73.333333
exact-online,exact-online,,7,3,2,10,37,12,4,1
picqer-exact-php-client,picqer-exact-php-client,,3,0,1,3,8,4,4,1
amazon-redshift,amazon-redshift,,246,300,513,546,995,1059,4,21.95122
signtool,signtool,,7,4,15,11,17,26,8,1
winverifytrust,winverifytrust,,1,0,0,1,1,1,8,1
jersey,jersey,,157,121,378,278,809,656,3,1
bem,bem,,14,13,28,27,60,55,1,1
dual-table,dual-table,,0,0,0,0,2,0,4,1
integer,integer,,183,125,341,308,801,649,0,1
sftp,sftp,,141,149,264,290,469,554,9,5.673759
winscp,winscp,,25,38,57,63,119,120,9,52
ssh2-sftp,ssh2-sftp,,5,3,22,8,15,30,1,1
sylius,sylius,,16,23,39,39,55,78,4,43.75
keycloak,keycloak,,249,266,452,515,579,967,3,6.827309
mod-auth-openidc,mod-auth-openidc,,4,1,8,5,9,13,3,1
google-bigquery,google-bigquery,,615,592,1093,1207,1846,2300,4,1
devise,devise,,152,125,322,277,802,599,12,1
two-way-binding,two-way-binding,,10,16,39,26,71,65,1,60
broadleaf-commerce,broadleaf-commerce,,2,2,20,4,22,24,3,1
user-defined-functions,user-defined-functions,,132,122,250,254,531,504,2,1
ngx-charts,ngx-charts,,30,16,26,46,49,72,1,1
jinja2,jinja2,,312,299,527,611,843,1138,0,1
array-map,array-map,,10,5,28,15,32,43,1,1
jackson,jackson,,456,443,871,899,1592,1770,3,1
embedded-linux,embedded-linux,,113,97,181,210,372,391,9,1
gpio,gpio,,57,59,105,116,186,221,0,3.508772
yql,yql,,0,1,10,1,23,11,4,1
ngfor,ngfor,,123,93,260,216,526,476,1,1
usb,usb,,140,160,308,300,511,608,3,14.285714
touch,touch,,85,65,149,150,304,299,1,1
hid,hid,,29,31,47,60,97,107,3,6.896552
android-date,android-date,,7,5,15,12,25,27,3,1
node-serialport,node-serialport,,8,7,21,15,34,36,1,1
kendo-dropdown,kendo-dropdown,,15,6,11,21,35,32,1,1
karma-runner,karma-runner,,80,87,203,167,414,370,1,8.75
karma-mocha,karma-mocha,,3,11,15,14,35,29,1,266.666667
cloud9,cloud9,,16,6,31,22,108,53,6,1
developer-tools,developer-tools,,22,16,35,38,71,73,1,1
crystal-reports,crystal-reports,,201,116,361,317,655,678,8,1
azure-sql-database,azure-sql-database,,268,252,517,520,1072,1037,8,1
ms-word,ms-word,,488,552,901,1040,1579,1941,5,13.114754
rich-text-editor,rich-text-editor,,13,16,34,29,70,63,1,23.076923
requestanimationframe,requestanimationframe,,17,14,31,31,80,62,1,1
arduino,arduino,,721,587,800,1308,1558,2108,9,1
esp8266,esp8266,,124,120,182,244,377,426,9,1
facebook-messenger-bot,facebook-messenger-bot,,34,32,96,66,274,162,13,1
procfile,procfile,,2,5,10,7,20,17,1,150
tinyint,tinyint,,2,0,2,2,5,4,4,1
google-maps-android-api-2,google-maps-android-api-2,,35,26,78,61,231,139,3,1
geojson,geojson,,167,133,296,300,424,596,1,1
ag-grid,ag-grid,,263,270,413,533,517,946,1,2.661597
ag-grid-react,ag-grid-react,,50,54,61,104,68,165,1,8
ios-sqlite,ios-sqlite,,0,0,2,0,1,2,13,1
morphia,morphia,,8,11,31,19,64,50,1,37.5
jenkins-pipeline,jenkins-pipeline,,705,614,1223,1319,2170,2542,6,1
mapping,mapping,,220,183,357,403,654,760,3,1
elasticsearch-5,elasticsearch-5,,35,22,124,57,461,181,6,1
reportlab,reportlab,,41,31,65,72,98,137,0,1
wsdl,wsdl,,158,140,345,298,543,643,3,1
script-task,script-task,,27,16,43,43,59,86,4,1
event-listener,event-listener,,58,37,109,95,203,204,1,1
string-formatting,string-formatting,,66,55,171,121,344,292,0,1
styles,styles,,128,127,308,255,583,563,1,1
quantlib,quantlib,,8,10,11,18,32,29,0,25
android-billing,android-billing,,16,24,21,40,36,61,3,50
android-inapp-purchase,android-inapp-purchase,,8,21,19,29,35,48,3,162.5
play-billing-library,play-billing-library,,10,14,9,24,42,33,3,40
weblogic,weblogic,,104,111,273,215,400,488,3,6.730769
asp.net-core-mvc-2.0,asp.net-core-mvc-2.0,,8,8,14,16,146,30,8,1
icalendar,icalendar,,39,51,85,90,161,175,4,30.769231
phpexcel-1.8.0,phpexcel-1.8.0,,2,1,8,3,15,11,4,1
spanned,spanned,,2,0,3,2,11,5,3,1
realm,realm,,244,198,524,442,1498,966,13,1
ssl-certificate,ssl-certificate,,355,309,666,664,997,1330,6,1
namecheap,namecheap,,17,13,22,30,49,52,4,1
vesta,vesta,,5,4,19,9,32,28,4,1
custom-error-handling,custom-error-handling,,8,6,13,14,27,27,3,1
asp.net-identity,asp.net-identity,,287,231,512,518,944,1030,8,1
jspdf,jspdf,,145,108,233,253,258,486,1,1
jspdf-autotable,jspdf-autotable,,29,26,36,55,54,91,1,1
uitabbarcontroller,uitabbarcontroller,,99,73,190,172,453,362,13,1
libcurl,libcurl,,67,44,124,111,230,235,4,1
jsoncpp,jsoncpp,,8,4,9,12,36,21,9,1
office365,office365,,267,247,622,514,890,1136,8,1
google-cloud-messaging,google-cloud-messaging,,50,28,123,78,273,201,13,1
firebase-cloud-messaging,firebase-cloud-messaging,,576,491,1132,1067,2109,2199,13,1
smartbanner,smartbanner,,2,3,9,5,10,14,3,50
codeigniter-restserver,codeigniter-restserver,,5,2,8,7,12,15,4,1
destructuring,destructuring,,58,56,95,114,156,209,1,1
git-extensions,git-extensions,,3,2,14,5,33,19,6,1
ipython-magic,ipython-magic,,4,3,7,7,14,14,0,1
genetics,genetics,,7,3,14,10,27,24,0,1
pyhook,pyhook,,12,9,9,21,21,30,0,1
owin,owin,,94,86,182,180,492,362,8,1
c#-5.0,c#-5.0,,0,2,7,2,12,9,8,100
owin-middleware,owin-middleware,,12,9,30,21,55,51,8,1
azure-app-service-plans,azure-app-service-plans,,15,25,51,40,99,91,8,66.666667
android-windowmanager,android-windowmanager,,14,6,32,20,52,52,3,1
c89,c89,,11,11,24,22,46,46,9,1
blobstore,blobstore,,3,9,4,12,14,16,6,200
angularjs-material,angularjs-material,,13,8,65,21,152,86,1,1
windows-forms-designer,windows-forms-designer,,55,39,92,94,195,186,8,1
preg-replace,preg-replace,,73,67,162,140,320,302,4,1
str-replace,str-replace,,38,33,87,71,181,158,4,1
activeadmin,activeadmin,,44,57,134,101,243,235,12,29.545455
io-redirection,io-redirection,,29,34,63,63,99,126,9,17.241379
process-substitution,process-substitution,,1,4,8,5,16,13,9,300
retrofit,retrofit,,292,275,584,567,1027,1151,3,1
call,call,,74,58,127,132,282,259,3,1
arm-template,arm-template,,66,82,185,148,194,333,8,24.242424
hibernate-mapping,hibernate-mapping,,61,57,142,118,252,260,3,1
hibernate-onetomany,hibernate-onetomany,,7,7,16,14,23,30,3,1
wireshark,wireshark,,92,69,136,161,229,297,9,1
electron,electron,,748,736,1255,1484,1867,2739,1,1
promise,promise,,690,667,1473,1357,3281,2830,1,1
async-await,async-await,,879,797,1598,1676,2498,3274,8,1
bluebird,bluebird,,17,13,57,30,170,87,1,1
bookshelf.js,bookshelf.js,,12,9,30,21,69,51,1,1
yii2-advanced-app,yii2-advanced-app,,50,30,132,80,359,212,4,1
yii2-basic-app,yii2-basic-app,,19,20,40,39,164,79,4,5.263158
meanjs,meanjs,,2,0,7,2,49,9,1,1
mod-rewrite,mod-rewrite,,319,206,556,525,1499,1081,4,1
angularjs-service,angularjs-service,,16,5,14,21,47,35,1,1
pygame,pygame,,637,482,896,1119,1603,2015,0,1
pynsist,pynsist,,2,2,0,4,11,4,0,1
global,global,,80,69,151,149,300,300,0,1
abstract-syntax-tree,abstract-syntax-tree,,66,64,139,130,240,269,9,1
behaviorsubject,behaviorsubject,,32,32,52,64,114,116,1,1
sirikit,sirikit,,23,25,72,48,57,120,13,8.695652
pdist,pdist,,0,1,2,1,9,3,0,1
high-availability,high-availability,,40,54,69,94,152,163,3,35
pingfederate,pingfederate,,9,5,10,14,31,24,8,1
vmware,vmware,,73,81,210,154,244,364,6,10.958904
scp,scp,,24,43,74,67,131,141,9,79.166667
esxi,esxi,,14,9,38,23,49,61,6,1
sparse-file,sparse-file,,4,0,4,4,6,8,9,1
angular2-services,angular2-services,,8,20,70,28,526,98,1,150
treeview,treeview,,157,114,292,271,615,563,8,1
vscode-settings,vscode-settings,,233,216,441,449,530,890,9,1
tmlanguage,tmlanguage,,8,3,12,11,15,23,9,1
postgresql-simple,postgresql-simple,,1,0,0,1,5,1,2,1
tty,tty,,27,14,55,41,58,96,9,1
hp-ux,hp-ux,,6,2,13,8,20,21,9,1
pty,pty,,13,6,14,19,29,33,9,1
sshpass,sshpass,,8,5,8,13,24,21,9,1
gdal,gdal,,92,69,148,161,235,309,0,1
sparse-matrix,sparse-matrix,,113,120,199,233,484,432,0,6.19469
expandablelistview,expandablelistview,,35,24,92,59,206,151,3,1
sql-insert,sql-insert,,115,113,192,228,444,420,4,1
apache-zookeeper,apache-zookeeper,,87,111,200,198,408,398,2,27.586207
mesos,mesos,,27,6,68,33,163,101,6,1
mesosphere,mesosphere,,9,3,22,12,54,34,6,1
applepay,applepay,,19,23,32,42,69,74,13,21.052632
wallet,wallet,,14,20,29,34,63,63,13,42.857143
passkit,passkit,,5,15,9,20,30,29,13,200
unzip,unzip,,36,36,66,72,155,138,9,1
angular2-template,angular2-template,,23,27,113,50,720,163,1,17.391304
angular2-components,angular2-components,,1,3,13,4,75,17,1,200
outlook-addin,outlook-addin,,104,112,264,216,457,480,8,7.692308
outlook-vba,outlook-vba,,171,112,232,283,480,515,5,1
sender,sender,,5,13,13,18,24,31,13,160
email-threading,email-threading,,0,0,1,0,3,1,4,1
native-base,native-base,,42,70,125,112,250,237,1,66.666667
n-gram,n-gram,,23,18,53,41,90,94,0,1
naivebayes,naivebayes,,58,26,92,84,160,176,0,1
uicollectionview,uicollectionview,,390,352,787,742,1844,1529,13,1
uicollectionviewcell,uicollectionviewcell,,114,109,240,223,547,463,13,1
uicollectionviewlayout,uicollectionviewlayout,,39,26,49,65,145,114,13,1
reddit,reddit,,25,31,64,56,103,120,0,24
httparty,httparty,,17,11,25,28,50,53,12,1
asterisk,asterisk,,45,38,78,83,261,161,13,1
cdr,cdr,,5,1,0,6,11,6,13,1
actionscript-3,actionscript-3,,60,48,96,108,452,204,13,1
flash,flash,,64,55,136,119,404,255,13,1
flex4,flex4,,2,1,5,3,14,8,13,1
google-spreadsheet-api,google-spreadsheet-api,,0,0,0,0,210,0,5,1
audio-player,audio-player,,22,28,65,50,95,115,3,27.272727
mpmusicplayercontroller,mpmusicplayercontroller,,3,3,18,6,16,24,13,1
abap,abap,,104,125,198,229,323,427,5,20.192308
utf-16,utf-16,,21,26,44,47,88,91,0,23.809524
cgi,cgi,,90,69,131,159,257,290,9,1
configparser,configparser,,15,19,29,34,66,63,0,26.666667
serializable,serializable,,11,9,35,20,57,55,3,1
lte,lte,,9,8,27,17,32,44,3,1
google-chartwrapper,google-chartwrapper,,11,20,34,31,90,65,1,81.818182
extjs6,extjs6,,20,12,56,32,141,88,1,1
apply,apply,,178,169,289,347,718,636,0,1
sapply,sapply,,36,16,61,52,149,113,0,1
agrep,agrep,,3,3,4,6,12,10,0,1
ssrs-2008,ssrs-2008,,59,61,154,120,326,274,4,3.389831
ssrs-tablix,ssrs-tablix,,47,28,82,75,110,157,4,1
angular-flex-layout,angular-flex-layout,,31,22,68,53,125,121,1,1
firewall,firewall,,76,73,149,149,227,298,9,1
sysadmin,sysadmin,,13,14,20,27,39,47,9,7.692308
ufw,ufw,,10,9,18,19,16,37,9,1
sweetalert2,sweetalert2,,44,51,90,95,151,185,1,15.909091
resnet,resnet,,37,33,49,70,88,119,0,1
dde,dde,,4,5,11,9,22,20,5,25
arduino-uno,arduino-uno,,102,58,95,160,224,255,9,1
fragment,fragment,,126,149,307,275,719,582,3,18.253968
mahout,mahout,,5,0,6,5,23,11,3,1
tycho,tycho,,7,15,32,22,68,54,3,114.285714
d3.js,d3.js,,797,714,1768,1511,3618,3279,1,1
data-visualization,data-visualization,,256,237,448,493,653,941,0,1
vtk,vtk,,78,69,117,147,222,264,0,1
paraview,paraview,,13,4,28,17,65,45,0,1
linq-to-entities,linq-to-entities,,41,52,110,93,244,203,8,26.829268
automapper,automapper,,153,165,330,318,631,648,8,7.843137
threadpool,threadpool,,92,87,211,179,298,390,3,1
executorservice,executorservice,,63,50,139,113,207,252,3,1
selected,selected,,14,10,31,24,47,55,1,1
ng-class,ng-class,,21,14,37,35,75,72,1,1
global-variables,global-variables,,145,118,324,263,643,587,0,1
javascript-objects,javascript-objects,,166,197,369,363,746,732,1,18.674699
runtime-permissions,runtime-permissions,,8,6,26,14,56,40,3,1
php-curl,php-curl,,70,75,119,145,192,264,4,7.142857
android-studio-3.0,android-studio-3.0,,70,51,210,121,908,331,3,1
exchange-server,exchange-server,,68,92,211,160,328,371,8,35.294118
exchangewebservices,exchangewebservices,,70,74,235,144,315,379,8,5.714286
msdn,msdn,,13,4,32,17,69,49,9,1
utf,utf,,27,17,41,44,83,85,0,1
reactive-programming,reactive-programming,,163,161,386,324,778,710,3,1
project-reactor,project-reactor,,135,168,265,303,362,568,3,24.444444
newrelic,newrelic,,22,34,50,56,73,106,6,54.545455
dfu,dfu,,1,1,6,2,6,8,3,1
movesense,movesense,,7,5,7,12,13,19,3,1
jogl,jogl,,11,5,15,16,47,31,3,1
xquery,xquery,,92,77,193,169,403,362,3,1
cross-apply,cross-apply,,6,12,10,18,43,28,4,100
django-admin,django-admin,,190,179,377,369,624,746,0,1
django-email,django-email,,7,12,20,19,29,39,0,71.428571
avalondock,avalondock,,8,3,15,11,18,26,8,1
yii2-model,yii2-model,,4,4,14,8,45,22,4,1
yii2-validation,yii2-validation,,1,0,9,1,27,10,4,1
concurrenthashmap,concurrenthashmap,,25,14,33,39,74,72,3,1
apple-push-notifications,apple-push-notifications,,136,126,287,262,614,549,13,1
remote-notifications,remote-notifications,,2,5,10,7,31,17,13,150
xib,xib,,39,30,77,69,190,146,13,1
ruby-on-rails-2,ruby-on-rails-2,,2,1,5,3,19,8,12,1
opencsv,opencsv,,36,30,47,66,94,113,3,1
lets-encrypt,lets-encrypt,,105,73,196,178,312,374,6,1
drawerlayout,drawerlayout,,19,14,32,33,84,65,3,1
crosstab,crosstab,,40,41,91,81,138,172,4,2.5
datefield,datefield,,4,6,6,10,25,16,0,50
bootstrap-modal,bootstrap-modal,,278,255,580,533,1065,1113,1,1
output,output,,204,194,394,398,834,792,0,1
figure,figure,,40,34,77,74,107,151,0,1
mp3,mp3,,77,53,123,130,210,253,13,1
google-sheets,google-sheets,,1531,1769,2109,3300,3391,5409,5,15.545395
background-process,background-process,,58,49,106,107,220,213,3,1
locale,locale,,99,95,238,194,381,432,3,1
glibc,glibc,,33,36,103,69,148,172,9,9.090909
buildroot,buildroot,,29,12,34,41,92,75,9,1
watchkit,watchkit,,60,47,123,107,221,230,13,1
health-kit,health-kit,,45,18,66,63,146,129,13,1
watch-os-4,watch-os-4,,1,1,6,2,55,8,13,1
template-meta-programming,template-meta-programming,,70,54,139,124,264,263,9,1
async.js,async.js,,34,20,59,54,168,113,1,1
sweetalert,sweetalert,,46,33,78,79,164,157,1,1
latex,latex,,236,201,394,437,738,831,0,1
legend,legend,,119,110,242,229,466,471,0,1
tikz,tikz,,13,13,15,26,34,41,0,1
android-7.0-nougat,android-7.0-nougat,,18,5,31,23,165,54,3,1
multi-window,multi-window,,5,8,9,13,29,22,3,60
freeform,freeform,,2,0,2,2,5,4,3,1
gtk,gtk,,132,116,234,248,479,482,9,1
glade,glade,,13,8,40,21,66,61,9,1
c11,c11,,24,17,21,41,95,62,9,1
maven-3,maven-3,,107,86,200,193,414,393,3,1
cdi,cdi,,54,50,136,104,305,240,3,1
jbehave,jbehave,,13,7,29,20,39,49,3,1
alarmmanager,alarmmanager,,83,63,160,146,394,306,3,1
nslayoutconstraint,nslayoutconstraint,,54,36,117,90,250,207,13,1
system-verilog,system-verilog,,68,83,114,151,219,265,9,22.058824
uvm,uvm,,22,17,22,39,46,61,9,1
cgfloat,cgfloat,,3,1,5,4,12,9,13,1
jetbrains-ide,jetbrains-ide,,76,72,168,148,259,316,3,1
visual-studio-addins,visual-studio-addins,,0,2,3,2,11,5,8,100
outlook-web-app,outlook-web-app,,10,11,32,21,24,53,5,10
mongoose-populate,mongoose-populate,,43,39,85,82,128,167,1,1
symfony-2.3,symfony-2.3,,2,1,5,3,41,8,4,1
frontend,frontend,,308,334,727,642,1163,1369,1,8.441558
create-react-app,create-react-app,,326,336,622,662,801,1284,1,3.067485
beatbox,beatbox,,1,0,0,1,2,1,14,1
netezza,netezza,,26,30,57,56,100,113,4,15.384615
ecdf,ecdf,,7,6,4,13,11,17,0,1
t4,t4,,12,10,36,22,67,58,8,1
scaffolding,scaffolding,,8,14,36,22,56,58,8,75
bootstrap-datepicker,bootstrap-datepicker,,29,35,63,64,131,127,1,20.689655
realm-list,realm-list,,3,8,22,11,36,33,13,166.666667
gem-bundler,gem-bundler,,1,0,7,1,6,8,12,1
graphql-java,graphql-java,,29,39,49,68,83,117,1,34.482759
sql-server-ce-3.5,sql-server-ce-3.5,,0,0,0,0,5,0,8,1
es6-class,es6-class,,64,72,120,136,277,256,1,12.5
angular2-testing,angular2-testing,,0,1,4,1,22,5,1,1
linker-errors,linker-errors,,75,44,142,119,326,261,9,1
recovery,recovery,,21,21,27,42,60,69,4,1
android.mk,android.mk,,11,8,11,19,33,30,3,1
lnk2019,lnk2019,,6,1,17,7,38,24,9,1
azure-stream-analytics,azure-stream-analytics,,35,34,57,69,160,126,8,1
azure-cosmosdb,azure-cosmosdb,,273,312,537,585,1033,1122,8,14.285714
webstorm,webstorm,,112,114,269,226,589,495,1,1.785714
countvectorizer,countvectorizer,,37,22,27,59,60,86,0,1
bounded-contexts,bounded-contexts,,1,3,9,4,11,13,8,200
webpack-dev-server,webpack-dev-server,,130,108,257,238,563,495,1,1
react-router-v4,react-router-v4,,129,84,344,213,807,557,1,1
primefaces,primefaces,,193,208,436,401,1056,837,3,7.772021
redmine,redmine,,25,18,45,43,100,88,12,1
find,find,,180,176,391,356,844,747,9,1
vbscript,vbscript,,212,217,376,429,1087,805,5,2.358491
jboss-eap-6,jboss-eap-6,,6,8,28,14,62,42,3,33.333333
setter,setter,,31,20,61,51,89,112,3,1
rfc,rfc,,12,10,33,22,36,55,4,1
po,po,,1,2,9,3,19,12,4,100
jco,jco,,2,2,11,4,20,15,5,1
signed,signed,,14,18,49,32,77,81,9,28.571429
karaf,karaf,,19,0,41,19,88,60,3,1
ca,ca,,29,25,39,54,71,93,6,1
floating-accuracy,floating-accuracy,,23,24,54,47,105,101,0,4.347826
jackson2,jackson2,,23,13,66,36,166,102,3,1
log4j,log4j,,140,137,329,277,607,606,3,1
log4j2,log4j2,,122,139,227,261,476,488,3,13.934426
ckeditor,ckeditor,,216,181,430,397,715,827,1,1
get,get,,343,289,666,632,1305,1298,4,1
httpclient,httpclient,,193,189,324,382,721,706,8,1
hsqldb,hsqldb,,31,14,71,45,150,116,3,1
findbugs,findbugs,,12,7,22,19,58,41,3,1
focus-stealing,focus-stealing,,0,0,0,0,1,0,9,1
jquery-selectors,jquery-selectors,,46,40,102,86,215,188,1,1
line,line,,107,118,218,225,390,443,0,10.280374
pydub,pydub,,19,15,20,34,41,54,0,1
tomcat8,tomcat8,,106,91,271,197,473,468,3,1
spring-4,spring-4,,9,3,10,12,47,22,3,1
amazon-vpc,amazon-vpc,,79,82,91,161,195,252,6,3.797468
angular-ui-router,angular-ui-router,,145,117,283,262,908,545,1,1
content-management-system,content-management-system,,63,70,176,133,358,309,4,11.111111
jcr,jcr,,9,5,26,14,49,40,3,1
magnolia,magnolia,,4,14,18,18,41,36,3,250
auth0,auth0,,107,122,195,229,368,424,4,14.018692
php-di,php-di,,6,4,5,10,24,15,4,1
outlook,outlook,,573,591,1240,1164,1772,2404,5,3.141361
html2canvas,html2canvas,,76,83,149,159,211,308,1,9.210526
apache-spark-mllib,apache-spark-mllib,,55,71,137,126,344,263,2,29.090909
parse-platform,parse-platform,,123,80,145,203,390,348,13,1
jqplot,jqplot,,3,6,16,9,47,25,1,100
twisted,twisted,,37,28,78,65,229,143,0,1
telnet,telnet,,46,32,89,78,184,167,9,1
task-parallel-library,task-parallel-library,,72,56,157,128,373,285,8,1
pipe,pipe,,227,152,431,379,788,810,9,1
oracle11g,oracle11g,,391,341,858,732,1835,1590,4,1
sql-loader,sql-loader,,19,13,33,32,86,65,4,1
port,port,,149,146,314,295,515,609,9,1
python-requests,python-requests,,774,830,1294,1604,2274,2898,0,7.235142
indexeddb,indexeddb,,67,39,106,106,207,212,1,1
localforage,localforage,,6,8,10,14,18,24,1,33.333333
geckodriver,geckodriver,,54,64,160,118,312,278,3,18.518519
angular2-observables,angular2-observables,,24,17,61,41,218,102,1,1
.net-framework-version,.net-framework-version,,49,32,64,81,104,145,8,1
p6spy,p6spy,,0,0,2,0,6,2,3,1
open-liberty,open-liberty,,17,14,35,31,80,66,3,1
static-libraries,static-libraries,,69,61,132,130,304,262,9,1
mingw32,mingw32,,8,10,28,18,53,46,9,25
android-instant-apps,android-instant-apps,,14,11,48,25,189,73,3,1
activemq,activemq,,149,109,217,258,464,475,3,1
electron-packager,electron-packager,,30,48,50,78,87,128,1,60
firebase-console,firebase-console,,20,24,42,44,104,86,13,20
sdl-2,sdl-2,,68,54,144,122,297,266,9,1
govendor,govendor,,3,3,8,6,8,14,6,1
schedule,schedule,,40,50,102,90,157,192,0,25
performance-testing,performance-testing,,137,120,293,257,584,550,3,1
loadrunner,loadrunner,,21,22,38,43,102,81,3,4.761905
excel-formula,excel-formula,,824,811,1450,1635,3076,3085,5,1
case-class,case-class,,22,11,37,33,71,70,2,1
asp.net-core-mvc,asp.net-core-mvc,,414,371,1076,785,1878,1861,8,1
video-encoding,video-encoding,,14,16,25,30,69,55,13,14.285714
unreal-engine4,unreal-engine4,,76,80,140,156,203,296,9,5.263158
moq,moq,,129,98,254,227,429,481,8,1
mongodb-.net-driver,mongodb-.net-driver,,64,55,120,119,171,239,1,1
linear-gradients,linear-gradients,,40,49,80,89,162,169,1,22.5
safari-windows,safari-windows,,1,0,0,1,1,1,1,1
spring-data-mongodb,spring-data-mongodb,,135,78,244,213,376,457,3,1
maven-site-plugin,maven-site-plugin,,2,1,7,3,21,10,3,1
sapui5,sapui5,,173,185,352,358,654,710,1,6.936416
rdf,rdf,,78,58,144,136,352,280,2,1
jena,jena,,50,26,89,76,208,165,2,1
owl,owl,,38,28,105,66,262,171,2,1
common-table-expression,common-table-expression,,80,84,187,164,342,351,4,5
target,target,,34,28,67,62,110,129,13,1
parent-node,parent-node,,1,0,2,1,7,3,1,1
python-imaging-library,python-imaging-library,,270,285,507,555,631,1062,0,5.555556
scikit-image,scikit-image,,74,71,121,145,255,266,0,1
datagridviewcomboboxcell,datagridviewcomboboxcell,,5,3,3,8,12,11,8,1
tooltip,tooltip,,158,123,255,281,466,536,1,1
bokeh,bokeh,,265,209,399,474,802,873,0,1
xsl-fo,xsl-fo,,26,24,62,50,135,112,3,1
apache-fop,apache-fop,,28,25,44,53,101,97,3,1
vsto,vsto,,115,120,262,235,524,497,8,4.347826
postsharp,postsharp,,7,4,18,11,42,29,8,1
zend-framework2,zend-framework2,,14,21,54,35,178,89,4,50
basex,basex,,11,7,24,18,23,42,3,1
microblaze,microblaze,,5,0,7,5,6,12,9,1
this,this,,114,129,220,243,524,463,1,13.157895
chaining,chaining,,14,17,27,31,76,58,1,21.428571
windows-7,windows-7,,57,58,152,115,296,267,9,1.754386
show,show,,27,14,62,41,126,103,1,1
android-sqlite,android-sqlite,,198,189,353,387,923,740,3,1
android-cursor,android-cursor,,9,16,14,25,67,39,3,77.777778
immutable.js,immutable.js,,35,19,82,54,208,136,1,1
hyperledger,hyperledger,,222,241,626,463,1247,1089,6,8.558559
hyperledger-composer,hyperledger-composer,,102,79,305,181,931,486,6,1
string-literals,string-literals,,19,19,38,38,88,76,9,1
c#-2.0,c#-2.0,,7,2,18,9,30,27,8,1
drools-guvnor,drools-guvnor,,4,4,12,8,18,20,3,1
rolling-computation,rolling-computation,,54,43,35,97,70,132,0,1
owl-api,owl-api,,14,1,26,15,72,41,2,1
winsxs,winsxs,,0,0,1,0,7,1,8,1
react-datepicker,react-datepicker,,20,25,36,45,34,81,1,25
tidyverse,tidyverse,,253,291,525,544,935,1069,0,15.019763
mutate,mutate,,105,81,166,186,291,352,0,1
directx,directx,,66,86,144,152,278,296,9,30.30303
slim,slim,,68,70,135,138,381,273,4,2.941176
composite-id,composite-id,,0,1,0,1,3,1,3,1
mahapps.metro,mahapps.metro,,10,9,42,19,85,61,8,1
identityserver3,identityserver3,,26,12,69,38,174,107,8,1
openid-connect,openid-connect,,161,110,262,271,506,533,8,1
appharbor,appharbor,,1,0,5,1,5,6,8,1
redux-form,redux-form,,148,108,268,256,678,524,1,1
hook-woocommerce,hook-woocommerce,,163,156,237,319,477,556,4,1
codeigniter-2,codeigniter-2,,17,14,64,31,107,95,4,1
components,components,,316,285,661,601,1227,1262,1,1
detection,detection,,56,55,88,111,148,199,0,1
servicestack,servicestack,,52,34,90,86,250,176,8,1
.net-core-1.1,.net-core-1.1,,0,0,1,0,9,1,8,1
contact,contact,,0,0,0,0,99,0,4,1
java-native-interface,java-native-interface,,145,151,334,296,675,630,3,4.137931
jnienv,jnienv,,7,6,21,13,21,34,3,1
apache-httpclient-4.x,apache-httpclient-4.x,,57,49,113,106,177,219,3,1
user-input,user-input,,109,84,209,193,432,402,0,1
gui-testing,gui-testing,,4,5,7,9,11,16,3,25
xmlstarlet,xmlstarlet,,11,14,24,25,76,49,9,27.272727
collect,collect,,8,7,24,15,29,39,3,1
saml-2.0,saml-2.0,,104,94,191,198,309,389,8,1
semantic-web,semantic-web,,40,14,56,54,151,110,2,1
glob,glob,,74,80,161,154,253,315,0,8.108108
inputstream,inputstream,,54,61,159,115,332,274,3,12.962963
bufferedreader,bufferedreader,,54,31,103,85,242,188,3,1
mocha,mocha,,317,282,600,599,1090,1199,1,1
chai,chai,,127,112,225,239,440,464,1,1
rotation,rotation,,172,141,364,313,725,677,1,1
kml,kml,,34,28,54,62,114,116,1,1
deep-linking,deep-linking,,93,92,202,185,381,387,3,1
android-7.1-nougat,android-7.1-nougat,,5,2,24,7,65,31,3,1
android-datepicker,android-datepicker,,19,9,29,28,57,57,3,1
portlet,portlet,,4,7,20,11,48,31,3,75
httpsession,httpsession,,15,11,25,26,58,51,3,1
mdm,mdm,,23,24,48,47,82,95,13,4.347826
vue-router,vue-router,,307,311,580,618,921,1198,1,1.302932
git-diff,git-diff,,22,16,65,38,96,103,6,1
git-hash,git-hash,,2,2,2,4,3,6,6,1
dkim,dkim,,13,12,27,25,53,52,4,1
pre-allocation,pre-allocation,,1,1,3,2,10,5,0,1
headless-browser,headless-browser,,15,24,65,39,104,104,3,60
htmlunit-driver,htmlunit-driver,,6,2,16,8,37,24,3,1
raspberry-pi3,raspberry-pi3,,366,261,611,627,1118,1238,0,1
alsa,alsa,,17,32,44,49,89,93,13,88.235294
hierarchical,hierarchical,,12,6,24,18,43,42,0,1
visualstates,visualstates,,0,3,5,3,8,8,8,200
mysql-5.1,mysql-5.1,,0,0,0,0,3,0,4,1
xmpp,xmpp,,59,52,162,111,287,273,3,1
xamarin.ios,xamarin.ios,,315,316,755,631,1991,1386,8,1
sonata-admin,sonata-admin,,52,23,91,75,241,166,4,1
azure-sdk,azure-sdk,,7,18,28,25,31,53,8,157.142857
frame,frame,,59,49,90,108,210,198,13,1
mgo,mgo,,20,8,49,28,121,77,1,1
property-injection,property-injection,,3,0,2,3,5,5,8,1
spring-integration,spring-integration,,143,124,389,267,777,656,3,1
iis-7,iis-7,,44,35,67,79,206,146,8,1
sha,sha,,34,16,51,50,118,101,6,1
java-bridge-method,java-bridge-method,,1,1,0,2,3,2,3,1
java-synthetic-methods,java-synthetic-methods,,0,0,0,0,3,0,3,1
azure-resource-manager,azure-resource-manager,,89,82,217,171,351,388,8,1
azure-redis-cache,azure-redis-cache,,9,9,22,18,37,40,8,1
solaris,solaris,,36,26,51,62,137,113,9,1
tar,tar,,45,47,100,92,193,192,9,4.444444
prestashop-1.7,prestashop-1.7,,77,66,177,143,241,320,4,1
jquery-masonry,jquery-masonry,,9,2,9,11,32,20,1,1
masonry,masonry,,21,16,42,37,91,79,1,1
ads,ads,,86,95,193,181,262,374,3,10.465116
apache-camel,apache-camel,,284,231,550,515,1180,1065,3,1
rightnow-crm,rightnow-crm,,0,0,0,0,7,0,3,1
oracle-service-cloud,oracle-service-cloud,,0,0,0,0,6,0,3,1
socketserver,socketserver,,10,3,19,13,26,32,9,1
constructor-overloading,constructor-overloading,,7,10,11,17,14,28,9,42.857143
chef,chef,,72,62,181,134,595,315,12,1
jaxb,jaxb,,183,176,351,359,703,710,3,1
pydev,pydev,,18,17,62,35,152,97,0,1
pep8,pep8,,31,24,39,55,87,94,0,1
autopep8,autopep8,,4,6,10,10,8,20,0,50
rijndael,rijndael,,5,8,10,13,17,23,6,60
shared-ptr,shared-ptr,,60,52,96,112,252,208,9,1
android-things,android-things,,33,10,60,43,237,103,3,1
navigationbar,navigationbar,,35,53,95,88,216,183,13,51.428571
webpack-style-loader,webpack-style-loader,,11,14,32,25,101,57,1,27.272727
element,element,,101,108,242,209,343,451,1,6.930693
sys,sys,,29,33,54,62,101,116,0,13.793103
tree-shaking,tree-shaking,,15,10,29,25,35,54,1,1
json-deserialization,json-deserialization,,74,67,133,141,258,274,8,1
buffer-overflow,buffer-overflow,,31,31,68,62,98,130,9,1
cloudflare,cloudflare,,99,83,199,182,252,381,4,1
w3-total-cache,w3-total-cache,,2,1,12,3,15,15,4,1
contact-form-7,contact-form-7,,93,71,151,164,281,315,4,1
docx4j,docx4j,,17,21,35,38,64,73,3,23.529412
apache-felix,apache-felix,,24,9,34,33,60,67,3,1
azure-blob-storage,azure-blob-storage,,78,88,130,166,199,296,8,12.820513
angular-unit-test,angular-unit-test,,8,20,13,28,34,41,1,150
slick,slick,,72,76,176,148,288,324,2,5.555556
treemap,treemap,,42,19,68,61,121,129,3,1
semantic-ui,semantic-ui,,132,102,185,234,485,419,1,1
semantic-ui-react,semantic-ui-react,,99,63,89,162,218,251,1,1
field,field,,74,66,182,140,359,322,4,1
adfs,adfs,,60,74,134,134,246,268,8,23.333333
scala-ide,scala-ide,,3,0,12,3,19,15,2,1
google-nearby,google-nearby,,12,9,44,21,87,65,3,1
nas,nas,,16,9,30,25,42,55,9,1
hiveql,hiveql,,240,214,393,454,724,847,2,1
karma-jasmine,karma-jasmine,,222,216,494,438,902,932,1,1
httpbackend,httpbackend,,2,0,5,2,5,7,1,1
tf-slim,tf-slim,,6,3,8,9,37,17,0,1
.net-standard-2.0,.net-standard-2.0,,40,34,97,74,253,171,8,1
phonegap-plugins,phonegap-plugins,,26,19,85,45,158,130,1,1
swagger-2.0,swagger-2.0,,104,88,164,192,250,356,3,1
jquery-ui-datepicker,jquery-ui-datepicker,,37,38,103,75,173,178,1,2.702703
datatables-1.10,datatables-1.10,,25,16,46,41,87,87,1,1
session-management,session-management,,10,7,22,17,35,39,3,1
aspectj,aspectj,,54,40,130,94,215,224,3,1
nested,nested,,377,329,777,706,1423,1483,0,1
config,config,,137,144,267,281,465,548,4,5.109489
configuration-files,configuration-files,,40,24,94,64,169,158,3,1
ini,ini,,26,36,57,62,103,119,4,38.461538
java-melody,java-melody,,2,4,7,6,15,13,3,100
joomla,joomla,,69,70,168,139,486,307,4,1.449275
jenssegers-mongodb,jenssegers-mongodb,,14,7,18,21,22,39,4,1
dicom,dicom,,26,40,41,66,116,107,0,53.846154
dcmtk,dcmtk,,5,5,16,10,17,26,9,1
grouping,grouping,,188,159,334,347,671,681,0,1
rdlc,rdlc,,73,57,115,130,196,245,8,1
laravel-5.2,laravel-5.2,,97,22,225,119,607,344,4,1
multifile-uploader,multifile-uploader,,6,9,13,15,13,28,4,50
intervention,intervention,,15,18,35,33,76,68,4,20
sql-server-data-tools,sql-server-data-tools,,84,70,131,154,288,285,4,1
jsoup,jsoup,,116,88,226,204,541,430,3,1
tinymce,tinymce,,134,104,267,238,455,505,1,1
tinymce-4,tinymce-4,,21,23,75,44,154,119,1,9.52381
html-editor,html-editor,,3,4,2,7,18,9,1,33.333333
date-formatting,date-formatting,,44,39,85,83,175,168,0,1
java-time,java-time,,26,22,68,48,228,116,3,1
week-number,week-number,,7,13,26,20,52,46,0,85.714286
android-toolbar,android-toolbar,,64,77,148,141,345,289,3,20.3125
hyperloglog,hyperloglog,,7,1,9,8,7,17,0,1
skype-for-business,skype-for-business,,28,24,66,52,121,118,8,1
ucwa,ucwa,,6,8,8,14,17,22,8,33.333333
jstree,jstree,,40,26,61,66,126,127,1,1
compare,compare,,163,124,395,287,759,682,0,1
timezone,timezone,,237,191,418,428,888,846,0,1
jodatime,jodatime,,31,26,55,57,157,112,3,1
tzdata,tzdata,,2,3,4,5,7,9,0,50
containers,containers,,303,303,581,606,958,1187,6,1
stdmap,stdmap,,28,24,74,52,151,126,9,1
qt-signals,qt-signals,,10,3,31,13,74,44,9,1
qprogressbar,qprogressbar,,4,5,2,9,18,11,0,25
qt-slot,qt-slot,,1,1,10,2,16,12,9,1
redhat,redhat,,99,115,181,214,376,395,9,16.161616
flask-wtforms,flask-wtforms,,110,93,155,203,211,358,0,1
reverse,reverse,,70,56,137,126,303,263,0,1
github-api,github-api,,104,100,177,204,379,381,6,1
requirements.txt,requirements.txt,,14,11,27,25,39,52,0,1
odoo-8,odoo-8,,22,8,76,30,346,106,0,1
asp.net-core-identity,asp.net-core-identity,,46,39,103,85,165,188,8,1
wolfram-mathematica,wolfram-mathematica,,36,30,63,66,139,129,0,1
mathematica-8,mathematica-8,,2,0,2,2,10,4,0,1
sensor,sensor,,63,50,96,113,186,209,3,1
dllimport,dllimport,,32,39,71,71,163,142,8,21.875
declspec,declspec,,1,1,0,2,3,2,9,1
celery-task,celery-task,,19,22,56,41,67,97,0,15.789474
angular1.6,angular1.6,,12,5,19,17,82,36,1,1
antialiasing,antialiasing,,11,13,26,24,44,50,1,18.181818
android-mediaplayer,android-mediaplayer,,92,96,229,188,431,417,3,4.347826
exoplayer,exoplayer,,81,87,223,168,293,391,3,7.407407
vitamio,vitamio,,0,1,0,1,11,1,3,1
spring-data,spring-data,,326,299,743,625,1577,1368,3,1
scheduled-tasks,scheduled-tasks,,170,140,302,310,542,612,3,1
executable-jar,executable-jar,,55,41,106,96,183,202,3,1
magento-1.9,magento-1.9,,60,54,178,114,411,292,4,1
qt4,qt4,,11,9,29,20,116,49,9,1
windows-installer,windows-installer,,114,130,274,244,662,518,8,14.035088
undefined-reference,undefined-reference,,18,17,34,35,93,69,9,1
openalpr,openalpr,,6,5,12,11,13,23,0,1
angular-forms,angular-forms,,119,111,241,230,538,471,1,1
rasa-nlu,rasa-nlu,,64,46,81,110,117,191,0,1
xslt-2.0,xslt-2.0,,89,70,143,159,319,302,3,1
junit4,junit4,,88,105,226,193,380,419,3,19.318182
powermockito,powermockito,,45,44,95,89,193,184,3,1
tfsbuild,tfsbuild,,32,32,60,64,267,124,8,1
prime-factoring,prime-factoring,,8,9,14,17,33,31,0,12.5
database-administration,database-administration,,42,53,122,95,219,217,4,26.190476
recursive-type,recursive-type,,1,2,3,3,5,6,9,100
pyomo,pyomo,,58,65,82,123,140,205,0,12.068966
mongoose-schema,mongoose-schema,,151,118,276,269,503,545,1,1
sim-card,sim-card,,4,9,7,13,15,20,3,125
join,join,,656,609,1489,1265,3229,2754,4,1
traits,traits,,88,81,132,169,303,301,9,1
shapeless,shapeless,,27,22,45,49,112,94,2,1
azure-media-services,azure-media-services,,17,10,37,27,79,64,8,1
ckeditor4.x,ckeditor4.x,,69,51,99,120,128,219,1,1
html-agility-pack,html-agility-pack,,65,47,103,112,206,215,8,1
auryn,auryn,,0,0,2,0,1,2,8,1
cytoscape,cytoscape,,4,5,15,9,37,24,1,25
css-transitions,css-transitions,,101,83,213,184,471,397,1,1
pseudo-element,pseudo-element,,43,35,74,78,174,152,1,1
webkit-transform,webkit-transform,,0,0,1,0,4,1,1,1
unsigned,unsigned,,15,11,42,26,74,68,9,1
cart,cart,,134,72,211,206,462,417,4,1
ultragrid,ultragrid,,0,1,2,1,10,3,8,1
gulp,gulp,,302,256,664,558,1302,1222,1,1
requirejs,requirejs,,67,70,140,137,312,277,1,4.477612
sql-update,sql-update,,225,178,454,403,956,857,4,1
dml,dml,,13,7,28,20,44,48,4,1
mex,mex,,38,23,38,61,87,99,0,1
tls1.2,tls1.2,,142,126,285,268,490,553,6,1
sikuli,sikuli,,26,15,44,41,95,85,3,1
sikuli-script,sikuli-script,,4,5,11,9,29,20,3,25
teradata,teradata,,121,116,277,237,570,514,4,1
gulp-sass,gulp-sass,,32,19,52,51,89,103,1,1
npm-scripts,npm-scripts,,63,49,115,112,161,227,1,1
gulp-clean-css,gulp-clean-css,,0,0,1,0,7,1,1,1
poco-libraries,poco-libraries,,21,27,35,48,59,83,9,28.571429
sendbird,sendbird,,3,3,17,6,15,23,3,1
eloquent,eloquent,,1056,957,1831,2013,2890,3844,4,1
imei,imei,,5,5,9,10,21,19,3,1
mapkit,mapkit,,84,92,195,176,452,371,13,9.52381
linq-expressions,linq-expressions,,14,8,18,22,51,40,8,1
mvxbind,mvxbind,,0,0,6,0,6,6,8,1
exiftool,exiftool,,9,13,22,22,33,44,3,44.444444
exif,exif,,36,37,76,73,142,149,3,2.777778
x509certificate,x509certificate,,77,68,156,145,231,301,6,1
dynamic-forms,dynamic-forms,,10,12,20,22,27,42,1,20
subdomain,subdomain,,113,109,195,222,359,417,4,1
ksh,ksh,,53,27,82,80,181,162,9,1
svg-animate,svg-animate,,11,22,32,33,54,65,1,100
castle-windsor,castle-windsor,,23,13,43,36,88,79,8,1
pom.xml,pom.xml,,129,127,250,256,469,506,3,1
software-design,software-design,,65,64,110,129,200,239,3,1
cakephp-2.0,cakephp-2.0,,23,13,56,36,129,92,4,1
cakephp-model,cakephp-model,,0,0,0,0,4,0,4,1
zurb-foundation,zurb-foundation,,39,67,117,106,277,223,1,71.794872
window-functions,window-functions,,93,70,142,163,252,305,4,1
bubble-chart,bubble-chart,,12,15,22,27,56,49,1,25
googlevis,googlevis,,9,4,15,13,16,28,0,1
runtime.exec,runtime.exec,,4,4,26,8,40,34,3,1
packageinstaller,packageinstaller,,4,2,3,6,9,9,3,1
wpfdatagrid,wpfdatagrid,,49,7,104,56,174,160,8,1
service-worker,service-worker,,229,210,510,439,826,949,1,1
progressive-web-apps,progressive-web-apps,,347,340,567,687,588,1254,1,1
ios10-today-widget,ios10-today-widget,,1,0,1,1,4,2,13,1
gpgpu,gpgpu,,29,22,45,51,119,96,0,1
certreq,certreq,,2,0,0,2,2,2,6,1
gettext,gettext,,17,11,56,28,102,84,4,1
msgfmt,msgfmt,,0,0,0,0,2,0,4,1
contextmenu,contextmenu,,62,48,110,110,225,220,8,1
react-native-listview,react-native-listview,,0,3,4,3,24,7,1,200
eval,eval,,81,70,156,151,317,307,0,1
complex-numbers,complex-numbers,,42,26,59,68,135,127,0,1
wtforms,wtforms,,42,35,83,77,105,160,0,1
imagemagick,imagemagick,,150,126,332,276,673,608,12,1
animated-gif,animated-gif,,30,35,31,65,104,96,3,16.666667
appium-android,appium-android,,88,95,188,183,287,371,3,7.954545
stateless,stateless,,9,9,32,18,44,50,3,1
boxfuse,boxfuse,,0,1,1,1,5,2,2,1
pytz,pytz,,18,10,39,28,48,67,0,1
pydoc,pydoc,,4,3,16,7,12,23,0,1
hitcounter,hitcounter,,0,0,3,0,3,3,3,1
wifi,wifi,,85,92,165,177,298,342,3,8.235294
signal-strength,signal-strength,,2,2,3,4,9,7,3,1
microsoft-graph,microsoft-graph,,403,465,766,868,1347,1634,8,15.384615
msal,msal,,76,104,143,180,166,323,8,36.842105
alert,alert,,88,89,188,177,362,365,1,1.136364
vs-unit-testing-framework,vs-unit-testing-framework,,4,9,10,13,27,23,8,125
virtualbox,virtualbox,,125,100,309,225,532,534,6,1
cannot-find-symbol,cannot-find-symbol,,5,6,12,11,26,23,3,20
android-constraintlayout,android-constraintlayout,,186,160,327,346,709,673,3,1
cordova-admob,cordova-admob,,2,3,9,5,20,14,1,50
cas,cas,,41,34,84,75,93,159,3,1
java-7,java-7,,32,24,72,56,157,128,3,1
delete-row,delete-row,,27,27,72,54,151,126,5,1
chardet,chardet,,1,0,1,1,8,2,0,1
keyword,keyword,,32,36,74,68,182,142,0,12.5
apache-spark-1.6,apache-spark-1.6,,1,3,7,4,30,11,2,200
ejml,ejml,,1,1,2,2,7,4,0,1
mule,mule,,132,91,247,223,442,470,14,1
quickbooks,quickbooks,,22,41,64,63,128,127,4,86.363636
intuit-partner-platform,intuit-partner-platform,,1,3,1,4,8,5,4,200
ejb,ejb,,90,75,181,165,302,346,3,1
ejb-3.1,ejb-3.1,,9,5,16,14,31,30,3,1
microsoft-bits,microsoft-bits,,0,1,3,1,5,4,8,1
jsonexception,jsonexception,,3,3,8,6,17,14,3,1
dql,dql,,16,15,42,31,97,73,4,1
translation,translation,,81,88,170,169,327,339,4,8.641975
xliff,xliff,,6,6,11,12,18,23,13,1
recaptcha,recaptcha,,147,103,299,250,485,549,1,1
ef-fluent-api,ef-fluent-api,,33,13,61,46,118,107,8,1
openmp,openmp,,146,98,254,244,535,498,9,1
thread-local,thread-local,,14,5,19,19,33,38,3,1
inno-setup,inno-setup,,42,46,106,88,188,194,8,9.52381
azure-ad-graph-api,azure-ad-graph-api,,62,69,138,131,227,269,8,11.290323
biztalk,biztalk,,71,31,105,102,219,207,8,1
biztalk-2013,biztalk-2013,,26,1,15,27,37,42,8,1
webhooks,webhooks,,171,169,326,340,579,666,4,1
redhat-openjdk,redhat-openjdk,,3,1,12,4,4,16,3,1
maven-profiles,maven-profiles,,1,8,12,9,28,21,3,700
subshell,subshell,,8,1,20,9,35,29,9,1
ctypes,ctypes,,77,101,156,178,353,334,0,31.168831
azure-pipelines-build-task,azure-pipelines-build-task,,56,32,117,88,215,205,8,1
x86-64,x86-64,,165,164,306,329,569,635,9,1
intel-syntax,intel-syntax,,3,4,10,7,10,17,9,33.333333
ng-switch,ng-switch,,1,2,5,3,17,8,1,100
ng-template,ng-template,,21,14,39,35,66,74,1,1
archlinux,archlinux,,48,31,65,79,158,144,9,1
pacman-package-manager,pacman-package-manager,,8,2,9,10,16,19,9,1
mysqlbinlog,mysqlbinlog,,10,5,12,15,15,27,4,1
casting,casting,,297,296,638,593,1415,1231,9,1
jax-rs,jax-rs,,162,137,364,299,684,663,3,1
code-push,code-push,,9,12,28,21,47,49,1,33.333333
react-native-code-push,react-native-code-push,,3,6,17,9,34,26,1,100
command,command,,202,179,370,381,747,751,9,1
graph-algorithm,graph-algorithm,,49,40,137,89,225,226,0,1
schema.org,schema.org,,29,44,52,73,121,125,4,51.724138
json-ld,json-ld,,33,38,55,71,112,126,4,15.151515
google-rich-snippets,google-rich-snippets,,9,20,21,29,39,50,4,122.222222
android-download-manager,android-download-manager,,26,23,60,49,105,109,3,1
latitude-longitude,latitude-longitude,,56,40,96,96,196,192,0,1
directions,directions,,7,12,26,19,40,45,1,71.428571
sfml,sfml,,82,67,158,149,328,307,9,1
installshield,installshield,,24,17,70,41,141,111,8,1
nuget-package,nuget-package,,107,80,224,187,433,411,8,1
.net-4.6.1,.net-4.6.1,,11,16,26,27,33,53,8,45.454545
scroll,scroll,,350,301,751,651,1339,1402,1,1
touch-punch,touch-punch,,0,1,0,1,1,1,1,1
android-navigation,android-navigation,,39,51,53,90,68,143,3,30.769231
post,post,,847,760,1694,1607,3299,3301,4,1
xtext,xtext,,24,21,59,45,115,104,3,1
xtend,xtend,,6,13,16,19,38,35,3,116.666667
testcafe,testcafe,,152,135,185,287,102,472,3,1
elasticsearch-dsl,elasticsearch-dsl,,16,32,33,48,90,81,6,100
value-of,value-of,,1,0,2,1,10,3,3,1
fetch,fetch,,394,358,760,752,1132,1512,1,1
decompiling,decompiling,,22,15,31,37,58,68,3,1
recompile,recompile,,3,5,7,8,16,15,3,66.666667
oracle-text,oracle-text,,2,3,9,5,8,14,4,50
jvm-hotspot,jvm-hotspot,,27,13,25,40,65,65,3,1
hotspot,hotspot,,16,25,38,41,63,79,3,56.25
org-mode,org-mode,,39,22,50,61,126,111,9,1
blessed,blessed,,6,1,5,7,8,12,1,1
swagger-ui,swagger-ui,,191,167,305,358,446,663,3,1
springfox,springfox,,35,36,76,71,107,147,3,2.857143
android-volley,android-volley,,229,182,432,411,1000,843,3,1
nativescript,nativescript,,520,522,1056,1042,828,2098,1,1
botframework,botframework,,460,469,778,929,1573,1707,8,1.956522
luis,luis,,55,62,138,117,314,255,8,12.727273
exposure,exposure,,1,2,8,3,8,11,13,100
average,average,,100,88,226,188,482,414,0,1
type-erasure,type-erasure,,17,16,24,33,62,57,3,1
spring-el,spring-el,,20,34,49,54,107,103,3,70
android-module,android-module,,13,10,24,23,27,47,3,1
command-line-arguments,command-line-arguments,,79,65,144,144,264,288,9,1
asp.net-authentication,asp.net-authentication,,5,5,8,10,18,18,8,1
liquibase,liquibase,,98,93,171,191,305,362,3,1
ehcache,ehcache,,40,29,76,69,165,145,3,1
cntk,cntk,,10,8,34,18,122,52,0,1
matchtemplate,matchtemplate,,3,1,3,4,8,7,0,1
mybatis,mybatis,,89,78,165,167,298,332,3,1
imagick,imagick,,33,37,88,70,162,158,4,12.121212
pluck,pluck,,2,1,2,3,10,5,4,1
aws-sdk,aws-sdk,,346,366,627,712,1061,1339,6,5.780347
photoshop,photoshop,,41,29,81,70,159,151,1,1
autologin,autologin,,5,5,19,10,24,29,4,1
loaddata,loaddata,,5,6,9,11,19,20,0,20
uialertcontroller,uialertcontroller,,48,33,91,81,191,172,13,1
markers,markers,,23,15,31,38,52,69,1,1
ios-charts,ios-charts,,25,17,49,42,135,91,13,1
changelistener,changelistener,,3,1,7,4,16,11,3,1
avassetwriter,avassetwriter,,9,11,24,20,48,44,13,22.222222
hibernate-criteria,hibernate-criteria,,40,45,109,85,156,194,3,12.5
singlepage,singlepage,,4,0,6,4,10,10,4,1
webpagetest,webpagetest,,4,5,4,9,10,13,3,25
crash,crash,,172,211,435,383,922,818,3,22.674419
django-migrations,django-migrations,,38,46,64,84,138,148,0,21.052632
mapbox,mapbox,,235,288,432,523,718,955,1,22.553191
plotly-dash,plotly-dash,,160,167,218,327,165,545,0,4.375
sonarqube-api,sonarqube-api,,0,0,0,0,7,0,3,1
valgrind,valgrind,,81,60,141,141,294,282,9,1
cashapelayer,cashapelayer,,23,21,54,44,114,98,13,1
sql-parametrized-query,sql-parametrized-query,,1,0,5,1,9,6,4,1
offline-caching,offline-caching,,5,16,35,21,75,56,1,220
android-productflavors,android-productflavors,,16,16,48,32,65,80,3,1
yesod,yesod,,10,13,25,23,86,48,2,30
yesod-forms,yesod-forms,,1,0,2,1,4,3,2,1
javacv,javacv,,10,10,30,20,53,50,3,1
scandir,scandir,,7,5,22,12,30,34,4,1
faultexception,faultexception,,1,0,2,1,7,3,8,1
silex,silex,,5,3,8,8,62,16,4,1
slidedown,slidedown,,3,0,4,3,22,7,1,1
slideup,slideup,,3,1,4,4,26,8,1,1
stoppropagation,stoppropagation,,8,5,15,13,39,28,1,1
telegram-bot,telegram-bot,,132,128,221,260,567,481,0,1
sketchjs,sketchjs,,0,0,0,0,2,0,1,1
primitive-types,primitive-types,,9,9,25,18,52,43,3,1
datasource,datasource,,105,87,189,192,336,381,3,1
applicationcontext,applicationcontext,,11,9,31,20,58,51,3,1
epoch,epoch,,35,47,59,82,132,141,0,34.285714
solver,solver,,48,47,81,95,162,176,0,1
nmf,nmf,,4,3,8,7,15,15,0,1
jaxb2,jaxb2,,0,0,3,0,82,3,3,1
q,q,,6,6,22,12,66,34,1,1
font-awesome,font-awesome,,162,158,345,320,710,665,1,1
vega-lite,vega-lite,,25,12,43,37,40,80,0,1
azure-ad-b2c,azure-ad-b2c,,135,163,293,298,636,591,8,20.740741
netlogo,netlogo,,60,33,95,93,214,188,0,1
agents,agents,,0,0,0,0,21,0,3,1
angular4-httpclient,angular4-httpclient,,2,3,27,5,173,32,1,50
google-cloud-storage,google-cloud-storage,,346,365,684,711,1151,1395,6,5.491329
always-encrypted,always-encrypted,,15,14,20,29,67,49,4,1
resource-files,resource-files,,6,6,7,12,17,19,8,1
identityserver4,identityserver4,,276,226,538,502,929,1040,8,1
asp.net-authorization,asp.net-authorization,,19,11,23,30,49,53,8,1
paragraph,paragraph,,20,11,31,31,48,62,1,1
flowdocument,flowdocument,,7,7,7,14,16,21,8,1
phpmyadmin,phpmyadmin,,414,296,774,710,1593,1484,4,1
webbrowser-control,webbrowser-control,,64,61,142,125,299,267,8,1
pixel,pixel,,72,70,137,142,168,279,0,1
eclipse-rcp,eclipse-rcp,,55,77,142,132,407,274,3,40
e4,e4,,19,16,51,35,104,86,3,1
shopware,shopware,,11,13,27,24,53,51,4,18.181818
ruby-on-rails-5.1,ruby-on-rails-5.1,,8,3,38,11,208,49,12,1
webpacker,webpacker,,40,47,73,87,144,160,12,17.5
bpmn.io,bpmn.io,,2,6,9,8,16,17,3,200
database-trigger,database-trigger,,152,100,242,252,315,494,4,1
pull,pull,,15,9,40,24,92,64,6,1
logstash-grok,logstash-grok,,48,47,89,95,163,184,6,1
logstash-configuration,logstash-configuration,,55,40,95,95,132,190,6,1
rclr,rclr,,0,0,0,0,1,0,8,1
camunda,camunda,,32,25,58,57,100,115,3,1
eslint,eslint,,218,239,459,457,614,916,1,9.633028
react-router-dom,react-router-dom,,213,207,320,420,456,740,1,1
delphi-xe3,delphi-xe3,,4,1,9,5,9,14,9,1
fastreport,fastreport,,9,8,22,17,35,39,9,1
angularjs-ng-repeat,angularjs-ng-repeat,,44,35,148,79,587,227,1,1
angular-ng-if,angular-ng-if,,35,42,83,77,226,160,1,20
xml-parsing,xml-parsing,,218,171,409,389,802,798,3,1
gpu.js,gpu.js,,1,0,0,1,3,1,1,1
regular-type,regular-type,,0,0,0,0,2,0,9,1
robolectric,robolectric,,41,29,84,70,108,154,3,1
ignite,ignite,,84,82,158,166,395,324,3,1
raspbian,raspbian,,117,107,240,224,397,464,0,1
amqp,amqp,,66,37,129,103,196,232,3,1
qpid,qpid,,14,7,13,21,33,34,3,1
hpc,hpc,,37,34,64,71,110,135,0,1
shared-hosting,shared-hosting,,29,37,63,66,128,129,4,27.586207
addressbook,addressbook,,1,2,10,3,14,13,13,100
yum,yum,,52,40,103,92,163,195,9,1
opensuse,opensuse,,7,10,33,17,70,50,9,42.857143
cleartool,cleartool,,2,4,4,6,17,10,6,100
add-on,add-on,,16,20,33,36,59,69,5,25
gsuite,gsuite,,100,84,173,184,200,357,5,1
colorbar,colorbar,,40,37,58,77,104,135,0,1
taskscheduler,taskscheduler,,51,47,98,98,176,196,9,1
web-statistics,web-statistics,,0,0,3,0,1,3,3,1
capture,capture,,21,17,47,38,96,85,3,1
keystroke,keystroke,,8,7,27,15,30,42,13,1
keylogger,keylogger,,8,8,26,16,32,42,0,1
pass-by-reference,pass-by-reference,,72,65,143,137,313,280,9,1
php-7,php-7,,127,96,249,223,556,472,4,1
discord,discord,,374,324,752,698,1071,1450,0,1
discord.js,discord.js,,354,380,495,734,604,1229,1,7.344633
jax-ws,jax-ws,,50,47,116,97,186,213,3,1
cxf-client,cxf-client,,5,1,9,6,16,15,3,1
xop,xop,,0,2,0,2,5,2,3,100
asp.net-apicontroller,asp.net-apicontroller,,17,11,32,28,47,60,8,1
github-services,github-services,,0,0,0,0,3,0,6,1
python-multiprocessing,python-multiprocessing,,207,216,351,423,574,774,0,4.347826
igraph,igraph,,121,109,214,230,485,444,0,1
std-function,std-function,,21,20,39,41,71,80,9,1
wso2,wso2,,257,196,588,453,925,1041,14,1
wso2esb,wso2esb,,60,76,161,136,272,297,14,26.666667
wso2carbon,wso2carbon,,47,44,80,91,159,171,14,1
spring-bean,spring-bean,,26,24,64,50,101,114,3,1
database-migration,database-migration,,136,118,226,254,423,480,4,1
oracle12c,oracle12c,,166,193,384,359,727,743,4,16.26506
ipmi,ipmi,,3,2,0,5,6,5,9,1
draw,draw,,59,40,100,99,213,199,0,1
angle,angle,,18,29,51,47,84,98,0,61.111111
spring-kafka,spring-kafka,,176,165,248,341,387,589,3,1
boost-optional,boost-optional,,4,1,3,5,12,8,9,1
stdoptional,stdoptional,,6,7,12,13,14,25,9,16.666667
sse,sse,,23,35,69,58,123,127,9,52.173913
simd,simd,,46,59,115,105,194,220,9,28.26087
intrinsics,intrinsics,,27,30,60,57,117,117,9,11.111111
avx2,avx2,,22,22,29,44,62,73,9,1
adjacency-list,adjacency-list,,15,13,35,28,45,63,0,1
adjacency-list-model,adjacency-list-model,,1,0,1,1,2,2,4,1
backbone.js,backbone.js,,32,35,74,67,217,141,1,9.375
android-animation,android-animation,,110,93,223,203,402,426,3,1
gawk,gawk,,0,0,0,0,104,0,9,1
cassandra-3.0,cassandra-3.0,,89,67,221,156,567,377,2,1
name-hiding,name-hiding,,0,1,5,1,3,6,9,1
isolatedstorage,isolatedstorage,,0,0,4,0,5,4,8,1
javafx-8,javafx-8,,101,62,235,163,689,398,3,1
tablecolumn,tablecolumn,,10,3,11,13,32,24,3,1
database-schema,database-schema,,28,19,58,47,184,105,4,1
matrix-multiplication,matrix-multiplication,,76,73,158,149,291,307,0,1
dynamic-memory-allocation,dynamic-memory-allocation,,81,55,170,136,244,306,9,1
memcpy,memcpy,,28,27,47,55,112,102,9,1
.net-4.0,.net-4.0,,25,24,68,49,101,117,8,1
reportviewer,reportviewer,,32,33,66,65,132,131,8,3.125
precision,precision,,96,105,193,201,453,394,0,9.375
win32gui,win32gui,,17,22,26,39,64,65,9,29.411765
tweepy,tweepy,,106,74,168,180,348,348,0,1
twitter-streaming-api,twitter-streaming-api,,8,3,16,11,29,27,0,1
twython,twython,,4,2,17,6,29,23,0,1
python-twitter,python-twitter,,4,1,4,5,6,9,0,1
excel-interop,excel-interop,,26,42,81,68,116,149,8,61.538462
e2e-testing,e2e-testing,,211,162,305,373,294,678,3,1
handlebars.js,handlebars.js,,165,120,271,285,633,556,1,1
azure-storage-blobs,azure-storage-blobs,,163,203,275,366,544,641,8,24.539877
named-pipes,named-pipes,,34,25,56,59,138,115,8,1
instagram,instagram,,165,157,327,322,581,649,13,1
instagram-api,instagram-api,,80,96,167,176,398,343,13,20
coded-ui-tests,coded-ui-tests,,10,8,60,18,124,78,8,1
pagespeed,pagespeed,,43,40,96,83,95,179,4,1
visual-composer,visual-composer,,16,23,68,39,84,107,4,43.75
closedxml,closedxml,,14,14,33,28,62,61,8,1
nest-nested-object,nest-nested-object,,0,0,0,0,14,0,1,1
asp.net-core-1.1,asp.net-core-1.1,,1,1,3,2,59,5,8,1
wp-admin,wp-admin,,11,8,29,19,33,48,4,1
openlayers-3,openlayers-3,,23,19,58,42,201,100,1,1
bots,bots,,254,216,496,470,975,966,8,1
facebook-messenger,facebook-messenger,,52,38,126,90,287,216,13,1
spell-checking,spell-checking,,21,18,53,39,89,92,0,1
complex-event-processing,complex-event-processing,,10,11,30,21,81,51,14,10
siddhi,siddhi,,20,24,30,44,69,74,14,20
group-by,group-by,,576,553,1204,1129,2163,2333,4,1
osgi-fragment,osgi-fragment,,1,3,2,4,2,6,3,200
onsaveinstancestate,onsaveinstancestate,,9,9,18,18,53,36,3,1
dotnetnuke,dotnetnuke,,31,39,83,70,195,153,8,25.806452
2sxc,2sxc,,8,9,16,17,60,33,8,12.5
dotnetnuke-9,dotnetnuke-9,,1,5,21,6,32,27,8,400
rails-api,rails-api,,30,25,60,55,78,115,12,1
angular-http,angular-http,,24,9,56,33,196,89,1,1
android-sdk-2.3,android-sdk-2.3,,0,9,8,9,26,17,3,800
tax,tax,,8,17,29,25,49,54,4,112.5
recipe,recipe,,2,10,16,12,42,28,9,400
angular-ui,angular-ui,,11,7,11,18,54,29,1,1
ui-grid,ui-grid,,19,15,51,34,101,85,1,1
web-deployment,web-deployment,,125,122,222,247,386,469,1,1
chronicle-map,chronicle-map,,2,2,4,4,13,8,3,1
javax.imageio,javax.imageio,,16,11,36,27,63,63,3,1
sw-precache,sw-precache,,8,1,11,9,24,20,1,1
training-data,training-data,,75,92,119,167,222,286,0,22.666667
active-directory-group,active-directory-group,,11,6,16,17,18,33,8,1
out-of-memory,out-of-memory,,148,154,284,302,645,586,3,4.054054
jgroups,jgroups,,9,5,15,14,37,29,3,1
prefix-tree,prefix-tree,,2,2,1,4,2,5,0,1
tfs2013,tfs2013,,6,4,13,10,72,23,8,1
jquery-ui-sortable,jquery-ui-sortable,,31,26,74,57,148,131,1,1
multi-index,multi-index,,66,81,163,147,308,310,0,22.727273
gravityforms,gravityforms,,32,28,69,60,65,129,4,1
google-floodlight,google-floodlight,,0,0,4,0,3,4,9,1
aurelia-binding,aurelia-binding,,6,5,22,11,92,33,1,1
watermark,watermark,,23,17,47,40,69,87,13,1
code-inspection,code-inspection,,7,5,16,12,22,28,3,1
relative-path,relative-path,,29,24,70,53,114,123,4,1
jquery-ui-slider,jquery-ui-slider,,5,4,14,9,36,23,1,1
dompdf,dompdf,,53,58,108,111,178,219,4,9.433962
python-tesseract,python-tesseract,,84,81,123,165,131,288,0,1
tess4j,tess4j,,1,11,9,12,27,21,3,1000
http-live-streaming,http-live-streaming,,88,67,169,155,225,324,13,1
fadein,fadein,,13,14,27,27,81,54,1,7.692308
version,version,,131,133,278,264,465,542,3,1.526718
maven-javadoc-plugin,maven-javadoc-plugin,,5,7,14,12,20,26,3,40
inner-classes,inner-classes,,42,38,82,80,166,162,9,1
function-pointers,function-pointers,,68,61,126,129,298,255,9,1
laravel-mix,laravel-mix,,74,65,136,139,195,275,1,1
fold,fold,,32,20,57,52,118,109,2,1
named,named,,14,1,27,15,36,42,0,1
electron-builder,electron-builder,,81,88,98,169,127,267,1,8.641975
camel-ftp,camel-ftp,,4,6,28,10,30,38,3,50
pillow,pillow,,0,0,0,0,269,0,0,1
printf,printf,,136,117,331,253,623,584,9,1
format-specifiers,format-specifiers,,4,5,13,9,31,22,9,25
monolog,monolog,,18,18,37,36,65,73,4,1
vagrant,vagrant,,141,121,349,262,566,611,4,1
protoc,protoc,,21,21,26,42,34,68,6,1
render,render,,108,101,211,209,394,420,1,1
jekyll,jekyll,,120,153,279,273,577,552,1,27.5
pandoc,pandoc,,54,50,131,104,238,235,0,1
github-flavored-markdown,github-flavored-markdown,,12,8,27,20,61,47,0,1
asciidoc,asciidoc,,12,5,27,17,43,44,3,1
asciidoctor,asciidoctor,,15,9,29,24,41,53,3,1
web-bluetooth,web-bluetooth,,19,12,13,31,15,44,3,1
jar,jar,,314,280,562,594,1212,1156,3,1
manifest,manifest,,75,62,171,137,245,308,3,1
swift-framework,swift-framework,,5,2,8,7,20,15,13,1
module-map,module-map,,2,1,7,3,7,10,13,1
outlook-restapi,outlook-restapi,,19,28,114,47,219,161,8,47.368421
udp,udp,,227,193,437,420,737,857,9,1
multiplexing,multiplexing,,7,3,11,10,21,21,9,1
meteor-blaze,meteor-blaze,,12,13,22,25,152,47,1,8.333333
android-build-type,android-build-type,,7,1,11,8,7,19,3,1
vim-plugin,vim-plugin,,20,19,62,39,75,101,9,1
tern,tern,,1,1,1,2,4,3,9,1
where,where,,116,5,175,121,380,296,4,1
android-sensors,android-sensors,,27,15,57,42,114,99,3,1
ansible,ansible,,690,725,1090,1415,1504,2505,6,5.072464
openam,openam,,8,13,15,21,30,36,3,62.5
opensso,opensso,,0,0,0,0,3,0,3,1
forgerock,forgerock,,1,6,8,7,17,15,3,500
google-dfp,google-dfp,,8,8,40,16,61,56,3,1
double-click-advertising,double-click-advertising,,6,8,15,14,29,29,3,33.333333
custom-rom,custom-rom,,1,5,11,6,15,17,3,400
index-error,index-error,,13,16,51,29,82,80,0,23.076923
oracleforms,oracleforms,,63,36,63,99,136,162,4,1
custom-overlay,custom-overlay,,0,0,1,0,1,1,1,1
tvos,tvos,,41,29,76,70,154,146,13,1
apple-tv,apple-tv,,15,8,28,23,41,51,13,1
sendmail,sendmail,,40,42,96,82,174,178,4,5
undefined,undefined,,125,96,249,221,532,470,1,1
dialogflow,dialogflow,,416,360,916,776,1227,1692,13,1
xss,xss,,99,75,146,174,274,320,4,1
core-audio,core-audio,,16,14,41,30,78,71,13,1
objective-c++,objective-c++,,18,17,34,35,76,69,13,1
avaudiosession,avaudiosession,,26,39,66,65,88,131,13,50
audiounit,audiounit,,5,12,15,17,33,32,13,140
nlohmann-json,nlohmann-json,,8,7,14,15,16,29,9,1
perforce,perforce,,26,24,69,50,166,119,6,1
changelist,changelist,,4,6,3,10,7,13,6,50
gitswarm,gitswarm,,0,0,0,0,3,0,6,1
ember-engines,ember-engines,,2,0,5,2,8,7,1,1
r-package,r-package,,38,43,80,81,160,161,0,13.157895
roxygen2,roxygen2,,20,17,32,37,56,69,0,1
amazon-cognito,amazon-cognito,,327,313,620,640,657,1260,6,1
aws-cognito,aws-cognito,,0,0,20,0,443,20,6,1
command-prompt,command-prompt,,83,88,164,171,368,335,9,6.024096
gwt-openlayers,gwt-openlayers,,0,1,0,1,3,1,1,1
payum,payum,,3,4,6,7,18,13,4,33.333333
angularfire2,angularfire2,,131,105,351,236,1065,587,13,1
exception-handling,exception-handling,,0,0,641,0,1183,641,3,1
gevent,gevent,,29,26,36,55,83,91,0,1
virus,virus,,5,11,28,16,53,44,4,120
testng,testng,,242,186,464,428,909,892,3,1
url-rewrite-module,url-rewrite-module,,16,13,33,29,76,62,8,1
webclient,webclient,,73,48,132,121,223,253,8,1
webproxy,webproxy,,1,2,8,3,8,11,8,100
defaultnetworkcredentials,defaultnetworkcredentials,,0,1,0,1,1,1,8,1
ntlm-authentication,ntlm-authentication,,9,13,17,22,31,39,8,44.444444
inject,inject,,19,10,41,29,69,70,3,1
serenity-bdd,serenity-bdd,,59,27,73,86,88,159,3,1
soap-client,soap-client,,81,63,152,144,221,296,3,1
g++,g++,,188,178,359,366,648,725,9,1
spring-tool-suite,spring-tool-suite,,37,41,77,78,137,155,3,10.810811
linux-mint,linux-mint,,24,31,88,55,154,143,9,29.166667
sign,sign,,24,23,54,47,106,101,6,1
digital-certificate,digital-certificate,,0,0,0,0,47,0,6,1
visual-studio-2013,visual-studio-2013,,65,46,130,111,402,241,8,1
spinning,spinning,,0,1,1,1,2,2,1,1
large-files,large-files,,26,25,40,51,93,91,0,1
resume-download,resume-download,,1,0,2,1,4,3,4,1
azure-search,azure-search,,57,42,94,99,166,193,8,1
mapbox-gl-js,mapbox-gl-js,,98,85,163,183,324,346,1,1
uwsgi,uwsgi,,84,93,195,177,286,372,0,10.714286
bitbucket-pipelines,bitbucket-pipelines,,75,61,106,136,182,242,6,1
stripe.js,stripe.js,,0,0,0,0,108,0,4,1
substring,substring,,190,143,351,333,795,684,0,1
onunload,onunload,,3,1,2,4,10,6,1,1
large-data,large-data,,37,60,90,97,180,187,0,62.162162
nsoperation,nsoperation,,2,4,7,6,27,13,13,100
nsoperationqueue,nsoperationqueue,,8,6,13,14,52,27,13,1
gstreamer,gstreamer,,96,123,206,219,309,425,13,28.125
rtsp,rtsp,,73,56,106,129,178,235,13,1
framebuffer,framebuffer,,22,24,42,46,87,88,9,9.090909
uilabel,uilabel,,84,83,186,167,547,353,13,1
parsexml,parsexml,,6,2,4,8,9,12,3,1
admin-on-rest,admin-on-rest,,13,6,32,19,169,51,1,1
pause,pause,,21,16,39,37,71,76,3,1
typecasting-operator,typecasting-operator,,2,4,9,6,20,15,9,100
jurassic,jurassic,,1,0,2,1,1,3,8,1
wxwidgets,wxwidgets,,35,28,75,63,231,138,9,1
panels,panels,,0,0,0,0,18,0,1,1
embedded-jetty,embedded-jetty,,30,26,67,56,98,123,3,1
spark-java,spark-java,,12,11,29,23,81,52,3,1
waffle,waffle,,2,3,4,5,12,9,3,50
tox,tox,,21,16,26,37,65,63,0,1
base58,base58,,2,2,4,4,6,8,6,1
repeat,repeat,,57,48,89,105,247,194,0,1
taxonomy-terms,taxonomy-terms,,47,17,29,64,45,93,4,1
orchestration,orchestration,,8,14,24,22,48,46,6,75
gtk-rs,gtk-rs,,3,6,2,9,3,11,9,100
expressionengine,expressionengine,,3,2,8,5,16,13,1,1
adobe-edge,adobe-edge,,0,0,2,0,2,2,1,1
resolution,resolution,,34,30,74,64,122,138,3,1
css-grid,css-grid,,335,252,566,587,981,1153,1,1
relative-import,relative-import,,4,0,2,4,9,6,0,1
google-slides,google-slides,,10,16,31,26,43,57,5,60
cellular-network,cellular-network,,9,5,13,14,26,27,3,1
echo,echo,,87,70,198,157,401,355,4,1
explode,explode,,26,34,62,60,143,122,4,30.769231
file-get-contents,file-get-contents,,37,27,86,64,172,150,4,1
tcpdf,tcpdf,,55,56,80,111,166,191,4,1.818182
xdebug,xdebug,,86,56,159,142,277,301,4,1
sqlcommand,sqlcommand,,18,14,31,32,50,63,8,1
oledbcommand,oledbcommand,,9,10,19,19,24,38,8,11.111111
executenonquery,executenonquery,,2,4,5,6,18,11,8,100
isqlquery,isqlquery,,2,0,0,2,4,2,4,1
subset,subset,,162,149,305,311,706,616,0,1
ambari,ambari,,22,41,58,63,122,121,2,86.363636
varnish,varnish,,24,23,57,47,134,104,4,1
solrcloud,solrcloud,,42,53,75,95,169,170,2,26.190476
templatetag,templatetag,,0,0,0,0,3,0,0,1
minitest,minitest,,26,23,49,49,132,98,12,1
rest-client,rest-client,,29,28,55,57,80,112,12,1
webmock,webmock,,2,3,11,5,13,16,12,50
qtranslator,qtranslator,,1,2,1,3,7,4,9,100
genfromtxt,genfromtxt,,8,5,15,13,38,28,0,1
qtablewidget,qtablewidget,,31,36,51,67,113,118,0,16.129032
oozie,oozie,,39,42,87,81,187,168,2,7.692308
system.net.sockets,system.net.sockets,,1,1,5,2,9,7,8,1
google-cloud-datastore,google-cloud-datastore,,83,63,238,146,568,384,6,1
eclipse-jdt,eclipse-jdt,,5,11,19,16,44,35,3,120
admin,admin,,72,60,170,132,284,302,4,1
linker,linker,,212,197,393,409,817,802,9,1
ld,ld,,61,44,113,105,184,218,9,1
gruntjs,gruntjs,,46,36,139,82,345,221,1,1
compass,compass,,8,8,22,16,54,38,1,1
kernel-module,kernel-module,,47,44,74,91,155,165,9,1
spree,spree,,26,18,50,44,87,94,12,1
httpoison,httpoison,,4,2,5,6,15,11,2,1
equals,equals,,38,35,93,73,187,166,3,1
python-3.5,python-3.5,,88,78,203,166,647,369,0,1
onenote,onenote,,15,12,37,27,54,64,8,1
onenote-api,onenote-api,,16,10,19,26,45,45,8,1
microsoft-dynamics,microsoft-dynamics,,78,100,187,178,321,365,8,28.205128
metricbeat,metricbeat,,14,14,21,28,16,49,6,1
poisson,poisson,,31,18,36,49,64,85,0,1
compiler-construction,compiler-construction,,92,58,195,150,357,345,9,1
machine-language,machine-language,,2,1,0,3,9,3,9,1
android-glide,android-glide,,135,86,196,221,484,417,3,1
sdl,sdl,,74,55,127,129,256,256,9,1
implicit-cast,implicit-cast,,1,0,2,1,6,3,9,1
hana,hana,,74,47,132,121,272,253,5,1
wildfly,wildfly,,215,218,449,433,757,882,3,1.395349
addition,addition,,26,21,56,47,107,103,0,1
tcpclient,tcpclient,,52,35,113,87,197,200,8,1
info.plist,info.plist,,16,14,52,30,62,82,13,1
build-settings,build-settings,,0,4,7,4,13,11,13,300
timing,timing,,22,21,54,43,81,97,0,1
openssl,openssl,,445,379,876,824,1306,1700,6,1
model-view-controller,model-view-controller,,1007,866,1587,1873,2340,3460,8,1
viewmodel,viewmodel,,96,114,211,210,287,421,8,18.75
nullpointerexception,nullpointerexception,,223,230,553,453,1212,1006,3,3.139013
preferenceactivity,preferenceactivity,,9,3,9,12,28,21,3,1
setcontentview,setcontentview,,4,4,5,8,24,13,3,1
boost-filesystem,boost-filesystem,,8,4,9,12,23,21,9,1
django-import-export,django-import-export,,16,12,35,28,32,63,0,1
spring-security-oauth2,spring-security-oauth2,,162,157,302,319,467,621,3,1
netflix-feign,netflix-feign,,18,0,31,18,49,49,3,1
react-server,react-server,,2,1,1,3,9,4,1,1
ember-components,ember-components,,0,1,4,1,12,5,1,1
wamp,wamp,,69,63,167,132,384,299,4,1
windows-server-2012-r2,windows-server-2012-r2,,71,28,126,99,205,225,8,1
core-bluetooth,core-bluetooth,,53,44,102,97,213,199,13,1
gfortran,gfortran,,62,60,119,122,280,241,9,1
fortran2003,fortran2003,,2,2,2,4,10,6,9,1
url-routing,url-routing,,59,61,111,120,282,231,4,3.389831
android-logcat,android-logcat,,0,0,0,0,81,0,3,1
jmeter-3.2,jmeter-3.2,,11,8,22,19,157,41,3,1
continuous-deployment,continuous-deployment,,115,149,200,264,384,464,6,29.565217
master-slave,master-slave,,18,20,37,38,80,75,4,11.111111
predefined-variables,predefined-variables,,0,1,4,1,5,5,9,1
write-host,write-host,,1,2,3,3,4,6,8,100
dask,dask,,238,200,360,438,526,798,0,1
slurm,slurm,,68,53,83,121,120,204,0,1
dask-distributed,dask-distributed,,68,57,118,125,163,243,0,1
if-constexpr,if-constexpr,,12,3,16,15,26,31,9,1
sentry,sentry,,51,43,91,94,124,185,1,1
raven,raven,,0,2,8,2,22,10,1,100
ms-access-2016,ms-access-2016,,79,54,169,133,292,302,5,1
ms-access-forms,ms-access-forms,,16,22,12,38,25,50,5,37.5
android-livedata,android-livedata,,191,201,366,392,379,758,3,5.235602
ember-cli,ember-cli,,62,18,70,80,145,150,1,1
broccolijs,broccolijs,,2,1,7,3,8,10,1,1
hierarchical-clustering,hierarchical-clustering,,43,33,66,76,128,142,0,1
sample-size,sample-size,,0,6,5,6,6,11,0,500
sanic,sanic,,9,18,22,27,38,49,0,100
compiler-optimization,compiler-optimization,,69,66,145,135,235,280,9,1
ngx-datatable,ngx-datatable,,42,30,71,72,137,143,1,1
jmeter-plugins,jmeter-plugins,,40,41,92,81,212,173,3,2.5
mysql-python,mysql-python,,95,66,169,161,311,330,0,1
pi,pi,,19,10,32,29,44,61,0,1
c#-7.0,c#-7.0,,22,6,40,28,110,68,8,1
combinations,combinations,,125,129,279,254,566,533,0,3.2
itertools,itertools,,75,75,160,150,311,310,0,1
cbind,cbind,,6,10,23,16,62,39,0,66.666667
pyserial,pyserial,,85,73,133,158,222,291,0,1
android-permissions,android-permissions,,127,119,236,246,387,482,3,1
parent,parent,,29,36,82,65,152,147,1,24.137931
android-relativelayout,android-relativelayout,,30,11,93,41,218,134,3,1
baseline,baseline,,8,7,10,15,22,25,0,1
scala-collections,scala-collections,,22,25,58,47,182,105,2,13.636364
obsolete,obsolete,,3,3,4,6,14,10,8,1
domdocument,domdocument,,21,44,96,65,159,161,4,109.52381
wkhtmltopdf,wkhtmltopdf,,59,48,132,107,203,239,8,1
today-extension,today-extension,,9,6,19,15,51,34,13,1
ios8-today-widget,ios8-today-widget,,0,0,1,0,2,1,13,1
qtableview,qtableview,,25,26,58,51,113,109,9,4
reverse-proxy,reverse-proxy,,185,172,380,357,542,737,6,1
response,response,,154,136,264,290,473,554,4,1
http-status-codes,http-status-codes,,35,34,74,69,129,143,4,1
terraform,terraform,,420,513,649,933,802,1582,6,22.142857
hcl,hcl,,3,5,6,8,17,14,6,66.666667
online-store,online-store,,1,2,0,3,2,3,4,100
deprecated,deprecated,,55,47,81,102,147,183,3,1
java-9,java-9,,52,31,129,83,863,212,3,1
jdeprscan,jdeprscan,,0,1,0,1,3,1,3,1
drjava,drjava,,6,2,16,8,20,24,3,1
vala,vala,,16,17,37,33,75,70,9,6.25
css-selectors,css-selectors,,332,333,597,665,1035,1262,1,1
capybara,capybara,,76,61,147,137,406,284,12,1
cpprest-sdk,cpprest-sdk,,16,6,24,22,56,46,9,1
django-signals,django-signals,,22,22,40,44,63,84,0,1
weblogic-10.x,weblogic-10.x,,9,10,22,19,27,41,3,11.111111
nuget-package-restore,nuget-package-restore,,24,27,39,51,127,90,8,12.5
plesk,plesk,,56,46,110,102,188,212,4,1
java-stream,java-stream,,463,409,933,872,1507,1805,3,1
python-2.6,python-2.6,,8,17,41,25,79,66,0,112.5
tabmenu,tabmenu,,1,0,1,1,4,2,13,1
ng-pattern,ng-pattern,,0,1,7,1,15,8,1,1
twilio,twilio,,268,299,514,567,1004,1081,13,11.567164
twilio-api,twilio-api,,91,89,169,180,374,349,13,1
asterisk-ari,asterisk-ari,,4,1,1,5,10,6,13,1
soundplayer,soundplayer,,3,0,6,3,7,9,8,1
significance,significance,,6,6,11,12,21,23,0,1
hypothesis-test,hypothesis-test,,19,12,26,31,32,57,0,1
statistical-test,statistical-test,,7,14,9,21,10,30,0,100
fibonacci,fibonacci,,41,26,99,67,194,166,0,1
prepend,prepend,,9,3,13,12,29,25,1,1
eventqueue,eventqueue,,1,2,3,3,8,6,3,100
tokbox,tokbox,,16,14,48,30,108,78,13,1
bitmapfactory,bitmapfactory,,6,3,17,9,29,26,3,1
akka-stream,akka-stream,,93,40,149,133,333,282,2,1
fs2,fs2,,5,3,14,8,26,22,2,1
windows-applications,windows-applications,,0,0,0,0,75,0,8,1
cubic-spline,cubic-spline,,9,7,14,16,22,30,0,1
lazy-evaluation,lazy-evaluation,,44,40,80,84,172,164,2,1
aspose,aspose,,13,15,39,28,106,67,8,15.384615
aspose.pdf,aspose.pdf,,7,11,8,18,25,26,8,57.142857
volatility,volatility,,2,3,13,5,20,18,0,50
hyper-v,hyper-v,,45,35,120,80,137,200,6,1
sink,sink,,6,9,8,15,20,23,0,50
getdate,getdate,,12,6,6,18,34,24,4,1
fftw,fftw,,22,12,32,34,71,66,0,1
credentials,credentials,,78,65,139,143,217,282,4,1
avr,avr,,40,36,109,76,167,185,9,1
atmega,atmega,,19,14,38,33,79,71,9,1
phantomjs,phantomjs,,85,52,161,137,624,298,3,1
passport.js,passport.js,,259,215,482,474,827,956,1,1
node-inspector,node-inspector,,6,2,7,8,25,15,1,1
jetty,jetty,,96,84,205,180,440,385,3,1
sitecore,sitecore,,57,52,106,109,244,215,8,1
sitecore-mvc,sitecore-mvc,,4,5,8,9,33,17,8,25
split,split,,503,426,905,929,2022,1834,0,1
purrr,purrr,,153,165,300,318,490,618,0,7.843137
unixodbc,unixodbc,,11,17,16,28,55,44,4,54.545455
haproxy,haproxy,,62,67,153,129,221,282,6,8.064516
shopify,shopify,,246,240,442,486,725,928,1,1
liquid,liquid,,101,113,170,214,357,384,1,11.881188
game-engine,game-engine,,57,45,120,102,224,222,8,1
godot,godot,,36,24,44,60,52,104,8,1
gdscript,gdscript,,17,13,26,30,25,56,8,1
array-formulas,array-formulas,,133,339,86,472,143,558,5,154.887218
sql-execution-plan,sql-execution-plan,,26,17,67,43,105,110,4,1
sql-server-linux,sql-server-linux,,4,2,0,6,10,6,4,1
sql-operations-studio,sql-operations-studio,,0,0,3,0,10,3,4,1
laravelcollective,laravelcollective,,19,8,25,27,63,52,4,1
itunesconnect,itunesconnect,,57,45,156,102,463,258,13,1
code-signing-certificate,code-signing-certificate,,19,9,25,28,46,53,13,1
xna,xna,,20,16,52,36,67,88,8,1
vpn,vpn,,170,123,154,293,228,447,6,1
icinga,icinga,,0,2,5,2,15,7,6,100
simple-html-dom,simple-html-dom,,23,18,47,41,119,88,4,1
picturebox,picturebox,,25,24,85,49,169,134,8,1
nextgen-gallery,nextgen-gallery,,0,3,1,3,4,4,4,200
qtranslate-x,qtranslate-x,,2,1,2,3,8,5,4,1
custom-exceptions,custom-exceptions,,4,1,25,5,22,30,3,1
class-extensions,class-extensions,,3,1,5,4,9,9,13,1
objective-c-swift-bridge,objective-c-swift-bridge,,3,2,11,5,22,16,13,1
camel-http,camel-http,,6,5,5,11,13,16,3,1
broadcastreceiver,broadcastreceiver,,152,140,240,292,581,532,3,1
android-service-binding,android-service-binding,,10,12,20,22,34,42,3,20
wildfly-swarm,wildfly-swarm,,5,3,17,8,78,25,3,1
scanf,scanf,,104,77,305,181,565,486,9,1
directshow,directshow,,26,4,28,30,60,58,13,1
webcam-capture,webcam-capture,,6,6,13,12,26,25,0,1
invokemember,invokemember,,1,1,3,2,4,5,8,1
typo3-6.2.x,typo3-6.2.x,,1,3,16,4,73,20,4,200
okhttp,okhttp,,88,73,180,161,352,341,3,1
libvirt,libvirt,,8,9,30,17,49,47,9,12.5
has-one,has-one,,3,2,7,5,26,12,12,1
mvvmfx,mvvmfx,,2,0,1,2,7,3,3,1
spotfire,spotfire,,44,53,83,97,156,180,3,20.454545
httpserver,httpserver,,36,25,68,61,118,129,1,1
morphing,morphing,,1,1,2,2,6,4,1,1
request,request,,535,546,985,1081,1692,2066,4,2.056075
pdf-generation,pdf-generation,,124,137,283,261,452,544,8,10.483871
adobe,adobe,,120,85,209,205,369,414,1,1
sas-ods,sas-ods,,3,1,2,4,10,6,0,1
rails-activerecord,rails-activerecord,,51,51,165,102,366,267,12,1
has-many-through,has-many-through,,13,8,30,21,76,51,12,1
apk,apk,,200,210,368,410,690,778,3,5
iptables,iptables,,36,34,137,70,147,207,9,1
amazon,amazon,,71,54,150,125,320,275,6,1
alexa,alexa,,163,145,397,308,744,705,6,1
cublas,cublas,,2,3,12,5,25,17,0,50
asort,asort,,2,2,0,4,4,4,4,1
double,double,,149,91,280,240,576,520,0,1
array-algorithms,array-algorithms,,8,5,18,13,27,31,0,1
system-calls,system-calls,,80,64,163,144,298,307,9,1
csrf-protection,csrf-protection,,22,5,62,27,138,89,4,1
x-xsrf-token,x-xsrf-token,,2,3,17,5,20,22,4,50
jquery-animate,jquery-animate,,44,35,92,79,245,171,1,1
slickgrid,slickgrid,,14,6,19,20,29,39,1,1
windows-store,windows-store,,6,7,33,13,57,46,8,16.666667
flops,flops,,3,2,5,5,11,10,0,1
google-geocoder,google-geocoder,,19,22,43,41,85,84,1,15.789474
webrequest,webrequest,,31,28,74,59,132,133,8,1
qnetworkrequest,qnetworkrequest,,2,0,6,2,8,8,9,1
format-string,format-string,,4,3,8,7,15,15,9,1
netty,netty,,107,93,217,200,371,417,3,1
protobuf-c,protobuf-c,,10,14,18,24,17,42,6,40
qemu,qemu,,52,58,103,110,186,213,9,11.538462
unique-ptr,unique-ptr,,49,46,83,95,181,178,9,1
gulp-sourcemaps,gulp-sourcemaps,,7,1,7,8,25,15,1,1
woocommerce-bookings,woocommerce-bookings,,10,11,26,21,37,47,4,10
unobtrusive-validation,unobtrusive-validation,,16,21,26,37,69,63,8,31.25
rails-migrations,rails-migrations,,6,10,26,16,64,42,12,66.666667
scatter,scatter,,28,25,47,53,95,100,0,1
unique,unique,,97,110,210,207,502,417,0,13.402062
rust-tokio,rust-tokio,,23,34,50,57,47,107,9,47.826087
last-modified,last-modified,,6,6,12,12,26,24,4,1
expression,expression,,149,150,253,299,508,552,8,1
gulp-notify,gulp-notify,,1,0,0,1,2,1,1,1
aleagpu,aleagpu,,2,0,5,2,23,7,8,1
angular-directive,angular-directive,,71,100,159,171,327,330,1,40.84507
private-members,private-members,,15,10,17,25,41,42,9,1
private-methods,private-methods,,5,6,8,11,18,19,9,20
perl6,perl6,,79,53,115,132,251,247,9,1
printers,printers,,16,11,35,27,43,62,8,1
serializer,serializer,,45,32,74,77,100,151,0,1
sails.js,sails.js,,71,95,209,166,524,375,1,33.802817
sails-mongo,sails-mongo,,9,11,11,20,47,31,1,22.222222
logcat,logcat,,25,36,74,61,127,135,3,44
asp.net-mvc-3,asp.net-mvc-3,,15,11,37,26,143,63,8,1
.net-4.6,.net-4.6,,11,5,23,16,52,39,8,1
uipickerview,uipickerview,,52,40,91,92,239,183,13,1
webserver,webserver,,144,149,313,293,542,606,4,3.472222
haskell-snap-framework,haskell-snap-framework,,1,0,2,1,4,3,2,1
extern,extern,,16,18,35,34,87,69,9,12.5
cygwin,cygwin,,93,66,233,159,445,392,9,1
visual-studio-cordova,visual-studio-cordova,,13,7,25,20,82,45,1,1
gwt,gwt,,69,54,180,123,364,303,3,1
wai-aria,wai-aria,,49,30,66,79,126,145,13,1
quill,quill,,46,54,90,100,157,190,1,17.391304
adb,adb,,171,204,357,375,530,732,3,19.298246
driver,driver,,132,135,281,267,382,548,9,2.272727
git-clone,git-clone,,37,23,64,60,100,124,6,1
threadpoolexecutor,threadpoolexecutor,,27,22,60,49,101,109,3,1
i2c,i2c,,75,55,101,130,165,231,9,1
spi,spi,,44,46,71,90,132,161,9,4.545455
asynchronous-javascript,asynchronous-javascript,,5,5,4,10,5,14,1,1
freebasic,freebasic,,0,0,1,0,5,1,5,1
any,any,,16,21,28,37,57,65,0,31.25
ibm-mq,ibm-mq,,86,66,131,152,346,283,3,1
comparator,comparator,,61,50,135,111,260,246,3,1
availability-zone,availability-zone,,0,4,4,4,6,8,6,300
subquery,subquery,,160,163,380,323,794,703,4,1.875
alias,alias,,102,88,165,190,354,355,9,1
yarnpkg,yarnpkg,,188,159,295,347,572,642,1,1
video-processing,video-processing,,74,57,142,131,228,273,13,1
obfuscation,obfuscation,,53,44,84,97,177,181,3,1
deobfuscation,deobfuscation,,8,6,12,14,25,26,3,1
unminify,unminify,,0,0,1,0,2,1,1,1
bitmap,bitmap,,177,169,361,346,890,707,3,1
access-violation,access-violation,,16,13,37,29,91,66,9,1
less,less,,88,64,196,152,383,348,1,1
css-modules,css-modules,,21,28,56,49,82,105,1,33.333333
ipython-notebook,ipython-notebook,,0,0,0,0,54,0,0,1
polymer-1.0,polymer-1.0,,14,10,31,24,96,55,1,1
polymer-2.x,polymer-2.x,,22,15,57,37,353,94,1,1
google-places,google-places,,45,48,73,93,108,166,1,6.666667
ipv6,ipv6,,36,28,73,64,206,137,9,1
subnet,subnet,,20,17,44,37,54,81,9,1
x509certificate2,x509certificate2,,22,23,50,45,96,95,8,4.545455
azure-app-service-envrmnt,azure-app-service-envrmnt,,19,17,33,36,76,69,8,1
sparklyr,sparklyr,,47,54,95,101,202,196,0,14.893617
html5-canvas,html5-canvas,,293,300,587,593,922,1180,1,2.389078
hangfire,hangfire,,52,37,88,89,152,177,8,1
avaudioengine,avaudioengine,,18,32,38,50,63,88,13,77.777778
avaudioplayernode,avaudioplayernode,,5,13,10,18,16,28,13,160
layout-manager,layout-manager,,52,18,82,70,155,152,3,1
gridbaglayout,gridbaglayout,,22,7,23,29,72,52,3,1
voxel,voxel,,9,17,16,26,28,42,0,88.888889
3d-modelling,3d-modelling,,8,5,18,13,44,31,0,1
scalapack,scalapack,,4,2,0,6,5,6,9,1
sml,sml,,30,8,72,38,150,110,2,1
smlnj,smlnj,,21,4,40,25,66,65,2,1
swrevealviewcontroller,swrevealviewcontroller,,4,3,10,7,50,17,13,1
nsdata,nsdata,,8,21,19,29,85,48,13,162.5
rtp,rtp,,28,32,57,60,94,117,13,14.285714
wowza,wowza,,4,7,28,11,52,39,13,75
sticky,sticky,,63,47,138,110,176,248,1,1
graph-tool,graph-tool,,13,12,21,25,34,46,0,1
django-urls,django-urls,,104,79,144,183,278,327,0,1
iterable-unpacking,iterable-unpacking,,8,10,16,18,33,34,0,25
pipenv,pipenv,,73,85,153,158,185,311,0,16.438356
clojurescript,clojurescript,,29,55,56,84,201,140,2,89.655172
webjars,webjars,,6,4,6,10,29,16,3,1
testng-eclipse,testng-eclipse,,12,12,25,24,58,49,3,1
surface,surface,,41,30,64,71,115,135,0,1
ubuntu-12.04,ubuntu-12.04,,2,1,9,3,21,12,9,1
powerdesigner,powerdesigner,,6,4,5,10,12,15,4,1
pentaho-data-integration,pentaho-data-integration,,48,35,89,83,168,172,4,1
session-variables,session-variables,,45,49,109,94,279,203,4,8.888889
session-state,session-state,,23,26,50,49,74,99,8,13.043478
maquette,maquette,,0,0,0,0,3,0,1,1
dfs,dfs,,8,8,30,16,21,46,0,1
clipboard,clipboard,,86,56,161,142,260,303,1,1
fgets,fgets,,37,25,78,62,157,140,9,1
tabular,tabular,,19,19,102,38,164,140,4,1
vi,vi,,22,14,42,36,123,78,9,1
collapse,collapse,,32,30,83,62,143,145,1,1
folding,folding,,9,1,14,10,22,24,9,1
code-folding,code-folding,,6,1,4,7,18,11,13,1
homestead,homestead,,49,54,85,103,200,188,4,10.204082
node-redis,node-redis,,23,6,37,29,66,66,3,1
wix,wix,,109,119,250,228,607,478,8,9.174312
digital-signature,digital-signature,,71,71,136,142,270,278,6,1
graphviz,graphviz,,77,60,111,137,234,248,0,1
informatica,informatica,,31,50,65,81,110,146,4,61.290323
informatica-powercenter,informatica-powercenter,,21,29,46,50,69,96,4,38.095238
cross-compiling,cross-compiling,,103,90,183,193,347,376,9,1
wildcard-subdomain,wildcard-subdomain,,10,12,24,22,41,46,4,20
stdin,stdin,,72,49,152,121,280,273,9,1
child-process,child-process,,71,81,142,152,246,294,1,14.084507
telegram,telegram,,134,151,274,285,712,559,0,12.686567
php-telegram-bot,php-telegram-bot,,15,6,20,21,78,41,0,1
stringr,stringr,,79,72,153,151,311,304,0,1
nsimageview,nsimageview,,7,0,3,7,13,10,13,1
jsdoc,jsdoc,,43,42,79,85,145,164,1,1
sql-server-2008-r2,sql-server-2008-r2,,87,54,228,141,482,369,4,1
justify,justify,,2,4,7,6,22,13,1,100
text-justify,text-justify,,3,0,2,3,5,5,1,1
nstextview,nstextview,,13,10,34,23,39,57,13,1
nssplitview,nssplitview,,0,2,3,2,6,5,13,100
agent,agent,,17,23,43,40,107,83,3,35.294118
multi-agent,multi-agent,,4,4,10,8,24,18,3,1
django-forms,django-forms,,559,541,1064,1100,1807,2164,0,1
loopbackjs,loopbackjs,,129,105,216,234,393,450,1,1
strongloop,strongloop,,34,16,18,50,103,68,1,1
loopback,loopback,,86,87,172,173,244,345,1,1.162791
plantuml,plantuml,,9,9,12,18,24,30,3,1
survey,survey,,33,27,56,60,110,116,0,1
key-value,key-value,,58,52,150,110,224,260,0,1
sharepoint-2010,sharepoint-2010,,24,25,69,49,144,118,8,4.166667
sharepoint-2013,sharepoint-2013,,88,88,234,176,394,410,8,1
thermal-printer,thermal-printer,,28,22,43,50,69,93,3,1
escpos,escpos,,19,20,24,39,37,63,3,5.263158
multibyte,multibyte,,3,2,2,5,13,7,0,1
jitpack,jitpack,,6,7,25,13,21,38,3,16.666667
printdialog,printdialog,,10,2,6,12,10,18,8,1
xpsdocument,xpsdocument,,1,1,2,2,7,4,8,1
hashmap,hashmap,,311,254,615,565,1244,1180,3,1
pgp,pgp,,22,20,63,42,68,105,6,1
openpgp,openpgp,,14,9,17,23,25,40,6,1
char,char,,214,159,487,373,865,860,9,1
dotnetify,dotnetify,,1,0,1,1,2,2,8,1
setuptools,setuptools,,82,84,151,166,299,317,0,2.439024
read-the-docs,read-the-docs,,9,16,23,25,58,48,0,77.777778
saucelabs,saucelabs,,10,13,28,23,48,51,3,30
qaf,qaf,,8,4,20,12,14,32,3,1
instruments,instruments,,18,19,19,37,43,56,13,5.555556
disk,disk,,28,19,64,47,86,111,9,1
limit,limit,,77,57,144,134,241,278,4,1
signedxml,signedxml,,2,1,5,3,7,8,8,1
content-security-policy,content-security-policy,,67,72,136,139,238,275,1,7.462687
evaluate,evaluate,,9,10,20,19,34,39,0,11.111111
rsa,rsa,,156,142,284,298,575,582,6,1
padding,padding,,57,54,85,111,258,196,1,1
avplayer,avplayer,,83,81,172,164,341,336,13,1
appdelegate,appdelegate,,47,29,70,76,172,146,13,1
case-statement,case-statement,,12,10,19,22,39,41,4,1
hm-10,hm-10,,7,1,7,8,23,15,3,1
clozure-cl,clozure-cl,,1,3,7,4,6,11,0,200
remote-server,remote-server,,46,43,70,89,200,159,9,1
background-image,background-image,,93,67,185,160,412,345,1,1
keydown,keydown,,25,20,43,45,80,88,1,1
mirth,mirth,,8,4,19,12,45,31,14,1
url-redirection,url-redirection,,165,34,307,199,520,506,4,1
mapbox-gl,mapbox-gl,,55,38,77,93,135,170,1,1
cgrect,cgrect,,8,4,20,12,42,32,13,1
rvm,rvm,,26,17,62,43,125,105,12,1
ruby-2.3,ruby-2.3,,0,4,3,4,12,7,12,300
keyerror,keyerror,,26,19,54,45,121,99,0,1
libgdx,libgdx,,155,114,321,269,816,590,3,1
nio,nio,,60,43,100,103,188,203,3,1
randomaccessfile,randomaccessfile,,8,2,16,10,28,26,3,1
django-authentication,django-authentication,,48,38,86,86,125,172,0,1
powershell-core,powershell-core,,25,22,40,47,33,87,8,1
ringtonemanager,ringtonemanager,,4,4,9,8,13,17,3,1
dagger-2,dagger-2,,160,137,331,297,671,628,3,1
bean-validation,bean-validation,,34,44,97,78,148,175,3,29.411765
rank,rank,,40,36,77,76,161,153,4,1
linux-device-driver,linux-device-driver,,86,99,200,185,361,385,9,15.116279
google-adwords,google-adwords,,56,53,138,109,209,247,5,1
calculated-columns,calculated-columns,,57,42,77,99,190,176,4,1
semantic-ui-css,semantic-ui-css,,2,1,2,3,12,5,1,1
ng2-semantic-ui,ng2-semantic-ui,,1,1,3,2,5,5,1,1
bearer-token,bearer-token,,57,63,85,120,136,205,8,10.526316
text-files,text-files,,122,84,246,206,472,452,0,1
zoom,zoom,,85,103,159,188,285,347,1,21.176471
pan,pan,,9,10,24,19,34,43,1,11.111111
delayed-job,delayed-job,,11,11,30,22,58,52,12,1
infinite-loop,infinite-loop,,59,37,106,96,274,202,0,1
android-ndk,android-ndk,,187,213,448,400,958,848,3,13.903743
http-post,http-post,,146,137,288,283,634,571,4,1
single-page-application,single-page-application,,135,154,312,289,521,601,1,14.074074
google-compute-engine,google-compute-engine,,147,179,534,326,889,860,6,21.768707
covariance,covariance,,38,41,83,79,147,162,0,7.894737
eigenvalue,eigenvalue,,33,16,35,49,70,84,0,1
label,label,,205,202,419,407,717,826,0,1
multiline,multiline,,29,40,65,69,133,134,0,37.931034
custom-renderer,custom-renderer,,11,15,41,26,78,67,8,36.363636
avx512,avx512,,8,11,21,19,29,40,9,37.5
rselenium,rselenium,,50,44,53,94,96,147,0,1
android-wifi,android-wifi,,35,30,94,65,156,159,3,1
python-2.x,python-2.x,,79,66,196,145,341,341,0,1
gps,gps,,137,102,251,239,510,490,3,1
tidyr,tidyr,,153,122,251,275,542,526,0,1
reshape2,reshape2,,29,28,42,57,128,99,0,1
backgroundworker,backgroundworker,,24,25,59,49,137,108,8,4.166667
filesystemwatcher,filesystemwatcher,,23,21,39,44,81,83,8,1
responsive-images,responsive-images,,19,18,36,37,60,73,1,1
magento-2.0,magento-2.0,,11,5,18,16,21,34,4,1
magento2.0.2,magento2.0.2,,0,1,1,1,3,2,4,1
magento2.1,magento2.1,,10,3,21,13,81,34,4,1
hql,hql,,70,65,170,135,369,305,3,1
sqlplus,sqlplus,,70,67,125,137,257,262,4,1
python-multithreading,python-multithreading,,149,147,242,296,426,538,0,1
minikube,minikube,,106,122,187,228,309,415,6,15.09434
odata,odata,,206,223,367,429,643,796,8,8.252427
swap,swap,,29,40,75,69,182,144,9,37.931034
rectangles,rectangles,,17,27,56,44,124,100,0,58.823529
mouseover,mouseover,,23,16,51,39,106,90,1,1
delphi-7,delphi-7,,14,23,44,37,105,81,9,64.285714
flask-restful,flask-restful,,73,75,117,148,196,265,0,2.739726
flurl,flurl,,9,8,27,17,29,44,8,1
ssrs-2012,ssrs-2012,,118,101,265,219,525,484,4,1
angular-bootstrap,angular-bootstrap,,7,7,34,14,51,48,1,1
graphql-js,graphql-js,,70,81,143,151,313,294,1,15.714286
lookahead,lookahead,,9,0,20,9,35,29,0,1
negative-lookahead,negative-lookahead,,5,1,16,6,27,22,0,1
steganography,steganography,,8,7,16,15,37,31,0,1
bar-chart,bar-chart,,206,179,410,385,721,795,0,1
record,record,,63,45,97,108,169,205,4,1
correctness,correctness,,5,2,7,7,11,14,0,1
jestjs,jestjs,,1118,1069,1898,2187,1711,4085,1,1
compiler-flags,compiler-flags,,10,3,20,13,30,33,9,1
penetration-testing,penetration-testing,,11,15,20,26,34,46,4,36.363636
stack-smash,stack-smash,,4,3,10,7,15,17,9,1
bioconductor,bioconductor,,22,16,43,38,79,81,0,1
blurry,blurry,,10,8,10,18,28,28,1,1
xjc,xjc,,19,11,19,30,44,49,3,1
django-celery,django-celery,,41,43,72,84,138,156,0,4.878049
react-bootstrap,react-bootstrap,,137,145,181,282,283,463,1,5.839416
konvajs,konvajs,,31,43,89,74,107,163,1,38.709677
sidekiq,sidekiq,,52,40,87,92,184,179,12,1
jpanel,jpanel,,105,49,170,154,363,324,3,1
grid-layout,grid-layout,,53,48,95,101,210,196,1,1
border-layout,border-layout,,2,1,13,3,17,16,3,1
verilog,verilog,,116,86,225,202,435,427,9,1
createuser,createuser,,0,1,5,1,12,6,4,1
append,append,,216,182,440,398,838,838,0,1
grafana,grafana,,190,218,328,408,385,736,6,14.736842
django-permissions,django-permissions,,13,15,16,28,38,44,0,15.384615
datagridcomboboxcolumn,datagridcomboboxcolumn,,10,12,10,22,16,32,8,20
playframework-2.3,playframework-2.3,,6,2,8,8,22,16,2,1
glmulti,glmulti,,1,0,5,1,6,6,0,1
network-programming,network-programming,,168,139,287,307,688,594,9,1
objectmapper,objectmapper,,46,44,88,90,181,178,3,1
href,href,,88,91,183,179,339,362,1,3.409091
naudio,naudio,,35,38,59,73,121,132,8,8.571429
bootstrap-ui,bootstrap-ui,,1,1,4,2,9,6,1,1
weld2,weld2,,0,1,1,1,5,2,3,1
conditional-compilation,conditional-compilation,,10,18,17,28,44,45,9,80
android-textwatcher,android-textwatcher,,9,8,10,17,35,27,3,1
google-speech-api,google-speech-api,,62,57,116,119,184,235,6,1
netflix-eureka,netflix-eureka,,98,85,169,183,282,352,3,1
wiremock,wiremock,,42,38,48,80,93,128,3,1
cocoa-touch,cocoa-touch,,81,52,151,133,331,284,13,1
data-synchronization,data-synchronization,,10,12,18,22,39,40,4,20
pcre,pcre,,75,70,138,145,209,283,0,1
subclass,subclass,,75,50,123,125,264,248,9,1
threshold,threshold,,16,14,35,30,72,65,0,1
shiny-server,shiny-server,,52,63,107,115,228,222,0,21.153846
facebook-likebox,facebook-likebox,,0,0,0,0,4,0,4,1
prototypal-inheritance,prototypal-inheritance,,7,9,18,16,58,34,1,28.571429
django-haystack,django-haystack,,22,12,18,34,58,52,0,1
jsgrid,jsgrid,,11,9,25,20,51,45,1,1
windows-client,windows-client,,0,0,0,0,1,0,6,1
return,return,,240,198,399,438,901,837,0,1
mathematical-morphology,mathematical-morphology,,2,1,2,3,4,5,0,1
qpainter,qpainter,,18,13,35,31,54,66,9,1
qlabel,qlabel,,21,16,46,37,87,83,0,1
html-framework-7,html-framework-7,,60,44,94,104,172,198,1,1
objective-c-blocks,objective-c-blocks,,13,10,25,23,60,48,13,1
spring-data-solr,spring-data-solr,,4,5,12,9,29,21,2,25
netbeans-8,netbeans-8,,59,38,133,97,264,230,3,1
apache-commons,apache-commons,,21,29,66,50,127,116,3,38.095238
qt-creator,qt-creator,,76,72,169,148,355,317,9,1
restangular,restangular,,2,4,5,6,26,11,1,100
angular2-formbuilder,angular2-formbuilder,,4,2,17,6,56,23,1,1
ode,ode,,64,45,105,109,161,214,0,1
voronoi,voronoi,,15,15,23,30,39,53,0,1
null-check,null-check,,6,3,8,9,13,17,3,1
generator,generator,,144,140,320,284,561,604,0,1
jframe,jframe,,178,99,295,277,611,572,3,1
bufferedimage,bufferedimage,,25,13,49,38,103,87,3,1
graphics2d,graphics2d,,25,20,41,45,109,86,3,1
stdio,stdio,,20,16,52,36,69,88,9,1
border,border,,75,67,162,142,396,304,1,1
cascade,cascade,,23,21,36,44,110,80,3,1
directoryinfo,directoryinfo,,5,0,5,5,13,10,8,1
ziparchive,ziparchive,,29,11,58,40,72,98,4,1
led,led,,15,18,31,33,68,64,9,20
views,views,,0,0,0,0,268,0,4,1
nskeyedarchiver,nskeyedarchiver,,6,5,21,11,43,32,13,1
nskeyedunarchiver,nskeyedunarchiver,,5,0,14,5,24,19,13,1
refactoring-databases,refactoring-databases,,1,0,0,1,3,1,4,1
suds,suds,,7,6,23,13,31,36,0,1
web-push,web-push,,34,29,84,63,86,147,13,1
flatbuffers,flatbuffers,,16,15,29,31,45,60,9,1
quaternions,quaternions,,37,35,72,72,126,144,8,1
raycasting,raycasting,,40,28,71,68,134,139,8,1
completion,completion,,9,6,18,15,28,33,13,1
repeater,repeater,,19,10,63,29,143,92,8,1
linkbutton,linkbutton,,2,2,7,4,11,11,8,1
thumbnails,thumbnails,,29,39,81,68,152,149,4,34.482759
android-textinputlayout,android-textinputlayout,,28,34,44,62,100,106,3,21.428571
function-approximation,function-approximation,,8,12,2,20,12,22,0,50
anypoint-studio,anypoint-studio,,46,35,68,81,98,149,14,1
dataweave,dataweave,,66,53,70,119,96,189,14,1
models,models,,13,10,9,23,276,32,0,1
atom-editor,atom-editor,,116,102,280,218,500,498,0,1
persistent-volume-claims,persistent-volume-claims,,8,9,14,17,24,31,6,12.5
statefulset,statefulset,,7,2,11,9,27,20,6,1
rbind,rbind,,31,23,53,54,88,107,0,1
huawei,huawei,,29,18,58,47,65,105,3,1
twitter-bootstrap-tooltip,twitter-bootstrap-tooltip,,1,3,10,4,28,14,1,200
mailchimp,mailchimp,,68,51,163,119,211,282,4,1
google-form,google-form,,99,101,158,200,254,358,5,2.020202
google-form-quiz,google-form-quiz,,5,5,10,10,11,20,5,1
r-markdown,r-markdown,,380,327,670,707,1185,1377,0,1
shadowing,shadowing,,5,5,3,10,14,13,9,1
autofac,autofac,,93,109,183,202,402,385,8,17.204301
nservicebus,nservicebus,,12,10,30,22,87,52,8,1
webpack-hmr,webpack-hmr,,14,14,26,28,68,54,1,1
sigabrt,sigabrt,,20,14,25,34,74,59,13,1
erase,erase,,10,10,19,20,51,39,9,1
birt,birt,,22,24,73,46,114,119,3,9.090909
solaris-10,solaris-10,,3,1,11,4,30,15,9,1
maximo,maximo,,10,18,32,28,45,60,3,80
ftpwebrequest,ftpwebrequest,,6,7,14,13,59,27,8,16.666667
borderpane,borderpane,,3,3,8,6,15,14,3,1
jstl,jstl,,81,66,134,147,271,281,3,1
inner-join,inner-join,,110,93,259,203,547,462,4,1
masking,masking,,25,29,57,54,91,111,0,16
shinydashboard,shinydashboard,,172,126,232,298,383,530,0,1
fopen,fopen,,44,37,90,81,203,171,9,1
writefile,writefile,,13,14,27,27,45,54,0,7.692308
circleci,circleci,,96,86,134,182,265,316,6,1
webassembly,webassembly,,86,79,127,165,156,292,1,1
opengl-es,opengl-es,,117,107,204,224,555,428,3,1
qquickitem,qquickitem,,0,1,3,1,18,4,9,1
qsgclipnode,qsgclipnode,,0,0,0,0,2,0,9,1
android-fileprovider,android-fileprovider,,24,26,71,50,131,121,3,8.333333
lagom,lagom,,14,8,37,22,103,59,2,1
bootstrap-tags-input,bootstrap-tags-input,,6,7,9,13,33,22,1,16.666667
coffeescript,coffeescript,,49,29,97,78,258,175,1,1
iron-ajax,iron-ajax,,1,0,7,1,18,8,1,1
ruby-on-rails-3,ruby-on-rails-3,,69,55,211,124,474,335,12,1
resque,resque,,10,10,6,20,28,26,12,1
android-manifest,android-manifest,,118,125,223,243,362,466,3,5.932203
segue,segue,,82,60,192,142,416,334,13,1
iterable,iterable,,29,24,66,53,111,119,0,1
resolver,resolver,,11,27,22,38,49,60,1,145.454545
gherkin,gherkin,,43,31,89,74,143,163,3,1
angularfire,angularfire,,22,41,73,63,210,136,13,86.363636
reason,reason,,18,18,45,36,136,81,9,1
postgresql-9.4,postgresql-9.4,,30,29,53,59,206,112,4,1
uistoryboard,uistoryboard,,24,30,58,54,157,112,13,25
minimization,minimization,,23,16,27,39,61,66,0,1
web.py,web.py,,10,5,21,15,27,36,0,1
fedora-25,fedora-25,,1,0,1,1,6,2,9,1
cllocationmanager,cllocationmanager,,31,22,69,53,160,122,13,1
unnotificationtrigger,unnotificationtrigger,,2,0,2,2,15,4,13,1
interactive,interactive,,52,38,72,90,137,162,0,1
notepad,notepad,,15,10,34,25,55,59,0,1
samsung-mobile,samsung-mobile,,34,31,68,65,119,133,3,1
logrotate,logrotate,,16,9,26,25,41,51,9,1
ping,ping,,53,48,105,101,190,206,9,1
lan,lan,,23,20,57,43,81,100,9,1
animator,animator,,8,6,14,14,31,28,8,1
readfile,readfile,,57,37,93,94,169,187,0,1
deadlock,deadlock,,57,56,146,113,253,259,3,1
formulas,formulas,,0,0,0,0,180,0,5,1
boost-python,boost-python,,29,24,65,53,94,118,9,1
react-android,react-android,,7,1,13,8,34,21,1,1
statusbar,statusbar,,25,45,86,70,192,156,13,80
system.reactive,system.reactive,,44,49,93,93,255,186,8,11.363636
filestream,filestream,,36,38,82,74,137,156,8,5.555556
tpl-dataflow,tpl-dataflow,,12,12,19,24,71,43,8,1
file-rename,file-rename,,36,27,50,63,128,113,0,1
batch-rename,batch-rename,,9,17,54,26,76,80,9,88.888889
cluster-computing,cluster-computing,,142,134,256,276,467,532,0,1
errorbar,errorbar,,19,18,27,37,47,64,0,1
sinon,sinon,,96,119,198,215,406,413,1,23.958333
statistics-bootstrap,statistics-bootstrap,,13,14,11,27,30,38,0,7.692308
ansible-facts,ansible-facts,,27,27,46,54,62,100,6,1
decompiler,decompiler,,17,10,18,27,37,45,3,1
mongodb-java,mongodb-java,,8,22,36,30,73,66,1,175
playframework-2.6,playframework-2.6,,24,16,64,40,142,104,2,1
chartboost,chartboost,,0,1,2,1,13,3,3,1
amazon-mws,amazon-mws,,23,24,48,47,78,95,6,4.347826
togglebutton,togglebutton,,9,8,26,17,74,43,1,1
bs4,bs4,,0,0,0,0,10,0,0,1
findall,findall,,32,14,41,46,71,87,0,1
esper,esper,,6,6,18,12,45,30,14,1
uipageviewcontroller,uipageviewcontroller,,33,29,62,62,166,124,13,1
http-status-code-404,http-status-code-404,,120,134,270,254,495,524,4,11.666667
diacritics,diacritics,,11,16,27,27,65,54,0,45.454545
facebook-login,facebook-login,,69,86,165,155,322,320,13,24.637681
exec,exec,,108,84,209,192,407,401,9,1
psycopg2,psycopg2,,154,140,215,294,371,509,0,1
phpfox,phpfox,,1,2,0,3,4,3,4,100
itext,itext,,241,229,476,470,1147,946,8,1
division,division,,36,38,78,74,170,152,0,5.555556
keep-alive,keep-alive,,24,19,43,43,48,86,4,1
duplex,duplex,,8,1,7,9,15,16,8,1
ransack,ransack,,6,11,28,17,81,45,12,83.333333
aframe,aframe,,116,108,232,224,479,456,1,1
ebay-api,ebay-api,,14,20,43,34,86,77,4,42.857143
mount,mount,,52,46,95,98,146,193,9,1
draftjs,draftjs,,29,37,63,66,115,129,1,27.586207
sd-card,sd-card,,15,17,26,32,71,58,9,13.333333
mmc,mmc,,3,0,6,3,13,9,9,1
amazon-cloudfront,amazon-cloudfront,,182,161,289,343,470,632,6,1
transform,transform,,116,97,213,213,407,426,1,1
nuxt.js,nuxt.js,,423,448,612,871,535,1483,1,5.910165
shoulda,shoulda,,1,2,6,3,12,9,12,100
bootloader,bootloader,,46,44,101,90,109,191,9,1
react-dragula,react-dragula,,1,0,0,1,2,1,1,1
heap-memory,heap-memory,,78,68,134,146,278,280,9,1
amq,amq,,3,6,14,9,17,23,3,100
browserify,browserify,,42,45,78,87,167,165,1,7.142857
screen-positioning,screen-positioning,,1,0,0,1,2,1,1,1
service-fabric-stateless,service-fabric-stateless,,5,12,26,17,70,43,8,140
parse-server,parse-server,,48,40,147,88,275,235,13,1
apple-vision,apple-vision,,2,1,9,3,45,12,13,1
pipeline,pipeline,,187,152,317,339,340,656,0,1
siesta-swift,siesta-swift,,1,0,6,1,18,7,13,1
pool,pool,,40,50,88,90,145,178,0,25
tslint,tslint,,69,59,153,128,212,281,1,1
markdown,markdown,,197,200,432,397,666,829,0,1.522843
beamer,beamer,,9,15,18,24,34,42,0,66.666667
android-dialogfragment,android-dialogfragment,,54,41,62,95,106,157,3,1
android-percentrelativelayout,android-percentrelativelayout,,0,0,0,0,7,0,3,1
foreign-keys,foreign-keys,,287,198,458,485,919,943,4,1
generic-relations,generic-relations,,1,0,1,1,2,2,0,1
observers,observers,,21,25,47,46,95,93,13,19.047619
date-conversion,date-conversion,,12,16,37,28,75,65,0,33.333333
julian-date,julian-date,,4,3,10,7,17,17,0,1
nested-lists,nested-lists,,67,69,124,136,260,260,0,2.985075
travis-ci,travis-ci,,184,154,295,338,540,633,6,1
puredata,puredata,,0,1,3,1,6,4,13,1
palm,palm,,0,0,0,0,1,0,0,1
imacros,imacros,,14,10,28,24,90,52,1,1
pyramid,pyramid,,15,27,34,42,92,76,0,80
android-mvp,android-mvp,,24,10,45,34,106,79,3,1
logarithm,logarithm,,20,12,35,32,82,67,0,1
r-caret,r-caret,,55,54,154,109,299,263,0,1
tmux,tmux,,36,29,72,65,141,137,9,1
byobu,byobu,,3,3,5,6,10,11,9,1
post-increment,post-increment,,8,10,14,18,34,32,9,25
pre-increment,pre-increment,,5,8,10,13,22,23,9,60
luigi,luigi,,22,16,32,38,50,70,0,1
youtube-dl,youtube-dl,,27,42,48,69,94,117,0,55.555556
relative,relative,,13,14,33,27,78,60,1,7.692308
venn-diagram,venn-diagram,,12,10,24,22,43,46,0,1
multiple-columns,multiple-columns,,136,126,258,262,529,520,0,1
jna,jna,,31,39,91,70,140,161,3,25.806452
unsatisfiedlinkerror,unsatisfiedlinkerror,,7,7,12,14,24,26,3,1
resize,resize,,96,96,201,192,446,393,1,1
webrtc,webrtc,,254,256,571,510,829,1081,1,1
increment,increment,,52,51,140,103,272,243,0,1
mean-stack,mean-stack,,119,69,274,188,571,462,1,1
viewpagerindicator,viewpagerindicator,,5,4,4,9,22,13,3,1
mysql-workbench,mysql-workbench,,248,192,466,440,694,906,4,1
object-model,object-model,,0,1,4,1,7,5,3,1
hdf5,hdf5,,65,67,132,132,259,264,0,3.076923
h5py,h5py,,44,40,78,84,131,162,0,1
hdf5storage,hdf5storage,,0,0,1,0,3,1,0,1
constraints,constraints,,181,174,393,355,812,748,13,1
gradient,gradient,,103,86,182,189,341,371,0,1
selector,selector,,48,37,85,85,208,170,1,1
system-sounds,system-sounds,,1,3,2,4,6,6,13,200
passport-local,passport-local,,26,22,57,48,131,105,1,1
reinterpret-cast,reinterpret-cast,,14,10,22,24,45,46,9,1
querydsl,querydsl,,44,51,123,95,220,218,3,15.909091
restart,restart,,22,19,39,41,114,80,9,1
postgis,postgis,,116,119,227,235,347,462,4,2.586207
pgrouting,pgrouting,,5,6,7,11,12,18,4,20
pyglet,pyglet,,54,30,39,84,61,123,0,1
git-describe,git-describe,,1,3,1,4,3,5,6,200
equatable,equatable,,4,5,4,9,16,13,13,25
sqliteopenhelper,sqliteopenhelper,,15,11,35,26,76,61,3,1
microsoft-chart-controls,microsoft-chart-controls,,0,0,4,0,7,4,8,1
keyboard-events,keyboard-events,,42,41,85,83,143,168,1,1
local-variables,local-variables,,23,16,54,39,107,93,0,1
riotjs,riotjs,,2,1,6,3,17,9,1,1
cell,cell,,91,86,238,177,388,415,13,1
aurelia-webpack,aurelia-webpack,,1,1,2,2,4,4,1,1
ember-data,ember-data,,39,23,75,62,228,137,1,1
nswag,nswag,,14,19,34,33,31,67,8,35.714286
xctest,xctest,,36,37,103,73,201,176,13,2.777778
appium-ios,appium-ios,,48,30,87,78,152,165,3,1
jersey-2.0,jersey-2.0,,55,37,118,92,229,210,3,1
entity-relationship,entity-relationship,,48,27,91,75,196,166,4,1
google-cloud-dataflow,google-cloud-dataflow,,230,182,441,412,823,853,6,1
opencv-contour,opencv-contour,,36,22,52,58,95,110,0,1
managed-bean,managed-bean,,9,5,18,14,36,32,3,1
excel-2010,excel-2010,,71,63,179,134,522,313,5,1
excel-2016,excel-2016,,75,58,183,133,348,316,5,1
reactstrap,reactstrap,,53,38,114,91,128,205,1,1
windows-firewall,windows-firewall,,9,15,15,24,40,39,9,66.666667
acumatica,acumatica,,47,70,81,117,179,198,8,48.93617
amazon-ecs,amazon-ecs,,186,185,360,371,404,731,6,1
google-translate,google-translate,,50,45,108,95,202,203,1,1
nokogiri,nokogiri,,34,32,83,66,176,149,12,1
slice,slice,,139,164,326,303,625,629,0,17.985612
yii2-widget,yii2-widget,,0,0,1,0,8,1,4,1
histogram,histogram,,156,145,325,301,591,626,0,1
html.dropdownlistfor,html.dropdownlistfor,,16,14,24,30,51,54,8,1
innodb,innodb,,75,67,159,142,276,301,4,1
tibco-rv,tibco-rv,,1,0,0,1,4,1,3,1
maven-archetype,maven-archetype,,15,7,28,22,39,50,3,1
vaadin8,vaadin8,,25,15,77,40,273,117,3,1
racket,racket,,72,81,213,153,402,366,0,12.5
racket-student-languages,racket-student-languages,,0,1,6,1,9,7,0,1
simpledateformat,simpledateformat,,52,37,107,89,247,196,3,1
datetime-parsing,datetime-parsing,,10,9,28,19,100,47,3,1
advanced-custom-fields,advanced-custom-fields,,175,153,337,328,514,665,4,1
ratpack,ratpack,,2,5,0,7,22,7,3,150
thunk,thunk,,2,1,2,3,5,5,2,1
cuda,cuda,,210,181,356,391,784,747,0,1
python-3.4,python-3.4,,10,6,67,16,120,83,0,1
urllib,urllib,,116,113,218,229,449,447,0,1
share-intent,share-intent,,5,4,8,9,15,17,3,1
tumblr-themes,tumblr-themes,,3,1,11,4,20,15,1,1
sendgrid,sendgrid,,96,92,190,188,294,378,4,1
puppeteer,puppeteer,,350,397,562,747,740,1309,1,13.428571
memory-layout,memory-layout,,10,8,13,18,26,31,9,1
vagrantfile,vagrantfile,,21,13,50,34,68,84,4,1
ansible-role,ansible-role,,15,11,14,26,22,40,6,1
ansible-galaxy,ansible-galaxy,,5,3,8,8,8,16,6,1
slider,slider,,178,169,399,347,617,746,1,1
iglistkit,iglistkit,,3,3,6,6,14,12,13,1
greasemonkey,greasemonkey,,18,14,51,32,117,83,1,1
axes,axes,,18,24,49,42,75,91,0,33.333333
multiple-axes,multiple-axes,,4,2,7,6,29,13,0,1
yahoo-finance,yahoo-finance,,13,13,33,26,67,59,0,1
imagemagick-convert,imagemagick-convert,,34,21,82,55,157,137,12,1
strtotime,strtotime,,17,12,33,29,80,62,4,1
preflight,preflight,,9,11,23,20,55,43,1,22.222222
clion,clion,,86,87,154,173,353,327,9,1.162791
fluent,fluent,,13,22,46,35,60,81,8,69.230769
vapor,vapor,,40,32,71,72,140,143,13,1
redis-py,redis-py,,6,5,14,11,16,25,3,1
collision,collision,,57,30,102,87,204,189,0,1
react-dom,react-dom,,39,41,67,80,148,147,1,5.128205
chart.js,chart.js,,447,455,848,902,1285,1750,1,1.789709
conditional,conditional,,210,0,427,210,972,637,0,1
elapsedtime,elapsedtime,,6,3,7,9,20,16,0,1
gen-server,gen-server,,9,8,16,17,42,33,2,1
sql-server-express,sql-server-express,,12,20,36,32,77,68,4,66.666667
winsock,winsock,,27,28,48,55,107,103,9,3.703704
connection-timeout,connection-timeout,,31,18,28,49,60,77,3,1
angularjs-ng-click,angularjs-ng-click,,10,1,22,11,75,33,1,1
portforwarding,portforwarding,,29,31,80,60,109,140,9,6.896552
lifecycle,lifecycle,,36,48,77,84,147,161,1,33.333333
unmount,unmount,,3,3,3,6,9,9,1,1
bluetooth-lowenergy,bluetooth-lowenergy,,301,264,551,565,1119,1116,3,1
at-command,at-command,,41,27,56,68,108,124,9,1
belongs-to,belongs-to,,4,5,19,9,46,28,12,25
itk,itk,,12,9,19,21,56,40,0,1
pydicom,pydicom,,18,11,17,29,39,46,0,1
android-lifecycle,android-lifecycle,,60,65,133,125,200,258,3,8.333333
spring-integration-dsl,spring-integration-dsl,,53,44,119,97,151,216,3,1
dsn,dsn,,7,7,13,14,22,27,4,1
nosuchelementexception,nosuchelementexception,,17,14,27,31,56,58,3,1
google-chrome-headless,google-chrome-headless,,58,66,132,124,315,256,3,13.793103
searchkick,searchkick,,7,15,36,22,78,58,12,114.285714
opencv3.0,opencv3.0,,92,85,250,177,396,427,0,1
cakephp-2.x,cakephp-2.x,,7,11,7,18,21,25,4,57.142857
master-pages,master-pages,,14,23,32,37,65,69,8,64.285714
templating,templating,,17,14,25,31,70,56,4,1
nunjucks,nunjucks,,17,15,30,32,60,62,1,1
client-side-templating,client-side-templating,,0,2,3,2,2,5,1,100
standardized,standardized,,9,6,12,15,16,27,0,1
playframework-2.0,playframework-2.0,,6,11,22,17,155,39,2,83.333333
berkshelf,berkshelf,,3,0,5,3,14,8,12,1
chefspec,chefspec,,0,6,6,6,19,12,12,500
bundle,bundle,,86,90,192,176,414,368,3,4.651163
gemfile,gemfile,,8,2,17,10,44,27,12,1
administrate,administrate,,2,1,4,3,5,7,12,1
pony,pony,,1,0,1,1,2,2,12,1
bison,bison,,42,37,94,79,176,173,9,1
yacc,yacc,,37,24,53,61,115,114,9,1
lex,lex,,36,14,66,50,99,116,9,1
height,height,,86,50,146,136,288,282,1,1
point,point,,31,20,70,51,132,121,0,1
tensorboard,tensorboard,,137,113,180,250,436,430,0,1
gorilla,gorilla,,21,21,25,42,72,67,6,1
gcloud,gcloud,,173,150,319,323,471,642,6,1
google-cloud-ml-engine,google-cloud-ml-engine,,0,0,0,0,39,0,0,1
tabcontrol,tabcontrol,,28,19,54,47,91,101,8,1
datatrigger,datatrigger,,13,13,33,26,55,59,8,1
ellipse,ellipse,,13,19,27,32,62,59,0,46.153846
alexa-skills-kit,alexa-skills-kit,,94,82,281,176,582,457,6,1
ethereum,ethereum,,185,184,505,369,1043,874,6,1
solidity,solidity,,149,103,295,252,589,547,6,1
truffle,truffle,,52,47,117,99,176,216,6,1
git-commit,git-commit,,47,32,101,79,194,180,6,1
photon-controller,photon-controller,,0,0,0,0,1,0,6,1
pyodbc,pyodbc,,134,135,201,269,374,470,0,1
htmlunit,htmlunit,,21,24,61,45,121,106,3,14.285714
timezone-offset,timezone-offset,,30,25,53,55,126,108,0,1
gmt,gmt,,6,9,12,15,32,27,0,50
web-config,web-config,,135,93,281,228,511,509,8,1
mix,mix,,22,19,38,41,84,79,2,1
enzyme,enzyme,,324,317,620,641,833,1261,1,1
flask-uploads,flask-uploads,,2,2,5,4,11,9,0,1
gradlew,gradlew,,35,30,85,65,129,150,3,1
minecraft-forge,minecraft-forge,,13,16,24,29,51,53,3,23.076923
prestashop-1.5,prestashop-1.5,,1,0,4,1,11,5,4,1
pageobjects,pageobjects,,16,17,49,33,110,82,3,6.25
fragmentpageradapter,fragmentpageradapter,,7,12,13,19,55,32,3,71.428571
rm,rm,,9,6,25,15,44,40,9,1
metaprogramming,metaprogramming,,77,74,121,151,316,272,9,1
kubelet,kubelet,,14,18,47,32,43,79,6,28.571429
nsdocumentdirectory,nsdocumentdirectory,,6,2,8,8,25,16,13,1
predict,predict,,57,53,104,110,180,214,0,1
h2,h2,,125,155,260,280,478,540,3,24
android-anr-dialog,android-anr-dialog,,5,8,15,13,45,28,3,60
create-table,create-table,,22,40,77,62,153,139,4,81.818182
fread,fread,,38,19,66,57,122,123,9,1
angularjs-filter,angularjs-filter,,7,2,19,9,82,28,1,1
geopandas,geopandas,,104,102,129,206,123,335,0,1
unc,unc,,6,14,20,20,46,40,8,133.333333
array-splice,array-splice,,4,6,14,10,22,24,1,50
scrapy-splash,scrapy-splash,,38,53,52,91,95,143,0,39.473684
factory-bot,factory-bot,,26,15,61,41,139,102,12,1
firefox-webextensions,firefox-webextensions,,54,58,136,112,343,248,1,7.407407
gmaps4rails,gmaps4rails,,2,2,4,4,11,8,12,1
kubernetes-go-client,kubernetes-go-client,,6,5,13,11,13,24,6,1
ssh-tunnel,ssh-tunnel,,39,43,67,82,108,149,9,10.25641
overlays,overlays,,0,0,0,0,12,0,1,1
asset-catalog,asset-catalog,,2,3,7,5,19,12,13,50
keychain,keychain,,51,32,87,83,146,170,13,1
mobileprovision,mobileprovision,,3,0,2,3,5,5,13,1
casperjs,casperjs,,25,12,30,37,134,67,3,1
capistrano3,capistrano3,,9,9,23,18,62,41,12,1
flutter,flutter,,4389,5062,5803,9451,3700,15254,13,15.333789
tensor,tensor,,132,115,182,247,379,429,0,1
tshark,tshark,,13,13,29,26,39,55,9,1
userscripts,userscripts,,19,24,75,43,84,118,1,26.315789
tampermonkey,tampermonkey,,65,76,123,141,194,264,1,16.923077
nat,nat,,34,26,65,60,74,125,9,1
wan,wan,,1,3,7,4,8,11,9,200
xpages,xpages,,42,34,113,76,251,189,5,1
xpages-ssjs,xpages-ssjs,,9,2,32,11,68,43,5,1
visual-studio-2008,visual-studio-2008,,18,10,61,28,116,89,8,1
nstextfield,nstextfield,,9,12,27,21,56,48,13,33.333333
ibaction,ibaction,,6,6,27,12,47,39,13,1
confidence-interval,confidence-interval,,38,40,76,78,83,154,0,5.263158
stargazer,stargazer,,19,17,28,36,51,64,0,1
contact-form,contact-form,,37,30,56,67,145,123,4,1
nested-forms,nested-forms,,17,6,28,23,98,51,12,1
nested-attributes,nested-attributes,,3,12,27,15,50,42,12,300
gdb,gdb,,179,182,392,361,719,753,9,1.675978
parallax,parallax,,47,50,103,97,156,200,1,6.382979
frame-rate,frame-rate,,17,31,60,48,103,108,13,82.352941
node-webkit,node-webkit,,2,8,5,10,36,15,1,300
nw.js,nw.js,,7,0,11,7,36,18,1,1
cakephp-3.x,cakephp-3.x,,28,35,82,63,204,145,4,25
cakedc,cakedc,,0,2,1,2,17,3,4,100
pass-through,pass-through,,5,7,9,12,17,21,5,40
data-manipulation,data-manipulation,,126,116,215,242,365,457,0,1
default-constructor,default-constructor,,16,16,20,32,59,52,9,1
cosine-similarity,cosine-similarity,,31,39,78,70,101,148,0,25.806452
chapel,chapel,,3,0,12,3,48,15,0,1
multer,multer,,133,117,223,250,332,473,1,1
express-validator,express-validator,,22,28,37,50,74,87,1,27.272727
wordnet,wordnet,,18,14,52,32,82,84,0,1
esprima,esprima,,2,0,6,2,8,8,1,1
esprima.js,esprima.js,,0,0,0,0,4,0,1,1
remote-execution,remote-execution,,1,4,4,5,8,9,9,300
pad,pad,,5,3,6,8,13,14,0,1
asp.net-2.0,asp.net-2.0,,1,1,2,2,3,4,8,1
animationdrawable,animationdrawable,,2,4,7,6,11,13,3,100
maxlength,maxlength,,5,10,19,15,29,34,1,100
windows-7-x64,windows-7-x64,,8,11,39,19,83,58,8,37.5
genesis,genesis,,7,9,21,16,36,37,4,28.571429
libavcodec,libavcodec,,11,7,26,18,44,44,13,1
libav,libav,,20,27,28,47,46,75,13,35
libavformat,libavformat,,5,2,13,7,21,20,13,1
xll,xll,,0,4,3,4,12,7,5,300
google-maps-api-2,google-maps-api-2,,8,9,25,17,64,42,1,12.5
endlessscroll,endlessscroll,,2,1,5,3,11,8,3,1
eb,eb,,4,1,7,5,10,12,6,1
emr,emr,,0,0,0,0,222,0,2,1
spring-webflow,spring-webflow,,18,12,25,30,50,55,3,1
multibinding,multibinding,,5,2,12,7,32,19,8,1
relativesource,relativesource,,0,0,5,0,5,5,8,1
html-helper,html-helper,,14,12,48,26,84,74,8,1
pyinstaller,pyinstaller,,252,315,413,567,634,980,0,25
py2exe,py2exe,,15,13,26,28,96,54,0,1
loadimage,loadimage,,12,3,7,15,13,22,1,1
grav,grav,,8,5,16,13,56,29,4,1
nomad,nomad,,6,6,14,12,16,26,6,1
nsmutableattributedstring,nsmutableattributedstring,,11,2,18,13,36,31,13,1
imessage-extension,imessage-extension,,8,8,13,16,39,29,13,1
hockeyapp,hockeyapp,,6,7,27,13,52,40,13,16.666667
mysqltuner,mysqltuner,,0,2,1,2,6,3,4,100
tuner,tuner,,3,1,5,4,3,9,0,1
line-intersection,line-intersection,,2,1,8,3,8,11,0,1
cpu-architecture,cpu-architecture,,95,56,140,151,295,291,9,1
cpu-registers,cpu-registers,,35,18,74,53,118,127,9,1
prepared-statement,prepared-statement,,119,97,231,216,501,447,4,1
mysql-num-rows,mysql-num-rows,,2,0,2,2,8,4,4,1
monads,monads,,66,65,114,131,258,245,2,1
galera,galera,,10,15,34,25,57,59,4,50
geoip,geoip,,12,12,27,24,58,51,4,1
maxmind,maxmind,,5,8,10,13,30,23,4,60
avcapturesession,avcapturesession,,24,16,48,40,92,88,13,1
soapui,soapui,,110,94,238,204,557,442,3,1
flashing,flashing,,4,3,13,7,8,20,9,1
twiml,twiml,,11,10,22,21,49,43,13,1
calayer,calayer,,23,27,69,50,157,119,13,17.391304
xpc,xpc,,2,2,11,4,17,15,13,1
runloop,runloop,,2,5,4,7,10,11,13,150
forall,forall,,2,0,11,2,10,13,4,1
file-copying,file-copying,,14,15,23,29,65,52,0,7.142857
django-autocomplete-light,django-autocomplete-light,,8,5,10,13,30,23,0,1
pandas-datareader,pandas-datareader,,14,18,38,32,94,70,0,28.571429
form-helpers,form-helpers,,1,4,2,5,14,7,12,300
uitextfield,uitextfield,,132,77,256,209,661,465,13,1
wc,wc,,5,3,19,8,31,27,9,1
contains,contains,,62,54,120,116,187,236,0,1
httprequest,httprequest,,167,183,335,350,738,685,4,9.580838
selenide,selenide,,9,18,26,27,36,53,3,100
react-native-navigation,react-native-navigation,,100,96,232,196,271,428,1,1
git-svn,git-svn,,14,11,30,25,68,55,6,1
case-sensitive,case-sensitive,,12,15,40,27,75,67,0,25
fabric8,fabric8,,6,10,18,16,67,34,6,66.666667
apache-commons-io,apache-commons-io,,2,3,4,5,14,9,3,50
python-ggplot,python-ggplot,,8,5,4,13,29,17,0,1
openresty,openresty,,22,18,25,40,62,65,6,1
rss,rss,,79,64,152,143,275,295,4,1
urlencode,urlencode,,55,61,60,116,138,176,4,10.909091
jbpm,jbpm,,27,37,48,64,74,112,3,37.037037
drawing,drawing,,70,54,128,124,262,252,8,1
android-cursoradapter,android-cursoradapter,,2,5,15,7,43,22,3,150
openshift-enterprise,openshift-enterprise,,6,7,24,13,29,37,6,16.666667
nslog,nslog,,3,1,4,4,16,8,13,1
modernizr,modernizr,,7,1,12,8,28,20,1,1
xlrd,xlrd,,33,54,81,87,124,168,0,63.636364
init,init,,35,38,62,73,123,135,9,8.571429
python-module,python-module,,45,51,79,96,181,175,0,13.333333
android-audiomanager,android-audiomanager,,13,24,25,37,71,62,3,84.615385
matrix-factorization,matrix-factorization,,4,6,12,10,23,22,0,50
rrdtool,rrdtool,,5,3,11,8,22,19,9,1
rrd,rrd,,3,3,5,6,11,11,9,1
socks,socks,,23,19,45,42,82,87,6,1
http-headers,http-headers,,231,238,488,469,886,957,4,3.030303
iis-8.5,iis-8.5,,25,10,47,35,80,82,8,1
httpresponse,httpresponse,,89,84,169,173,308,342,4,1
group-concat,group-concat,,15,12,42,27,102,69,4,1
richtext,richtext,,11,7,9,18,34,27,5,1
clean-urls,clean-urls,,4,1,7,5,20,12,4,1
lotus-notes,lotus-notes,,67,67,75,134,197,209,5,1
statements,statements,,6,7,23,13,29,36,0,16.666667
restsharp,restsharp,,66,74,136,140,235,276,8,12.121212
wordpress-theming,wordpress-theming,,250,221,472,471,801,943,4,1
subroutine,subroutine,,24,15,30,39,101,69,9,1
angular-observable,angular-observable,,8,8,32,16,83,48,1,1
permission-denied,permission-denied,,35,22,61,57,89,118,9,1
vlookup,vlookup,,117,86,207,203,468,410,5,1
videochat,videochat,,4,7,14,11,27,25,3,75
streamsets,streamsets,,16,10,14,26,26,40,2,1
digits,digits,,25,19,64,44,62,108,0,1
openstack,openstack,,82,60,166,142,332,308,6,1
transactional,transactional,,25,0,74,25,111,99,3,1
hibernateexception,hibernateexception,,0,1,1,1,4,2,3,1
git-push,git-push,,31,26,70,57,132,127,6,1
afhttpsessionmanager,afhttpsessionmanager,,0,1,1,1,3,2,13,1
capistrano,capistrano,,31,26,65,57,162,122,12,1
gradle-kotlin-dsl,gradle-kotlin-dsl,,54,35,88,89,58,177,3,1
oracle-pro-c,oracle-pro-c,,5,1,4,6,16,10,4,1
html5-video,html5-video,,171,144,369,315,620,684,1,1
amazon-data-pipeline,amazon-data-pipeline,,10,6,24,16,83,40,6,1
webharvest,webharvest,,0,0,1,0,3,1,0,1
panic,panic,,4,4,12,8,30,20,9,1
firewalld,firewalld,,3,3,12,6,18,18,9,1
android-notifications,android-notifications,,147,125,306,272,535,578,3,1
magento2,magento2,,270,233,498,503,716,1001,4,1
uitextview,uitextview,,104,76,144,180,398,324,13,1
screen-brightness,screen-brightness,,3,2,5,5,9,10,3,1
call-by-value,call-by-value,,4,3,3,7,6,10,9,1
jekyll-extensions,jekyll-extensions,,4,4,9,8,29,17,1,1
php-carbon,php-carbon,,46,43,92,89,260,181,4,1
set,set,,245,187,474,432,890,906,0,1
std-pair,std-pair,,16,13,35,29,78,64,9,1
apache-karaf,apache-karaf,,38,43,67,81,136,148,3,13.157895
jbossfuse,jbossfuse,,18,28,50,46,139,96,3,55.555556
rundeck,rundeck,,12,15,21,27,35,48,9,25
c++builder,c++builder,,55,42,139,97,197,236,9,1
cheerio,cheerio,,79,54,105,133,187,238,1,1
nightmare,nightmare,,12,18,36,30,109,66,1,50
kibana,kibana,,283,279,510,562,688,1072,6,1
kibana-5,kibana-5,,6,3,31,9,70,40,6,1
doc2vec,doc2vec,,42,30,57,72,134,129,0,1
listboxitem,listboxitem,,4,10,20,14,56,34,8,150
list-separator,list-separator,,0,0,0,0,3,0,8,1
fullcalendar-2,fullcalendar-2,,1,1,3,2,14,5,1,1
cancan,cancan,,2,3,15,5,34,20,12,50
pundit,pundit,,10,8,23,18,59,41,12,1
database-replication,database-replication,,47,46,93,93,157,186,4,1
merge-replication,merge-replication,,2,2,5,4,23,9,4,1
multibranch-pipeline,multibranch-pipeline,,27,14,33,41,54,74,6,1
azure-servicebusrelay,azure-servicebusrelay,,3,1,3,4,14,7,8,1
dtsearch,dtsearch,,0,1,1,1,3,2,8,1
qtp,qtp,,14,12,24,26,82,50,5,1
hp-uft,hp-uft,,22,23,65,45,155,110,5,4.545455
bulkupdate,bulkupdate,,12,16,22,28,36,50,4,33.333333
react-slick,react-slick,,9,9,17,18,38,35,1,1
ios8.3,ios8.3,,0,0,0,0,2,0,13,1
textfield,textfield,,93,109,133,202,273,335,13,17.204301
var,var,,48,42,90,90,210,180,1,1
encode,encode,,72,65,154,137,261,291,0,1
superset,superset,,17,20,31,37,62,68,0,17.647059
facebook-javascript-sdk,facebook-javascript-sdk,,62,48,160,110,315,270,13,1
telecommunication,telecommunication,,13,9,16,22,28,38,3,1
inotifypropertychanged,inotifypropertychanged,,26,15,47,41,98,88,8,1
fill,fill,,40,21,67,61,133,128,0,1
arcgis,arcgis,,58,63,109,121,188,230,0,8.62069
jsf-2.2,jsf-2.2,,26,24,69,50,174,119,3,1
web.xml,web.xml,,23,25,58,48,102,106,3,8.695652
worksheet,worksheet,,27,25,67,52,137,119,5,1
google-vr,google-vr,,27,9,44,36,76,80,8,1
daydream,daydream,,6,2,9,8,33,17,8,1
getter,getter,,36,23,65,59,113,124,3,1
shorthand,shorthand,,3,4,6,7,22,13,1,33.333333
actionfilterattribute,actionfilterattribute,,6,1,9,7,20,16,8,1
actionmethod,actionmethod,,1,0,3,1,11,4,8,1
filterattribute,filterattribute,,0,1,0,1,2,1,8,1
stdvector,stdvector,,70,92,124,162,237,286,9,31.428571
ngrx-store-4.0,ngrx-store-4.0,,5,1,12,6,75,18,1,1
maven-versions-plugin,maven-versions-plugin,,2,2,3,4,12,7,3,1
32-bit,32-bit,,21,22,41,43,91,84,9,4.761905
rx-android,rx-android,,51,40,121,91,419,212,3,1
pusher,pusher,,45,62,102,107,147,209,4,37.777778
mailchimp-api-v3.0,mailchimp-api-v3.0,,23,30,69,53,108,122,4,30.434783
batch-delete,batch-delete,,1,0,0,1,1,1,8,1
webcam,webcam,,48,48,93,96,160,189,0,1
raspberry-pi2,raspberry-pi2,,11,8,20,19,58,39,0,1
hashtag,hashtag,,11,16,18,27,55,45,1,45.454545
dataservice,dataservice,,3,1,4,4,12,8,14,1
wso2ei,wso2ei,,28,52,100,80,97,180,14,85.714286
exe,exe,,117,129,195,246,325,441,0,10.25641
ruby-2.4,ruby-2.4,,5,4,3,9,29,12,12,1
ioexception,ioexception,,23,15,53,38,105,91,3,1
clickonce,clickonce,,38,35,84,73,144,157,8,1
publish,publish,,52,84,142,136,271,278,8,61.538462
selenium-firefoxdriver,selenium-firefoxdriver,,22,51,67,73,116,140,3,131.818182
crash-reports,crash-reports,,18,23,34,41,142,75,13,27.777778
web-application-project,web-application-project,,1,3,11,4,8,15,8,200
sql-server-2017,sql-server-2017,,126,113,247,239,287,486,4,1
android-source,android-source,,88,75,162,163,254,325,3,1
sequential,sequential,,28,15,42,43,79,85,0,1
inline,inline,,46,51,114,97,245,211,9,10.869565
seed,seed,,10,8,21,18,44,39,0,1
sequelize-cli,sequelize-cli,,30,24,46,54,79,100,1,1
jest,jest,,4,5,13,9,541,22,1,25
odoo,odoo,,310,323,697,633,970,1330,0,4.193548
odoo-11,odoo-11,,122,95,246,217,282,463,0,1
amazon-signed-cookie,amazon-signed-cookie,,1,3,2,4,3,6,6,200
database-connection,database-connection,,139,123,274,262,489,536,4,1
aero-glass,aero-glass,,0,0,2,0,5,2,8,1
codepages,codepages,,8,8,20,16,22,36,0,1
powershell-4.0,powershell-4.0,,65,56,100,121,254,221,8,1
failovercluster,failovercluster,,8,4,11,12,21,23,4,1
private-key,private-key,,42,35,81,77,121,158,6,1
localdb,localdb,,13,20,25,33,87,58,8,53.846154
animate-cc,animate-cc,,10,6,22,16,58,38,1,1
camera-calibration,camera-calibration,,45,42,71,87,132,158,0,1
stereo-3d,stereo-3d,,15,11,24,26,41,50,0,1
xserver,xserver,,10,7,13,17,27,30,9,1
egl,egl,,16,13,18,29,23,47,3,1
coords,coords,,2,0,2,2,4,4,1,1
ownerdrawn,ownerdrawn,,3,2,2,5,12,7,9,1
stdlist,stdlist,,6,7,5,13,17,18,9,16.666667
protobuf-net,protobuf-net,,15,26,40,41,68,81,8,73.333333
case,case,,141,115,319,256,628,575,4,1
ef-code-first,ef-code-first,,108,78,183,186,423,369,8,1
asp.net-boilerplate,asp.net-boilerplate,,15,3,23,18,66,41,8,1
symfony-2.8,symfony-2.8,,14,16,45,30,161,75,4,14.285714
vichuploaderbundle,vichuploaderbundle,,14,10,23,24,31,47,4,1
hook,hook,,103,105,215,208,361,423,4,1.941748
fallback,fallback,,8,7,17,15,35,32,1,1
nsviewcontroller,nsviewcontroller,,7,8,15,15,24,30,13,14.285714
virtualenv,virtualenv,,199,177,373,376,761,749,0,1
cesium,cesium,,24,21,28,45,74,73,1,1
tensorflow-serving,tensorflow-serving,,88,77,201,165,241,366,0,1
tensorflow-xla,tensorflow-xla,,4,5,7,9,14,16,0,25
user-defined,user-defined,,5,5,9,10,21,19,0,1
atomikos,atomikos,,3,1,10,4,29,14,3,1
android-fonts,android-fonts,,3,11,16,14,49,30,3,266.666667
build-agent,build-agent,,4,9,15,13,34,28,8,125
execution-time,execution-time,,17,4,18,21,53,39,0,1
multicore,multicore,,12,15,28,27,50,55,0,25
android-imageview,android-imageview,,74,30,109,104,280,213,3,1
android-gridlayout,android-gridlayout,,9,23,36,32,87,68,3,155.555556
buffer,buffer,,125,105,278,230,511,508,9,1
backtrace,backtrace,,4,11,15,15,20,30,9,175
premailer,premailer,,1,0,2,1,3,3,12,1
wpallimport,wpallimport,,10,9,23,19,14,42,4,1
nsdateformatter,nsdateformatter,,31,21,43,52,145,95,13,1
html-encode,html-encode,,4,6,8,10,22,18,1,50
html-escape-characters,html-escape-characters,,10,11,10,21,19,31,1,10
rtcmulticonnection,rtcmulticonnection,,7,1,5,8,15,13,1,1
localhost,localhost,,224,212,459,436,827,895,4,1
django-orm,django-orm,,119,118,195,237,316,432,0,1
windows-10-iot-core,windows-10-iot-core,,23,20,61,43,140,104,8,1
google-docs,google-docs,,71,69,131,140,251,271,5,1
google-drive-realtime-api,google-drive-realtime-api,,6,2,18,8,46,26,5,1
silverlight,silverlight,,8,10,44,18,60,62,8,25
lotusscript,lotusscript,,29,38,35,67,93,102,5,31.034483
amazon-rds,amazon-rds,,221,192,366,413,714,779,6,1
aws-code-deploy,aws-code-deploy,,45,44,73,89,131,162,6,1
powershell-remoting,powershell-remoting,,23,28,42,51,106,93,8,21.73913
azure-pipelines-release-pipeline,azure-pipelines-release-pipeline,,75,73,185,148,407,333,8,1
raw-data,raw-data,,9,4,9,13,30,22,0,1
python-docx,python-docx,,56,65,102,121,144,223,0,16.071429
restful-architecture,restful-architecture,,0,0,0,0,162,0,3,1
xsd-validation,xsd-validation,,42,45,74,87,164,161,3,7.142857
grails-domain-class,grails-domain-class,,5,2,8,7,13,15,3,1
grails-controller,grails-controller,,1,4,6,5,19,11,3,300
grails3,grails3,,14,11,44,25,80,69,3,1
nfc,nfc,,79,87,141,166,288,307,3,10.126582
rfid,rfid,,41,32,72,73,122,145,3,1
mifare,mifare,,13,17,26,30,53,56,3,30.769231
jpeg,jpeg,,102,67,177,169,313,346,0,1
uirefreshcontrol,uirefreshcontrol,,11,9,21,20,61,41,13,1
iphone-6,iphone-6,,3,0,1,3,6,4,13,1
each,each,,41,38,81,79,206,160,1,1
elements,elements,,0,0,0,0,161,0,1,1
autorun,autorun,,0,1,9,1,23,10,3,1
openxml,openxml,,86,93,167,179,292,346,8,8.139535
docx,docx,,87,85,171,172,255,343,0,1
openxml-sdk,openxml-sdk,,31,31,69,62,116,131,8,1
apache-pulsar,apache-pulsar,,9,13,2,22,4,24,2,44.444444
android-studio-2.3,android-studio-2.3,,0,0,2,0,92,2,3,1
procedure,procedure,,65,48,128,113,217,241,4,1
weekday,weekday,,10,6,22,16,48,38,0,1
malware,malware,,17,11,37,28,86,65,4,1
bottomnavigationview,bottomnavigationview,,95,95,185,190,279,375,3,1
bootstrapping,bootstrapping,,5,3,22,8,78,30,0,1
pysolr,pysolr,,2,0,2,2,16,4,2,1
chromium,chromium,,137,131,216,268,394,484,1,1
cefsharp,cefsharp,,60,74,124,134,163,258,8,23.333333
wifi-direct,wifi-direct,,22,11,41,33,53,74,3,1
amazon-echo,amazon-echo,,2,0,12,2,39,14,6,1
kendo-ui-angular2,kendo-ui-angular2,,31,24,87,55,239,142,1,1
cancellationtokensource,cancellationtokensource,,8,6,16,14,39,30,8,1
.net-4.6.2,.net-4.6.2,,3,2,5,5,33,10,8,1
batterymanager,batterymanager,,5,5,6,10,17,16,3,1
resttemplate,resttemplate,,141,149,234,290,356,524,3,5.673759
qprocess,qprocess,,13,9,25,22,73,47,9,1
glog,glog,,7,2,8,9,15,17,9,1
discourse,discourse,,6,4,14,10,22,24,12,1
cumsum,cumsum,,22,21,35,43,104,78,0,1
rstudio-server,rstudio-server,,27,19,43,46,92,89,0,1
oracle-spatial,oracle-spatial,,8,5,9,13,20,22,4,1
hyperledger-fabric,hyperledger-fabric,,383,350,828,733,1493,1561,6,1
uialertviewcontroller,uialertviewcontroller,,2,1,5,3,13,8,13,1
webmin,webmin,,3,6,16,9,21,25,4,100
virtualmin,virtualmin,,7,8,13,15,15,28,4,14.285714
jdeveloper,jdeveloper,,31,19,55,50,89,105,3,1
delphi-xe6,delphi-xe6,,3,2,5,5,18,10,9,1
interbase,interbase,,2,4,11,6,16,17,4,100
interrupt-handling,interrupt-handling,,16,16,34,32,66,66,9,1
stm32f4,stm32f4,,23,15,40,38,69,78,9,1
coocox,coocox,,0,0,1,0,3,1,9,1
git-blame,git-blame,,4,5,4,9,17,13,6,25
dynamic-sql,dynamic-sql,,63,57,108,120,217,228,4,1
select-query,select-query,,4,0,6,4,18,10,4,1
google-api-php-client,google-api-php-client,,53,32,100,85,194,185,5,1
phpstorm-2017.2,phpstorm-2017.2,,1,0,0,1,33,1,4,1
cowboy,cowboy,,1,4,11,5,22,16,2,300
analyzer,analyzer,,10,8,22,18,43,40,6,1
varcharmax,varcharmax,,0,2,5,2,3,7,4,100
geom-bar,geom-bar,,18,36,55,54,126,109,0,100
material-ui,material-ui,,609,678,969,1287,1289,2256,1,11.330049
octobercms,octobercms,,86,72,156,158,274,314,4,1
xmlunit,xmlunit,,5,1,5,6,13,11,3,1
cordova-plugin-fcm,cordova-plugin-fcm,,15,21,44,36,96,80,1,40
talend,talend,,50,38,112,88,249,200,4,1
windows-services,windows-services,,121,117,259,238,473,497,8,1
invantive-sql,invantive-sql,,3,0,1,3,26,4,4,1
invantive-data-hub,invantive-data-hub,,0,0,0,0,8,0,4,1
unmarshalling,unmarshalling,,45,24,91,69,172,160,3,1
qt5,qt5,,253,277,542,530,1090,1072,9,9.486166
qgraphicsview,qgraphicsview,,29,31,51,60,81,111,9,6.896552
qmouseevent,qmouseevent,,1,2,10,3,10,13,9,100
pepper,pepper,,15,19,39,34,84,73,0,26.666667
choregraphe,choregraphe,,3,4,21,7,45,28,0,33.333333
multiprocessing-manager,multiprocessing-manager,,3,5,5,8,10,13,0,66.666667
mac-address,mac-address,,16,15,38,31,66,69,9,1
build.gradle,build.gradle,,280,282,648,562,1235,1210,3,1
zxing,zxing,,46,46,94,92,156,186,3,1
onchange,onchange,,79,51,114,130,250,244,1,1
filereader,filereader,,78,48,165,126,275,291,1,1
mqtt,mqtt,,224,237,424,461,758,885,6,5.803571
mosquitto,mosquitto,,38,33,87,71,144,158,6,1
zigbee,zigbee,,11,4,13,15,28,28,6,1
google-sheets-api,google-sheets-api,,188,222,321,410,578,731,5,18.085106
code-injection,code-injection,,38,35,67,73,112,140,4,1
gesture-recognition,gesture-recognition,,10,7,12,17,23,29,0,1
complextype,complextype,,9,3,9,12,18,21,8,1
binary-image,binary-image,,3,7,5,10,15,15,0,133.333333
homomorphic-filter,homomorphic-filter,,0,2,0,2,1,2,0,100
ftplib,ftplib,,24,13,33,37,69,70,0,1
angular-httpclient,angular-httpclient,,135,91,279,226,388,505,1,1
ionic-cli,ionic-cli,,8,3,11,11,23,22,1,1
ng-file-upload,ng-file-upload,,9,2,23,11,51,34,1,1
sublimetext3,sublimetext3,,138,137,333,275,655,608,0,1
material-theme,material-theme,,4,0,5,4,3,9,3,1
newmips,newmips,,0,0,0,0,1,0,1,1
android-scrollview,android-scrollview,,36,30,63,66,203,129,3,1
trafficshaping,trafficshaping,,3,1,2,4,9,6,9,1
nscollectionview,nscollectionview,,11,4,22,15,47,37,13,1
linkedin,linkedin,,174,127,274,301,356,575,4,1
.net-2.0,.net-2.0,,3,5,14,8,36,22,8,66.666667
remote-host,remote-host,,1,0,1,1,4,2,9,1
authorize.net,authorize.net,,17,29,35,46,94,81,4,70.588235
subscriptions,subscriptions,,0,0,0,0,49,0,13,1
quickblox,quickblox,,12,12,41,24,93,65,3,1
quickblox-android,quickblox-android,,3,4,8,7,31,15,3,33.333333
rhel,rhel,,36,48,94,84,164,178,9,33.333333
database-normalization,database-normalization,,29,20,60,49,135,109,4,1
hazelcast,hazelcast,,86,64,150,150,315,300,3,1
hazelcast-imap,hazelcast-imap,,21,10,21,31,82,52,3,1
line-breaks,line-breaks,,35,27,68,62,135,130,1,1
qtcharts,qtcharts,,11,10,13,21,35,34,9,1
portable-class-library,portable-class-library,,2,2,8,4,69,12,8,1
uncaughtexceptionhandler,uncaughtexceptionhandler,,0,0,3,0,9,3,3,1
mathjax,mathjax,,52,29,78,81,143,159,1,1
reveal.js,reveal.js,,11,10,21,21,46,42,1,1
ef-migrations,ef-migrations,,70,46,122,116,293,238,8,1
verbosity,verbosity,,2,2,2,4,7,6,8,1
verbose,verbose,,5,2,4,7,18,11,3,1
octopus-deploy,octopus-deploy,,17,16,47,33,101,80,8,1
visual-studio-lightswitch,visual-studio-lightswitch,,1,1,10,2,6,12,8,1
lightswitch-2013,lightswitch-2013,,0,0,0,0,2,0,8,1
on-screen-keyboard,on-screen-keyboard,,3,7,14,10,19,24,8,133.333333
jedi,jedi,,2,2,11,4,13,15,9,1
profiler,profiler,,27,22,50,49,91,99,9,1
trendline,trendline,,8,4,11,12,21,23,0,1
ormlite,ormlite,,4,6,29,10,65,39,3,50
expect.pm,expect.pm,,1,1,0,2,2,2,9,1
reduce,reduce,,84,90,174,174,335,348,1,7.142857
move-semantics,move-semantics,,32,31,70,63,175,133,9,1
collapsable,collapsable,,5,3,14,8,16,22,1,1
rspec-rails,rspec-rails,,42,43,136,85,210,221,12,2.380952
tcp-ip,tcp-ip,,0,0,73,0,193,73,9,1
beagleboard,beagleboard,,7,3,11,10,29,21,9,1
qtcpsocket,qtcpsocket,,4,8,11,12,29,23,9,100
spring-cloud-stream,spring-cloud-stream,,128,130,206,258,310,464,3,1.5625
uiswitch,uiswitch,,12,12,35,24,82,59,13,1
image-gallery,image-gallery,,26,19,32,45,90,77,1,1
android-camera-intent,android-camera-intent,,14,12,34,26,104,60,3,1
firebird,firebird,,71,41,134,112,330,246,4,1
samba,samba,,27,26,61,53,71,114,9,1
apps-for-office,apps-for-office,,1,0,0,1,4,1,5,1
ravendb,ravendb,,12,11,28,23,89,51,8,1
game-physics,game-physics,,83,76,161,159,277,320,8,1
unity2d,unity2d,,0,0,0,0,39,0,8,1
parent-child,parent-child,,98,72,201,170,374,371,1,1
property-binding,property-binding,,5,5,16,10,28,26,1,1
sizeof,sizeof,,28,26,56,54,132,110,9,1
gcc-warning,gcc-warning,,18,10,40,28,64,68,9,1
native-activity,native-activity,,1,1,2,2,10,4,3,1
android-thread,android-thread,,7,5,25,12,52,37,3,1
branching-and-merging,branching-and-merging,,29,17,40,46,101,86,6,1
depth-first-search,depth-first-search,,49,37,89,86,187,175,0,1
emit,emit,,14,5,21,19,40,40,1,1
type-hinting,type-hinting,,27,33,67,60,136,127,0,22.222222
wso2is,wso2is,,84,46,163,130,236,293,14,1
scim,scim,,4,8,13,12,28,25,14,100
mod-wsgi,mod-wsgi,,52,37,125,89,345,214,0,1
wsgi,wsgi,,49,56,110,105,167,215,0,14.285714
uipath,uipath,,37,29,55,66,55,121,5,1
nsmutablearray,nsmutablearray,,9,9,21,18,88,39,13,1
nspredicate,nspredicate,,21,21,53,42,146,95,13,1
el,el,,26,13,43,39,105,82,3,1
uiswipegesturerecognizer,uiswipegesturerecognizer,,4,3,19,7,29,26,13,1
postcss,postcss,,26,19,51,45,118,96,1,1
battery,battery,,17,17,29,34,62,63,3,1
realm-mobile-platform,realm-mobile-platform,,22,22,55,44,168,99,13,1
metalsmith,metalsmith,,4,1,4,5,10,9,1,1
.net-4.7,.net-4.7,,3,9,10,12,37,22,8,200
twitter-oauth,twitter-oauth,,32,22,81,54,157,135,0,1
preg-match,preg-match,,73,46,97,119,300,216,4,1
phone-number,phone-number,,10,19,31,29,65,60,3,90
gremlin,gremlin,,135,143,222,278,402,500,2,5.925926
tinkerpop,tinkerpop,,30,33,73,63,87,136,2,10
tinkerpop3,tinkerpop3,,23,23,78,46,126,124,2,1
janusgraph,janusgraph,,42,60,69,102,167,171,2,42.857143
operator-keyword,operator-keyword,,42,37,86,79,167,165,9,1
slowdown,slowdown,,0,7,10,7,20,17,0,600
bandwidth-throttling,bandwidth-throttling,,1,3,3,4,7,7,9,200
metronic,metronic,,7,7,17,14,24,31,1,1
owasp,owasp,,40,35,65,75,96,140,4,1
zap,zap,,12,9,38,21,72,59,4,1
long-polling,long-polling,,6,5,32,11,46,43,3,1
clip,clip,,10,16,20,26,53,46,1,60
in-app-purchase,in-app-purchase,,170,207,349,377,634,726,13,21.764706
ionic2-tabs,ionic2-tabs,,0,0,0,0,2,0,1,1
bitbucket-api,bitbucket-api,,26,11,31,37,47,68,6,1
abstract,abstract,,35,42,89,77,182,166,9,20
google-cloud-vision,google-cloud-vision,,60,42,73,102,134,175,6,1
firemonkey,firemonkey,,75,76,194,151,322,345,9,1.333333
delphi-xe8,delphi-xe8,,3,1,4,4,17,8,9,1
eigen3,eigen3,,34,30,74,64,148,138,9,1
md5,md5,,52,53,118,105,217,223,12,1.923077
renderer,renderer,,17,24,41,41,73,82,8,41.176471
adaptive-cards,adaptive-cards,,42,46,53,88,73,141,8,9.52381
couchdb-futon,couchdb-futon,,1,2,11,3,20,14,1,100
couchdb-2.0,couchdb-2.0,,7,1,19,8,30,27,1,1
gmail-imap,gmail-imap,,12,3,24,15,35,39,4,1
imaplib,imaplib,,33,18,35,51,49,86,0,1
psql,psql,,103,76,218,179,387,397,4,1
lighting,lighting,,14,19,34,33,43,67,9,35.714286
render-to-texture,render-to-texture,,9,3,3,12,21,15,9,1
elastic4s,elastic4s,,1,5,3,6,17,9,6,400
facebook-analytics,facebook-analytics,,5,8,17,13,24,30,13,60
appveyor,appveyor,,13,8,16,21,77,37,8,1
udev,udev,,19,11,31,30,33,61,9,1
docusignapi,docusignapi,,69,98,145,167,277,312,8,42.028986
geo,geo,,21,24,53,45,94,98,0,14.285714
sp,sp,,35,18,59,53,102,112,0,1
guid,guid,,38,23,51,61,111,112,8,1
multi-module,multi-module,,27,23,47,50,88,97,3,1
versions-maven-plugin,versions-maven-plugin,,2,2,7,4,10,11,3,1
cursor-position,cursor-position,,12,10,19,22,34,41,1,1
edittextpreference,edittextpreference,,2,0,5,2,9,7,3,1
one-to-many,one-to-many,,65,60,117,125,259,242,3,1
xquery-sql,xquery-sql,,8,8,7,16,22,23,4,1
password-protection,password-protection,,29,33,74,62,126,136,4,13.793103
mysql-cluster,mysql-cluster,,4,1,10,5,33,15,4,1
python-telegram-bot,python-telegram-bot,,35,53,66,88,170,154,0,51.428571
raster,raster,,93,107,198,200,341,398,0,15.053763
mapserver,mapserver,,6,3,6,9,9,15,1,1
metafor,metafor,,4,10,16,14,27,30,0,150
haxe,haxe,,17,11,26,28,97,54,9,1
kha,kha,,1,0,0,1,1,1,9,1
cartodb,cartodb,,3,2,12,5,32,17,1,1
carto-mobile,carto-mobile,,0,0,2,0,13,2,1,1
derived-class,derived-class,,17,17,33,34,84,67,9,1
base-class,base-class,,9,6,26,15,34,41,9,1
file-io,file-io,,184,151,359,335,755,694,0,1
error-logging,error-logging,,26,8,21,34,58,55,3,1
many-to-many,many-to-many,,169,152,324,321,663,645,4,1
listener,listener,,81,90,222,171,378,393,3,11.111111
alembic,alembic,,21,34,39,55,62,94,0,61.904762
paper-android,paper-android,,0,0,0,0,1,0,3,1
fizzbuzz,fizzbuzz,,3,3,14,6,28,20,0,1
schematron,schematron,,7,9,7,16,21,23,3,28.571429
pyspark-sql,pyspark-sql,,244,235,344,479,577,823,2,1
socat,socat,,9,7,13,16,20,29,9,1
core,core,,184,194,198,378,349,576,8,5.434783
sql-session-state,sql-session-state,,2,1,0,3,4,3,8,1
vsix,vsix,,38,34,79,72,133,151,8,1
assets,assets,,73,56,155,129,257,284,13,1
ejabberd,ejabberd,,42,35,120,77,189,197,3,1
syslog,syslog,,34,25,81,59,94,140,9,1
appender,appender,,6,10,11,16,24,27,3,66.666667
log4cplus,log4cplus,,2,0,10,2,12,12,9,1
crypt,crypt,,13,2,15,15,35,30,9,1
makecert,makecert,,1,0,6,1,13,7,8,1
laravel-eloquent,laravel-eloquent,,0,0,0,0,472,0,4,1
yara,yara,,3,2,5,5,5,10,0,1
wampserver,wampserver,,24,18,87,42,204,129,4,1
localserver,localserver,,1,6,20,7,17,27,4,500
custom-controls,custom-controls,,63,40,88,103,181,191,8,1
8thwall-xr,8thwall-xr,,2,2,2,4,7,6,8,1
subview,subview,,19,9,31,28,35,59,13,1
uitapgesturerecognizer,uitapgesturerecognizer,,26,17,45,43,124,88,13,1
angularjs-select2,angularjs-select2,,1,2,6,3,5,9,1,100
nsight,nsight,,3,4,14,7,12,21,0,33.333333
gauge,gauge,,15,10,24,25,38,49,1,1
google-gauges,google-gauges,,0,0,1,0,5,1,1,1
imputation,imputation,,37,40,69,77,99,146,0,8.108108
language-translation,language-translation,,11,10,17,21,31,38,6,1
pyparsing,pyparsing,,14,25,32,39,58,71,0,78.571429
python-xarray,python-xarray,,77,81,119,158,146,277,0,5.194805
google-plus,google-plus,,23,9,70,32,103,102,5,1
laravel-passport,laravel-passport,,104,102,192,206,310,398,4,1
symfony-forms,symfony-forms,,42,32,122,74,218,196,4,1
business-objects,business-objects,,14,11,36,25,55,61,5,1
alm,alm,,11,12,31,23,60,54,5,9.090909
hp-quality-center,hp-quality-center,,4,0,4,4,9,8,5,1
influxdb,influxdb,,132,119,187,251,287,438,6,1
non-relational-database,non-relational-database,,3,2,9,5,14,14,1,1
application-settings,application-settings,,9,4,16,13,23,29,8,1
xaml-designer,xaml-designer,,1,4,3,5,6,8,8,300
do-while,do-while,,41,42,119,83,263,202,0,2.439024
go-cd,go-cd,,8,12,17,20,23,37,6,50
thoughtworks-go,thoughtworks-go,,0,2,1,2,3,3,6,100
context-param,context-param,,0,0,1,0,3,1,3,1
amazon-lex,amazon-lex,,42,25,54,67,173,121,6,1
recurrent-neural-network,recurrent-neural-network,,223,200,212,423,321,635,0,1
grpc,grpc,,268,244,377,512,595,889,6,1
visualgdb,visualgdb,,3,0,4,3,4,7,9,1
conda,conda,,303,327,562,630,757,1192,0,7.920792
mojarra,mojarra,,2,2,11,4,30,15,3,1
mongotemplate,mongotemplate,,10,15,36,25,40,61,3,50
icc,icc,,12,16,33,28,46,61,9,33.333333
cs50,cs50,,44,69,98,113,168,211,9,56.818182
onedrive,onedrive,,71,80,156,151,287,307,8,12.676056
ms-wopi,ms-wopi,,7,3,4,10,29,14,8,1
docker-swarm-mode,docker-swarm-mode,,11,17,33,28,58,61,6,54.545455
derived,derived,,7,3,11,10,27,21,9,1
xalan,xalan,,3,10,10,13,15,23,3,233.333333
save-as,save-as,,9,24,25,33,60,58,5,166.666667
dropbox,dropbox,,46,47,115,93,192,208,4,2.173913
activiti,activiti,,37,35,75,72,114,147,3,1
android-app-indexing,android-app-indexing,,0,1,9,1,6,10,3,1
superagent,superagent,,11,6,25,17,71,42,1,1
gitkraken,gitkraken,,27,12,46,39,73,85,6,1
angular-filters,angular-filters,,6,3,24,9,64,33,1,1
dart-webui,dart-webui,,2,3,4,5,21,9,13,50
query-planner,query-planner,,5,5,10,10,22,20,4,1
angular-router,angular-router,,128,110,199,238,501,437,1,1
cvxopt,cvxopt,,5,6,17,11,29,28,0,20
aws-kms,aws-kms,,32,24,43,56,84,99,6,1
jdb,jdb,,3,2,7,5,12,12,3,1
gravity-forms-plugin,gravity-forms-plugin,,33,42,76,75,121,151,4,27.272727
multisite,multisite,,43,25,89,68,122,157,4,1
homebrew,homebrew,,160,119,323,279,593,602,13,1
stacked-chart,stacked-chart,,26,21,37,47,79,84,0,1
cpanel,cpanel,,149,179,306,328,457,634,4,20.134228
doxygen,doxygen,,35,24,90,59,150,149,9,1
jsonb-api,jsonb-api,,6,4,4,10,9,14,3,1
angular2-router,angular2-router,,0,0,2,0,13,2,1,1
kik,kik,,2,1,3,3,6,6,8,1
eventemitter,eventemitter,,31,29,38,60,145,98,1,1
nullreferenceexception,nullreferenceexception,,39,32,69,71,161,140,8,1
collectionview,collectionview,,35,26,55,61,126,116,13,1
claims-based-identity,claims-based-identity,,24,27,62,51,156,113,8,12.5
asp.net-identity-2,asp.net-identity-2,,8,7,25,15,50,40,8,1
mcrypt,mcrypt,,8,10,29,18,73,47,4,25
jms-queue,jms-queue,,1,1,3,2,8,5,3,1
branch.io,branch.io,,23,19,51,42,138,93,3,1
iboutlet,iboutlet,,11,4,22,15,60,37,13,1
onmouseover,onmouseover,,12,6,31,18,46,49,1,1
amazon-route53,amazon-route53,,94,86,171,180,286,351,6,1
proj,proj,,18,8,13,26,15,39,0,1
war,war,,63,59,141,122,276,263,3,1
android-adapter,android-adapter,,68,53,152,121,318,273,3,1
scilab,scilab,,26,9,28,35,82,63,0,1
wear-os,wear-os,,40,30,77,70,197,147,3,1
intentfilter,intentfilter,,38,25,44,63,85,107,3,1
wait,wait,,59,50,115,109,260,224,3,1
visual-studio-express,visual-studio-express,,3,1,6,4,11,10,8,1
checked-exceptions,checked-exceptions,,3,0,4,3,8,7,3,1
xps,xps,,9,7,17,16,17,33,8,1
documentviewer,documentviewer,,3,2,7,5,7,12,8,1
simplecov,simplecov,,2,2,2,4,8,6,12,1
post-processing,post-processing,,5,7,21,12,31,33,9,40
encrypted-core-data-sql,encrypted-core-data-sql,,1,0,2,1,4,3,13,1
poster,poster,,0,0,3,0,1,3,1,1
gsl,gsl,,10,10,28,20,48,48,9,1
ibm-midrange,ibm-midrange,,38,45,100,83,212,183,4,18.421053
db2-400,db2-400,,32,47,55,79,119,134,4,46.875
beacon,beacon,,35,28,78,63,156,141,3,1
estimote,estimote,,2,2,6,4,22,10,3,1
multipartform-data,multipartform-data,,135,144,299,279,453,578,3,6.666667
dropwizard,dropwizard,,44,45,108,89,254,197,3,2.272727
biopython,biopython,,34,20,46,54,109,100,0,1
pchart,pchart,,3,2,2,5,1,7,4,1
phpexcel,phpexcel,,48,42,135,90,323,225,4,1
android-gridview,android-gridview,,9,20,41,29,82,70,3,122.222222
xml-layout,xml-layout,,3,0,5,3,8,8,3,1
unsigned-integer,unsigned-integer,,9,10,17,19,43,36,9,11.111111
josql,josql,,0,0,0,0,1,0,3,1
cloudfoundry,cloudfoundry,,72,63,158,135,334,293,3,1
pivotal-cloud-foundry,pivotal-cloud-foundry,,42,49,102,91,199,193,3,16.666667
concourse,concourse,,16,13,17,29,62,46,6,1
code-coverage,code-coverage,,136,120,274,256,436,530,3,1
istanbul,istanbul,,21,24,50,45,88,95,1,14.285714
google-custom-search,google-custom-search,,17,11,30,28,75,58,1,1
drupal-8,drupal-8,,193,173,364,366,466,730,4,1
cncontactviewcontroller,cncontactviewcontroller,,1,1,14,2,19,16,13,1
phpixie,phpixie,,0,0,1,0,1,1,4,1
launchd,launchd,,14,8,18,22,26,40,13,1
launchctl,launchctl,,9,4,8,13,11,21,13,1
antlr4,antlr4,,78,67,145,145,331,290,0,1
facebook-opengraph,facebook-opengraph,,22,28,55,50,95,105,13,27.272727
hdfs,hdfs,,242,254,478,496,1065,974,2,4.958678
distcp,distcp,,6,8,18,14,20,32,2,33.333333
s3distcp,s3distcp,,2,3,6,5,12,11,2,50
apache-cocoon,apache-cocoon,,2,2,2,4,7,6,12,1
free,free,,49,23,84,72,180,156,9,1
destroy,destroy,,16,10,23,26,61,49,9,1
simple-schema,simple-schema,,3,0,6,3,28,9,1,1
formatter,formatter,,25,19,26,44,67,70,3,1
browser-history,browser-history,,34,23,58,57,93,115,1,1
android-transitions,android-transitions,,30,20,45,50,116,95,3,1
reactivex,reactivex,,21,15,67,36,156,103,1,1
rx-py,rx-py,,7,6,6,13,20,19,0,1
navigationview,navigationview,,16,22,33,38,66,71,3,37.5
kotlin-android-extensions,kotlin-android-extensions,,35,28,101,63,202,164,3,1
xwalkview,xwalkview,,0,0,6,0,4,6,3,1
tclientdataset,tclientdataset,,2,3,8,5,20,13,9,50
delphi-10.2-tokyo,delphi-10.2-tokyo,,26,24,104,50,245,154,9,1
executable,executable,,65,62,133,127,249,260,0,1
phalcon,phalcon,,26,25,76,51,153,127,4,1
cucumber-java,cucumber-java,,44,51,102,95,156,197,3,15.909091
android-contacts,android-contacts,,24,28,60,52,108,112,3,16.666667
bearing,bearing,,1,1,1,2,10,3,1,1
icommand,icommand,,5,2,18,7,48,25,8,1
intellij-idea-2016,intellij-idea-2016,,0,0,1,0,16,1,3,1
spannablestring,spannablestring,,11,15,26,26,53,52,3,36.363636
silverstripe,silverstripe,,34,30,64,64,224,128,4,1
.net-native,.net-native,,4,5,10,9,24,19,8,25
payment-gateway,payment-gateway,,99,108,183,207,338,390,4,9.090909
rows,rows,,84,97,176,181,370,357,0,15.47619
storefront,storefront,,15,19,31,34,51,65,4,26.666667
tlistview,tlistview,,1,3,5,4,12,9,9,200
ghostscript,ghostscript,,37,42,81,79,161,160,8,13.513514
custom-fields,custom-fields,,36,30,84,66,159,150,4,1
filedialog,filedialog,,10,6,14,16,25,30,5,1
aws-cli,aws-cli,,136,151,276,287,490,563,6,11.029412
distinct-values,distinct-values,,12,18,29,30,62,59,4,50
launchimage,launchimage,,2,0,5,2,18,7,13,1
ng2-translate,ng2-translate,,0,0,6,0,8,6,1,1
ngx-translate,ngx-translate,,40,28,83,68,150,151,1,1
kinvey,kinvey,,1,1,4,2,9,6,3,1
mbaas,mbaas,,2,1,2,3,5,5,3,1
kafkacat,kafkacat,,1,1,1,2,4,3,2,1
google-api-nodejs-client,google-api-nodejs-client,,29,24,61,53,113,114,5,1
clickable,clickable,,6,3,19,9,45,28,3,1
pdfbox,pdfbox,,103,96,195,199,380,394,3,1
criteria,criteria,,55,51,93,106,179,199,3,1
freemarker,freemarker,,55,71,103,126,225,229,3,29.090909
youtube-api,youtube-api,,221,175,407,396,753,803,5,1
youtube-data-api,youtube-data-api,,179,113,280,292,483,572,5,1
spring-jms,spring-jms,,59,48,89,107,231,196,3,1
serverside-rendering,serverside-rendering,,59,44,176,103,309,279,1,1
android-sharedpreferences,android-sharedpreferences,,0,0,0,0,124,0,3,1
external-tables,external-tables,,11,10,17,21,30,38,4,1
jcomponent,jcomponent,,9,2,19,11,45,30,3,1
superclass,superclass,,25,22,56,47,97,103,9,1
turfjs,turfjs,,16,7,18,23,31,41,1,1
eof,eof,,34,31,71,65,137,136,9,1
splice,splice,,8,11,30,19,58,49,1,37.5
allocator,allocator,,14,15,27,29,53,56,9,7.142857
angular2-ngmodel,angular2-ngmodel,,5,3,19,8,45,27,1,1
powerquery,powerquery,,158,160,237,318,354,555,5,1.265823
aix,aix,,38,40,79,78,137,157,9,5.263158
vsql,vsql,,0,1,1,1,7,2,4,1
pyaudio,pyaudio,,65,60,88,125,104,213,0,1
java-ee-7,java-ee-7,,16,17,35,33,89,68,3,6.25
httpurlconnection,httpurlconnection,,58,43,98,101,274,199,3,1
openweathermap,openweathermap,,28,14,58,42,91,100,1,1
sandcastle,sandcastle,,2,3,3,5,12,8,8,50
.net-standard-1.4,.net-standard-1.4,,0,0,1,0,8,1,8,1
logback,logback,,87,96,199,183,349,382,3,10.344828
cloudant,cloudant,,19,16,55,35,126,90,1,1
html-lists,html-lists,,57,57,138,114,271,252,1,1
android-webview,android-webview,,224,195,404,419,588,823,3,1
xlsxwriter,xlsxwriter,,78,65,137,143,208,280,0,1
rhapsody,rhapsody,,5,1,12,6,24,18,9,1
list-comprehension,list-comprehension,,169,159,345,328,673,673,0,1
h.264,h.264,,56,65,124,121,206,245,13,16.071429
minimum,minimum,,20,16,41,36,88,77,0,1
self-contained,self-contained,,5,5,4,10,9,14,8,1
player-swift,player-swift,,0,1,0,1,1,1,13,1
twitterkit,twitterkit,,7,1,13,8,60,21,13,1
pnotify,pnotify,,1,0,3,1,8,4,1,1
amazon-cloudwatch,amazon-cloudwatch,,152,204,282,356,389,638,6,34.210526
android-actionbar,android-actionbar,,44,45,97,89,301,186,3,2.272727
numpy-dtype,numpy-dtype,,1,0,2,1,6,3,0,1
morelinq,morelinq,,1,0,5,1,5,6,8,1
gulp-protractor,gulp-protractor,,3,2,3,5,17,8,3,1
csom,csom,,42,29,55,71,115,126,8,1
palindrome,palindrome,,38,24,89,62,130,151,0,1
listiterator,listiterator,,9,0,20,9,39,29,3,1
permalinks,permalinks,,50,43,87,93,143,180,4,1
deferred,deferred,,13,12,29,25,75,54,1,1
jquery-chaining,jquery-chaining,,0,0,0,0,3,0,1,1
screenshot,screenshot,,98,84,180,182,327,362,3,1
ab-initio,ab-initio,,1,2,1,3,5,4,4,100
amazon-sqs,amazon-sqs,,147,160,270,307,370,577,6,8.843537
android-library,android-library,,39,30,99,69,174,168,3,1
aar,aar,,34,33,69,67,131,136,3,1
keil,keil,,26,15,52,41,92,93,9,1
ssas,ssas,,152,114,265,266,390,531,4,1
mdx,mdx,,54,59,144,113,259,257,4,9.259259
cube,cube,,23,19,67,42,102,109,4,1
unreal-blueprint,unreal-blueprint,,13,18,15,31,37,46,9,38.461538
launch-screen,launch-screen,,4,5,8,9,51,17,13,25
powerpoint,powerpoint,,158,210,326,368,494,694,5,32.911392
python-pptx,python-pptx,,37,47,43,84,61,127,0,27.027027
pull-request,pull-request,,74,56,107,130,218,237,6,1
software-collections,software-collections,,4,4,2,8,15,10,9,1
debian,debian,,219,195,385,414,838,799,9,1
network-connection,network-connection,,1,2,13,3,15,16,3,100
azure-eventhub,azure-eventhub,,67,99,135,166,190,301,8,47.761194
apriori,apriori,,23,10,40,33,75,73,0,1
arules,arules,,14,6,22,20,69,42,0,1
file-writing,file-writing,,27,26,47,53,109,100,0,1
jsonlite,jsonlite,,18,25,32,43,73,75,0,38.888889
gluon,gluon,,28,22,57,50,109,107,3,1
word-vba,word-vba,,43,46,110,89,546,199,5,6.976744
outlook-2010,outlook-2010,,7,4,18,11,49,29,5,1
public-key-encryption,public-key-encryption,,39,36,99,75,154,174,6,1
pagemethods,pagemethods,,0,0,1,0,11,1,8,1
dhtmlx,dhtmlx,,12,11,12,23,34,35,1,1
rename,rename,,107,82,227,189,406,416,0,1
android-custom-attributes,android-custom-attributes,,0,1,2,1,3,3,3,1
epplus,epplus,,68,47,120,115,255,235,8,1
telethon,telethon,,22,25,33,47,54,80,0,13.636364
ruby-on-rails-3.2,ruby-on-rails-3.2,,13,1,44,14,53,58,12,1
xbrl,xbrl,,4,8,9,12,18,21,3,100
data-corruption,data-corruption,,1,0,5,1,4,6,8,1
2d,2d,,129,84,271,213,432,484,0,1
ajaxcontroltoolkit,ajaxcontroltoolkit,,16,17,24,33,57,57,8,6.25
unmanaged,unmanaged,,12,17,33,29,61,62,8,41.666667
managed,managed,,10,7,19,17,41,36,8,1
indexof,indexof,,38,32,87,70,181,157,1,1
lastindexof,lastindexof,,0,1,5,1,12,6,1,1
django-csrf,django-csrf,,13,12,27,25,54,52,0,1
fpdf,fpdf,,46,46,118,92,226,210,4,1
apache-beam,apache-beam,,244,225,433,469,723,902,6,1
dbunit,dbunit,,5,7,18,12,48,30,3,40
regex-lookarounds,regex-lookarounds,,256,103,134,359,252,493,0,1
regex-group,regex-group,,339,120,172,459,334,631,0,1
dt,dt,,61,76,145,137,222,282,0,24.590164
spaces,spaces,,13,9,38,22,82,60,0,1
kylo,kylo,,1,2,10,3,34,13,2,100
m2m,m2m,,7,4,17,11,18,28,0,1
mps,mps,,2,1,1,3,6,4,3,1
cil,cil,,17,15,34,32,84,66,8,1
reflection.emit,reflection.emit,,4,7,20,11,33,31,8,75
mono.cecil,mono.cecil,,5,3,13,8,21,21,8,1
api-gateway,api-gateway,,67,65,127,132,142,259,6,1
sql-merge,sql-merge,,9,10,15,19,30,34,4,11.111111
jenkins-jira-trigger,jenkins-jira-trigger,,1,1,1,2,4,3,6,1
dependency-properties,dependency-properties,,30,28,58,58,108,116,8,1
tfs2015,tfs2015,,23,19,49,42,182,91,8,1
neovim,neovim,,22,16,48,38,84,86,9,1
zero,zero,,14,14,38,28,88,66,0,1
date-parsing,date-parsing,,15,12,21,27,86,48,3,1
dayofmonth,dayofmonth,,5,2,3,7,18,10,0,1
google-play-services,google-play-services,,149,144,311,293,712,604,3,1
android-toast,android-toast,,8,24,40,32,70,72,3,200
android-application-class,android-application-class,,5,7,3,12,21,15,3,40
pentaho-spoon,pentaho-spoon,,40,36,52,76,159,128,4,1
django-class-based-views,django-class-based-views,,52,39,70,91,150,161,0,1
lazarus,lazarus,,17,16,45,33,61,78,9,1
freepascal,freepascal,,15,24,41,39,86,80,9,60
ftpwebresponse,ftpwebresponse,,1,1,2,2,6,4,8,1
visual-studio-extensions,visual-studio-extensions,,56,60,91,116,161,207,8,7.142857
visual-studio-mac,visual-studio-mac,,41,49,98,90,225,188,8,19.512195
nsworkspace,nsworkspace,,5,3,7,8,8,15,13,1
macos-high-sierra,macos-high-sierra,,25,26,135,51,545,186,13,4
custom-post-type,custom-post-type,,90,66,204,156,329,360,4,1
meta-key,meta-key,,1,2,8,3,12,11,4,100
angular-validation,angular-validation,,22,16,47,38,123,85,1,1
angular4-forms,angular4-forms,,12,8,88,20,445,108,1,1
cname,cname,,17,15,45,32,78,77,4,1
chain,chain,,11,11,19,22,59,41,1,1
google-cloud-dns,google-cloud-dns,,11,12,18,23,14,41,6,9.090909
annotate,annotate,,14,14,16,28,37,44,0,1
subpixel,subpixel,,2,2,2,4,7,6,1,1
noty,noty,,0,5,6,5,11,11,1,400
google-cloud-endpoints,google-cloud-endpoints,,30,34,47,64,188,111,6,13.333333
dynamics-365,dynamics-365,,83,78,162,161,208,323,8,1
tzinfo,tzinfo,,0,2,1,2,5,3,12,100
nodemailer,nodemailer,,107,88,166,195,274,361,1,1
httpc,httpc,,1,0,0,1,3,1,2,1
arch,arch,,14,7,13,21,31,34,9,1
jsf-2.3,jsf-2.3,,12,8,27,20,26,47,3,1
antd,antd,,173,216,314,389,301,703,1,24.855491
compact-framework,compact-framework,,5,5,14,10,37,24,8,1
crypto++,crypto++,,12,12,31,24,49,55,9,1
diffie-hellman,diffie-hellman,,14,4,30,18,39,48,6,1
rest-assured,rest-assured,,92,86,142,178,270,320,3,1
spring-restdocs,spring-restdocs,,20,12,25,32,41,57,3,1
pruning,pruning,,12,7,9,19,18,28,0,1
proxy-pattern,proxy-pattern,,9,0,7,9,13,16,9,1
aes,aes,,170,142,296,312,565,608,6,1
react-router-redux,react-router-redux,,3,9,15,12,122,27,1,200
cplex,cplex,,93,78,104,171,206,275,0,1
knapsack-problem,knapsack-problem,,27,18,50,45,80,95,0,1
monix,monix,,5,9,14,14,20,28,2,80
amazon-elb,amazon-elb,,96,75,152,171,227,323,6,1
salt-stack,salt-stack,,15,26,51,41,84,92,0,73.333333
activity-lifecycle,activity-lifecycle,,7,11,26,18,75,44,3,57.142857
onpause,onpause,,3,3,5,6,26,11,3,1
classpath,classpath,,43,44,122,87,236,209,3,2.325581
nsnotificationcenter,nsnotificationcenter,,23,11,64,34,94,98,13,1
odoo-view,odoo-view,,20,8,35,28,93,63,0,1
datetime2,datetime2,,9,2,5,11,15,16,4,1
novell,novell,,2,3,2,5,5,7,8,50
laravel-socialite,laravel-socialite,,26,33,66,59,98,125,4,26.923077
laravel-middleware,laravel-middleware,,14,18,45,32,75,77,4,28.571429
googletest,googletest,,79,75,135,154,254,289,9,1
gmock,gmock,,17,28,24,45,83,69,9,64.705882
django-channels,django-channels,,75,63,139,138,184,277,0,1
kubernetes-security,kubernetes-security,,1,3,2,4,61,6,6,200
kwargs,kwargs,,21,15,28,36,81,64,0,1
wget,wget,,76,66,145,142,283,287,9,1
swagger-node-express,swagger-node-express,,1,3,0,4,4,4,3,200
bouncycastle,bouncycastle,,67,57,142,124,279,266,6,1
pkcs#11,pkcs#11,,22,24,43,46,84,89,6,9.090909
hsm,hsm,,12,16,33,28,60,61,6,33.333333
pkcs11interop,pkcs11interop,,6,4,9,10,27,19,6,1
dump,dump,,33,37,89,70,139,159,9,12.121212
extjs5,extjs5,,5,7,12,12,86,24,1,40
ipc,ipc,,88,68,172,156,279,328,9,1
chromecast,chromecast,,56,36,81,92,158,173,13,1
google-cast,google-cast,,39,23,51,62,117,113,13,1
artoolkit,artoolkit,,2,2,6,4,27,10,13,1
python-sphinx,python-sphinx,,103,85,180,188,340,368,0,1
restructuredtext,restructuredtext,,18,28,47,46,121,93,0,55.555556
rgb,rgb,,74,51,145,125,224,270,0,1
marklogic,marklogic,,121,95,221,216,442,437,3,1
velocity,velocity,,29,30,67,59,139,126,3,3.448276
azure-powershell,azure-powershell,,79,80,162,159,287,321,8,1.265823
blogs,blogs,,37,34,92,71,156,163,4,1
uianimation,uianimation,,2,6,3,8,19,11,13,200
sql-server-agent,sql-server-agent,,10,7,17,17,44,34,4,1
metaclass,metaclass,,18,26,45,44,111,89,0,44.444444
nvd3.js,nvd3.js,,23,16,39,39,121,78,1,1
smtplib,smtplib,,45,43,78,88,118,166,0,1
dojo,dojo,,33,32,86,65,256,151,1,1
permutation,permutation,,113,105,237,218,426,455,0,1
http-proxy,http-proxy,,55,45,110,100,176,210,6,1
android-fingerprint-api,android-fingerprint-api,,12,17,29,29,66,58,3,41.666667
avplayerview,avplayerview,,1,0,1,1,8,2,13,1
restful-authentication,restful-authentication,,37,32,63,69,129,132,4,1
livelink,livelink,,1,0,1,1,3,2,5,1
fragmenttransaction,fragmenttransaction,,5,10,15,15,42,30,3,100
navbar,navbar,,162,101,281,263,666,544,1,1
appbar,appbar,,19,11,30,30,41,60,13,1
shinyjs,shinyjs,,29,33,49,62,100,111,0,13.793103
google-maps-direction-api,google-maps-direction-api,,9,8,14,17,41,31,1,1
slack-api,slack-api,,96,128,184,224,347,408,6,33.333333
velocity.js,velocity.js,,5,3,7,8,38,15,1,1
apache-zeppelin,apache-zeppelin,,66,52,115,118,254,233,2,1
caesar-cipher,caesar-cipher,,17,18,46,35,83,81,0,5.882353
iphonecoredatarecipes,iphonecoredatarecipes,,2,1,1,3,5,4,13,1
nexus,nexus,,84,95,158,179,334,337,3,13.095238
react-datetime,react-datetime,,2,2,6,4,10,10,1,1
handsontable,handsontable,,19,17,50,36,115,86,1,1
transpose,transpose,,82,108,147,190,276,337,0,31.707317
tornado,tornado,,75,40,127,115,309,242,0,1
jqgrid,jqgrid,,48,51,95,99,321,194,1,6.25
analysis,analysis,,56,42,100,98,182,198,0,1
react-chartjs,react-chartjs,,25,14,42,39,46,81,1,1
gaps-and-islands,gaps-and-islands,,29,21,58,50,104,108,4,1
sql-order-by,sql-order-by,,82,107,243,189,509,432,4,30.487805
ports,ports,,3,1,1,4,68,5,6,1
azure-data-lake,azure-data-lake,,85,71,148,156,371,304,8,1
u-sql,u-sql,,10,22,82,32,246,114,8,120
zk,zk,,14,7,25,21,57,46,3,1
system.data.sqlite,system.data.sqlite,,8,13,18,21,26,39,8,62.5
pika,pika,,31,30,39,61,67,100,3,1
openseadragon,openseadragon,,2,3,6,5,19,11,1,50
text-extraction,text-extraction,,33,39,38,72,123,110,0,18.181818
name-conflict,name-conflict,,0,0,0,0,3,0,4,1
sap-cloud-platform,sap-cloud-platform,,26,23,32,49,28,81,3,1
apache-commons-vfs,apache-commons-vfs,,4,3,6,7,7,13,3,1
cwd,cwd,,2,0,1,2,4,3,9,1
refit,refit,,6,9,11,15,19,26,8,50
code-snippets,code-snippets,,51,44,74,95,120,169,9,1
http-referer,http-referer,,8,7,17,15,35,32,4,1
hapi.js,hapi.js,,2,0,3,2,14,5,1,1
widevine,widevine,,6,4,12,10,19,22,3,1
qmake,qmake,,41,35,60,76,145,136,9,1
qtcore,qtcore,,3,1,3,4,9,7,9,1
qt-linguist,qt-linguist,,1,2,4,3,8,7,9,100
prefix,prefix,,28,16,43,44,82,87,0,1
debug-symbols,debug-symbols,,28,10,22,38,55,60,9,1
ios-frameworks,ios-frameworks,,11,10,34,21,44,55,13,1
dsym,dsym,,3,6,11,9,23,20,13,100
ec2-ami,ec2-ami,,4,8,14,12,24,26,6,100
database-performance,database-performance,,48,58,132,106,231,238,4,20.833333
perl-module,perl-module,,4,2,7,6,56,13,9,1
notification-action,notification-action,,1,2,2,3,10,5,3,100
es6-promise,es6-promise,,247,183,509,430,899,939,1,1
pdf.js,pdf.js,,36,28,40,64,58,104,1,1
qtreewidget,qtreewidget,,17,13,25,30,39,55,0,1
time-format,time-format,,7,4,17,11,29,28,0,1
oledbconnection,oledbconnection,,20,19,38,39,72,77,8,1
keypress,keypress,,36,31,88,67,168,155,1,1
kalman-filter,kalman-filter,,30,23,26,53,55,79,0,1
darknet,darknet,,27,16,37,43,57,80,0,1
angularjs-controller,angularjs-controller,,7,2,19,9,53,28,1,1
seccomp,seccomp,,4,13,10,17,11,27,9,225
asp.net-mvc-routing,asp.net-mvc-routing,,19,24,46,43,156,89,8,26.315789
slf4j,slf4j,,81,83,141,164,290,305,3,2.469136
transfer-function,transfer-function,,5,1,2,6,12,8,0,1
compojure,compojure,,3,4,10,7,26,17,2,33.333333
uhd,uhd,,1,1,2,2,5,4,0,1
simple-injector,simple-injector,,32,18,51,50,111,101,8,1
query-parameters,query-parameters,,24,31,49,55,82,104,1,29.166667
raphael,raphael,,6,7,17,13,38,30,1,16.666667
vcl,vcl,,35,27,50,62,84,112,9,1
nsappleeventdescriptor,nsappleeventdescriptor,,0,0,2,0,1,2,13,1
angular2-modules,angular2-modules,,0,0,3,0,12,3,1,1
jet-ef-provider,jet-ef-provider,,1,1,2,2,4,4,8,1
android-camera,android-camera,,104,101,212,205,450,417,3,1
android-canvas,android-canvas,,53,37,113,90,173,203,3,1
dex,dex,,14,14,34,28,147,62,3,1
marshalling,marshalling,,59,59,122,118,223,240,8,1
com-interop,com-interop,,28,17,34,45,90,79,8,1
reactphp,reactphp,,7,7,15,14,23,29,4,1
break,break,,39,37,92,76,179,168,0,1
spatial,spatial,,87,69,141,156,251,297,0,1
background-color,background-color,,54,56,112,110,256,222,1,3.703704
android-sdk-tools,android-sdk-tools,,20,18,51,38,133,89,3,1
android-build,android-build,,15,21,59,36,90,95,3,40
android-sdk-manager,android-sdk-manager,,13,10,26,23,76,49,3,1
google-maps-markers,google-maps-markers,,95,103,165,198,414,363,1,8.421053
jboss-arquillian,jboss-arquillian,,10,18,36,28,88,64,3,80
persistence.xml,persistence.xml,,10,6,16,16,31,32,3,1
google-app-engine-python,google-app-engine-python,,18,11,55,29,106,84,6,1
job-scheduling,job-scheduling,,34,34,82,68,161,150,3,1
android-bitmap,android-bitmap,,56,46,102,102,199,204,3,1
relation,relation,,43,22,67,65,114,132,4,1
sankey-diagram,sankey-diagram,,27,22,51,49,89,100,0,1
networkd3,networkd3,,14,6,29,20,73,49,0,1
reserved-words,reserved-words,,6,1,10,7,23,17,4,1
unwind-segue,unwind-segue,,5,6,14,11,38,25,13,20
extent,extent,,3,5,11,8,27,19,3,66.666667
todictionary,todictionary,,0,1,2,1,4,3,8,1
attachment,attachment,,42,70,106,112,184,218,4,66.666667
mailjet,mailjet,,7,5,12,12,31,24,4,1
durandal,durandal,,1,5,5,6,15,11,1,400
msxml3,msxml3,,0,0,0,0,2,0,9,1
tr,tr,,7,10,30,17,68,47,9,42.857143
forward-declaration,forward-declaration,,12,7,33,19,79,52,9,1
windows-authentication,windows-authentication,,69,61,128,130,204,258,8,1
sqlcmd,sqlcmd,,30,37,50,67,116,117,4,23.333333
sql-server-2005-express,sql-server-2005-express,,0,0,0,0,3,0,4,1
cxf,cxf,,98,92,222,190,358,412,3,1
react-virtualized,react-virtualized,,20,21,59,41,86,100,1,5
template-deduction,template-deduction,,30,28,64,58,77,122,9,1
mouseenter,mouseenter,,9,5,13,14,32,27,1,1
arduino-esp8266,arduino-esp8266,,78,53,91,131,153,222,9,1
arduino-yun,arduino-yun,,1,0,3,1,9,4,9,1
qgis,qgis,,66,60,101,126,127,227,0,1
bson,bson,,46,31,71,77,101,148,1,1
amazon-ses,amazon-ses,,68,68,144,136,234,280,6,1
iso-8859-1,iso-8859-1,,16,20,28,36,68,64,0,25
grunt-contrib-copy,grunt-contrib-copy,,0,1,0,1,4,1,1,1
apartment-gem,apartment-gem,,6,3,15,9,18,24,12,1
pam,pam,,7,11,37,18,37,55,9,57.142857
point-cloud-library,point-cloud-library,,32,54,68,86,143,154,9,68.75
akka-http,akka-http,,53,44,120,97,275,217,2,1
castle-activerecord,castle-activerecord,,0,0,1,0,2,1,8,1
settimeout,settimeout,,95,89,208,184,427,392,1,1
squirrel.windows,squirrel.windows,,3,4,11,7,16,18,1,33.333333
node-red,node-red,,101,70,165,171,323,336,1,1
watson,watson,,1,0,2,1,226,3,6,1
watson-iot,watson-iot,,5,3,9,8,40,17,6,1
apex,apex,,93,106,137,199,248,336,14,13.978495
rails-engines,rails-engines,,7,9,17,16,28,33,12,28.571429
typo3-8.7.x,typo3-8.7.x,,5,2,26,7,88,33,4,1
ordereddictionary,ordereddictionary,,12,11,21,23,79,44,0,1
nuspec,nuspec,,8,9,26,17,44,43,8,12.5
facebook-android-sdk,facebook-android-sdk,,15,12,29,27,79,56,3,1
xslt-1.0,xslt-1.0,,137,98,180,235,383,415,3,1
xslt-grouping,xslt-grouping,,20,10,13,30,51,43,3,1
datagram,datagram,,13,14,19,27,34,46,9,7.692308
vertex-shader,vertex-shader,,14,20,46,34,78,80,9,42.857143
w3.css,w3.css,,6,7,10,13,36,23,1,16.666667
som,som,,3,7,8,10,18,18,0,133.333333
unused-variables,unused-variables,,3,4,6,7,15,13,9,33.333333
self-organizing-maps,self-organizing-maps,,1,2,3,3,13,6,0,100
particle-system,particle-system,,11,6,23,17,51,40,8,1
shoutem,shoutem,,2,2,3,4,16,7,1,1
assignment-operator,assignment-operator,,21,26,55,47,79,102,9,23.809524
root-framework,root-framework,,9,10,10,19,28,29,9,11.111111
angular-ui-tree,angular-ui-tree,,0,0,6,0,10,6,1,1
aspose-cells,aspose-cells,,4,3,8,7,45,15,8,1
picklesdoc,picklesdoc,,0,0,3,0,2,3,8,1
injectable,injectable,,2,2,1,4,20,5,1,1
putty,putty,,37,43,92,80,225,172,9,16.216216
appkit,appkit,,26,41,74,67,101,141,13,57.692308
class-library,class-library,,15,21,38,36,52,74,8,40
spring-test,spring-test,,75,69,110,144,240,254,3,1
cds,cds,,9,9,12,18,14,30,5,1
ember-router,ember-router,,1,0,7,1,12,8,1,1
interface-implementation,interface-implementation,,4,2,5,6,6,11,9,1
opcode,opcode,,9,6,17,15,30,32,9,1
obiee,obiee,,15,16,44,31,83,75,4,6.666667
signed-apk,signed-apk,,7,8,13,15,42,28,3,14.285714
contactpicker,contactpicker,,0,1,0,1,4,1,3,1
invoice,invoice,,13,18,28,31,55,59,4,38.461538
accounting,accounting,,12,10,6,22,30,28,4,1
signal-handling,signal-handling,,5,4,15,9,12,24,9,1
kafka-producer-api,kafka-producer-api,,93,83,161,176,306,337,2,1
payfort,payfort,,4,4,6,8,18,14,13,1
meta-tags,meta-tags,,36,39,86,75,127,161,1,8.333333
chrome-mobile,chrome-mobile,,3,3,6,6,6,12,1,1
distinct,distinct,,77,56,166,133,366,299,4,1
logparser,logparser,,5,5,7,10,20,17,4,1
liferay,liferay,,64,70,143,134,331,277,3,9.375
liferay-7,liferay-7,,46,46,80,92,191,172,3,1
liferay-dxp,liferay-dxp,,5,4,17,9,31,26,3,1
nexus3,nexus3,,24,20,53,44,71,97,3,1
maven-metadata,maven-metadata,,2,1,3,3,7,6,3,1
slot,slot,,9,8,16,17,45,33,9,1
hackage,hackage,,0,0,6,0,9,6,2,1
tablefilter,tablefilter,,1,2,2,3,8,5,1,100
aramex,aramex,,1,1,3,2,1,5,4,1
autoit,autoit,,19,20,50,39,129,89,3,5.263158
worklight-server,worklight-server,,1,2,5,3,26,8,13,100
worklight-security,worklight-security,,0,0,1,0,3,1,13,1
worklight-runtime,worklight-runtime,,0,0,1,0,10,1,13,1
running-total,running-total,,13,21,34,34,65,68,4,61.538462
addthis,addthis,,2,2,4,4,15,8,1,1
android-navigationview,android-navigationview,,7,12,19,19,25,38,3,71.428571
antlr,antlr,,65,44,105,109,215,214,0,1
antlr3,antlr3,,4,7,2,11,32,13,0,75
isomorphic,isomorphic,,9,2,6,11,7,17,12,1
quartz-scheduler,quartz-scheduler,,83,47,134,130,261,264,3,1
crontrigger,crontrigger,,11,5,16,16,19,32,3,1
quartz,quartz,,32,30,50,62,83,112,3,1
btdf,btdf,,0,2,4,2,6,6,8,100
text-to-speech,text-to-speech,,103,89,178,192,317,370,3,1
pyttsx,pyttsx,,8,15,10,23,30,33,0,87.5
elasticsearch-painless,elasticsearch-painless,,21,35,48,56,72,104,6,66.666667
payment-method,payment-method,,14,3,13,17,18,30,4,1
jwplayer,jwplayer,,23,22,34,45,87,79,1,1
basic4android,basic4android,,3,2,3,5,6,8,3,1
openembedded,openembedded,,16,10,35,26,70,61,9,1
depends,depends,,0,0,2,0,6,2,3,1
pyrocms,pyrocms,,1,0,5,1,16,6,4,1
binutils,binutils,,7,6,18,13,33,31,9,1
orders,orders,,96,16,149,112,288,261,4,1
clientwebsocket,clientwebsocket,,0,1,1,1,5,2,8,1
sudo,sudo,,63,57,132,120,241,252,9,1
two-factor-authentication,two-factor-authentication,,22,19,36,41,67,77,8,1
tabview,tabview,,12,10,22,22,38,44,3,1
publishing,publishing,,20,17,47,37,82,84,8,1
jboss,jboss,,232,195,511,427,896,938,3,1
cast-iron,cast-iron,,1,1,1,2,4,3,3,1
viewhelper,viewhelper,,0,0,1,0,9,1,4,1
connector,connector,,21,31,37,52,66,89,4,47.619048
azure-storage,azure-storage,,201,133,455,334,732,789,8,1
angularjs-bindings,angularjs-bindings,,2,0,2,2,7,4,1,1
google-api-java-client,google-api-java-client,,13,11,42,24,75,66,5,1
google-play-developer-api,google-play-developer-api,,15,20,27,35,51,62,3,33.333333
user-agent,user-agent,,39,36,70,75,127,145,4,1
kivy-language,kivy-language,,89,104,154,193,369,347,0,16.853933
nan,nan,,94,83,189,177,388,366,0,1
drupal-modules,drupal-modules,,24,21,79,45,70,124,4,1
opennlp,opennlp,,20,7,22,27,70,49,0,1
inline-assembly,inline-assembly,,44,50,69,94,169,163,9,13.636364
python-unittest.mock,python-unittest.mock,,7,7,15,14,15,29,0,1
gridfs,gridfs,,32,21,64,53,68,117,1,1
euro,euro,,1,0,1,1,6,2,0,1
mapstruct,mapstruct,,46,39,79,85,109,164,3,1
vb6,vb6,,73,47,193,120,352,313,8,1
icomparer,icomparer,,0,0,9,0,12,9,8,1
qshortcut,qshortcut,,2,1,0,3,2,3,0,1
static-code-analysis,static-code-analysis,,8,14,26,22,52,48,3,75
false-positive,false-positive,,8,4,13,12,15,25,0,1
pvs-studio,pvs-studio,,2,1,1,3,10,4,9,1
sap-fiori,sap-fiori,,37,35,27,72,51,99,1,1
scraper,scraper,,3,0,17,3,47,20,0,1
brightcove,brightcove,,6,6,10,12,17,22,1,1
zencoder,zencoder,,2,0,1,2,3,3,13,1
file-permissions,file-permissions,,50,45,120,95,241,215,9,1
sms-gateway,sms-gateway,,9,11,21,20,52,41,4,22.222222
haml,haml,,33,18,56,51,142,107,12,1
first-responder,first-responder,,4,1,9,5,19,14,13,1
formula,formula,,178,122,307,300,519,607,5,1
cloudera-quickstart-vm,cloudera-quickstart-vm,,5,9,15,14,38,29,2,80
runtime-error,runtime-error,,166,164,343,330,842,673,5,1
smartgwt,smartgwt,,5,6,23,11,25,34,3,20
gxt,gxt,,7,6,8,13,26,21,3,1
hidden-files,hidden-files,,5,2,11,7,15,18,0,1
file-globs,file-globs,,0,0,0,0,1,0,6,1
angular-broadcast,angular-broadcast,,0,0,0,0,6,0,1,1
quotes,quotes,,38,31,65,69,123,134,0,1
video-streaming,video-streaming,,214,182,404,396,673,800,13,1
scala-macros,scala-macros,,21,24,22,45,48,67,2,14.285714
scala-quasiquotes,scala-quasiquotes,,4,1,2,5,9,7,2,1
bamboo,bamboo,,36,46,76,82,163,158,6,27.777778
spring-cloud-config,spring-cloud-config,,47,48,127,95,192,222,3,2.12766
libjpeg,libjpeg,,7,4,12,11,29,23,9,1
cimg,cimg,,6,3,8,9,37,17,9,1
backgrid,backgrid,,2,0,4,2,3,6,1,1
backbone.paginator,backbone.paginator,,0,0,0,0,3,0,1,1
freemat,freemat,,0,0,0,0,1,0,0,1
chunking,chunking,,13,9,15,22,36,37,0,1
fixed,fixed,,24,27,56,51,110,107,1,12.5
jquery-ui-autocomplete,jquery-ui-autocomplete,,40,32,68,72,184,140,1,1
skip,skip,,9,2,20,11,55,31,0,1
read.csv,read.csv,,14,21,31,35,81,66,0,50
asp.net-routing,asp.net-routing,,4,4,7,8,27,15,8,1
angular2-changedetection,angular2-changedetection,,17,14,44,31,91,75,1,1
firebird2.5,firebird2.5,,13,7,21,20,52,41,4,1
azure-virtual-machine,azure-virtual-machine,,61,68,171,129,386,300,8,11.47541
azure-traffic-manager,azure-traffic-manager,,8,3,18,11,28,29,8,1
jboss7.x,jboss7.x,,31,34,82,65,89,147,3,9.677419
ios-universal-links,ios-universal-links,,15,20,52,35,92,87,13,33.333333
knex.js,knex.js,,104,117,200,221,277,421,1,12.5
vpython,vpython,,6,7,24,13,43,37,0,16.666667
cartesian-coordinates,cartesian-coordinates,,10,3,11,13,20,24,0,1
catalyst,catalyst,,3,14,9,17,9,26,9,366.666667
iphone-privateapi,iphone-privateapi,,1,3,4,4,16,8,13,200
mailgun,mailgun,,40,46,98,86,181,184,4,15
dbix-class,dbix-class,,2,4,8,6,22,14,9,100
dancer,dancer,,2,0,8,2,18,10,9,1
aws-mobilehub,aws-mobilehub,,3,0,16,3,81,19,6,1
xampp,xampp,,299,280,641,579,1236,1220,4,1
joptionpane,joptionpane,,25,11,45,36,97,81,3,1
spring-data-redis,spring-data-redis,,51,44,113,95,134,208,3,1
plc,plc,,28,16,49,44,81,93,9,1
azure-automation,azure-automation,,19,34,50,53,126,103,8,78.947368
azure-authentication,azure-authentication,,16,16,33,32,53,65,8,1
netflix-zuul,netflix-zuul,,93,86,155,179,227,334,3,1
rfc5545,rfc5545,,0,1,3,1,4,4,4,1
python-install,python-install,,1,3,4,4,7,8,0,200
mo,mo,,0,0,2,0,3,2,4,1
google-drive-android-api,google-drive-android-api,,16,11,54,27,102,81,3,1
valueerror,valueerror,,65,54,129,119,212,248,0,1
grid-system,grid-system,,2,1,0,3,17,3,1,1
model-validation,model-validation,,7,2,19,9,24,28,8,1
custom-model-binder,custom-model-binder,,8,5,5,13,14,18,8,1
automatic-properties,automatic-properties,,2,2,2,4,2,6,8,1
scanning,scanning,,13,13,28,26,58,54,3,1
fluentd,fluentd,,39,64,80,103,131,183,6,64.102564
unityscript,unityscript,,37,5,83,42,214,125,8,1
fold-expression,fold-expression,,6,6,9,12,23,21,9,1
python-datetime,python-datetime,,42,63,76,105,153,181,0,50
anchor,anchor,,71,81,140,152,281,292,1,14.084507
backup,backup,,99,101,184,200,387,384,4,2.020202
x509,x509,,47,35,71,82,132,153,6,1
uncrustify,uncrustify,,1,3,2,4,6,6,9,200
numpy-broadcasting,numpy-broadcasting,,44,31,82,75,134,157,0,1
kendo-window,kendo-window,,5,3,6,8,21,14,1,1
blast,blast,,1,5,13,6,17,19,0,400
ncbi,ncbi,,8,5,7,13,20,20,0,1
wpftoolkit,wpftoolkit,,12,8,22,20,40,42,8,1
name-value,name-value,,2,0,1,2,4,3,8,1
oci8,oci8,,7,10,14,17,39,31,4,42.857143
gzip,gzip,,115,126,253,241,418,494,0,9.565217
bridge,bridge,,11,11,23,22,45,45,6,1
two-way,two-way,,3,2,8,5,11,13,6,1
dagger,dagger,,73,50,109,123,245,232,3,1
jar-signing,jar-signing,,4,0,7,4,15,11,3,1
angularjs-interpolate,angularjs-interpolate,,1,2,0,3,7,3,1,100
rainmeter,rainmeter,,2,0,0,2,3,2,9,1
anonymous-types,anonymous-types,,9,7,22,16,38,38,8,1
bitcoin,bitcoin,,61,53,130,114,306,244,6,1
in-app-billing,in-app-billing,,47,67,88,114,177,202,3,42.553191
in-app-subscription,in-app-subscription,,30,27,54,57,44,111,3,1
android-push-notification,android-push-notification,,23,7,32,30,76,62,13,1
enterprise-guide,enterprise-guide,,11,17,18,28,45,46,0,54.545455
nsattributedstring,nsattributedstring,,63,39,82,102,254,184,13,1
zsh,zsh,,68,104,179,172,321,351,9,52.941176
footable,footable,,3,8,13,11,25,24,1,166.666667
android-view,android-view,,66,59,109,125,275,234,3,1
bulma,bulma,,51,37,124,88,155,212,1,1
extrapolation,extrapolation,,8,5,11,13,29,24,0,1
labview,labview,,22,25,46,47,102,93,0,13.636364
idictionary,idictionary,,4,0,4,4,6,8,8,1
iostream,iostream,,29,24,65,53,126,118,9,1
amr,amr,,0,3,2,3,4,5,13,200
connection-leaks,connection-leaks,,3,5,3,8,10,11,3,66.666667
event-bus,event-bus,,12,9,26,21,44,47,3,1
dbus,dbus,,34,22,72,56,93,128,9,1
server-sent-events,server-sent-events,,57,60,104,117,118,221,3,5.263158
opencover,opencover,,4,12,6,16,30,22,8,200
mongoimport,mongoimport,,11,11,17,22,35,39,1,1
persistent-storage,persistent-storage,,13,13,24,26,43,50,6,1
kerberos,kerberos,,108,139,246,247,341,493,2,28.703704
winrm,winrm,,16,29,33,45,67,78,8,81.25
object-literal,object-literal,,7,10,9,17,34,26,1,42.857143
bulkinsert,bulkinsert,,52,40,110,92,169,202,4,1
robot,robot,,17,12,42,29,64,71,0,1
web-worker,web-worker,,51,64,116,115,196,231,1,25.490196
html.actionlink,html.actionlink,,0,4,4,4,14,8,8,300
haskell-stack,haskell-stack,,33,32,90,65,250,155,2,1
flipview,flipview,,2,1,4,3,12,7,8,1
invoke-command,invoke-command,,23,10,17,33,73,50,8,1
scriptblock,scriptblock,,4,4,11,8,16,19,8,1
moving-average,moving-average,,29,18,60,47,124,107,0,1
standard-deviation,standard-deviation,,21,27,55,48,74,103,0,28.571429
msgbox,msgbox,,9,11,29,20,43,49,5,22.222222
signals-slots,signals-slots,,16,19,35,35,113,70,9,18.75
curses,curses,,24,20,35,44,64,79,0,1
apache-spark-ml,apache-spark-ml,,30,22,100,52,185,152,2,1
brainfuck,brainfuck,,1,3,5,4,11,9,9,200
ttk,ttk,,26,26,54,52,100,106,0,1
blueimp,blueimp,,8,11,24,19,44,43,1,37.5
web-component,web-component,,126,153,210,279,244,489,1,21.428571
pascal,pascal,,20,24,73,44,139,117,9,20
nosuchfileexception,nosuchfileexception,,3,1,1,4,9,5,0,1
google-data-studio,google-data-studio,,70,89,116,159,158,275,4,27.142857
query-performance,query-performance,,83,59,162,142,332,304,4,1
wmi,wmi,,74,76,147,150,267,297,8,2.702703
openhardwaremonitor,openhardwaremonitor,,2,2,5,4,4,9,8,1
android-event,android-event,,2,3,5,5,19,10,3,50
web-audio-api,web-audio-api,,65,47,128,112,183,240,1,1
production-environment,production-environment,,44,40,110,84,178,194,1,1
respond-to,respond-to,,0,0,4,0,8,4,12,1
maya,maya,,76,62,125,138,261,263,0,1
maya-api,maya-api,,4,5,8,9,19,17,0,25
mpld3,mpld3,,2,4,13,6,28,19,0,100
avfoundation,avfoundation,,136,124,327,260,557,587,13,1
jira-rest-api,jira-rest-api,,48,51,111,99,162,210,6,6.25
row,row,,141,109,260,250,543,510,0,1
uniqueidentifier,uniqueidentifier,,15,12,49,27,95,76,4,1
richtextbox,richtextbox,,49,32,85,81,180,166,8,1
markerclusterer,markerclusterer,,17,16,32,33,57,65,1,1
video.js,video.js,,59,49,133,108,167,241,1,1
c-strings,c-strings,,38,66,84,104,144,188,9,73.684211
char-pointer,char-pointer,,2,3,6,5,12,11,9,50
http-options-method,http-options-method,,0,3,8,3,8,11,4,200
barcode-scanner,barcode-scanner,,60,43,121,103,252,224,3,1
sox,sox,,14,11,34,25,49,59,13,1
iis-express,iis-express,,47,39,92,86,180,178,8,1
iis-metabase,iis-metabase,,0,0,0,0,1,0,8,1
netsuite,netsuite,,147,123,304,270,405,574,14,1
suitetalk,suitetalk,,4,2,22,6,25,28,14,1
query-optimization,query-optimization,,99,110,217,209,506,426,4,11.111111
variable-assignment,variable-assignment,,65,75,128,140,276,268,0,15.384615
assign,assign,,39,29,76,68,127,144,0,1
scenekit,scenekit,,135,143,324,278,778,602,13,5.925926
scnnode,scnnode,,17,19,39,36,99,75,13,11.764706
cx-oracle,cx-oracle,,57,69,98,126,171,224,0,21.052632
windows-store-apps,windows-store-apps,,16,24,54,40,138,94,8,50
java.util.calendar,java.util.calendar,,5,6,13,11,42,24,3,20
asp.net-core-tag-helpers,asp.net-core-tag-helpers,,20,18,31,38,102,69,8,1
contenteditable,contenteditable,,38,44,95,82,189,177,1,15.789474
npgsql,npgsql,,51,46,93,97,172,190,8,1
webdriver-io,webdriver-io,,57,61,109,118,234,227,3,7.017544
gis,gis,,157,159,302,316,495,618,0,1.273885
rgeo,rgeo,,3,4,1,7,14,8,12,33.333333
rad,rad,,5,1,8,6,15,14,3,1
sharepoint-online,sharepoint-online,,190,164,324,354,514,678,8,1
android-xml,android-xml,,69,45,84,114,171,198,3,1
zul,zul,,3,2,6,5,13,11,3,1
class-variables,class-variables,,6,7,14,13,31,27,0,16.666667
required,required,,19,14,27,33,75,60,1,1
laravel-validation,laravel-validation,,22,26,41,48,117,89,4,18.181818
geofencing,geofencing,,16,24,49,40,92,89,3,50
linkedin-api,linkedin-api,,140,113,201,253,229,454,4,1
function-calls,function-calls,,0,0,0,0,35,0,0,1
jsonresponse,jsonresponse,,13,15,14,28,27,42,3,15.384615
impala,impala,,82,88,156,170,282,326,2,7.317073
java-annotations,java-annotations,,6,9,20,15,39,35,3,50
dotnet-cli,dotnet-cli,,14,10,29,24,56,53,8,1
mdbootstrap,mdbootstrap,,32,35,38,67,38,105,1,9.375
oracle-golden-gate,oracle-golden-gate,,7,3,12,10,21,22,4,1
mapr-streams,mapr-streams,,0,0,0,0,7,0,3,1
p4v,p4v,,2,6,12,8,28,20,6,200
calculation,calculation,,52,72,109,124,202,233,0,38.461538
typedef,typedef,,39,33,97,72,166,169,9,1
powerbuilder,powerbuilder,,14,8,32,22,65,54,8,1
elf,elf,,49,46,90,95,178,185,9,1
codeceptjs,codeceptjs,,16,11,28,27,24,55,3,1
jsf-2,jsf-2,,36,28,76,64,295,140,3,1
salesforce-mobile-sdk,salesforce-mobile-sdk,,3,5,1,8,1,9,14,66.666667
minecraft,minecraft,,67,92,115,159,226,274,3,37.313433
maven-plugin,maven-plugin,,81,67,172,148,310,320,3,1
autoscaling,autoscaling,,78,72,168,150,235,318,6,1
plots.jl,plots.jl,,13,4,13,17,19,30,0,1
mlcp,mlcp,,7,6,19,13,26,32,3,1
jquery-plugins,jquery-plugins,,43,53,127,96,329,223,1,23.255814
dotcover,dotcover,,5,1,13,6,22,19,8,1
yeoman,yeoman,,13,14,24,27,56,51,1,7.692308
yeoman-generator,yeoman-generator,,10,9,17,19,32,36,1,1
spfx,spfx,,61,45,78,106,69,184,8,1
react-native-flatlist,react-native-flatlist,,144,112,232,256,361,488,1,1
firebase-hosting,firebase-hosting,,93,89,167,182,347,349,13,1
gapi,gapi,,17,20,38,37,43,75,5,17.647059
spring-boot-configuration,spring-boot-configuration,,1,1,6,2,25,8,3,1
restore,restore,,48,48,69,96,180,165,4,1
minimize,minimize,,22,14,54,36,67,90,0,1
qt-designer,qt-designer,,53,51,105,104,151,209,0,1
hlsl,hlsl,,24,41,62,65,79,127,9,70.833333
office365connectors,office365connectors,,9,8,8,17,21,25,8,1
npm-request,npm-request,,3,7,19,10,39,29,1,133.333333
action-filter,action-filter,,6,3,23,9,32,32,8,1
saving-data,saving-data,,6,4,16,10,33,26,0,1
rdata,rdata,,8,7,7,15,13,22,0,1
ntp,ntp,,12,18,27,30,56,57,9,50
fileinputstream,fileinputstream,,16,15,43,31,82,74,3,1
end-of-line,end-of-line,,2,4,4,6,7,10,9,100
macvim,macvim,,1,3,10,4,49,14,9,200
gateway,gateway,,48,32,85,80,117,165,3,1
rcp,rcp,,27,20,56,47,128,103,3,1
subject,subject,,10,9,30,19,49,49,1,1
smo,smo,,9,14,23,23,42,46,4,55.555556
databricks,databricks,,196,214,320,410,245,730,2,9.183673
mysqlimport,mysqlimport,,3,1,3,4,15,7,4,1
git-patch,git-patch,,1,2,4,3,8,7,6,100
border-box,border-box,,0,1,2,1,4,3,1,1
box-sizing,box-sizing,,1,2,8,3,13,11,1,100
java-memory-model,java-memory-model,,7,3,19,10,35,29,3,1
ora-12154,ora-12154,,0,0,2,0,2,2,4,1
magnific-popup,magnific-popup,,13,12,29,25,44,54,1,1
xcode-ui-testing,xcode-ui-testing,,26,12,50,38,156,88,13,1
ui-testing,ui-testing,,48,21,43,69,83,112,3,1
checker-framework,checker-framework,,2,3,2,5,13,7,3,50
phusion,phusion,,3,3,2,6,11,8,12,1
alexa-skill,alexa-skill,,70,75,173,145,337,318,6,7.142857
django-cms,django-cms,,24,29,51,53,106,104,0,20.833333
oracle-sqldeveloper,oracle-sqldeveloper,,169,130,309,299,535,608,4,1
bubble-popup,bubble-popup,,1,1,0,2,2,2,3,1
linechart,linechart,,61,47,90,108,189,198,1,1
bootstrap-daterangepicker,bootstrap-daterangepicker,,4,4,6,8,25,14,1,1
asp.net-web-api2,asp.net-web-api2,,202,143,443,345,1114,788,8,1
fiddler,fiddler,,32,36,83,68,110,151,8,12.5
testcase,testcase,,28,18,48,46,77,94,3,1
test-suite,test-suite,,7,2,18,9,27,27,3,1
ldd,ldd,,9,3,12,12,21,24,9,1
docker-for-mac,docker-for-mac,,15,11,21,26,60,47,6,1
shared-project,shared-project,,4,5,5,9,17,14,8,25
gunicorn,gunicorn,,154,144,271,298,473,569,0,1
dl4j,dl4j,,9,8,16,17,42,33,3,1
nd4j,nd4j,,8,3,15,11,25,26,3,1
messenger,messenger,,33,16,62,49,132,111,13,1
kendo-asp.net-mvc,kendo-asp.net-mvc,,78,38,142,116,228,258,1,1
factors,factors,,20,13,29,33,58,62,0,1
fullpage.js,fullpage.js,,30,21,37,51,128,88,1,1
.net-3.5,.net-3.5,,13,13,58,26,86,84,8,1
azure-table-storage,azure-table-storage,,43,56,112,99,214,211,8,30.232558
ibeacon,ibeacon,,27,18,63,45,161,108,3,1
android-tabs,android-tabs,,5,9,22,14,59,36,3,80
pid,pid,,34,20,63,54,127,117,9,1
spawn,spawn,,32,39,67,71,88,138,1,21.875
android-touch-event,android-touch-event,,8,5,24,13,27,37,3,1
cacheapi,cacheapi,,1,3,9,4,11,13,1,200
grand-central-dispatch,grand-central-dispatch,,50,49,104,99,277,203,13,1
completionhandler,completionhandler,,18,15,44,33,98,77,13,1
bitwise-or,bitwise-or,,2,2,5,4,12,9,9,1
code-first,code-first,,32,13,45,45,90,90,8,1
babylonjs,babylonjs,,14,12,21,26,45,47,1,1
axapta,axapta,,28,22,64,50,122,114,8,1
x++,x++,,26,22,31,48,65,79,8,1
dynamics-ax7,dynamics-ax7,,0,0,1,0,10,1,8,1
dynamics-365-operations,dynamics-365-operations,,11,13,26,24,23,50,8,18.181818
rmi,rmi,,32,14,45,46,122,91,3,1
android-espresso,android-espresso,,163,118,242,281,430,523,3,1
consul,consul,,53,50,96,103,140,199,3,1
blogger,blogger,,69,54,125,123,226,248,1,1
blogspot,blogspot,,12,0,20,12,31,32,1,1
nlog,nlog,,72,80,129,152,247,281,8,11.111111
rx-swift,rx-swift,,105,94,207,199,413,406,13,1
arff,arff,,8,1,16,9,22,25,0,1
train-test-split,train-test-split,,21,21,23,42,29,65,0,1
tessnet2,tessnet2,,0,1,0,1,2,1,0,1
expectations,expectations,,4,1,2,5,9,7,3,1
binaryfiles,binaryfiles,,63,43,111,106,227,217,0,1
firebase-analytics,firebase-analytics,,111,94,220,205,351,425,13,1
signature,signature,,44,47,114,91,178,205,6,6.818182
tokenize,tokenize,,77,60,116,137,196,253,0,1
pos-tagger,pos-tagger,,10,12,36,22,59,58,0,20
code-signing,code-signing,,48,30,91,78,167,169,13,1
testflight,testflight,,40,36,72,76,166,148,13,1
apple-developer,apple-developer,,20,11,32,31,48,63,13,1
object-files,object-files,,9,7,11,16,27,27,9,1
ibm-mobilefirst,ibm-mobilefirst,,23,23,67,46,213,113,13,1
ibm-mobile-services,ibm-mobile-services,,2,1,3,3,12,6,6,1
vertical-alignment,vertical-alignment,,49,40,74,89,190,163,1,1
paste,paste,,60,57,126,117,220,243,5,1
jira-plugin,jira-plugin,,14,17,37,31,58,68,6,21.428571
jira-agile,jira-agile,,0,2,12,2,24,14,6,100
uiactivityindicatorview,uiactivityindicatorview,,15,6,15,21,52,36,13,1
glsl,glsl,,157,156,339,313,535,652,9,1
microsoft-account,microsoft-account,,3,1,15,4,17,19,8,1
lowpass-filter,lowpass-filter,,4,4,8,8,11,16,0,1
lwjgl,lwjgl,,49,38,97,87,192,184,3,1
google-home,google-home,,40,42,124,82,252,206,13,5
smtp-auth,smtp-auth,,3,5,11,8,16,19,4,66.666667
voip,voip,,55,52,123,107,220,230,13,1
namespaces,namespaces,,163,148,339,311,798,650,9,1
systemjs,systemjs,,18,6,35,24,108,59,1,1
daterangepicker,daterangepicker,,24,21,45,45,64,90,1,1
google-plugin-eclipse,google-plugin-eclipse,,0,0,0,0,9,0,6,1
google-cloud-tools,google-cloud-tools,,0,1,3,1,10,4,6,1
officer,officer,,15,24,35,39,55,74,0,60
boto3,boto3,,286,338,527,624,910,1151,6,18.181818
ambiguous,ambiguous,,10,5,22,15,56,37,9,1
angular-router-guards,angular-router-guards,,10,18,31,28,50,59,1,80
android-videoview,android-videoview,,40,37,82,77,162,159,3,1
angular-ui-bootstrap,angular-ui-bootstrap,,53,50,83,103,296,186,1,1
outsystems,outsystems,,5,4,7,9,18,16,1,1
acumatica-kb,acumatica-kb,,22,19,29,41,28,70,8,1
ssis-2012,ssis-2012,,48,45,98,93,169,191,4,1
qcombobox,qcombobox,,20,23,40,43,94,83,0,15
date-fns,date-fns,,12,10,22,22,18,44,1,1
incoming-mail,incoming-mail,,1,3,5,4,7,9,4,200
php-7.1,php-7.1,,24,15,73,39,203,112,4,1
redactor,redactor,,2,2,4,4,15,8,4,1
windows-server-2016,windows-server-2016,,54,51,143,105,226,248,8,1
iis-10,iis-10,,53,47,80,100,150,180,8,1
hashable,hashable,,10,6,11,16,16,27,13,1
datastax-java-driver,datastax-java-driver,,18,25,34,43,91,77,2,38.888889
jsonparser,jsonparser,,33,29,54,62,116,116,1,1
erlang-shell,erlang-shell,,4,4,4,8,20,12,2,1
middleman-4,middleman-4,,1,1,3,2,8,5,12,1
context-free-grammar,context-free-grammar,,24,13,48,37,89,85,0,1
nucleo,nucleo,,14,11,13,25,22,38,9,1
centos6,centos6,,28,21,73,49,128,122,9,1
margin,margin,,38,43,81,81,205,162,1,13.157895
page-numbering,page-numbering,,6,1,11,7,9,18,5,1
footnotes,footnotes,,1,10,1,11,11,12,0,900
azure-storage-files,azure-storage-files,,7,9,9,16,37,25,8,28.571429
shockwave,shockwave,,0,2,1,2,2,3,13,100
swashbuckle,swashbuckle,,45,69,109,114,201,223,8,53.333333
layout-inflater,layout-inflater,,22,21,46,43,98,89,3,1
spark-jobserver,spark-jobserver,,4,1,3,5,12,8,2,1
algolia,algolia,,76,58,126,134,233,260,4,1
laravel-scout,laravel-scout,,7,11,19,18,44,37,4,57.142857
rpart,rpart,,29,14,28,43,63,71,0,1
tortoisesvn,tortoisesvn,,34,34,106,68,204,174,6,1
spring-webflux,spring-webflux,,249,275,427,524,577,951,3,10.441767
.post,.post,,1,2,5,3,6,8,1,100
ioslides,ioslides,,3,2,7,5,32,12,0,1
kendo-scheduler,kendo-scheduler,,6,5,9,11,28,20,1,1
ember-simple-auth,ember-simple-auth,,4,3,6,7,10,13,1,1
mime-types,mime-types,,59,61,128,120,208,248,4,3.389831
symfony-1.4,symfony-1.4,,4,1,11,5,35,16,4,1
mime,mime,,36,30,77,66,120,143,4,1
f#-scripting,f#-scripting,,0,0,3,0,3,3,8,1
idris,idris,,17,13,32,30,90,62,2,1
rational-numbers,rational-numbers,,0,0,0,0,9,0,9,1
usb-otg,usb-otg,,8,6,12,14,15,26,3,1
concatenation,concatenation,,190,185,370,375,769,745,0,1
mp4,mp4,,70,62,149,132,235,281,13,1
rxjs5,rxjs5,,20,9,56,29,420,85,1,1
quickfix,quickfix,,10,21,19,31,56,50,14,110
fix-protocol,fix-protocol,,12,17,19,29,41,48,14,41.666667
excel-2007,excel-2007,,21,11,44,32,123,76,5,1
android-button,android-button,,55,53,79,108,127,187,3,1
filewriter,filewriter,,21,9,40,30,96,70,3,1
voice-recognition,voice-recognition,,42,29,62,71,141,133,3,1
recognizer-intent,recognizer-intent,,1,1,0,2,3,2,3,1
ggplotly,ggplotly,,48,38,56,86,132,142,0,1
nose,nose,,16,7,32,23,62,55,0,1
carthage,carthage,,23,27,49,50,66,99,13,17.391304
linux-capabilities,linux-capabilities,,2,7,11,9,16,20,9,250
odoo-accounting,odoo-accounting,,1,0,3,1,2,4,0,1
rule-engine,rule-engine,,15,23,46,38,67,84,3,53.333333
formset,formset,,18,10,39,28,68,67,0,1
inline-formset,inline-formset,,12,6,18,18,36,36,0,1
formidable,formidable,,16,13,36,29,41,65,1,1
ane,ane,,5,0,1,5,12,6,13,1
outliers,outliers,,52,42,65,94,106,159,0,1
resteasy,resteasy,,28,25,80,53,140,133,3,1
dependency-parsing,dependency-parsing,,6,2,4,8,12,12,0,1
dereference,dereference,,18,20,31,38,84,69,9,11.111111
altbeacon,altbeacon,,30,22,48,52,87,100,3,1
android-orientation,android-orientation,,4,5,13,9,47,22,3,25
gatsby,gatsby,,319,360,426,679,346,1105,1,12.852665
euler-angles,euler-angles,,14,8,30,22,49,52,0,1
symfony3.x,symfony3.x,,7,3,26,10,121,36,4,1
resolve,resolve,,15,5,22,20,72,42,1,1
mathematical-optimization,mathematical-optimization,,92,72,143,164,288,307,0,1
evolutionary-algorithm,evolutionary-algorithm,,12,9,22,21,34,43,0,1
twilio-php,twilio-php,,14,24,42,38,95,80,13,71.428571
wordpress-rest-api,wordpress-rest-api,,72,93,180,165,207,345,4,29.166667
flexslider,flexslider,,7,6,35,13,35,48,1,1
hwioauthbundle,hwioauthbundle,,5,3,9,8,22,17,4,1
yahoo,yahoo,,9,10,20,19,34,39,4,11.111111
yahoo-api,yahoo-api,,8,8,18,16,49,34,4,1
apache-commons-cli,apache-commons-cli,,2,4,10,6,9,16,3,100
httpcontext,httpcontext,,19,25,50,44,66,94,8,31.578947
asp.net-core-middleware,asp.net-core-middleware,,15,13,15,28,50,43,8,1
sandbox,sandbox,,36,45,93,81,132,174,13,25
symfony-console,symfony-console,,2,5,4,7,23,11,4,150
rpgle,rpgle,,10,11,34,21,80,55,4,10
instrumentation,instrumentation,,20,16,45,36,105,81,3,1
mobx,mobx,,111,92,198,203,343,401,1,1
mobx-react,mobx-react,,61,38,95,99,153,194,1,1
autoload,autoload,,23,26,53,49,126,102,4,13.043478
z-index,z-index,,45,40,100,85,206,185,1,1
angular2-hostbinding,angular2-hostbinding,,0,0,7,0,11,7,1,1
webfonts,webfonts,,17,28,51,45,113,96,1,64.705882
woff2,woff2,,1,2,5,3,7,8,1,100
gtm-database,gtm-database,,1,0,0,1,3,1,5,1
newtype,newtype,,2,3,9,5,15,14,2,50
whenever,whenever,,6,5,12,11,32,23,12,1
whenever-capistrano,whenever-capistrano,,0,1,0,1,1,1,12,1
xml-validation,xml-validation,,16,16,30,32,84,62,3,1
temporary-files,temporary-files,,15,21,28,36,74,64,0,40
temporary-objects,temporary-objects,,8,3,14,11,20,25,9,1
c++-cli,c++-cli,,55,40,115,95,300,210,8,1
easyautocomplete,easyautocomplete,,2,3,10,5,18,15,1,50
strncmp,strncmp,,1,3,4,4,7,8,9,200
cancancan,cancancan,,9,9,29,18,63,47,12,1
spark-submit,spark-submit,,23,28,68,51,129,119,2,21.73913
readr,readr,,15,16,42,31,77,73,0,6.666667
glfw,glfw,,58,53,124,111,193,235,9,1
stylelint,stylelint,,17,8,15,25,32,40,1,1
solace,solace,,15,12,21,27,46,48,3,1
keystonejs,keystonejs,,14,19,38,33,85,71,1,35.714286
webvr,webvr,,24,19,63,43,137,106,1,1
android-asynctask,android-asynctask,,152,97,294,249,831,543,3,1
vscode-tasks,vscode-tasks,,21,31,46,52,60,98,9,47.619048
apache-servicemix,apache-servicemix,,5,11,24,16,43,40,3,120
ace,ace,,2,0,4,2,16,6,9,1
indexoutofboundsexception,indexoutofboundsexception,,58,29,139,87,241,226,3,1
getelementbyid,getelementbyid,,32,31,63,63,177,126,1,1
mpandroidchart,mpandroidchart,,62,75,131,137,298,268,3,20.967742
swiperefreshlayout,swiperefreshlayout,,26,17,29,43,82,72,3,1
updates,updates,,74,93,165,167,328,332,4,25.675676
android-testing,android-testing,,52,72,126,124,184,250,3,38.461538
embed,embed,,78,79,204,157,236,361,1,1.282051
gitignore,gitignore,,56,63,125,119,251,244,6,12.5
3dsmax,3dsmax,,12,6,36,18,53,54,0,1
fbx,fbx,,13,13,25,26,53,51,1,1
git-bash,git-bash,,130,113,205,243,323,448,6,1
scapy,scapy,,64,59,116,123,220,239,9,1
html-heading,html-heading,,8,4,9,12,24,21,1,1
auto-increment,auto-increment,,44,32,74,76,149,150,4,1
aws-iot,aws-iot,,76,45,119,121,228,240,6,1
postmessage,postmessage,,23,13,46,36,63,82,1,1
sp-send-dbmail,sp-send-dbmail,,9,2,6,11,25,17,4,1
fedex,fedex,,11,10,29,21,16,50,4,1
asp-classic,asp-classic,,69,76,115,145,330,260,5,10.144928
ecmascript-2017,ecmascript-2017,,6,9,35,15,108,50,1,50
bazel-aspect,bazel-aspect,,0,1,2,1,6,3,9,1
html5-audio,html5-audio,,88,73,150,161,242,311,1,1
audio-streaming,audio-streaming,,46,52,116,98,131,214,13,13.043478
esri-javascript-api,esri-javascript-api,,2,0,11,2,14,13,1,1
static-files,static-files,,21,10,34,31,65,65,0,1
opus,opus,,12,11,18,23,36,41,13,1
orthographic,orthographic,,3,3,11,6,34,17,9,1
swifty-json,swifty-json,,32,15,56,47,133,103,13,1
webservicetemplate,webservicetemplate,,2,4,6,6,7,12,3,100
wlan,wlan,,7,5,12,12,22,24,3,1
instances,instances,,0,0,0,0,57,0,9,1
setinterval,setinterval,,90,79,179,169,355,348,1,1
memory-profiling,memory-profiling,,8,2,12,10,33,22,9,1
bro,bro,,0,1,4,1,12,5,9,1
prerender,prerender,,19,17,37,36,60,73,1,1
vaadin-grid,vaadin-grid,,16,14,20,30,82,50,3,1
opengraph,opengraph,,13,23,46,36,87,82,13,76.923077
typed.js,typed.js,,2,5,8,7,14,15,1,150
pandas-groupby,pandas-groupby,,446,540,965,986,1396,1951,0,21.076233
lync,lync,,5,5,14,10,35,24,8,1
ucma,ucma,,2,0,12,2,12,14,8,1
deflate,deflate,,4,8,22,12,35,34,0,100
backup-sqldatabase,backup-sqldatabase,,2,0,0,2,4,2,4,1
interrupted-exception,interrupted-exception,,3,3,6,6,15,12,3,1
nearest-neighbor,nearest-neighbor,,32,28,54,60,110,114,0,1
pentaho,pentaho,,80,78,182,158,373,340,4,1
data-integration,data-integration,,6,5,12,11,19,23,4,1
mathnet-numerics,mathnet-numerics,,2,3,6,5,22,11,8,50
helper,helper,,23,21,72,44,86,116,4,1
extend,extend,,24,21,41,45,70,86,9,1
materialize,materialize,,130,112,305,242,721,547,1,1
outputstream,outputstream,,28,18,50,46,114,96,3,1
storage-access-framework,storage-access-framework,,8,19,17,27,31,44,3,137.5
documentfile,documentfile,,1,1,6,2,11,8,3,1
precompile,precompile,,11,8,12,19,33,31,12,1
therubyracer,therubyracer,,1,0,1,1,5,2,12,1
execjs,execjs,,0,0,2,0,7,2,12,1
highmaps,highmaps,,0,0,0,0,50,0,1,1
paramiko,paramiko,,90,120,146,210,269,356,0,33.333333
sensenet,sensenet,,1,3,7,4,16,11,8,200
jsonpath,jsonpath,,63,55,96,118,186,214,1,1
pie-chart,pie-chart,,45,61,136,106,251,242,1,35.555556
smartgwt-pro,smartgwt-pro,,0,0,0,0,3,0,3,1
printdocument,printdocument,,6,12,13,18,22,31,8,100
mapquest,mapquest,,1,5,8,6,23,14,1,400
forwarding,forwarding,,13,15,23,28,27,51,4,15.384615
lldb,lldb,,33,32,98,65,143,163,13,1
appcode,appcode,,2,3,6,5,17,11,13,50
app-code,app-code,,0,1,4,1,9,5,8,1
glusterfs,glusterfs,,3,6,34,9,38,43,6,100
phonegap-cli,phonegap-cli,,2,4,7,6,22,13,1,100
gcp,gcp,,3,3,3,6,199,9,6,1
pjsip,pjsip,,20,43,48,63,112,111,13,115
pjsua2,pjsua2,,11,12,19,23,27,42,13,9.090909
hortonworks-data-platform,hortonworks-data-platform,,30,44,120,74,188,194,2,46.666667
angular2-pipe,angular2-pipe,,1,0,1,1,25,2,1,1
ramda.js,ramda.js,,58,42,87,100,193,187,1,1
clockrates,clockrates,,0,0,0,0,2,0,0,1
perlin-noise,perlin-noise,,13,6,19,19,25,38,0,1
bootstrap-datetimepicker,bootstrap-datetimepicker,,19,18,43,37,99,80,1,1
removing-whitespace,removing-whitespace,,13,20,28,33,66,61,0,53.846154
android-update-app,android-update-app,,1,5,3,6,11,9,3,400
entitlements,entitlements,,7,6,17,13,17,30,13,1
milestone,milestone,,3,3,1,6,6,7,3,1
dynamic-allocation,dynamic-allocation,,0,0,3,0,68,3,9,1
jpl,jpl,,0,1,9,1,5,10,3,1
yasnippet,yasnippet,,0,0,0,0,3,0,9,1
android-alertdialog,android-alertdialog,,86,93,167,179,450,346,3,8.139535
forkjoinpool,forkjoinpool,,13,10,24,23,27,47,3,1
intel-fortran,intel-fortran,,23,21,52,44,89,96,9,1
array-column,array-column,,5,2,5,7,15,12,4,1
alfresco,alfresco,,39,38,83,77,237,160,3,1
alfresco-maven,alfresco-maven,,2,4,2,6,12,8,3,100
emc,emc,,0,2,4,2,8,6,6,100
python-webbrowser,python-webbrowser,,14,10,18,24,37,42,0,1
css-loader,css-loader,,25,35,44,60,125,104,1,40
drools,drools,,80,106,196,186,330,382,3,32.5
rete,rete,,1,0,2,1,3,3,3,1
postgrex,postgrex,,2,3,5,5,7,10,2,50
pm2,pm2,,92,88,187,180,242,367,1,1
archive,archive,,45,42,75,87,145,162,4,1
provisioning-profile,provisioning-profile,,37,27,64,64,141,128,13,1
ios-app-extension,ios-app-extension,,16,8,15,24,54,39,13,1
text-classification,text-classification,,95,56,137,151,218,288,0,1
fluentvalidation,fluentvalidation,,28,33,68,61,80,129,8,17.857143
broadcast,broadcast,,48,31,108,79,161,187,9,1
submenu,submenu,,22,17,38,39,89,77,1,1
jquery-ui-contextmenu,jquery-ui-contextmenu,,0,1,2,1,3,3,1,1
fluent-nhibernate,fluent-nhibernate,,25,22,38,47,95,85,8,1
nhibernate-mapping,nhibernate-mapping,,6,12,13,18,42,31,8,100
laravel-routing,laravel-routing,,19,23,90,42,139,132,4,21.052632
weak-references,weak-references,,15,20,28,35,80,63,13,33.333333
asmx,asmx,,37,30,71,67,83,138,8,1
boxplot,boxplot,,90,90,171,180,313,351,0,1
ms-access-2010,ms-access-2010,,65,60,152,125,409,277,5,1
prebid.js,prebid.js,,4,3,14,7,12,21,3,1
batch-processing,batch-processing,,52,67,153,119,342,272,3,28.846154
proc,proc,,24,20,43,44,74,87,0,1
validationerror,validationerror,,3,4,6,7,19,13,0,33.333333
global-temp-tables,global-temp-tables,,2,2,3,4,11,7,4,1
angular-ui-grid,angular-ui-grid,,16,16,40,32,132,72,1,1
outlook-api,outlook-api,,6,6,11,12,29,23,8,1
dirty-tracking,dirty-tracking,,0,0,0,0,2,0,3,1
powerbi-embedded,powerbi-embedded,,42,24,94,66,179,160,5,1
knockout-3.0,knockout-3.0,,3,5,29,8,57,37,1,66.666667
computed-observable,computed-observable,,0,1,5,1,9,6,1,1
bit-shift,bit-shift,,47,28,81,75,137,156,9,1
ios-autolayout,ios-autolayout,,42,34,79,76,171,155,13,1
tx-news,tx-news,,26,14,40,40,73,80,4,1
azure-sql-server,azure-sql-server,,23,20,44,43,71,87,8,1
kill,kill,,28,16,60,44,107,104,9,1
oh-my-zsh,oh-my-zsh,,25,25,38,50,90,88,9,1
php-extension,php-extension,,17,14,36,31,74,67,4,1
phpinfo,phpinfo,,3,2,8,5,20,13,4,1
bandwidth,bandwidth,,16,11,31,27,46,58,9,1
angular-strap,angular-strap,,0,0,1,0,12,1,1,1
etw,etw,,6,6,27,12,29,39,8,1
google-cloud-sql,google-cloud-sql,,135,119,233,254,396,487,6,1
kotlin-null-safety,kotlin-null-safety,,2,2,12,4,29,16,3,1
model-binding,model-binding,,51,39,85,90,157,175,8,1
oembed,oembed,,6,7,10,13,10,23,4,16.666667
rulers,rulers,,1,0,3,1,5,4,8,1
google-web-component,google-web-component,,0,2,0,2,10,2,1,100
ant,ant,,122,102,250,224,523,474,3,1
webkit,webkit,,91,78,162,169,258,331,1,1
mamp,mamp,,39,46,130,85,242,215,4,17.948718
flatten,flatten,,36,39,63,75,113,138,0,8.333333
google-datatable,google-datatable,,1,0,1,1,3,2,1,1
cudafy.net,cudafy.net,,0,1,1,1,3,2,8,1
binary-decision-diagram,binary-decision-diagram,,3,0,2,3,12,5,0,1
angularjs-rootscope,angularjs-rootscope,,0,1,3,1,16,4,1,1
channel,channel,,44,42,115,86,186,201,6,1
constantcontact,constantcontact,,1,0,1,1,8,2,4,1
ui-automation,ui-automation,,91,98,199,189,332,388,3,7.692308
pywinauto,pywinauto,,24,35,77,59,103,136,0,45.833333
outer-join,outer-join,,30,26,53,56,136,109,4,1
thread-safety,thread-safety,,147,128,303,275,557,578,3,1
swt,swt,,68,48,115,116,285,231,3,1
asp.net-webpages,asp.net-webpages,,7,4,8,11,9,19,8,1
wpf-style,wpf-style,,4,3,16,7,23,23,8,1
google-elevation-api,google-elevation-api,,2,2,1,4,5,5,1,1
homescreen,homescreen,,4,5,17,9,35,26,3,25
account-kit,account-kit,,13,11,23,24,50,47,3,1
scene,scene,,26,15,61,41,83,102,3,1
oms,oms,,3,1,7,4,10,11,8,1
jigsaw,jigsaw,,22,19,53,41,98,94,3,1
picasso,picasso,,76,55,137,131,314,268,3,1
kentico,kentico,,25,50,77,75,157,152,8,100
kamailio,kamailio,,4,9,11,13,32,24,13,125
jssip,jssip,,1,2,5,3,10,8,13,100
seam3,seam3,,1,0,0,1,1,1,3,1
crystal-reports-2010,crystal-reports-2010,,12,8,34,20,48,54,8,1
system.diagnostics,system.diagnostics,,7,12,26,19,35,45,8,71.428571
strsplit,strsplit,,15,11,33,26,72,59,0,1
file-conversion,file-conversion,,8,24,34,32,52,66,0,200
docker-build,docker-build,,19,18,32,37,64,69,6,1
ecmascript-5,ecmascript-5,,64,50,162,114,269,276,1,1
assemblies,assemblies,,7,10,22,17,38,39,8,42.857143
cloudkit,cloudkit,,37,39,84,76,174,160,13,5.405405
sense,sense,,1,1,1,2,8,3,6,1
nmake,nmake,,7,9,20,16,24,36,9,28.571429
setting,setting,,0,0,0,0,13,0,4,1
virtualenvwrapper,virtualenvwrapper,,12,11,29,23,76,52,0,1
routeparams,routeparams,,1,3,10,4,23,14,1,200
nslookup,nslookup,,4,5,15,9,23,24,4,25
virtual-keyboard,virtual-keyboard,,8,8,15,16,32,31,9,1
android-preferences,android-preferences,,34,36,75,70,90,145,3,5.882353
hammer.js,hammer.js,,17,19,33,36,54,69,1,11.764706
halide,halide,,1,9,6,10,12,16,9,800
android-switch,android-switch,,7,3,5,10,18,15,3,1
oncheckedchanged,oncheckedchanged,,2,3,7,5,6,12,3,50
wchar-t,wchar-t,,6,2,8,8,29,16,9,1
wstring,wstring,,2,3,9,5,24,14,9,50
stdout,stdout,,96,84,178,180,369,358,9,1
strawberry-perl,strawberry-perl,,5,7,5,12,17,17,9,40
virtual-dom,virtual-dom,,3,4,21,7,34,28,1,33.333333
bulk-load,bulk-load,,6,10,13,16,36,29,4,66.666667
buildpack,buildpack,,6,6,17,12,30,29,1,1
swisscomdev,swisscomdev,,10,4,16,14,57,30,3,1
vector-graphics,vector-graphics,,13,19,42,32,65,74,1,46.153846
inkscape,inkscape,,17,23,28,40,69,68,1,35.294118
transparency,transparency,,43,43,88,86,162,174,1,1
imagefilter,imagefilter,,6,5,12,11,24,23,0,1
pointer-arithmetic,pointer-arithmetic,,13,8,27,21,53,48,9,1
tdatasetprovider,tdatasetprovider,,0,0,2,0,3,2,9,1
azure-iot-hub,azure-iot-hub,,111,100,194,211,300,405,8,1
nsmutableurlrequest,nsmutableurlrequest,,1,5,4,6,17,10,13,400
arcpy,arcpy,,24,22,39,46,53,85,0,1
selenium-ide,selenium-ide,,34,43,45,77,90,122,3,26.470588
selenium-rc,selenium-rc,,3,0,4,3,12,7,3,1
alphablending,alphablending,,10,5,13,15,27,28,9,1
point-sprites,point-sprites,,0,0,0,0,2,0,1,1
stack-trace,stack-trace,,47,31,63,78,137,141,3,1
naming-conventions,naming-conventions,,41,50,94,91,198,185,3,21.95122
file-descriptor,file-descriptor,,27,32,62,59,122,121,9,18.518519
awesomium,awesomium,,0,0,2,0,6,2,8,1
webpage,webpage,,0,0,173,0,212,173,1,1
axlsx,axlsx,,13,5,18,18,22,36,12,1
fixtures,fixtures,,27,34,55,61,78,116,0,25.925926
awt,awt,,104,94,194,198,326,392,3,1
hamcrest,hamcrest,,10,16,45,26,77,71,3,60
rubocop,rubocop,,22,10,15,32,63,47,12,1
md-autocomplete,md-autocomplete,,3,0,4,3,16,7,1,1
data-processing,data-processing,,29,29,47,58,78,105,0,1
with-statement,with-statement,,15,29,48,44,88,92,0,93.333333
stm32f4discovery,stm32f4discovery,,19,15,22,34,74,56,9,1
hal,hal,,22,19,42,41,58,83,9,1
fastcgi,fastcgi,,25,22,64,47,87,111,4,1
which,which,,13,11,22,24,54,46,0,1
visual-recognition,visual-recognition,,10,3,12,13,31,25,6,1
squash,squash,,10,7,10,17,31,27,6,1
git-squash,git-squash,,9,8,10,17,25,27,6,1
soap1.2,soap1.2,,3,0,2,3,8,5,3,1
dyno,dyno,,6,3,13,9,14,22,1,1
hug,hug,,2,0,1,2,8,3,0,1
bloomberg,bloomberg,,11,32,38,43,83,81,5,190.909091
wso2-das,wso2-das,,0,3,10,3,30,13,14,200
ifs,ifs,,5,7,16,12,29,28,9,40
lme4,lme4,,58,56,101,114,167,215,0,1
mixed-models,mixed-models,,52,51,103,103,130,206,0,1
browser-sync,browser-sync,,30,27,61,57,142,118,1,1
lite-server,lite-server,,3,6,5,9,11,14,1,100
node8.4,node8.4,,0,1,2,1,3,3,1,1
custom-wordpress-pages,custom-wordpress-pages,,70,83,146,153,222,299,4,18.571429
screen-readers,screen-readers,,21,26,44,47,82,91,13,23.809524
hashicorp-vault,hashicorp-vault,,50,49,62,99,86,161,3,1
csr,csr,,17,14,28,31,41,59,6,1
excel-2013,excel-2013,,20,18,74,38,149,112,5,1
hybrid-mobile-app,hybrid-mobile-app,,62,43,165,105,251,270,1,1
maven-release-plugin,maven-release-plugin,,20,11,26,31,57,57,3,1
maven-scm,maven-scm,,4,2,6,6,10,12,3,1
http-get,http-get,,31,33,45,64,127,109,4,6.451613
gsm,gsm,,31,31,78,62,116,140,9,1
sim900,sim900,,9,7,4,16,20,20,9,1
keymapping,keymapping,,2,6,16,8,25,24,9,200
weblogic11g,weblogic11g,,11,5,15,16,25,31,3,1
wlst,wlst,,5,7,26,12,28,38,3,40
spring-transactions,spring-transactions,,63,56,133,119,197,252,3,1
private,private,,45,32,79,77,165,156,9,1
rsync,rsync,,40,40,89,80,147,169,9,1
colormap,colormap,,29,35,52,64,85,116,0,20.689655
node-postgres,node-postgres,,16,19,38,35,58,73,1,18.75
onitemclicklistener,onitemclicklistener,,11,12,27,23,53,50,3,9.090909
transition,transition,,97,76,242,173,336,415,1,1
in-app,in-app,,7,5,18,12,22,30,13,1
rethinkdb,rethinkdb,,15,10,61,25,130,86,1,1
rethinkdb-javascript,rethinkdb-javascript,,2,2,17,4,34,21,1,1
amazon-elasticsearch,amazon-elasticsearch,,6,9,9,15,17,24,6,50
devise-invitable,devise-invitable,,5,1,12,6,16,18,12,1
securestring,securestring,,9,5,11,14,25,25,8,1
unmanaged-memory,unmanaged-memory,,0,1,6,1,2,7,8,1
stdclass,stdclass,,7,6,16,13,35,29,4,1
cactoos,cactoos,,0,0,2,0,5,2,3,1
android-video-player,android-video-player,,7,10,11,17,29,28,3,42.857143
greenplum,greenplum,,19,10,31,29,83,60,4,1
hawq,hawq,,0,0,4,0,14,4,2,1
osgi-bundle,osgi-bundle,,14,17,35,31,96,66,3,21.428571
blueprint-osgi,blueprint-osgi,,9,12,28,21,43,49,3,33.333333
opendaylight,opendaylight,,21,15,53,36,139,89,9,1
data-connections,data-connections,,5,2,6,7,10,13,5,1
c++-concepts,c++-concepts,,11,15,23,26,34,49,9,36.363636
boost-hana,boost-hana,,2,7,8,9,33,17,9,250
c++20,c++20,,64,81,75,145,69,220,9,26.5625
unity-container,unity-container,,42,31,126,73,236,199,8,1
python-cffi,python-cffi,,10,7,13,17,20,30,0,1
cffi,cffi,,5,6,12,11,15,23,0,20
auto-update,auto-update,,19,20,61,39,90,100,3,5.263158
ip-geolocation,ip-geolocation,,1,3,7,4,18,11,3,200
bigquery-standard-sql,bigquery-standard-sql,,30,62,72,92,100,164,4,106.666667
playframework-2.2,playframework-2.2,,0,2,9,2,18,11,2,100
css-shapes,css-shapes,,20,25,31,45,104,76,1,25
dst,dst,,32,17,48,49,100,97,0,1
json-api,json-api,,31,22,30,53,86,83,12,1
katharsis,katharsis,,0,0,1,0,4,1,3,1
uisegmentedcontrol,uisegmentedcontrol,,21,14,40,35,117,75,13,1
zeep,zeep,,28,29,56,57,60,113,0,3.571429
notice,notice,,7,3,18,10,25,28,4,1
ar.drone,ar.drone,,0,0,5,0,14,5,0,1
geocoding,geocoding,,60,52,114,112,217,226,1,1
google-geocoding-api,google-geocoding-api,,15,29,36,44,81,80,1,93.333333
geopy,geopy,,17,15,22,32,34,54,0,1
switching,switching,,3,4,14,7,22,21,9,33.333333
angular4-router,angular4-router,,6,1,35,7,251,42,1,1
jsonschema,jsonschema,,95,105,164,200,312,364,1,10.526316
mustache,mustache,,35,28,72,63,120,135,1,1
tile,tile,,11,11,26,22,49,48,1,1
flixel,flixel,,0,0,0,0,2,0,13,1
form-data,form-data,,67,51,135,118,175,253,1,1
objective-c-category,objective-c-category,,3,3,6,6,10,12,13,1
instancetype,instancetype,,1,0,1,1,4,2,6,1
yelp,yelp,,12,3,23,15,40,38,4,1
parsley.js,parsley.js,,6,10,22,16,55,38,1,66.666667
css-float,css-float,,28,31,71,59,192,130,1,10.714286
word-wrap,word-wrap,,40,29,64,69,148,133,1,1
keylistener,keylistener,,28,13,41,41,88,82,3,1
arrow-keys,arrow-keys,,6,6,17,12,22,29,1,1
ng-animate,ng-animate,,5,4,10,9,25,19,1,1
ng-show,ng-show,,4,1,9,5,37,14,1,1
apollo,apollo,,270,270,495,540,628,1035,1,1
jquery-ui-droppable,jquery-ui-droppable,,7,3,16,10,43,26,1,1
angular-route-guards,angular-route-guards,,6,3,12,9,25,21,1,1
protected-mode,protected-mode,,2,4,9,6,15,15,9,100
asp.net-core-webapi,asp.net-core-webapi,,361,367,701,728,957,1429,8,1.66205
uber-api,uber-api,,12,13,27,25,95,52,13,8.333333
web-api-testing,web-api-testing,,40,28,71,68,94,139,3,1
avro,avro,,157,151,257,308,409,565,2,1
magento-1.13,magento-1.13,,0,0,1,0,4,1,4,1
date-difference,date-difference,,8,6,34,14,69,48,0,1
java-date,java-date,,21,14,42,35,69,77,3,1
vs-color-theme-editor,vs-color-theme-editor,,0,1,2,1,3,3,8,1
geodjango,geodjango,,27,22,44,49,114,93,0,1
hacklang,hacklang,,1,2,0,3,11,3,4,100
google-admob,google-admob,,0,0,46,0,143,46,3,1
pkcs#7,pkcs#7,,12,15,31,27,51,58,6,25
calculator,calculator,,62,62,166,124,334,290,0,1
spring-cache,spring-cache,,34,22,51,56,97,107,3,1
webservicehost,webservicehost,,0,1,1,1,3,2,8,1
botocore,botocore,,7,12,21,19,39,40,6,71.428571
moto,moto,,6,5,14,11,17,25,6,1
text-recognition,text-recognition,,19,19,32,38,41,70,0,1
excel-vba-mac,excel-vba-mac,,24,20,39,44,70,83,5,1
nix,nix,,26,17,43,43,93,86,2,1
nixpkgs,nixpkgs,,7,2,5,9,19,14,2,1
360-degrees,360-degrees,,7,3,10,10,27,20,1,1
openrefine,openrefine,,5,4,14,9,29,23,0,1
pcap,pcap,,37,22,53,59,100,112,9,1
uniform-distribution,uniform-distribution,,6,6,9,12,24,21,0,1
spring-cloud-consul,spring-cloud-consul,,10,7,26,17,38,43,3,1
qwebview,qwebview,,5,3,3,8,28,11,9,1
doparallel,doparallel,,17,18,50,35,68,85,0,5.882353
dompi,dompi,,0,0,4,0,6,4,0,1
grails-3.3,grails-3.3,,11,8,13,19,57,32,3,1
babel-loader,babel-loader,,57,33,100,90,126,190,1,1
cidr,cidr,,9,11,10,20,33,30,9,22.222222
crash-log,crash-log,,2,1,3,3,15,6,13,1
partial-views,partial-views,,34,38,70,72,135,142,8,11.764706
ajax-request,ajax-request,,0,0,0,0,19,0,1,1
localizable.strings,localizable.strings,,3,2,7,5,19,12,13,1
nodemcu,nodemcu,,67,48,72,115,139,187,9,1
http-caching,http-caching,,9,6,11,15,31,26,4,1
mmap,mmap,,38,52,71,90,147,161,9,36.842105
bcp,bcp,,29,31,46,60,92,106,4,6.896552
lenses,lenses,,5,8,9,13,23,22,2,60
jpeg2000,jpeg2000,,3,4,13,7,7,20,0,33.333333
tunnel,tunnel,,8,9,25,17,40,42,9,12.5
htop,htop,,4,4,3,8,10,11,9,1
top-command,top-command,,0,1,1,1,6,2,9,1
transitionend,transitionend,,0,1,2,1,6,3,1,1
angular-promise,angular-promise,,34,13,62,47,209,109,1,1
win-universal-app,win-universal-app,,28,23,53,51,168,104,8,1
datagridviewbuttoncolumn,datagridviewbuttoncolumn,,0,1,2,1,6,3,8,1
pivot-table,pivot-table,,261,235,406,496,895,902,5,1
acl,acl,,68,41,116,109,163,225,4,1
fody-propertychanged,fody-propertychanged,,4,2,3,6,10,9,8,1
freshmvvm,freshmvvm,,6,2,10,8,20,18,8,1
circe,circe,,35,13,38,48,54,86,2,1
stream-fusion,stream-fusion,,0,0,0,0,1,0,2,1
bukkit,bukkit,,28,34,58,62,114,120,3,21.428571
django-1.11,django-1.11,,19,19,49,38,155,87,0,1
object-initializers,object-initializers,,5,4,6,9,19,15,8,1
twitter-bootstrap-4,twitter-bootstrap-4,,0,0,0,0,243,0,1,1
automatic-ref-counting,automatic-ref-counting,,29,18,47,47,79,94,13,1
corba,corba,,14,6,9,20,22,29,3,1
sun,sun,,4,3,5,7,15,12,3,1
simple-form,simple-form,,29,36,74,65,190,139,12,24.137931
log-analysis,log-analysis,,2,0,10,2,9,12,0,1
swiftmailer,swiftmailer,,40,51,80,91,150,171,4,27.5
symfony-2.7,symfony-2.7,,6,6,13,12,51,25,4,1
twitter-fabric,twitter-fabric,,3,2,2,5,31,7,3,1
drm,drm,,14,17,20,31,37,51,3,21.428571
eglfs,eglfs,,1,0,2,1,6,3,9,1
nsview,nsview,,25,9,34,34,75,68,13,1
initwithcoder,initwithcoder,,0,0,1,0,3,1,13,1
initwithframe,initwithframe,,0,0,0,0,3,0,13,1
number-formatting,number-formatting,,38,46,91,84,239,175,0,21.052632
stripos,stripos,,0,0,3,0,6,3,4,1
processor,processor,,17,9,29,26,69,55,9,1
react-redux-form,react-redux-form,,6,8,25,14,69,39,1,33.333333
amazon-cloudwatchlogs,amazon-cloudwatchlogs,,38,63,68,101,79,169,6,65.789474
gridextra,gridextra,,8,9,26,17,69,43,0,12.5
mobile-angular-ui,mobile-angular-ui,,0,1,0,1,1,1,1,1
sql-delete,sql-delete,,67,52,103,119,204,222,4,1
praw,praw,,14,15,44,29,78,73,0,7.142857
base,base,,24,14,49,38,98,87,0,1
shop,shop,,7,4,14,11,25,25,4,1
xamarin-studio,xamarin-studio,,7,9,16,16,71,32,8,28.571429
unsafe,unsafe,,19,19,37,38,80,75,8,1
temp-tables,temp-tables,,22,21,55,43,152,98,4,1
setcookie,setcookie,,29,26,44,55,88,99,4,1
oracle-apex,oracle-apex,,149,113,281,262,484,543,4,1
oracle-apex-5,oracle-apex-5,,21,17,49,38,161,87,4,1
implicit-conversion,implicit-conversion,,31,46,91,77,130,168,9,48.387097
smsmanager,smsmanager,,10,12,24,22,46,46,3,20
timespan,timespan,,10,13,52,23,81,75,8,30
enum-flags,enum-flags,,7,2,7,9,8,16,8,1
functor,functor,,30,23,61,53,102,114,2,1
posixct,posixct,,28,29,55,57,128,112,0,3.571429
umbraco7,umbraco7,,22,11,68,33,207,101,8,1
jenkins-job-dsl,jenkins-job-dsl,,26,15,27,41,94,68,6,1
handler,handler,,54,52,106,106,205,212,3,1
runnable,runnable,,35,25,73,60,151,133,3,1
cucumber-jvm,cucumber-jvm,,65,45,86,110,186,196,3,1
pymssql,pymssql,,18,23,29,41,66,70,0,27.777778
azure-servicebus-topics,azure-servicebus-topics,,23,21,62,44,80,106,8,1
glyph,glyph,,2,1,16,3,23,19,1,1
snakemake,snakemake,,41,46,60,87,86,147,0,12.195122
isapi,isapi,,3,5,6,8,21,14,8,66.666667
android-softkeyboard,android-softkeyboard,,51,48,109,99,199,208,3,1
mbed,mbed,,36,15,40,51,51,91,9,1
netscape,netscape,,1,1,1,2,1,3,0,1
checkboxlist,checkboxlist,,19,12,34,31,68,65,8,1
appfabric,appfabric,,0,1,3,1,6,4,8,1
sqlxml,sqlxml,,10,11,9,21,25,30,4,10
ews-managed-api,ews-managed-api,,6,3,10,9,23,19,8,1
kinect,kinect,,34,32,44,66,77,110,8,1
kinect-v2,kinect-v2,,7,12,12,19,49,31,8,71.428571
kube-dns,kube-dns,,13,6,32,19,50,51,6,1
ogr,ogr,,8,6,11,14,22,25,0,1
gnu-screen,gnu-screen,,15,13,32,28,53,60,9,1
metamodel,metamodel,,1,3,11,4,19,15,3,200
devise-token-auth,devise-token-auth,,15,7,17,22,31,39,12,1
mesos-chronos,mesos-chronos,,1,1,3,2,13,5,6,1
nbconvert,nbconvert,,12,12,36,24,35,60,0,1
google-calendar-api,google-calendar-api,,156,151,315,307,616,622,5,1
java-me,java-me,,6,1,8,7,11,15,3,1
montecarlo,montecarlo,,50,38,64,88,123,152,0,1
bounded-wildcard,bounded-wildcard,,4,3,8,7,16,15,3,1
model-comparison,model-comparison,,6,1,6,7,17,13,0,1
git-lfs,git-lfs,,36,28,49,64,114,113,6,1
summary,summary,,28,28,63,56,116,119,0,1
gpuimage,gpuimage,,9,12,22,21,47,43,13,33.333333
assert,assert,,50,45,100,95,213,195,3,1
variations,variations,,22,18,61,40,92,101,4,1
topshelf,topshelf,,12,13,20,25,29,45,8,8.333333
sublimetext,sublimetext,,37,25,69,62,175,131,0,1
sublimetext-snippet,sublimetext-snippet,,0,1,1,1,13,2,0,1
android-arrayadapter,android-arrayadapter,,52,37,97,89,325,186,3,1
nest,nest,,77,75,188,152,334,340,6,1
elasticsearch-net,elasticsearch-net,,1,3,5,4,48,9,6,200
sklearn-pandas,sklearn-pandas,,93,63,114,156,202,270,0,1
wagtail,wagtail,,81,85,137,166,328,303,0,4.938272
expect,expect,,37,48,94,85,164,179,9,29.72973
cudnn,cudnn,,46,25,70,71,115,141,0,1
hsl,hsl,,3,5,7,8,17,15,0,66.666667
chai-as-promised,chai-as-promised,,3,3,9,6,22,15,1,1
stroke,stroke,,9,8,10,17,27,27,1,1
graphene-python,graphene-python,,44,54,57,98,118,155,1,22.727273
fwrite,fwrite,,28,14,47,42,140,89,9,1
vuetify.js,vuetify.js,,405,582,632,987,606,1619,1,43.703704
bounded-types,bounded-types,,2,4,4,6,10,10,3,100
splunk,splunk,,68,83,120,151,167,271,6,22.058824
adjustment,adjustment,,1,2,8,3,8,11,0,100
php-imap,php-imap,,3,1,6,4,8,10,4,1
paperjs,paperjs,,21,22,35,43,55,78,1,4.761905
scheduler,scheduler,,90,75,200,165,291,365,3,1
repast-simphony,repast-simphony,,0,9,4,9,5,13,3,800
timedelay,timedelay,,2,3,6,5,16,11,0,50
django-1.10,django-1.10,,1,2,4,3,12,7,0,100
resultset,resultset,,46,38,75,84,180,159,3,1
mouseout,mouseout,,3,1,10,4,10,14,1,1
pythonpath,pythonpath,,15,16,34,31,54,65,0,6.666667
sys.path,sys.path,,6,2,7,8,13,15,0,1
top-n,top-n,,16,9,17,25,29,42,4,1
saas,saas,,20,14,42,34,79,76,4,1
cancellation-token,cancellation-token,,10,6,15,16,25,31,8,1
collectors,collectors,,20,25,58,45,69,103,3,25
jooq,jooq,,86,58,114,144,242,258,3,1
codec,codec,,31,29,56,60,111,116,13,1
adfs4.0,adfs4.0,,9,11,19,20,19,39,8,22.222222
java.util.concurrent,java.util.concurrent,,27,26,71,53,114,124,3,1
html5boilerplate,html5boilerplate,,0,0,3,0,4,3,1,1
dev-c++,dev-c++,,19,11,32,30,57,62,9,1
shortcode,shortcode,,64,63,112,127,274,239,4,1
nomethoderror,nomethoderror,,4,1,15,5,26,20,12,1
confluent,confluent,,89,82,208,171,281,379,2,1
judy-array,judy-array,,0,1,0,1,2,1,9,1
entitymanager,entitymanager,,28,29,62,57,139,119,3,3.571429
auditing,auditing,,9,10,15,19,22,34,3,11.111111
avaudiofile,avaudiofile,,0,2,2,2,11,4,13,100
google-apps-script-addon,google-apps-script-addon,,20,29,34,49,51,83,5,45
material-components,material-components,,14,16,52,30,79,82,3,14.285714
gsutil,gsutil,,30,22,47,52,106,99,6,1
angular-meteor,angular-meteor,,4,2,7,6,38,13,1,1
hudson,hudson,,8,5,15,13,28,28,6,1
spring-cloud-contract,spring-cloud-contract,,13,12,37,25,72,62,3,1
extract,extract,,112,104,225,216,443,441,0,1
tostring,tostring,,45,29,81,74,172,155,3,1
eclipse-oxygen,eclipse-oxygen,,8,4,21,12,156,33,3,1
trim,trim,,49,30,92,79,174,171,0,1
implode,implode,,13,3,25,16,59,41,4,1
basic-authentication,basic-authentication,,73,74,135,147,250,282,4,1.369863
functional-interface,functional-interface,,30,16,60,46,81,106,3,1
eclipse-neon,eclipse-neon,,2,7,2,9,38,11,3,250
uitableviewsectionheader,uitableviewsectionheader,,11,8,26,19,28,45,13,1
wifimanager,wifimanager,,21,20,30,41,58,71,3,1
android-connectivitymanager,android-connectivitymanager,,6,10,16,16,25,32,3,66.666667
ng-view,ng-view,,0,2,7,2,20,9,1,100
hadoop-streaming,hadoop-streaming,,15,5,23,20,41,43,2,1
hadoop-partitioning,hadoop-partitioning,,7,9,22,16,32,38,2,28.571429
drone,drone,,16,15,23,31,75,54,6,1
drone.io,drone.io,,9,8,17,17,48,34,6,1
urllib2,urllib2,,24,32,43,56,151,99,0,33.333333
urlopen,urlopen,,4,14,10,18,50,28,0,250
react-select,react-select,,94,93,205,187,187,392,1,1
edmx,edmx,,16,8,31,24,46,55,8,1
friend,friend,,28,14,39,42,90,81,9,1
fs,fs,,124,129,212,253,318,465,1,4.032258
bits,bits,,0,0,0,0,71,0,9,1
bitmask,bitmask,,14,16,23,30,61,53,9,14.285714
mobile-center,mobile-center,,0,0,0,0,13,0,8,1
visual-studio-app-center,visual-studio-app-center,,51,56,78,107,124,185,8,9.803922
trackbar,trackbar,,5,3,11,8,10,19,8,1
iis-7.5,iis-7.5,,39,24,53,63,144,116,8,1
http-status-code-302,http-status-code-302,,9,11,24,20,40,44,4,22.222222
dotnetnuke-6,dotnetnuke-6,,0,0,0,0,1,0,8,1
lvalue-to-rvalue,lvalue-to-rvalue,,2,4,2,6,7,8,9,100
docker-registry,docker-registry,,56,37,71,93,144,164,6,1
libc,libc,,19,20,46,39,93,85,9,5.263158
fft,fft,,143,114,234,257,380,491,0,1
spectrum,spectrum,,10,5,16,15,27,31,0,1
coordinator-layout,coordinator-layout,,6,7,5,13,26,18,3,16.666667
sql-server-2016-localdb,sql-server-2016-localdb,,1,1,5,2,9,7,8,1
detect,detect,,18,11,22,29,37,51,3,1
uglifyjs,uglifyjs,,14,13,53,27,112,80,1,1
ajax4jsf,ajax4jsf,,2,1,3,3,6,6,3,1
seam2,seam2,,1,1,1,2,4,3,3,1
associations,associations,,71,60,173,131,312,304,12,1
begincollectionitem,begincollectionitem,,1,1,3,2,6,5,8,1
segment,segment,,16,10,40,26,49,66,0,1
chef-solo,chef-solo,,2,4,11,6,40,17,12,100
autoscroll,autoscroll,,13,12,24,25,38,49,1,1
associative-array,associative-array,,54,41,100,95,229,195,4,1
dynamics-crm-2016,dynamics-crm-2016,,17,13,24,30,110,54,8,1
media-library,media-library,,2,5,10,7,18,17,4,150
enterprise-integration,enterprise-integration,,3,3,4,6,21,10,3,1
preg-grep,preg-grep,,2,2,4,4,5,8,4,1
salesforce-lightning,salesforce-lightning,,81,85,84,166,88,250,14,4.938272
salesforce-communities,salesforce-communities,,16,15,22,31,26,53,14,1
quantization,quantization,,19,11,30,30,25,60,0,1
git-pull,git-pull,,21,18,46,39,96,85,6,1
git-add,git-add,,7,3,12,10,21,22,6,1
p5.js,p5.js,,126,116,225,242,304,467,1,1
rolify,rolify,,3,2,9,5,13,14,12,1
cycle,cycle,,18,16,32,34,79,66,0,1
rollupjs,rollupjs,,24,44,53,68,87,121,1,83.333333
uitableviewrowaction,uitableviewrowaction,,1,7,13,8,32,21,13,600
google-cloud-kms,google-cloud-kms,,10,8,12,18,18,30,6,1
okhttp3,okhttp3,,92,112,179,204,349,383,3,21.73913
marionette,marionette,,6,9,12,15,37,27,1,50
stderr,stderr,,27,24,53,51,89,104,9,1
customization,customization,,81,79,149,160,262,309,4,1
posts,posts,,27,12,34,39,70,73,4,1
memory-model,memory-model,,19,7,8,26,31,34,9,1
csc,csc,,12,4,12,16,26,28,8,1
relayjs,relayjs,,12,15,16,27,69,43,1,25
relaymodern,relaymodern,,8,10,18,18,64,36,1,25
scrolltop,scrolltop,,16,7,42,23,74,65,1,1
contentpresenter,contentpresenter,,5,4,7,9,11,16,8,1
contenttemplate,contenttemplate,,0,2,1,2,4,3,8,100
pymc,pymc,,9,7,13,16,39,29,0,1
pymc3,pymc3,,25,28,54,53,87,107,0,12
buttonfield,buttonfield,,2,0,0,2,4,2,8,1
dokku,dokku,,15,12,22,27,39,49,6,1
jtextfield,jtextfield,,28,19,67,47,152,114,3,1
sqlexception,sqlexception,,7,15,33,22,55,55,3,114.285714
lg,lg,,3,3,10,6,21,16,3,1
iaas,iaas,,4,1,10,5,18,15,8,1
vcloud-director-rest-api,vcloud-director-rest-api,,0,0,2,0,4,2,6,1
githooks,githooks,,59,31,83,90,189,173,6,1
gogs,gogs,,2,3,10,5,29,15,6,50
qbasic,qbasic,,2,3,11,5,18,16,5,50
qb64,qb64,,4,1,6,5,13,11,5,1
shutil,shutil,,39,40,73,79,108,152,0,2.564103
webhose,webhose,,0,0,1,0,3,1,0,1
office365api,office365api,,19,34,79,53,162,132,8,78.947368
hibernate-search,hibernate-search,,23,22,46,45,148,91,3,1
ado,ado,,57,25,70,82,146,152,5,1
google-login,google-login,,34,51,88,85,127,173,5,50
google-trends,google-trends,,7,9,20,16,33,36,0,28.571429
nslocalizedstring,nslocalizedstring,,3,5,9,8,33,17,13,66.666667
py2neo,py2neo,,17,19,41,36,76,77,2,11.764706
time-wait,time-wait,,2,2,1,4,6,5,9,1
binary-data,binary-data,,27,30,75,57,103,132,0,11.111111
decoder,decoder,,17,17,23,34,55,57,13,1
percentage,percentage,,79,41,120,120,226,240,0,1
django-admin-actions,django-admin-actions,,2,4,8,6,14,14,0,100
uidocumentpickervc,uidocumentpickervc,,2,1,4,3,17,7,13,1
nsis,nsis,,21,9,48,30,88,78,9,1
alasset,alasset,,0,0,0,0,2,0,13,1
phphotolibrary,phphotolibrary,,6,13,18,19,28,37,13,116.666667
jsp-tags,jsp-tags,,11,10,41,21,58,62,3,1
friendly-url,friendly-url,,7,7,21,14,34,35,4,1
cross-domain,cross-domain,,66,70,173,136,327,309,1,6.060606
statelistdrawable,statelistdrawable,,0,1,0,1,2,1,3,1
iomanip,iomanip,,5,3,4,8,11,12,9,1
console-application,console-application,,153,135,336,288,625,624,8,1
classloader,classloader,,57,53,109,110,250,219,3,1
multicast,multicast,,24,24,62,48,115,110,9,1
babel-jest,babel-jest,,38,27,72,65,65,137,1,1
html-select,html-select,,68,64,135,132,267,267,1,1
leakcanary,leakcanary,,17,16,34,33,26,67,3,1
vue-cli,vue-cli,,112,89,172,201,275,373,1,1
multi-level,multi-level,,11,10,29,21,48,50,0,1
android-file,android-file,,14,18,40,32,74,72,3,28.571429
android-external-storage,android-external-storage,,24,16,38,40,92,78,3,1
android-music-player,android-music-player,,13,10,26,23,68,49,3,1
android-internal-storage,android-internal-storage,,11,4,20,15,28,35,3,1
cabasicanimation,cabasicanimation,,13,8,20,21,39,41,13,1
sqlgeography,sqlgeography,,9,3,8,12,28,20,4,1
unix-socket,unix-socket,,14,20,35,34,52,69,9,42.857143
snapcraft,snapcraft,,8,2,11,10,22,21,9,1
cam-pdf,cam-pdf,,0,0,0,0,2,0,8,1
xamarin.auth,xamarin.auth,,5,3,12,8,32,20,8,1
mobileserviceclient,mobileserviceclient,,0,1,3,1,7,4,8,1
firebase-tools,firebase-tools,,14,22,15,36,48,51,13,57.142857
exe4j,exe4j,,1,0,4,1,4,5,3,1
ef-database-first,ef-database-first,,16,11,33,27,77,60,8,1
clock,clock,,40,28,56,68,130,124,9,1
vtiger,vtiger,,13,13,24,26,35,50,4,1
vtigercrm,vtigercrm,,11,9,18,20,29,38,4,1
image-compression,image-compression,,15,19,43,34,90,77,0,26.666667
caliburn.micro,caliburn.micro,,47,38,39,85,110,124,8,1
gemfire,gemfire,,12,11,31,23,81,54,3,1
ternary-operator,ternary-operator,,60,46,113,106,204,219,1,1
jquery-focusout,jquery-focusout,,1,3,0,4,6,4,1,200
bundler,bundler,,62,58,117,120,216,237,12,1
mailer,mailer,,8,12,27,20,40,47,4,50
google-fit,google-fit,,36,32,46,68,105,114,3,1
guzzle,guzzle,,113,94,152,207,302,359,4,1
eddystone,eddystone,,5,6,12,11,50,23,3,20
google-beacon-platform,google-beacon-platform,,1,1,5,2,25,7,3,1
titan,titan,,2,1,3,3,23,6,2,1
skinning,skinning,,2,2,3,4,10,7,8,1
for-of-loop,for-of-loop,,3,8,8,11,15,19,1,166.666667
center,center,,30,26,66,56,181,122,1,1
jss,jss,,32,33,80,65,70,145,1,3.125
ddd-repositories,ddd-repositories,,8,6,19,14,33,33,8,1
qbytearray,qbytearray,,5,7,9,12,26,21,9,40
windows-10-universal,windows-10-universal,,41,26,84,67,318,151,8,1
checkedlistbox,checkedlistbox,,4,6,16,10,31,26,8,50
uibarbuttonitem,uibarbuttonitem,,28,21,56,49,174,105,13,1
uitoolbar,uitoolbar,,7,3,15,10,70,25,13,1
uitoolbaritem,uitoolbaritem,,3,0,0,3,4,3,13,1
myisam,myisam,,9,9,16,18,44,34,4,1
aws-glue,aws-glue,,166,166,233,332,339,565,6,1
express-jwt,express-jwt,,18,18,26,36,43,62,1,1
kartik-v,kartik-v,,12,11,33,23,63,56,4,1
xamarin.uwp,xamarin.uwp,,37,20,75,57,118,132,8,1
wiki,wiki,,18,16,25,34,76,59,4,1
scrapy-spider,scrapy-spider,,0,0,174,0,335,174,0,1
django-mongodb-engine,django-mongodb-engine,,0,0,0,0,4,0,0,1
antiforgerytoken,antiforgerytoken,,9,6,29,15,50,44,8,1
bitbucket-server,bitbucket-server,,25,25,67,50,86,117,6,1
bitbucket-cloud,bitbucket-cloud,,17,9,17,26,20,43,6,1
grunt-contrib-uglify,grunt-contrib-uglify,,1,3,8,4,25,12,1,200
coldfusion-2016,coldfusion-2016,,23,12,51,35,87,86,4,1
logical-operators,logical-operators,,55,57,122,112,227,234,0,3.636364
yui,yui,,2,0,7,2,11,9,1,1
postgresql-9.6,postgresql-9.6,,41,39,100,80,234,180,4,1
fragment-backstack,fragment-backstack,,8,13,11,21,45,32,3,62.5
pg-dump,pg-dump,,14,28,36,42,75,78,4,100
pg-restore,pg-restore,,5,11,12,16,33,28,4,120
cncontactstore,cncontactstore,,2,6,10,8,20,18,13,200
hydrogen,hydrogen,,5,5,13,10,18,23,0,1
android-cardview,android-cardview,,77,69,133,146,315,279,3,1
objectanimator,objectanimator,,9,7,22,16,37,38,3,1
keycode,keycode,,14,15,26,29,53,55,1,7.142857
apache-curator,apache-curator,,7,5,15,12,29,27,2,1
chmod,chmod,,16,16,40,32,92,72,9,1
umask,umask,,3,1,7,4,12,11,9,1
apt-get,apt-get,,25,18,46,43,103,89,9,1
meta-boxes,meta-boxes,,7,10,23,17,44,40,4,42.857143
browser-testing,browser-testing,,8,1,8,9,11,17,4,1
mkpinannotationview,mkpinannotationview,,1,0,1,1,2,2,13,1
crop,crop,,56,49,123,105,170,228,1,1
angular-local-storage,angular-local-storage,,1,8,10,9,18,19,1,700
drf-extensions,drf-extensions,,1,1,1,2,2,3,0,1
parse-error,parse-error,,8,8,15,16,33,31,4,1
caanimation,caanimation,,14,2,18,16,34,34,13,1
extends,extends,,38,27,50,65,104,115,3,1
microcontroller,microcontroller,,77,62,140,139,282,279,9,1
hexdump,hexdump,,10,6,25,16,28,41,0,1
case-insensitive,case-insensitive,,12,13,28,25,62,53,0,8.333333
ends-with,ends-with,,4,5,6,9,12,15,0,25
polymerfire,polymerfire,,1,0,3,1,12,4,13,1
react-styleguidist,react-styleguidist,,13,8,9,21,14,30,1,1
software-defined-radio,software-defined-radio,,4,7,5,11,10,16,0,75
ethernet,ethernet,,50,29,85,79,152,164,9,1
nopcommerce,nopcommerce,,23,14,35,37,94,72,8,1
logfile,logfile,,19,16,47,35,78,82,9,1
gurobi,gurobi,,45,35,82,80,115,162,0,1
confluence,confluence,,21,28,60,49,87,109,6,33.333333
jasperserver,jasperserver,,17,16,24,33,41,57,3,1
ckreference,ckreference,,0,0,1,0,5,1,13,1
xml-rpc,xml-rpc,,37,20,36,57,77,93,0,1
odoo-mobile,odoo-mobile,,0,0,2,0,7,2,0,1
html-entities,html-entities,,14,13,27,27,66,54,1,1
html4,html4,,3,3,1,6,8,7,1,1
android-styles,android-styles,,50,41,81,91,131,172,3,1
cropper,cropper,,5,3,24,8,32,32,1,1
cropperjs,cropperjs,,12,13,25,25,33,50,1,8.333333
xcodebuild,xcodebuild,,29,26,48,55,81,103,13,1
laravel-5.1,laravel-5.1,,38,13,92,51,200,143,4,1
ef-model-builder,ef-model-builder,,4,1,4,5,8,9,8,1
ratingbar,ratingbar,,4,8,11,12,38,23,3,100
guava,guava,,45,51,104,96,236,200,3,13.333333
autostart,autostart,,15,10,22,25,41,47,3,1
chef-recipe,chef-recipe,,17,17,46,34,162,80,12,1
mxnet,mxnet,,35,28,62,63,174,125,0,1
cut,cut,,23,22,66,45,149,111,9,1
angular2-aot,angular2-aot,,6,9,14,15,116,29,1,50
aot,aot,,9,9,22,18,80,40,1,1
iis-8,iis-8,,63,31,114,94,255,208,8,1
cinder,cinder,,2,0,9,2,11,11,6,1
breakpoints,breakpoints,,53,59,108,112,184,220,9,11.320755
rabbitvcs,rabbitvcs,,0,0,1,0,2,1,6,1
anime.js,anime.js,,21,20,31,41,59,72,1,1
callkit,callkit,,31,23,54,54,121,108,13,1
apple-watch,apple-watch,,43,58,109,101,170,210,13,34.883721
android-resources,android-resources,,53,52,95,105,237,200,3,1
clip-path,clip-path,,23,21,55,44,67,99,1,1
axis2,axis2,,23,21,64,44,70,108,3,1
robots.txt,robots.txt,,25,25,44,50,70,94,4,1
appdomain,appdomain,,15,13,29,28,64,57,8,1
fipy,fipy,,8,2,8,10,12,18,0,1
aes-gcm,aes-gcm,,5,13,22,18,38,40,6,160
highcharts-ng,highcharts-ng,,10,3,10,13,26,23,1,1
amazon-kinesis-firehose,amazon-kinesis-firehose,,38,29,59,67,92,126,6,1
strip,strip,,21,27,42,48,99,90,0,28.571429
screen-capture,screen-capture,,11,15,32,26,57,58,3,36.363636
bitblt,bitblt,,3,0,2,3,5,5,9,1
airflow,airflow,,291,381,528,672,623,1200,0,30.927835
google-cloud-dataproc,google-cloud-dataproc,,46,48,104,94,197,198,6,4.347826
typemaps,typemaps,,2,3,1,5,10,6,9,50
selenium-edgedriver,selenium-edgedriver,,3,3,7,6,19,13,3,1
microsoft-webdriver,microsoft-webdriver,,1,0,2,1,8,3,3,1
anagram,anagram,,6,10,21,16,42,37,0,66.666667
socialengine,socialengine,,0,0,9,0,32,9,4,1
hbase,hbase,,153,136,334,289,581,623,2,1
angular2-decorators,angular2-decorators,,1,1,1,2,8,3,1,1
woocommerce-subscriptions,woocommerce-subscriptions,,38,18,42,56,59,98,4,1
system-administration,system-administration,,5,4,11,9,30,20,9,1
scrape,scrape,,27,16,49,43,109,92,0,1
m3u8,m3u8,,32,17,48,49,67,97,13,1
mobile-website,mobile-website,,12,18,26,30,45,56,1,50
responsiveness,responsiveness,,4,7,17,11,26,28,1,75
jenkins-docker,jenkins-docker,,5,4,10,9,18,19,6,1
ssrs-2014,ssrs-2014,,4,9,9,13,30,22,4,125
varying,varying,,3,1,2,4,3,6,0,1
elementtree,elementtree,,65,78,139,143,239,282,0,20
docker-volume,docker-volume,,63,54,95,117,188,212,6,1
sdwebimage,sdwebimage,,9,14,35,23,79,58,13,55.555556
snapshot,snapshot,,59,56,94,115,158,209,6,1
php-manager,php-manager,,0,0,0,0,3,0,8,1
package.json,package.json,,145,132,208,277,391,485,1,1
escodegen,escodegen,,0,0,2,0,2,2,1,1
retry-logic,retry-logic,,8,11,19,19,22,38,3,37.5
heron,heron,,1,0,8,1,17,9,2,1
toggleswitch,toggleswitch,,1,2,6,3,9,9,1,100
regex-greedy,regex-greedy,,204,30,34,234,74,268,0,1
psexec,psexec,,15,19,30,34,62,64,9,26.666667
c3p0,c3p0,,21,18,37,39,79,76,3,1
forgot-password,forgot-password,,9,12,16,21,35,37,4,33.333333
application-cache,application-cache,,1,2,2,3,5,5,1,100
ncache,ncache,,1,0,6,1,7,7,8,1
datastax,datastax,,67,42,108,109,297,217,2,1
phantom-dsl,phantom-dsl,,1,1,4,2,14,6,2,1
phantom-types,phantom-types,,1,2,2,3,8,5,2,100
google-play-games,google-play-games,,41,30,107,71,149,178,3,1
jquery-mobile,jquery-mobile,,59,29,86,88,238,174,1,1
ipv4,ipv4,,28,13,41,41,92,82,9,1
ns-3,ns-3,,14,5,24,19,29,43,9,1
face-detection,face-detection,,39,48,80,87,128,167,0,23.076923
avcapturedevice,avcapturedevice,,9,4,21,13,41,34,13,1
qtextbrowser,qtextbrowser,,5,4,12,9,18,21,0,1
taglib-sharp,taglib-sharp,,0,2,1,2,11,3,8,100
add-in,add-in,,25,32,68,57,119,125,5,28
spring-data-commons,spring-data-commons,,4,1,3,5,12,8,3,1
summernote,summernote,,42,47,68,89,121,157,1,11.904762
fifo,fifo,,30,18,40,48,100,88,9,1
keystore,keystore,,68,54,155,122,277,277,6,1
dbms-scheduler,dbms-scheduler,,2,3,6,5,29,11,4,50
zendesk,zendesk,,10,17,36,27,44,63,4,70
zendesk-api,zendesk-api,,7,8,23,15,25,38,4,14.285714
zopim,zopim,,0,1,4,1,2,5,1,1
altova,altova,,3,1,2,4,6,6,3,1
blazemeter,blazemeter,,10,11,22,21,61,43,3,10
data-retrieval,data-retrieval,,4,12,25,16,31,41,13,200
typescript2.0,typescript2.0,,33,27,81,60,386,141,1,1
dwr,dwr,,0,2,3,2,6,5,3,100
equation,equation,,42,37,83,79,124,162,0,1
websphere-mq-ams,websphere-mq-ams,,1,0,0,1,2,1,3,1
audioflinger,audioflinger,,1,0,1,1,3,2,3,1
twitter-card,twitter-card,,2,5,5,7,11,12,1,150
javapoet,javapoet,,1,5,9,6,17,15,3,400
dockpanel-suite,dockpanel-suite,,1,0,3,1,4,4,8,1
salesforce-ios-sdk,salesforce-ios-sdk,,3,1,5,4,6,9,13,1
relevance,relevance,,5,3,12,8,22,20,6,1
monitor,monitor,,19,21,51,40,100,91,3,10.526316
sendkeys,sendkeys,,31,24,49,55,124,104,3,1
build-error,build-error,,15,15,26,30,57,56,3,1
ftrace,ftrace,,4,6,10,10,12,20,9,50
xerces,xerces,,10,6,15,16,25,31,3,1
xerces-c,xerces-c,,1,2,6,3,15,9,9,100
regex-negation,regex-negation,,112,34,94,146,218,240,0,1
teradata-covalent,teradata-covalent,,0,2,2,2,20,4,1,100
jms-topic,jms-topic,,8,5,17,13,32,30,3,1
web-chat,web-chat,,19,32,19,51,26,70,8,68.421053
alfresco-share,alfresco-share,,7,13,21,20,79,41,3,85.714286
alfresco-webscripts,alfresco-webscripts,,2,7,19,9,46,28,3,250
codenameone,codenameone,,58,28,90,86,293,176,3,1
angular-http-interceptors,angular-http-interceptors,,47,44,95,91,193,186,1,1
mesh,mesh,,83,56,161,139,221,300,0,1
android-trafficstats,android-trafficstats,,0,2,3,2,6,5,3,100
networkstatsmanager,networkstatsmanager,,2,3,7,5,6,12,3,50
compiler-warnings,compiler-warnings,,40,43,97,83,172,180,9,7.5
ffmpeg-php,ffmpeg-php,,9,6,17,15,33,32,13,1
nswindow,nswindow,,11,20,30,31,46,61,13,81.818182
base-class-library,base-class-library,,1,1,5,2,10,7,8,1
minidom,minidom,,5,5,11,10,25,21,0,1
aql,aql,,23,10,34,33,69,67,2,1
image-caching,image-caching,,4,4,8,8,12,16,13,1
pageload,pageload,,11,8,20,19,46,39,1,1
monogame,monogame,,36,26,76,62,143,138,8,1
word-cloud,word-cloud,,25,23,49,48,90,97,0,1
android-drawable,android-drawable,,73,70,133,143,270,276,3,1
samsung-galaxy,samsung-galaxy,,35,19,35,54,55,89,3,1
touch-id,touch-id,,11,4,16,15,62,31,13,1
refer,refer,,3,0,2,3,7,5,13,1
iif,iif,,5,8,26,13,39,39,4,60
punycode,punycode,,0,3,3,3,3,6,9,200
angularjs-ng-show,angularjs-ng-show,,3,3,3,6,17,9,1,1
fscalendar,fscalendar,,2,7,15,9,35,24,13,250
indy,indy,,34,30,81,64,127,145,9,1
columnname,columnname,,8,9,16,17,39,33,0,12.5
notnull,notnull,,3,5,14,8,24,22,3,66.666667
android-cursorloader,android-cursorloader,,6,1,15,7,30,22,3,1
innerhtml,innerhtml,,44,48,100,92,219,192,1,9.090909
qscrollarea,qscrollarea,,5,8,18,13,34,31,0,60
text-analysis,text-analysis,,0,0,26,0,90,26,0,1
sqlperformance,sqlperformance,,12,12,44,24,67,68,4,1
passbook,passbook,,2,5,7,7,20,14,13,150
core-text,core-text,,8,8,11,16,27,27,13,1
android-coordinatorlayout,android-coordinatorlayout,,48,46,99,94,239,193,3,1
android-appbarlayout,android-appbarlayout,,33,35,52,68,127,120,3,6.060606
android-collapsingtoolbarlayout,android-collapsingtoolbarlayout,,30,39,86,69,183,155,3,30
android-widget,android-widget,,23,22,67,45,126,112,3,1
ondraw,ondraw,,3,9,16,12,27,28,3,200
android-vectordrawable,android-vectordrawable,,34,23,56,57,99,113,3,1
knitr,knitr,,112,105,268,217,609,485,0,1
asp.net-ajax,asp.net-ajax,,78,58,131,136,249,267,8,1
static-variables,static-variables,,16,5,23,21,58,44,9,1
pyyaml,pyyaml,,25,27,49,52,87,101,0,8
sequelpro,sequelpro,,10,7,16,17,34,33,4,1
last-insert-id,last-insert-id,,2,6,14,8,21,22,4,200
voiceover,voiceover,,40,32,63,72,85,135,13,1
webdrivermanager-java,webdrivermanager-java,,4,6,4,10,13,14,3,50
datagridrowheader,datagridrowheader,,0,0,0,0,2,0,8,1
spring-jdbc,spring-jdbc,,54,80,156,134,256,290,3,48.148148
hxtt,hxtt,,0,0,0,0,1,0,3,1
ng-tags-input,ng-tags-input,,0,1,4,1,10,5,1,1
partial,partial,,19,21,44,40,79,84,0,10.526316
upsert,upsert,,35,20,62,55,92,117,4,1
java-client,java-client,,5,8,10,13,11,23,3,60
scrapyd,scrapyd,,7,9,12,16,33,28,0,28.571429
multipleoutputs,multipleoutputs,,4,5,6,9,12,15,0,25
aws-php-sdk,aws-php-sdk,,10,14,17,24,40,41,6,40
lumen,lumen,,120,99,250,219,443,469,4,1
import-module,import-module,,4,3,7,7,14,14,8,1
laravel-controller,laravel-controller,,4,5,30,9,19,39,4,25
tortoisehg,tortoisehg,,11,11,19,22,40,41,6,1
rds,rds,,39,37,60,76,155,136,6,1
smoothing,smoothing,,32,36,68,68,109,136,0,12.5
scatter3d,scatter3d,,4,7,24,11,19,35,0,75
mod-pagespeed,mod-pagespeed,,4,7,8,11,19,19,4,75
appcelerator-titanium,appcelerator-titanium,,22,12,64,34,152,98,13,1
appcelerator-mobile,appcelerator-mobile,,5,0,21,5,36,26,13,1
appcelerator-alloy,appcelerator-alloy,,3,0,8,3,46,11,13,1
android-nested-fragment,android-nested-fragment,,0,1,6,1,20,7,3,1
xenforo,xenforo,,5,5,4,10,14,14,4,1
fcgid,fcgid,,0,0,1,0,2,1,4,1
sslhandshakeexception,sslhandshakeexception,,17,16,35,33,82,68,6,1
pkix,pkix,,3,3,5,6,23,11,6,1
multi-gpu,multi-gpu,,12,18,19,30,52,49,0,50
qlineedit,qlineedit,,16,18,29,34,51,63,0,12.5
check-constraint,check-constraint,,0,0,0,0,8,0,4,1
siri,siri,,21,17,66,38,42,104,13,1
intents-extension,intents-extension,,2,2,2,4,4,6,13,1
json-web-token,json-web-token,,0,0,0,0,37,0,1,1
redux-actions,redux-actions,,4,6,9,10,30,19,1,50
concat,concat,,75,79,160,154,267,314,0,5.333333
kubectl,kubectl,,158,140,307,298,382,605,6,1
opentok,opentok,,23,27,77,50,115,127,13,17.391304
quicktime,quicktime,,0,6,10,6,16,16,13,500
after-effects,after-effects,,23,12,33,35,44,68,1,1
execl,execl,,6,4,5,10,20,15,9,1
hough-transform,hough-transform,,27,24,48,51,77,99,0,1
pdfminer,pdfminer,,33,37,40,70,63,110,0,12.121212
msp432,msp432,,2,3,8,5,5,13,9,50
openvms,openvms,,1,1,0,2,10,2,9,1
styling,styling,,57,36,98,93,180,191,1,1
confirm,confirm,,9,8,20,17,45,37,1,1
chromium-embedded,chromium-embedded,,33,29,72,62,104,134,8,1
java.util.scanner,java.util.scanner,,131,91,315,222,516,537,3,1
pyenv,pyenv,,24,21,37,45,64,82,0,1
mavendeployer,mavendeployer,,1,0,1,1,1,2,3,1
angular-controller,angular-controller,,4,0,5,4,42,9,1,1
criteria-api,criteria-api,,31,38,91,69,106,160,3,22.580645
jq,jq,,186,214,378,400,659,778,1,15.053763
wso2bps,wso2bps,,2,3,10,5,16,15,14,50
head,head,,14,18,17,32,47,49,1,28.571429
boost-spirit-qi,boost-spirit-qi,,5,1,11,6,37,17,9,1
windows-server,windows-server,,38,44,73,82,92,155,8,15.789474
angular-pipe,angular-pipe,,29,21,83,50,186,133,1,1
streamreader,streamreader,,26,20,56,46,126,102,8,1
points,points,,9,12,37,21,62,58,0,33.333333
delphi-ios,delphi-ios,,0,0,0,0,1,0,9,1
contiki,contiki,,27,20,29,47,54,76,9,1
coap,coap,,20,6,12,26,35,38,9,1
domcontentloaded,domcontentloaded,,2,7,11,9,14,20,1,250
python-decorators,python-decorators,,58,76,137,134,246,271,0,31.034483
android-tabhost,android-tabhost,,1,4,7,5,27,12,3,300
multer-s3,multer-s3,,9,11,17,20,20,37,1,22.222222
amqpstorm,amqpstorm,,0,0,0,0,2,0,3,1
java-web-start,java-web-start,,17,12,43,29,96,72,3,1
java-security,java-security,,13,22,33,35,55,68,3,69.230769
folktale,folktale,,0,0,0,0,7,0,2,1
fantasyland,fantasyland,,0,1,0,1,11,1,2,1
gremlin-server,gremlin-server,,15,40,36,55,87,91,2,166.666667
emf,emf,,7,6,25,13,46,38,3,1
google-vr-sdk,google-vr-sdk,,12,7,22,19,27,41,8,1
read.table,read.table,,15,4,19,19,63,38,0,1
nul,nul,,6,4,7,10,26,17,9,1
decode,decode,,110,99,206,209,380,415,0,1
inkcanvas,inkcanvas,,7,5,8,12,34,20,8,1
pubnub,pubnub,,13,8,23,21,74,44,13,1
air,air,,25,18,40,43,122,83,13,1
helpers,helpers,,0,0,0,0,46,0,4,1
gembox-spreadsheet,gembox-spreadsheet,,0,1,3,1,13,4,8,1
jstorage,jstorage,,1,0,0,1,1,1,1,1
twgl.js,twgl.js,,3,0,0,3,5,3,1,1
nested-loops,nested-loops,,107,81,197,188,385,385,0,1
atlassian-crowd,atlassian-crowd,,2,3,2,5,10,7,3,50
sonarqube6.3,sonarqube6.3,,1,0,3,1,7,4,3,1
midi,midi,,41,32,67,73,114,140,0,1
nuodb,nuodb,,1,0,0,1,3,1,0,1
nifti,nifti,,7,7,17,14,15,31,0,1
uiprogressview,uiprogressview,,10,1,12,11,34,23,13,1
adobe-indesign,adobe-indesign,,21,18,32,39,74,71,1,1
disk-access,disk-access,,1,0,0,1,1,1,9,1
opencart2.x,opencart2.x,,20,14,39,34,99,73,4,1
redux-middleware,redux-middleware,,4,1,10,5,23,15,1,1
popen,popen,,49,46,95,95,199,190,0,1
mpdf,mpdf,,39,44,99,83,185,182,4,12.820513
dynamics-ax-2009,dynamics-ax-2009,,1,0,8,1,16,9,8,1
formcollection,formcollection,,2,1,6,3,8,9,8,1
main,main,,52,39,112,91,195,203,3,1
unnotificationrequest,unnotificationrequest,,5,3,7,8,29,15,13,1
adcolony,adcolony,,3,1,2,4,11,6,3,1
mobile-ad-mediation,mobile-ad-mediation,,6,4,14,10,18,24,3,1
koa2,koa2,,8,11,25,19,62,44,1,37.5
external-accessory,external-accessory,,3,5,5,8,10,13,13,66.666667
executioncontext,executioncontext,,11,5,11,16,15,27,1,1
app-engine-flexible,app-engine-flexible,,16,15,52,31,114,83,6,1
featherlight.js,featherlight.js,,4,1,5,5,15,10,1,1
itemtouchhelper,itemtouchhelper,,12,17,18,29,30,47,3,41.666667
morris.js,morris.js,,26,11,19,37,64,56,1,1
android-intentservice,android-intentservice,,14,10,23,24,54,47,3,1
android-ondestroy,android-ondestroy,,2,1,6,3,12,9,3,1
attributeerror,attributeerror,,61,53,121,114,221,235,0,1
onesignal,onesignal,,73,79,204,152,289,356,3,8.219178
file-type,file-type,,16,15,26,31,31,57,0,1
uniform-initialization,uniform-initialization,,5,2,3,7,12,10,9,1
firebase-notifications,firebase-notifications,,23,14,33,37,128,70,13,1
scientific-computing,scientific-computing,,13,12,29,25,54,54,0,1
condor,condor,,1,0,6,1,4,7,0,1
background-mode,background-mode,,5,4,7,9,4,16,13,1
bounding-box,bounding-box,,29,22,45,51,89,96,0,1
renderscript,renderscript,,18,8,27,26,47,53,3,1
createcriteria,createcriteria,,0,0,4,0,4,4,3,1
xc8,xc8,,7,7,13,14,16,27,9,1
xceed,xceed,,12,14,30,26,51,56,8,16.666667
ternary,ternary,,17,17,26,34,46,60,0,1
binary-heap,binary-heap,,4,4,10,8,20,18,0,1
circular-reference,circular-reference,,15,7,33,22,55,55,5,1
hammer,hammer,,1,1,2,2,5,4,1,1
nsurlconnection,nsurlconnection,,3,6,16,9,34,25,13,100
nserror,nserror,,2,5,7,7,12,14,13,150
shutdown,shutdown,,30,19,46,49,72,95,3,1
httpi,httpi,,0,0,1,0,2,1,12,1
dllexport,dllexport,,12,9,22,21,44,43,9,1
hwnd,hwnd,,4,8,16,12,25,28,9,100
offsetwidth,offsetwidth,,0,1,1,1,3,2,1,1
reselect,reselect,,14,16,35,30,65,65,1,14.285714
office-interop,office-interop,,60,79,131,139,260,270,8,31.666667
x-sendfile,x-sendfile,,1,0,0,1,10,1,4,1
populate,populate,,29,22,56,51,79,107,1,1
suppress-warnings,suppress-warnings,,10,8,40,18,55,58,9,1
json4s,json4s,,15,9,18,24,59,42,2,1
lampp,lampp,,4,14,17,18,28,35,4,250
fedora-26,fedora-26,,0,0,0,0,21,0,9,1
new-operator,new-operator,,53,51,125,104,119,229,9,1
class-method,class-method,,16,17,22,33,73,55,0,6.25
postgresql-9.1,postgresql-9.1,,20,13,36,33,88,69,4,1
webapp2,webapp2,,13,9,17,22,61,39,6,1
pysftp,pysftp,,18,22,27,40,34,67,0,22.222222
mobile-devices,mobile-devices,,6,5,13,11,15,24,1,1
recompose,recompose,,14,7,33,21,87,54,1,1
datejs,datejs,,1,0,0,1,5,1,1,1
wcf-binding,wcf-binding,,10,13,27,23,42,50,8,30
gulp-uglify,gulp-uglify,,3,4,15,7,34,22,1,33.333333
gulp-ng-annotate,gulp-ng-annotate,,0,0,0,0,1,0,1,1
hide,hide,,55,52,133,107,234,240,1,1
mmdrawercontroller,mmdrawercontroller,,0,0,5,0,7,5,13,1
spring-hateoas,spring-hateoas,,28,33,56,61,82,117,3,17.857143
startswith,startswith,,11,10,14,21,28,35,0,1
database-deadlocks,database-deadlocks,,12,9,21,21,53,42,4,1
preprocessor,preprocessor,,56,46,84,102,188,186,9,1
stringbuilder,stringbuilder,,34,28,73,62,141,135,3,1
asteriskami,asteriskami,,6,3,6,9,15,15,13,1
interceptor,interceptor,,73,73,137,146,241,283,3,1
paypal-adaptive-payments,paypal-adaptive-payments,,8,9,17,17,40,34,4,12.5
getchar,getchar,,14,11,26,25,76,51,9,1
word-count,word-count,,18,7,25,25,65,50,0,1
richtextediting,richtextediting,,0,0,1,0,1,1,0,1
vuforia,vuforia,,78,58,140,136,232,276,8,1
py2app,py2app,,5,7,22,12,35,34,0,40
gsub,gsub,,59,61,118,120,277,238,0,3.389831
google-finance,google-finance,,7,8,14,15,71,29,5,14.285714
google-finance-api,google-finance-api,,0,0,2,0,24,2,5,1
angular-aot,angular-aot,,16,15,29,31,64,60,1,1
hp-alm,hp-alm,,6,5,7,11,27,18,5,1
nsmanagedobject,nsmanagedobject,,10,5,26,15,64,41,13,1
nsmanagedobjectmodel,nsmanagedobjectmodel,,0,0,2,0,2,2,13,1
selendroid,selendroid,,0,2,3,2,11,5,3,100
testautomationfx,testautomationfx,,0,1,5,1,6,6,3,1
firebase-remote-config,firebase-remote-config,,22,25,44,47,78,91,13,13.636364
image-thresholding,image-thresholding,,10,15,25,25,22,50,0,50
filesize,filesize,,25,19,37,44,101,81,0,1
html5mode,html5mode,,3,1,0,4,10,4,1,1
option,option,,35,15,62,50,123,112,1,1
custom-element,custom-element,,45,42,100,87,93,187,1,1
collision-detection,collision-detection,,74,64,137,138,253,275,0,1
laravel-forge,laravel-forge,,5,5,19,10,28,29,4,1
stylus,stylus,,11,9,27,20,75,47,1,1
eclipselink,eclipselink,,74,54,126,128,302,254,3,1
string-concatenation,string-concatenation,,37,26,58,63,169,121,0,1
coding-efficiency,coding-efficiency,,13,14,30,27,49,57,0,7.692308
ng2-charts,ng2-charts,,35,35,44,70,69,114,1,1
chartjs-2.6.0,chartjs-2.6.0,,25,19,68,44,69,112,1,1
browser-cache,browser-cache,,64,64,135,128,230,263,1,1
node-sqlite3,node-sqlite3,,21,15,19,36,15,55,1,1
polyline,polyline,,18,38,51,56,82,107,1,111.111111
git-merge,git-merge,,71,80,162,151,302,313,6,12.676056
jaxb2-maven-plugin,jaxb2-maven-plugin,,6,5,12,11,33,23,3,1
artisan,artisan,,53,50,122,103,245,225,4,1
elasticsearch-mapping,elasticsearch-mapping,,4,8,6,12,17,18,6,100
data-partitioning,data-partitioning,,13,7,18,20,25,38,4,1
progress-db,progress-db,,13,4,13,17,28,30,4,1
standard-error,standard-error,,9,13,15,22,25,37,0,44.444444
sendmessage,sendmessage,,12,8,29,20,56,49,9,1
plivo,plivo,,2,2,3,4,23,7,4,1
observablecollection,observablecollection,,31,33,80,64,168,144,8,6.451613
grouped-collection-select,grouped-collection-select,,0,1,2,1,2,3,12,1
serversocket,serversocket,,49,31,94,80,161,174,9,1
apache-pig,apache-pig,,23,16,57,39,179,96,2,1
libpng,libpng,,16,12,16,28,34,44,0,1
deb,deb,,14,13,19,27,38,46,9,1
xero-api,xero-api,,17,25,23,42,51,65,4,47.058824
xeroizer,xeroizer,,0,0,1,0,4,1,12,1
kubernetes-health-check,kubernetes-health-check,,5,2,28,7,47,35,6,1
directive,directive,,29,27,55,56,156,111,1,1
scala-cats,scala-cats,,71,60,91,131,165,222,2,1
enterprise-library,enterprise-library,,9,7,16,16,24,32,8,1
copy-elision,copy-elision,,4,7,9,11,37,20,9,75
shortcut,shortcut,,34,38,95,72,137,167,3,11.764706
share-button,share-button,,3,3,6,6,12,12,3,1
home-directory,home-directory,,0,2,4,2,11,6,8,100
asyncdisplaykit,asyncdisplaykit,,2,6,9,8,26,17,13,200
android-keystore,android-keystore,,37,27,81,64,117,145,3,1
apc,apc,,2,4,4,6,13,10,4,100
swiper,swiper,,74,64,86,138,123,224,1,1
smartcontracts,smartcontracts,,70,36,162,106,279,268,6,1
frames,frames,,8,11,29,19,52,48,1,37.5
embedding,embedding,,45,31,68,76,96,144,0,1
xtrareport,xtrareport,,2,4,17,6,18,23,8,100
squarespace,squarespace,,21,26,49,47,76,96,1,23.809524
uft-api,uft-api,,1,0,9,1,14,10,5,1
uisplitviewcontroller,uisplitviewcontroller,,19,18,23,37,60,60,13,1
rabbitmq-c,rabbitmq-c,,0,0,4,0,5,4,3,1
nusoap,nusoap,,11,5,17,16,22,33,4,1
non-ascii-characters,non-ascii-characters,,29,18,36,47,79,83,0,1
mapr,mapr,,11,9,36,20,61,56,2,1
nservicebus-sagas,nservicebus-sagas,,0,1,3,1,9,4,8,1
nuget-spec,nuget-spec,,5,6,18,11,26,29,8,20
string-comparison,string-comparison,,45,45,81,90,151,171,0,1
compareto,compareto,,13,8,22,21,56,43,3,1
lexicographic,lexicographic,,6,5,9,11,20,20,0,1
native-ads,native-ads,,3,8,14,11,26,25,3,166.666667
fabric,fabric,,31,14,58,45,71,103,0,1
begininvoke,begininvoke,,3,2,2,5,9,7,8,1
spring-retry,spring-retry,,14,16,30,30,63,60,3,14.285714
change-password,change-password,,11,11,21,22,55,43,4,1
execution,execution,,28,28,55,56,112,111,0,1
inetaddress,inetaddress,,6,1,5,7,11,12,3,1
aem,aem,,70,75,170,145,383,315,3,7.142857
sparkr,sparkr,,18,20,47,38,105,85,2,11.111111
markupbuilder,markupbuilder,,1,1,1,2,3,3,3,1
jconsole,jconsole,,9,5,10,14,27,24,3,1
jmc,jmc,,7,5,8,12,21,20,3,1
primary-key,primary-key,,63,49,150,112,267,262,4,1
data-annotations,data-annotations,,31,41,75,72,147,147,8,32.258065
console.readline,console.readline,,0,1,5,1,8,6,8,1
cumulocity,cumulocity,,10,8,21,18,32,39,3,1
nspopover,nspopover,,5,1,6,6,16,12,13,1
openssh,openssh,,37,37,59,74,104,133,9,1
sshd,sshd,,6,11,12,17,30,29,9,83.333333
auth.log,auth.log,,0,0,0,0,2,0,9,1
point-clouds,point-clouds,,41,41,90,82,109,172,0,1
helix-3d-toolkit,helix-3d-toolkit,,12,10,20,22,16,42,8,1
avaudioplayer,avaudioplayer,,27,44,87,71,154,158,13,62.962963
mysql-error-1064,mysql-error-1064,,16,22,68,38,122,106,4,37.5
itext7,itext7,,59,83,144,142,319,286,8,40.677966
c++98,c++98,,30,12,26,42,60,68,9,1
maven-cargo,maven-cargo,,0,3,0,3,3,3,3,200
smack,smack,,18,8,44,26,124,70,3,1
datamodel,datamodel,,13,7,14,20,39,34,4,1
spelling,spelling,,3,0,9,3,22,12,0,1
angular-template,angular-template,,43,22,52,65,157,117,1,1
readxl,readxl,,14,11,33,25,53,58,0,1
insert-update,insert-update,,27,22,43,49,97,92,4,1
gwt-super-dev-mode,gwt-super-dev-mode,,0,1,4,1,4,5,3,1
redmine-api,redmine-api,,5,5,6,10,9,16,12,1
delete-file,delete-file,,19,40,64,59,148,123,9,110.526316
measurement-protocol,measurement-protocol,,9,6,16,15,38,31,5,1
openmeetings,openmeetings,,0,1,1,1,7,2,6,1
fancybox,fancybox,,37,24,45,61,169,106,1,1
spring-annotations,spring-annotations,,28,27,48,55,95,103,3,1
decimalformat,decimalformat,,12,10,25,22,62,47,3,1
one-hot-encoding,one-hot-encoding,,64,59,105,123,155,228,0,1
rocket.chat,rocket.chat,,15,12,19,27,51,46,1,1
explorer,explorer,,26,21,33,47,60,80,9,1
flyout,flyout,,4,7,6,11,11,17,8,75
ionic2-datetime,ionic2-datetime,,0,0,1,0,1,1,1,1
holoviews,holoviews,,53,38,70,91,87,161,0,1
packet-capture,packet-capture,,13,11,26,24,50,50,9,1
packet-sniffers,packet-sniffers,,18,24,33,42,42,75,9,33.333333
salt,salt,,23,15,38,38,88,76,4,1
pbkdf2,pbkdf2,,8,10,12,18,39,30,6,25
warehouse,warehouse,,3,3,7,6,16,13,4,1
python-ldap,python-ldap,,3,6,11,9,20,20,0,100
gorm,gorm,,38,37,106,75,196,181,3,1
extension-methods,extension-methods,,55,56,103,111,193,214,8,1.818182
pptp,pptp,,0,4,3,4,6,7,9,300
spring-data-neo4j-4,spring-data-neo4j-4,,0,0,2,0,30,2,2,1
neo4j-ogm,neo4j-ogm,,17,10,30,27,82,57,2,1
spring-data-neo4j-5,spring-data-neo4j-5,,0,0,2,0,35,2,2,1
owl-carousel-2,owl-carousel-2,,11,12,29,23,60,52,1,9.090909
spring-restcontroller,spring-restcontroller,,57,59,121,116,245,237,3,3.508772
gist,gist,,7,15,9,22,34,31,6,114.285714
spark-cloudant,spark-cloudant,,0,0,0,0,1,0,1,1
perfect-forwarding,perfect-forwarding,,13,11,27,24,51,51,9,1
pgadmin-4,pgadmin-4,,45,32,82,77,115,159,4,1
derivative,derivative,,25,22,51,47,73,98,0,1
internet-explorer-10,internet-explorer-10,,7,1,12,8,32,20,1,1
xacml,xacml,,13,7,20,20,47,40,4,1
magrittr,magrittr,,17,20,22,37,58,59,0,17.647059
iosdeployment,iosdeployment,,1,2,7,3,20,10,13,100
panel-data,panel-data,,27,26,31,53,63,84,0,1
countdowntimer,countdowntimer,,42,36,66,78,154,144,3,1
nouislider,nouislider,,12,9,24,21,45,45,1,1
watch-os,watch-os,,29,47,68,76,86,144,13,62.068966
glew,glew,,13,18,33,31,64,64,9,38.461538
soundcloud,soundcloud,,14,9,22,23,42,45,1,1
svprogresshud,svprogresshud,,1,2,5,3,13,8,13,100
laravel-storage,laravel-storage,,7,4,18,11,19,29,4,1
gradle-task,gradle-task,,1,8,10,9,22,19,3,700
export-to-excel,export-to-excel,,51,57,94,108,225,202,5,11.764706
spark-cassandra-connector,spark-cassandra-connector,,25,18,36,43,119,79,2,1
sagepay,sagepay,,6,20,13,26,25,39,4,233.333333
dynamics-crm-webapi,dynamics-crm-webapi,,12,16,30,28,48,58,8,33.333333
searchbar,searchbar,,27,28,48,55,107,103,13,3.703704
tabbedpage,tabbedpage,,21,8,30,29,42,59,8,1
bridging-header,bridging-header,,8,6,26,14,37,40,13,1
airplay,airplay,,15,17,10,32,29,42,13,13.333333
mirroring,mirroring,,7,8,24,15,20,39,6,14.285714
iso8601,iso8601,,20,18,40,38,101,78,0,1
controlfile,controlfile,,2,1,3,3,4,6,4,1
ioerror,ioerror,,2,6,11,8,33,19,0,200
teamforge,teamforge,,1,0,4,1,2,5,6,1
spinnaker,spinnaker,,17,20,51,37,68,88,6,17.647059
webshop,webshop,,2,1,7,3,8,10,4,1
jmx,jmx,,61,52,92,113,171,205,3,1
jcs,jcs,,1,2,1,3,5,4,3,100
uiimagepickercontroller,uiimagepickercontroller,,44,37,103,81,241,184,13,1
key-generator,key-generator,,1,0,5,1,14,6,3,1
ultisnips,ultisnips,,0,1,5,1,8,6,9,1
cakephp-2.5,cakephp-2.5,,2,4,6,6,12,12,4,100
gulp-watch,gulp-watch,,19,20,58,39,88,97,1,5.263158
gulp-browser-sync,gulp-browser-sync,,5,3,25,8,34,33,1,1
kineticjs,kineticjs,,0,3,2,3,3,5,1,200
boto,boto,,29,30,54,59,153,113,6,3.448276
reportingservices-2005,reportingservices-2005,,6,4,14,10,17,24,4,1
hdmi-cec,hdmi-cec,,0,1,2,1,6,3,3,1
selenium-iedriver,selenium-iedriver,,9,12,32,21,70,53,3,33.333333
akka.net,akka.net,,10,10,39,20,96,59,8,1
fpdi,fpdi,,6,6,21,12,38,33,4,1
llvm-clang,llvm-clang,,44,46,95,90,171,185,9,4.545455
sctp,sctp,,3,2,12,5,20,17,3,1
rtcdatachannel,rtcdatachannel,,6,0,3,6,9,9,1,1
material-design-lite,material-design-lite,,7,7,23,14,47,37,1,1
angular2-mdl,angular2-mdl,,0,0,0,0,6,0,1,1
xdr,xdr,,0,0,1,0,7,1,3,1
scrapy-signal,scrapy-signal,,0,0,0,0,1,0,0,1
regression-testing,regression-testing,,5,6,8,11,20,19,3,20
interlocked,interlocked,,3,2,3,5,15,8,8,1
powershell-2.0,powershell-2.0,,63,29,111,92,265,203,8,1
windows-server-2008-r2,windows-server-2008-r2,,9,13,41,22,71,63,8,44.444444
dnf,dnf,,3,1,7,4,10,11,9,1
gd,gd,,22,21,62,43,97,105,4,1
vim-syntax-highlighting,vim-syntax-highlighting,,6,4,15,10,42,25,9,1
css-sprites,css-sprites,,5,4,13,9,18,22,1,1
onblur,onblur,,11,16,16,27,38,43,1,45.454545
jsr223,jsr223,,25,25,39,50,47,89,3,1
ios9,ios9,,4,2,14,6,65,20,13,1
uiapplication,uiapplication,,7,7,14,14,37,28,13,1
ienumerable,ienumerable,,36,48,94,84,168,178,8,33.333333
clib,clib,,0,1,0,1,1,1,9,1
member-functions,member-functions,,12,9,23,21,37,44,9,1
openmdao,openmdao,,3,4,14,7,22,21,0,33.333333
3-tier,3-tier,,4,3,6,7,19,13,8,1
android-gps,android-gps,,38,32,56,70,124,126,3,1
argument-dependent-lookup,argument-dependent-lookup,,5,12,8,17,36,25,9,140
light,light,,9,9,38,18,74,56,9,1
basil.js,basil.js,,0,1,0,1,1,1,1,1
inlining,inlining,,3,1,4,4,9,8,9,1
menuitem,menuitem,,35,28,60,63,144,123,3,1
angular-translate,angular-translate,,8,6,25,14,67,39,1,1
angular-sanitizer,angular-sanitizer,,0,0,1,0,7,1,1,1
jettison,jettison,,2,0,2,2,5,4,3,1
istream,istream,,13,4,20,17,43,37,9,1
vfs,vfs,,6,8,12,14,26,26,9,33.333333
ecmascript-7,ecmascript-7,,9,21,42,30,44,72,1,133.333333
spring-web,spring-web,,45,3,65,48,103,113,3,1
searchview,searchview,,56,46,110,102,269,212,3,1
owl-carousel,owl-carousel,,68,48,128,116,209,244,1,1
mikrotik,mikrotik,,14,14,29,28,42,57,4,1
azure-worker-roles,azure-worker-roles,,2,1,7,3,30,10,8,1
azure-cloud-services,azure-cloud-services,,15,15,60,30,88,90,8,1
nic,nic,,4,11,18,15,21,33,9,175
scalastyle,scalastyle,,2,0,4,2,7,6,2,1
fileserver,fileserver,,2,10,12,12,19,24,4,400
kitura,kitura,,8,6,3,14,17,17,13,1
server-side-swift,server-side-swift,,11,5,8,16,12,24,13,1
access-rules,access-rules,,0,2,2,2,2,4,6,100
redis-sentinel,redis-sentinel,,8,14,19,22,34,41,3,75
android-renderscript,android-renderscript,,9,4,13,13,17,26,3,1
jface,jface,,14,8,18,22,94,40,3,1
git-branch,git-branch,,50,55,97,105,241,202,6,10
master,master,,6,9,25,15,58,40,6,50
joomla3.0,joomla3.0,,20,30,61,50,133,111,4,50
joomla-extensions,joomla-extensions,,2,5,10,7,37,17,4,150
chronoforms,chronoforms,,1,1,5,2,4,7,4,1
kruskal-wallis,kruskal-wallis,,6,5,9,11,6,20,0,1
ntfs,ntfs,,22,11,51,33,67,84,9,1
vds,vds,,2,0,2,2,3,4,9,1
vhdl,vhdl,,140,83,184,223,351,407,9,1
fpga,fpga,,88,63,157,151,256,308,9,1
synthesis,synthesis,,10,8,21,18,29,39,9,1
vivado,vivado,,34,37,63,71,98,134,9,8.823529
spring-social,spring-social,,12,9,18,21,44,39,3,1
rlang,rlang,,40,48,65,88,128,153,0,20
trigonometry,trigonometry,,68,54,128,122,200,250,0,1
protected,protected,,22,22,40,44,88,84,9,1
jndi,jndi,,48,45,109,93,159,202,3,1
phpfastcache,phpfastcache,,0,0,2,0,3,2,4,1
hamburger-menu,hamburger-menu,,23,11,40,34,80,74,1,1
sql-server-2005,sql-server-2005,,25,19,59,44,180,103,4,1
django-1.9,django-1.9,,6,2,17,8,18,25,0,1
ldap3,ldap3,,11,15,17,26,24,43,0,36.363636
sprite,sprite,,62,43,128,105,237,233,0,1
spock,spock,,61,50,104,111,239,215,3,1
semantic-markup,semantic-markup,,13,11,24,24,74,48,1,1
openstack-horizon,openstack-horizon,,2,1,8,3,20,11,6,1
amazon-elastic-beanstalk,amazon-elastic-beanstalk,,292,242,532,534,198,1066,6,1
android-context,android-context,,48,22,85,70,173,155,3,1
directoryservices,directoryservices,,8,7,22,15,32,37,8,1
directoryentry,directoryentry,,6,1,5,7,15,12,8,1
directorysearcher,directorysearcher,,2,1,6,3,12,9,8,1
mediarecorder,mediarecorder,,25,27,49,52,96,101,3,8
audiotrack,audiotrack,,19,6,18,25,37,43,3,1
screen-recording,screen-recording,,5,9,20,14,34,34,13,80
mediastream,mediastream,,19,19,23,38,33,61,1,1
conditional-formatting,conditional-formatting,,75,73,137,148,262,285,5,1
back4app,back4app,,15,11,24,26,33,50,13,1
serde,serde,,21,29,38,50,65,88,9,38.095238
serde-json,serde-json,,0,6,4,6,13,10,9,500
pre-commit,pre-commit,,7,9,8,16,18,24,6,28.571429
pygobject,pygobject,,19,16,54,35,70,89,9,1
team-project,team-project,,0,0,2,0,2,2,8,1
headless,headless,,43,38,74,81,162,155,3,1
http-error,http-error,,23,15,35,38,71,73,4,1
es6-modules,es6-modules,,120,104,178,224,355,402,1,1
asp.net-membership,asp.net-membership,,10,10,19,20,37,39,8,1
transaction-log,transaction-log,,3,3,10,6,12,16,4,1
dms,dms,,9,3,9,12,12,21,6,1
happens-before,happens-before,,2,4,6,6,11,12,3,100
reorderlist,reorderlist,,1,2,3,3,10,6,0,100
facebook-marketing-api,facebook-marketing-api,,36,25,68,61,102,129,13,1
single-responsibility-principle,single-responsibility-principle,,8,12,9,20,26,29,3,50
letters,letters,,0,0,3,0,31,3,0,1
python-wheel,python-wheel,,25,21,36,46,101,82,0,1
dynamicresource,dynamicresource,,2,1,4,3,9,7,8,1
ssrs-2016,ssrs-2016,,29,18,55,47,105,102,4,1
jsqmessagesviewcontroller,jsqmessagesviewcontroller,,3,2,10,5,45,15,13,1
paypal-mpl,paypal-mpl,,0,0,0,0,1,0,13,1
aws-xray,aws-xray,,14,16,25,30,46,55,6,14.285714
marshmallow,marshmallow,,45,29,58,74,63,132,0,1
differential-equations,differential-equations,,33,32,86,65,153,151,0,1
rowheader,rowheader,,0,0,1,0,4,1,8,1
laravel-query-builder,laravel-query-builder,,60,65,146,125,232,271,4,8.333333
tex,tex,,21,14,41,35,58,76,0,1
android-menu,android-menu,,20,11,50,31,80,81,3,1
jquery-inputmask,jquery-inputmask,,9,4,12,13,28,25,1,1
input-mask,input-mask,,8,8,10,16,27,26,1,1
directx-11,directx-11,,34,38,83,72,146,155,9,11.764706
application-server,application-server,,1,2,27,3,31,30,3,100
typehead,typehead,,7,2,3,9,17,12,1,1
flip,flip,,10,4,19,14,37,33,1,1
arduino-ide,arduino-ide,,58,57,62,115,101,177,9,1
bad-gateway,bad-gateway,,9,7,12,16,27,28,6,1
android-architecture-components,android-architecture-components,,136,117,351,253,592,604,3,1
excellibrary,excellibrary,,0,2,3,2,5,5,8,100
directoryindex,directoryindex,,2,2,3,4,4,7,4,1
google-input-tools,google-input-tools,,1,0,0,1,2,1,1,1
uialertaction,uialertaction,,7,7,10,14,24,24,13,1
webspeech-api,webspeech-api,,4,1,17,5,26,22,1,1
rollup,rollup,,38,36,60,74,91,134,1,1
scorm2004,scorm2004,,2,0,7,2,8,9,1,1
winston,winston,,37,55,85,92,135,177,1,48.648649
odo,odo,,0,0,3,0,8,3,0,1
uicollectionviewdelegateflowlayout,uicollectionviewdelegateflowlayout,,1,1,8,2,10,10,13,1
minify,minify,,29,29,104,58,181,162,1,1
purifycss,purifycss,,0,0,0,0,7,0,1,1
elassandra,elassandra,,2,5,18,7,21,25,2,150
v-for,v-for,,34,39,59,73,104,132,1,14.705882
http-status-code-301,http-status-code-301,,37,35,72,72,124,144,4,1
location-updates,location-updates,,1,2,0,3,12,3,3,100
sap-web-ide,sap-web-ide,,22,14,28,36,31,64,1,1
utf8mb4,utf8mb4,,16,9,27,25,49,52,4,1
invalid-characters,invalid-characters,,3,1,5,4,14,9,0,1
etherpad,etherpad,,2,3,0,5,3,5,1,50
plone,plone,,11,3,18,14,46,32,0,1
plone-3.x,plone-3.x,,0,0,0,0,2,0,0,1
woopra,woopra,,0,0,0,0,1,0,4,1
extension-builder3,extension-builder3,,0,0,0,0,3,0,4,1
apache-nms,apache-nms,,1,0,1,1,4,2,8,1
fragmentstatepageradapter,fragmentstatepageradapter,,4,2,14,6,37,20,3,1
parameterized-query,parameterized-query,,4,8,12,12,27,24,4,100
.net-remoting,.net-remoting,,1,0,5,1,12,6,8,1
osgeo,osgeo,,12,4,7,16,21,23,0,1
dreamfactory,dreamfactory,,2,2,6,4,19,10,4,1
princexml,princexml,,2,1,2,3,3,5,8,1
css-paged-media,css-paged-media,,2,2,4,4,9,8,1,1
amazon-cloudformation,amazon-cloudformation,,332,337,601,669,1005,1270,6,1.506024
nagios,nagios,,18,20,44,38,88,82,6,11.111111
connection-refused,connection-refused,,13,8,28,21,33,49,4,1
python-mlab,python-mlab,,0,0,0,0,1,0,0,1
mlab,mlab,,18,11,68,29,134,97,1,1
network-monitoring,network-monitoring,,4,6,10,10,18,20,9,50
odeint,odeint,,14,20,37,34,55,71,0,42.857143
c++-cx,c++-cx,,11,10,20,21,54,41,8,1
confluence-rest-api,confluence-rest-api,,6,9,17,15,24,32,6,50
glib,glib,,28,27,47,55,100,102,9,1
javafx-9,javafx-9,,0,1,2,1,42,3,3,1
cdata,cdata,,17,11,41,28,65,69,3,1
ioc-container,ioc-container,,19,14,44,33,103,77,8,1
type-assertion,type-assertion,,4,4,8,8,28,16,6,1
eve,eve,,13,14,25,27,57,52,0,7.692308
cerberus,cerberus,,7,7,11,14,26,25,0,1
intellij-idea2017,intellij-idea2017,,0,0,1,0,18,1,3,1
tfs-workitem,tfs-workitem,,8,7,34,15,67,49,8,1
cassandra-2.0,cassandra-2.0,,22,15,37,37,74,74,2,1
hang,hang,,16,13,46,29,79,75,3,1
bufferblock,bufferblock,,2,0,0,2,4,2,8,1
speaker,speaker,,10,6,9,16,20,25,3,1
getusermedia,getusermedia,,43,27,63,70,104,133,1,1
http-status-code-500,http-status-code-500,,13,21,49,34,77,83,4,61.538462
xmlrpclib,xmlrpclib,,2,1,2,3,8,5,0,1
microsoft-ui-automation,microsoft-ui-automation,,5,8,10,13,19,23,8,60
imagecreatefrompng,imagecreatefrompng,,1,2,3,3,12,6,4,100
cloud-sql-proxy,cloud-sql-proxy,,15,7,19,22,27,41,6,1
nice,nice,,1,2,6,3,3,9,9,100
mstest,mstest,,57,66,119,123,239,242,8,15.789474
cefsharp.offscreen,cefsharp.offscreen,,2,3,6,5,13,11,8,50
servicenow,servicenow,,38,46,78,84,109,162,1,21.052632
box,box,,25,18,39,43,77,82,1,1
elementwise-operations,elementwise-operations,,3,6,14,9,27,23,0,100
antivirus,antivirus,,14,11,26,25,41,51,8,1
sha256,sha256,,54,35,113,89,192,202,6,1
pki,pki,,17,12,34,29,57,63,6,1
paypal-rest-sdk,paypal-rest-sdk,,36,46,90,82,125,172,4,27.777778
xarray,xarray,,0,0,0,0,55,0,0,1
openoffice-calc,openoffice-calc,,5,7,9,12,32,21,5,40
uno,uno,,3,5,12,8,13,20,5,66.666667
weld-se,weld-se,,1,2,6,3,5,9,3,100
whatsapp,whatsapp,,92,101,154,193,252,347,3,9.782609
android-package-managers,android-package-managers,,10,5,23,15,32,38,3,1
activitynotfoundexception,activitynotfoundexception,,2,0,2,2,6,4,3,1
start-job,start-job,,4,2,13,6,19,19,8,1
suitescript,suitescript,,43,46,99,89,165,188,14,6.976744
isset,isset,,15,8,34,23,71,57,4,1
totalview,totalview,,0,0,0,0,2,0,9,1
pstricks,pstricks,,0,0,0,0,3,0,0,1
data-lineage,data-lineage,,4,2,5,6,8,11,2,1
jbutton,jbutton,,49,33,115,82,263,197,3,1
uitabbaritem,uitabbaritem,,9,15,36,24,63,60,13,66.666667
jquery-bootgrid,jquery-bootgrid,,4,3,9,7,16,16,1,1
linq-to-xml,linq-to-xml,,28,31,53,59,160,112,8,10.714286
aspen,aspen,,3,1,7,4,8,11,4,1
angular-di,angular-di,,0,1,2,1,13,3,1,1
dygraphs,dygraphs,,22,10,25,32,75,57,0,1
windows-phone-8,windows-phone-8,,0,0,4,0,21,4,8,1
xamarin.uitest,xamarin.uitest,,16,17,33,33,52,66,8,6.25
multipage,multipage,,8,4,7,12,27,19,5,1
mobile-safari,mobile-safari,,89,72,179,161,239,340,1,1
swingworker,swingworker,,6,2,22,8,24,30,3,1
worksheet-function,worksheet-function,,25,10,34,35,78,69,5,1
wshttpbinding,wshttpbinding,,1,2,11,3,6,14,8,100
innertext,innertext,,4,4,8,8,10,16,1,1
reload,reload,,49,36,88,85,179,173,1,1
baseadapter,baseadapter,,12,6,35,18,82,53,3,1
race-condition,race-condition,,45,43,91,88,167,179,3,1
condition-variable,condition-variable,,17,15,24,32,69,56,9,1
xlpagertabstrip,xlpagertabstrip,,4,6,16,10,38,26,13,50
spring-ldap,spring-ldap,,20,23,36,43,57,79,3,15
hstore,hstore,,6,11,6,17,15,23,4,83.333333
sonarqube-plugin,sonarqube-plugin,,4,0,2,4,8,6,3,1
jprofiler,jprofiler,,5,4,22,9,31,31,3,1
gecko,gecko,,11,11,16,22,39,38,8,1
retina,retina,,4,4,6,8,10,14,1,1
python-unicode,python-unicode,,52,29,68,81,149,149,0,1
treeviewer,treeviewer,,0,0,3,0,6,3,3,1
mmenu,mmenu,,4,5,11,9,23,20,1,25
ofstream,ofstream,,21,12,30,33,74,63,9,1
stdthread,stdthread,,13,13,24,26,55,50,9,1
swipe-gesture,swipe-gesture,,6,5,20,11,32,31,3,1
messageformat,messageformat,,2,0,5,2,12,7,3,1
arrow-functions,arrow-functions,,65,59,131,124,226,255,1,1
firebase-crash-reporting,firebase-crash-reporting,,2,4,18,6,50,24,3,100
flyway,flyway,,63,51,90,114,192,204,3,1
phpdoc,phpdoc,,14,7,24,21,55,45,4,1
psr-2,psr-2,,2,2,4,4,22,8,4,1
psr-1,psr-1,,0,2,1,2,4,3,4,100
xgettext,xgettext,,1,2,2,3,7,5,4,100
associative,associative,,8,6,10,14,23,24,1,1
socket.io-redis,socket.io-redis,,3,2,6,5,13,11,1,1
stylecop,stylecop,,7,15,20,22,29,42,8,114.285714
vs-community-edition,vs-community-edition,,1,0,3,1,10,4,8,1
qpixmap,qpixmap,,7,4,18,11,54,29,0,1
service-layer,service-layer,,2,1,14,3,9,17,8,1
sapb1,sapb1,,15,15,26,30,54,56,5,1
xsodata,xsodata,,0,0,3,0,9,3,5,1
ondestroy,ondestroy,,4,4,8,8,15,16,3,1
objectid,objectid,,8,14,20,22,39,42,1,75
lync-2013,lync-2013,,0,0,9,0,7,9,8,1
lync-client-sdk,lync-client-sdk,,3,1,15,4,12,19,8,1
onvif,onvif,,12,7,27,19,43,46,13,1
ws-discovery,ws-discovery,,1,0,2,1,4,3,8,1
dispose,dispose,,28,20,54,48,91,102,8,1
showdialog,showdialog,,3,2,10,5,12,15,8,1
filemaker,filemaker,,14,12,27,26,81,53,4,1
debian-jessie,debian-jessie,,20,10,22,30,72,52,9,1
ff,ff,,4,4,6,8,17,14,0,1
git-submodules,git-submodules,,82,47,147,129,243,276,6,1
sqlfiddle,sqlfiddle,,1,1,3,2,23,5,4,1
imessage,imessage,,10,6,33,16,46,49,13,1
image-segmentation,image-segmentation,,101,92,130,193,230,323,0,1
sugarcrm,sugarcrm,,25,23,44,48,100,92,4,1
suitecrm,suitecrm,,22,19,34,41,73,75,4,1
stomp,stomp,,51,57,81,108,131,189,3,11.764706
cytoscape.js,cytoscape.js,,31,21,55,52,93,107,1,1
autobahn,autobahn,,13,6,16,19,40,35,0,1
builder,builder,,41,31,74,72,132,146,3,1
python-packaging,python-packaging,,33,37,54,70,98,124,0,12.121212
publish-subscribe,publish-subscribe,,66,71,116,137,246,253,3,7.575758
uisearchcontroller,uisearchcontroller,,35,28,74,63,244,137,13,1
cumulative-sum,cumulative-sum,,16,18,43,34,75,77,0,12.5
oclazyload,oclazyload,,2,2,6,4,23,10,1,1
jquery-lazyload,jquery-lazyload,,0,2,4,2,12,6,1,100
connection-pooling,connection-pooling,,56,63,124,119,204,243,3,12.5
hikaricp,hikaricp,,66,60,116,126,148,242,3,1
spring-rest,spring-rest,,63,50,125,113,281,238,3,1
angular-ngselect,angular-ngselect,,15,23,57,38,42,95,1,53.333333
asynchttpclient,asynchttpclient,,6,10,27,16,39,43,3,66.666667
zipwith,zipwith,,3,1,1,4,4,5,2,1
parameterized,parameterized,,7,7,18,14,20,32,3,1
viewbox,viewbox,,8,6,12,14,30,26,1,1
boxable,boxable,,2,2,4,4,7,8,3,1
nstablecellview,nstablecellview,,4,2,4,6,11,10,13,1
ngonchanges,ngonchanges,,4,3,9,7,29,16,1,1
spring-amqp,spring-amqp,,61,44,80,105,204,185,3,1
spring-rabbit,spring-rabbit,,5,12,22,17,78,39,3,140
persistent,persistent,,9,8,21,17,41,38,2,1
odm,odm,,3,2,12,5,14,17,1,1
clear,clear,,15,17,29,32,55,61,1,13.333333
temporary,temporary,,6,4,12,10,36,22,9,1
object-oriented-analysis,object-oriented-analysis,,11,9,21,20,48,41,3,1
azure-api-management,azure-api-management,,70,80,131,150,190,281,8,14.285714
sql-workbench-j,sql-workbench-j,,2,5,11,7,11,18,4,150
javers,javers,,9,19,20,28,44,48,3,111.111111
firebase-dynamic-links,firebase-dynamic-links,,60,68,128,128,200,256,13,13.333333
firebase-invites,firebase-invites,,1,2,19,3,29,22,13,100
nohup,nohup,,12,15,27,27,58,54,9,25
gamekit,gamekit,,6,3,18,9,18,27,13,1
iec61131-3,iec61131-3,,2,1,5,3,4,8,9,1
skstorereviewcontroller,skstorereviewcontroller,,2,1,7,3,18,10,13,1
tk,tk,,48,33,78,81,212,159,0,1
dbflow,dbflow,,2,3,11,5,17,16,3,50
least-privilege,least-privilege,,0,0,0,0,3,0,9,1
aurelia-templating,aurelia-templating,,0,0,0,0,9,0,1,1
updatepanel,updatepanel,,30,21,52,51,101,103,8,1
fosuserbundle,fosuserbundle,,39,18,80,57,249,137,4,1
nancy,nancy,,8,13,21,21,75,42,8,62.5
background-size,background-size,,5,5,9,10,20,19,1,1
testbed,testbed,,5,8,15,13,32,28,1,60
one-to-one,one-to-one,,32,18,54,50,118,104,3,1
project-calico,project-calico,,9,9,18,18,21,36,6,1
dm-script,dm-script,,2,5,3,7,28,10,9,150
template-matching,template-matching,,7,12,15,19,45,34,0,71.428571
janus,janus,,2,6,8,8,9,16,8,200
autocompletetextview,autocompletetextview,,22,19,44,41,102,85,3,1
ime,ime,,5,11,16,16,21,32,3,120
excel-addins,excel-addins,,26,39,79,65,109,144,5,50
myfaces,myfaces,,2,3,14,5,22,19,3,50
model-associations,model-associations,,5,5,22,10,49,32,12,1
contacts,contacts,,49,44,118,93,93,211,3,1
ghc,ghc,,36,26,67,62,182,129,2,1
firebug,firebug,,2,1,6,3,29,9,1,1
screen,screen,,53,48,128,101,223,229,3,1
onbeforeunload,onbeforeunload,,9,7,31,16,56,47,1,1
jaws-screen-reader,jaws-screen-reader,,20,6,29,26,53,55,13,1
xsp,xsp,,4,1,3,5,4,8,8,1
sass-loader,sass-loader,,23,14,31,37,76,68,1,1
sql-agent-job,sql-agent-job,,9,10,11,19,39,30,4,11.111111
sql-agent,sql-agent,,7,10,11,17,32,28,4,42.857143
optional-parameters,optional-parameters,,15,13,38,28,80,66,8,1
jqgrid-asp.net,jqgrid-asp.net,,3,3,7,6,17,13,1,1
free-jqgrid,free-jqgrid,,12,5,22,17,89,39,1,1
jqgrid-formatter,jqgrid-formatter,,3,3,3,6,19,9,1,1
mvcjqgrid,mvcjqgrid,,0,0,4,0,9,4,1,1
network-security,network-security,,2,12,8,14,11,22,9,500
port-scanning,port-scanning,,3,4,6,7,16,13,9,33.333333
openvas,openvas,,2,0,5,2,7,7,9,1
fuseki,fuseki,,17,10,23,27,45,50,2,1
conditional-statements,conditional-statements,,178,362,274,540,565,814,0,103.370787
graphdb,graphdb,,22,8,33,30,53,63,2,1
cryptojs,cryptojs,,52,51,94,103,141,197,6,1
requestjs,requestjs,,8,6,8,14,27,22,1,1
kendo-validator,kendo-validator,,3,1,2,4,12,6,1,1
powershell-5.0,powershell-5.0,,18,46,50,64,155,114,8,155.555556
angular-chart,angular-chart,,5,10,17,15,27,32,1,100
parsec,parsec,,8,3,21,11,39,32,2,1
subtitle,subtitle,,20,15,44,35,47,79,13,1
avspeechsynthesizer,avspeechsynthesizer,,13,6,15,19,25,34,13,1
unusernotificationcenter,unusernotificationcenter,,18,20,27,38,98,65,13,11.111111
glpk,glpk,,24,10,17,34,36,51,0,1
elastic-stack,elastic-stack,,222,145,355,367,402,722,6,1
include-path,include-path,,7,11,30,18,61,48,9,57.142857
setstate,setstate,,122,134,159,256,236,415,1,9.836066
type-mismatch,type-mismatch,,20,14,36,34,81,70,5,1
traefik,traefik,,143,107,260,250,301,510,6,1
applescript,applescript,,122,110,270,232,447,502,13,1
dbeaver,dbeaver,,17,26,40,43,63,83,4,52.941176
jmsserializerbundle,jmsserializerbundle,,11,8,20,19,57,39,4,1
jms-serializer,jms-serializer,,9,3,21,12,35,33,4,1
ingres,ingres,,3,6,3,9,18,12,4,100
rpm,rpm,,45,50,90,95,183,185,9,11.111111
armadillo,armadillo,,15,17,60,32,121,92,9,13.333333
elm,elm,,32,35,90,67,197,157,1,9.375
offset,offset,,54,61,122,115,224,237,5,12.962963
android-maps,android-maps,,8,6,14,14,32,28,3,1
archilogic,archilogic,,0,0,0,0,30,0,1,1
3d.io,3d.io,,0,0,0,0,30,0,1,1
tiff,tiff,,51,55,104,106,154,210,0,7.843137
lzw,lzw,,6,2,8,8,10,16,0,1
selinux,selinux,,24,21,33,45,61,78,9,1
square-connect,square-connect,,11,17,38,28,92,66,4,54.545455
log-likelihood,log-likelihood,,18,7,23,25,32,48,0,1
pygtk,pygtk,,20,14,33,34,62,67,9,1
mysql2,mysql2,,17,15,25,32,44,57,12,1
elastic-load-balancer,elastic-load-balancer,,0,0,4,0,171,4,6,1
content-type,content-type,,36,42,76,78,119,154,4,16.666667
asn.1,asn.1,,13,10,25,23,59,48,6,1
asio,asio,,19,11,40,30,63,70,9,1
acrobat-sdk,acrobat-sdk,,1,4,7,5,16,12,8,300
activesync,activesync,,0,4,3,4,6,7,8,300
shared-directory,shared-directory,,11,11,16,22,34,38,9,1
distutils,distutils,,15,11,46,26,68,72,0,1
qliksense,qliksense,,35,36,47,71,80,118,5,2.857143
blank-line,blank-line,,9,5,9,14,21,23,0,1
blueprism,blueprism,,24,22,72,46,133,118,5,1
datatemplate,datatemplate,,22,23,41,45,113,86,8,4.545455
devexpress-wpf,devexpress-wpf,,3,3,10,6,25,16,8,1
rewardedvideoad,rewardedvideoad,,8,3,17,11,45,28,3,1
x-frame-options,x-frame-options,,19,14,32,33,56,65,1,1
axis,axis,,64,63,118,127,214,245,0,1
joystick,joystick,,13,11,24,24,40,48,8,1
spring-saml,spring-saml,,26,22,35,48,75,83,3,1
android-app-signing,android-app-signing,,9,4,16,13,34,29,3,1
kendo-observable,kendo-observable,,0,1,0,1,2,1,1,1
backpack-for-laravel,backpack-for-laravel,,22,24,48,46,79,94,4,9.090909
excelquery,excelquery,,4,3,1,7,8,8,5,1
static-site,static-site,,23,20,44,43,46,87,1,1
paper-elements,paper-elements,,5,0,3,5,17,8,1,1
android-pendingintent,android-pendingintent,,19,30,58,49,153,107,3,57.894737
selenium2library,selenium2library,,8,0,19,8,47,27,3,1
rect,rect,,11,7,20,18,51,38,1,1
sigma.js,sigma.js,,7,7,9,14,21,23,1,1
jdbi,jdbi,,10,13,31,23,55,54,3,30
msiexec,msiexec,,15,10,34,25,69,59,8,1
polyvariadic,polyvariadic,,0,0,1,0,2,1,2,1
cache-control,cache-control,,43,35,78,78,91,156,4,1
webdeploy,webdeploy,,25,16,45,41,74,86,8,1
csproj,csproj,,39,36,78,75,147,153,8,1
lines,lines,,0,0,0,0,114,0,0,1
orientdb,orientdb,,32,21,94,53,229,147,2,1
hybris,hybris,,57,63,145,120,247,265,3,10.526316
impex,impex,,2,3,10,5,24,15,3,50
openshift-client-tools,openshift-client-tools,,9,10,18,19,31,37,6,11.111111
angular-animations,angular-animations,,54,46,96,100,204,196,1,1
react-apollo,react-apollo,,180,158,266,338,474,604,1,1
cf-bosh,cf-bosh,,2,4,10,6,27,16,3,100
r-exams,r-exams,,2,1,9,3,9,12,0,1
fitbounds,fitbounds,,1,3,0,4,11,4,1,200
moshi,moshi,,18,22,35,40,66,75,3,22.222222
apollo-client,apollo-client,,157,140,268,297,329,565,1,1
chinese-locale,chinese-locale,,9,8,19,17,63,36,0,1
ghcjs,ghcjs,,0,0,1,0,16,1,2,1
static-classes,static-classes,,4,7,3,11,14,14,8,75
execute,execute,,31,22,39,53,91,92,4,1
opencmis,opencmis,,1,2,7,3,29,10,3,100
alfresco-enterprise,alfresco-enterprise,,3,7,10,10,25,20,3,133.333333
shuffle,shuffle,,43,42,98,85,173,183,0,1
apple-watch-complication,apple-watch-complication,,7,1,20,8,9,28,13,1
depth,depth,,12,8,28,20,51,48,0,1
depth-buffer,depth-buffer,,11,6,21,17,30,38,9,1
ssao,ssao,,1,1,3,2,8,5,9,1
constructor-injection,constructor-injection,,2,2,12,4,21,16,8,1
eureka-forms,eureka-forms,,13,11,28,24,73,52,13,1
simulator,simulator,,27,23,60,50,126,110,13,1
webgrid,webgrid,,16,12,11,28,25,39,8,1
database-partitioning,database-partitioning,,31,28,56,59,88,115,4,1
filegroup,filegroup,,4,2,5,6,9,11,4,1
anko,anko,,9,14,36,23,103,59,3,55.555556
gadt,gadt,,3,9,16,12,47,28,2,200
type-variables,type-variables,,3,1,3,4,11,7,2,1
amazon-athena,amazon-athena,,122,126,209,248,299,457,6,3.278689
createprocess,createprocess,,11,9,24,20,44,44,9,1
r-raster,r-raster,,43,37,64,80,143,144,0,1
rgdal,rgdal,,21,10,40,31,77,71,0,1
map-projections,map-projections,,17,13,30,30,36,60,0,1
squid,squid,,21,26,66,47,58,113,6,23.809524
ceph,ceph,,16,26,37,42,55,79,6,62.5
io-monad,io-monad,,14,9,17,23,18,40,2,1
data-access-layer,data-access-layer,,8,7,10,15,39,25,8,1
oracleclient,oracleclient,,6,8,14,14,14,28,4,33.333333
system.data.oracleclient,system.data.oracleclient,,0,1,7,1,6,8,8,1
rscript,rscript,,18,24,39,42,75,81,0,33.333333
maven-publish,maven-publish,,9,6,24,15,21,39,3,1
solr-boost,solr-boost,,3,2,1,5,10,6,2,1
buffer-geometry,buffer-geometry,,2,4,3,6,10,9,1,100
maven-deploy-plugin,maven-deploy-plugin,,4,3,7,7,16,14,3,1
maven-jar-plugin,maven-jar-plugin,,8,5,9,13,12,22,3,1
kendo-grid,kendo-grid,,201,162,331,363,669,694,1,1
sketch-3,sketch-3,,4,0,11,4,19,15,1,1
export-to-xml,export-to-xml,,0,2,1,2,4,3,3,100
cocoascript,cocoascript,,1,0,0,1,3,1,13,1
boost-interprocess,boost-interprocess,,6,7,15,13,34,28,9,16.666667
openflow,openflow,,13,9,28,22,61,50,9,1
gitversion,gitversion,,7,7,12,14,19,26,6,1
babel-node,babel-node,,7,2,9,9,14,18,1,1
packet,packet,,39,37,75,76,93,151,9,1
referenceerror,referenceerror,,10,9,32,19,50,51,1,1
kindle-fire,kindle-fire,,3,0,6,3,4,9,3,1
okio,okio,,4,3,5,7,16,12,3,1
pdfsharp,pdfsharp,,24,16,34,40,76,74,8,1
angular2-http,angular2-http,,2,1,2,3,49,5,1,1
smb,smb,,26,23,52,49,80,101,9,1
jcifs,jcifs,,2,8,10,10,22,20,3,300
pmap,pmap,,6,8,9,14,16,23,0,33.333333
transducer,transducer,,2,2,3,4,13,7,2,1
dom-events,dom-events,,214,186,200,400,223,600,1,1
nsurlsessiondownloadtask,nsurlsessiondownloadtask,,10,7,7,17,34,24,13,1
http-patch,http-patch,,4,4,11,8,14,19,3,1
json-patch,json-patch,,6,4,18,10,21,28,8,1
url-scheme,url-scheme,,29,18,40,47,112,87,13,1
logfiles,logfiles,,0,0,1,0,17,1,9,1
access-log,access-log,,6,7,10,13,18,23,3,16.666667
azure-data-factory,azure-data-factory,,175,167,248,342,419,590,8,1
intersection-observer,intersection-observer,,22,24,29,46,32,75,1,9.090909
ag-grid-ng2,ag-grid-ng2,,24,3,31,27,100,58,1,1
excel-2003,excel-2003,,1,2,2,3,11,5,5,100
weather,weather,,16,9,43,25,59,68,0,1
sony-lifelog-api,sony-lifelog-api,,0,0,0,0,2,0,3,1
intel-mkl,intel-mkl,,25,20,46,45,83,91,0,1
game-center,game-center,,8,9,29,17,28,46,13,12.5
mdbtools,mdbtools,,2,2,5,4,7,9,5,1
do.call,do.call,,8,2,9,10,29,19,0,1
tibble,tibble,,51,49,103,100,177,203,0,1
ivy,ivy,,16,21,30,37,66,67,3,31.25
function-address,function-address,,0,0,1,0,1,1,9,1
docker-networking,docker-networking,,38,25,72,63,108,135,6,1
print-preview,print-preview,,2,5,6,7,20,13,1,150
rangeslider,rangeslider,,12,8,34,20,36,54,1,1
matomo,matomo,,7,5,24,12,37,36,4,1
nginx-reverse-proxy,nginx-reverse-proxy,,116,118,207,234,249,441,6,1.724138
amazon-efs,amazon-efs,,10,13,25,23,40,48,6,30
compiler-options,compiler-options,,3,2,3,5,20,8,9,1
ondemand,ondemand,,2,1,5,3,6,8,6,1
return-value,return-value,,98,64,172,162,271,334,0,1
hook-theme,hook-theme,,0,0,0,0,1,0,4,1
accelerometer,accelerometer,,37,33,75,70,122,145,3,1
gyroscope,gyroscope,,10,14,39,24,52,63,3,40
phaser-framework,phaser-framework,,65,42,116,107,177,223,1,1
ava,ava,,11,6,10,17,50,27,1,1
nyc,nyc,,12,9,24,21,21,45,1,1
forms-authentication,forms-authentication,,26,23,50,49,63,99,8,1
global-asax,global-asax,,11,10,15,21,36,36,8,1
inversifyjs,inversifyjs,,15,9,22,24,24,46,1,1
psutil,psutil,,18,16,27,34,57,61,0,1
centering,centering,,37,17,60,54,152,114,1,1
data-migration,data-migration,,24,28,59,52,76,111,4,16.666667
country-codes,country-codes,,2,5,9,7,20,16,3,150
iso-3166,iso-3166,,1,1,1,2,4,3,8,1
overload-resolution,overload-resolution,,10,20,20,30,40,50,9,100
inventory,inventory,,11,12,36,23,47,59,4,9.090909
middleman,middleman,,5,3,11,8,30,19,12,1
sqldatareader,sqldatareader,,15,9,30,24,54,54,8,1
modalviewcontroller,modalviewcontroller,,8,11,22,19,43,41,13,37.5
generator-expression,generator-expression,,1,1,8,2,19,10,0,1
persist,persist,,9,13,18,22,51,40,3,44.444444
rot13,rot13,,3,2,1,5,9,6,0,1
alphabetical,alphabetical,,12,9,19,21,43,40,0,1
google-apps-marketplace,google-apps-marketplace,,9,13,19,22,30,41,5,44.444444
opencv3.1,opencv3.1,,7,2,24,9,77,33,0,1
make-install,make-install,,3,1,2,4,7,6,9,1
migrate,migrate,,21,20,54,41,101,95,4,1
geotiff,geotiff,,20,20,38,40,40,78,0,1
opencvsharp,opencvsharp,,13,10,14,23,22,37,8,1
sharepoint-search,sharepoint-search,,1,2,12,3,11,15,8,100
nscollectionviewitem,nscollectionviewitem,,0,1,3,1,10,4,13,1
domain-name,domain-name,,14,10,16,24,39,40,4,1
apache-spark-2.0,apache-spark-2.0,,13,14,51,27,130,78,2,7.692308
strcmp,strcmp,,11,11,33,22,65,55,9,1
variable-initialization,variable-initialization,,2,1,5,3,9,8,9,1
ssis-2014,ssis-2014,,4,5,2,9,19,11,4,25
loss,loss,,22,27,32,49,84,81,0,22.727273
xmlworker,xmlworker,,5,1,2,6,14,8,8,1
uiwindow,uiwindow,,10,11,16,21,33,37,13,10
template-haskell,template-haskell,,4,4,11,8,35,19,2,1
esqueleto,esqueleto,,1,0,3,1,11,4,2,1
haskell-persistent,haskell-persistent,,2,1,8,3,15,11,2,1
boost-mutex,boost-mutex,,2,2,0,4,8,4,9,1
scoped-lock,scoped-lock,,0,2,1,2,2,3,9,100
fractals,fractals,,16,6,31,22,45,53,0,1
postfix-mta,postfix-mta,,46,41,88,87,22,175,4,1
curve-fitting,curve-fitting,,95,67,169,162,345,331,0,1
screencast,screencast,,3,2,10,5,4,15,3,1
visible,visible,,10,16,26,26,45,52,5,60
banner,banner,,17,9,37,26,71,63,3,1
interstitial,interstitial,,14,14,45,28,76,73,3,1
app-inventor,app-inventor,,13,15,28,28,46,56,3,15.384615
output-directory,output-directory,,1,0,2,1,2,3,8,1
xunit.net,xunit.net,,33,29,60,62,82,122,8,1
fscheck,fscheck,,5,1,12,6,17,18,8,1
garrys-mod,garrys-mod,,4,8,7,12,17,19,9,100
slidetoggle,slidetoggle,,9,1,23,10,53,33,1,1
m,m,,64,57,94,121,103,215,5,1
zipfile,zipfile,,45,58,122,103,199,225,0,28.888889
temporary-directory,temporary-directory,,5,1,1,6,2,7,0,1
overlap,overlap,,36,23,79,59,158,138,0,1
intersect,intersect,,13,7,26,20,55,46,4,1
swift2,swift2,,4,3,12,7,50,19,13,1
xcode9-beta5,xcode9-beta5,,0,0,0,0,3,0,13,1
roracle,roracle,,4,6,10,10,18,20,0,50
seq,seq,,22,16,41,38,74,79,0,1
serilog,serilog,,90,80,110,170,198,280,8,1
ldap-query,ldap-query,,19,16,22,35,68,57,8,1
unboundid-ldap-sdk,unboundid-ldap-sdk,,9,3,8,12,17,20,8,1
lighttpd,lighttpd,,13,8,29,21,40,50,4,1
monad-transformers,monad-transformers,,14,15,27,29,66,56,2,7.142857
reader-monad,reader-monad,,10,6,2,16,7,18,2,1
dotnet-httpclient,dotnet-httpclient,,83,82,171,165,295,336,8,1
bulletphysics,bulletphysics,,5,3,14,8,23,22,8,1
fortran77,fortran77,,8,12,14,20,42,34,9,50
laravel-spark,laravel-spark,,4,7,19,11,41,30,4,75
inorder,inorder,,5,3,14,8,32,22,0,1
preorder,preorder,,3,6,15,9,24,24,0,100
kableextra,kableextra,,32,26,57,58,109,115,0,1
gnuplot,gnuplot,,81,56,129,137,292,266,0,1
data-fitting,data-fitting,,25,16,56,41,100,97,0,1
dbcontext,dbcontext,,47,62,93,109,182,202,8,31.914894
missingmethodexception,missingmethodexception,,2,5,3,7,14,10,8,150
fbsdksharedialog,fbsdksharedialog,,1,2,8,3,19,11,13,100
amazon-cognito-facebook,amazon-cognito-facebook,,0,3,5,3,21,8,6,200
jackson-modules,jackson-modules,,6,5,5,11,16,16,3,1
scheme,scheme,,113,81,232,194,461,426,0,1
guile,guile,,5,7,15,12,27,27,0,40
api-key,api-key,,31,43,66,74,85,140,4,38.709677
vbulletin,vbulletin,,3,4,9,7,14,16,4,33.333333
ejb-3.0,ejb-3.0,,12,7,27,19,67,46,3,1
newline,newline,,81,57,158,138,297,296,0,1
cat,cat,,35,32,69,67,112,136,9,1
shopping,shopping,,4,2,6,6,14,12,4,1
resampling,resampling,,34,29,74,63,118,137,0,1
favorites,favorites,,4,3,10,7,14,17,3,1
google-apis-explorer,google-apis-explorer,,61,37,98,98,133,196,5,1
wsgen,wsgen,,3,0,4,3,7,7,3,1
privileges,privileges,,24,28,51,52,93,103,4,16.666667
dbnull,dbnull,,7,2,14,9,7,23,8,1
netcdf,netcdf,,56,39,110,95,208,205,0,1
netcdf4,netcdf4,,32,36,41,68,106,109,0,12.5
delimiter,delimiter,,55,40,108,95,287,203,0,1
coroutine,coroutine,,89,70,143,159,172,302,3,1
win32com,win32com,,66,87,110,153,155,263,0,31.818182
adsense,adsense,,43,52,86,95,110,181,3,20.930233
outlook-2016,outlook-2016,,15,10,36,25,58,61,5,1
retain-cycle,retain-cycle,,9,6,13,15,38,28,13,1
bubble-sort,bubble-sort,,46,29,84,75,162,159,0,1
cgroups,cgroups,,9,11,14,20,34,34,9,22.222222
linux-namespaces,linux-namespaces,,2,2,4,4,17,8,9,1
x86-16,x86-16,,99,75,132,174,250,306,9,1
emu8086,emu8086,,29,19,56,48,109,104,9,1
stringi,stringi,,8,5,20,13,51,33,0,1
cloudera,cloudera,,60,70,152,130,276,282,2,16.666667
cloudera-cdh,cloudera-cdh,,31,29,55,60,113,115,2,1
cloudera-manager,cloudera-manager,,12,13,24,25,35,49,2,8.333333
pagerequestmanager,pagerequestmanager,,1,1,1,2,2,3,8,1
ns2,ns2,,7,10,15,17,60,32,9,42.857143
string-aggregation,string-aggregation,,13,17,24,30,53,54,4,30.769231
ssas-tabular,ssas-tabular,,45,42,69,87,115,156,4,1
bookdown,bookdown,,51,49,98,100,164,198,0,1
subtotal,subtotal,,10,7,23,17,47,40,5,1
rxdatasources,rxdatasources,,5,3,9,8,14,17,13,1
array-merge,array-merge,,18,17,32,35,66,67,1,1
ios-simulator,ios-simulator,,65,65,146,130,342,276,13,1
turtle-graphics,turtle-graphics,,171,89,205,260,342,465,0,1
video-reactjs,video-reactjs,,1,2,3,3,6,6,1,100
mechanize-ruby,mechanize-ruby,,2,0,1,2,4,3,12,1
domexception,domexception,,5,3,7,8,8,15,1,1
qbs,qbs,,1,1,9,2,30,11,9,1
flipclock,flipclock,,10,3,10,13,11,23,1,1
pymysql,pymysql,,69,52,112,121,239,233,0,1
cryptoapi,cryptoapi,,8,18,16,26,35,42,6,125
cng,cng,,14,12,17,26,43,43,6,1
wincrypt,wincrypt,,2,4,4,6,12,10,9,100
android-assetmanager,android-assetmanager,,4,1,6,5,9,11,3,1
cell-formatting,cell-formatting,,6,2,0,8,15,8,8,1
java-io,java-io,,30,19,48,49,126,97,3,1
apache-commons-fileupload,apache-commons-fileupload,,7,4,6,11,19,17,3,1
text-widget,text-widget,,0,5,7,5,10,12,0,400
terrain,terrain,,8,5,17,13,38,30,8,1
quadtree,quadtree,,4,10,11,14,20,25,0,150
fail2ban,fail2ban,,7,7,18,14,36,32,4,1
recursive-query,recursive-query,,42,21,87,63,151,150,4,1
mvvm-light,mvvm-light,,35,19,68,54,150,122,8,1
sysdatetime,sysdatetime,,0,0,0,0,2,0,0,1
subscript,subscript,,12,9,22,21,38,43,0,1
apache-storm,apache-storm,,47,35,82,82,225,164,2,1
prime-ui,prime-ui,,0,0,1,0,1,1,1,1
bucklescript,bucklescript,,12,11,23,23,73,46,9,1
angular-module,angular-module,,28,32,52,60,108,112,1,14.285714
mbox,mbox,,4,5,6,9,4,15,0,25
cascadingdropdown,cascadingdropdown,,3,12,14,15,26,29,8,300
aws-java-sdk,aws-java-sdk,,29,16,60,45,73,105,6,1
google-index,google-index,,4,3,6,7,7,13,4,1
google-search-platform,google-search-platform,,1,2,2,3,1,5,4,100
java-print,java-print,,1,0,4,1,9,5,3,1
javaspaces,javaspaces,,0,0,2,0,2,2,3,1
jython,jython,,60,41,101,101,140,202,0,1
derby,derby,,51,31,85,82,157,167,3,1
menubar,menubar,,15,3,18,18,39,36,13,1
android-tv,android-tv,,61,61,114,122,154,236,3,1
apache-spark-dataset,apache-spark-dataset,,32,42,128,74,235,202,2,31.25
google-app-indexing,google-app-indexing,,0,2,2,2,2,4,3,100
transfer,transfer,,13,15,55,28,83,83,4,15.384615
data-transfer,data-transfer,,27,18,28,45,66,73,3,1
pc,pc,,9,7,23,16,39,39,9,1
leaflet.markercluster,leaflet.markercluster,,18,19,21,37,47,58,1,5.555556
in-memory-database,in-memory-database,,24,18,44,42,89,86,3,1
webui,webui,,3,3,8,6,4,14,3,1
spring-profiles,spring-profiles,,12,9,25,21,34,46,3,1
spring-cloud-dataflow,spring-cloud-dataflow,,50,38,108,88,154,196,3,1
linked-server,linked-server,,30,29,58,59,125,117,4,1
major-upgrade,major-upgrade,,1,1,3,2,21,5,8,1
croppic,croppic,,0,0,0,0,1,0,13,1
boost-multi-index,boost-multi-index,,5,1,5,6,15,11,9,1
freebsd,freebsd,,36,18,61,54,134,115,9,1
timber,timber,,29,27,56,56,69,112,4,1
stackdriver,stackdriver,,63,76,118,139,169,257,6,20.634921
google-cloud-monitoring,google-cloud-monitoring,,4,4,9,8,14,17,6,1
propertynotfoundexception,propertynotfoundexception,,2,0,2,2,8,4,3,1
lnk,lnk,,2,2,2,4,13,6,9,1
xcopy,xcopy,,16,10,28,26,47,54,9,1
ios-universal-app,ios-universal-app,,0,2,2,2,1,4,13,100
heredoc,heredoc,,20,16,25,36,51,61,9,1
gnu-findutils,gnu-findutils,,0,4,3,4,9,7,9,300
initializer-list,initializer-list,,30,22,55,52,102,107,9,1
powershell-ise,powershell-ise,,12,10,13,22,37,35,8,1
sdn,sdn,,25,21,66,46,94,112,9,1
mininet,mininet,,24,17,55,41,88,96,9,1
aerospike,aerospike,,15,8,28,23,83,51,3,1
django-validation,django-validation,,10,5,19,15,26,34,0,1
atlas,atlas,,13,10,14,23,18,37,1,1
numerical-integration,numerical-integration,,17,16,29,33,70,62,0,1
qtoolbar,qtoolbar,,5,3,7,8,10,15,9,1
nagiosxi,nagiosxi,,2,2,7,4,15,11,6,1
loader,loader,,19,47,65,66,151,131,1,147.368421
viewchild,viewchild,,16,35,38,51,95,89,1,118.75
monkeypatching,monkeypatching,,18,24,25,42,65,67,0,33.333333
pypi,pypi,,54,59,80,113,172,193,0,9.259259
regularized,regularized,,13,10,17,23,41,40,0,1
stripe.net,stripe.net,,0,0,0,0,23,0,4,1
reentrantlock,reentrantlock,,10,4,9,14,29,23,3,1
autohotkey,autohotkey,,71,51,116,122,226,238,9,1
viewcontroller,viewcontroller,,49,41,94,90,235,184,13,1
uicontainerview,uicontainerview,,8,12,34,20,79,54,13,50
qpushbutton,qpushbutton,,16,12,25,28,68,53,0,1
arrow-python,arrow-python,,1,0,0,1,3,1,0,1
python-arrow,python-arrow,,1,0,0,1,4,1,0,1
xcode-instruments,xcode-instruments,,10,2,9,12,24,21,13,1
zend-framework3,zend-framework3,,32,23,93,55,230,148,4,1
wkwebviewconfiguration,wkwebviewconfiguration,,12,8,15,20,26,35,13,1
protege,protege,,26,22,52,48,138,100,2,1
http-status-code-400,http-status-code-400,,19,16,29,35,86,64,4,1
topicmodels,topicmodels,,9,6,11,15,18,26,0,1
warp,warp,,7,3,2,10,6,12,0,1
rust-macros,rust-macros,,5,7,32,12,21,44,9,40
lag,lag,,56,53,88,109,185,197,4,1
miniconda,miniconda,,39,33,80,72,84,152,0,1
embedded-resource,embedded-resource,,25,26,56,51,95,107,3,4
android-maps-v2,android-maps-v2,,12,14,24,26,55,50,3,16.666667
pyautogui,pyautogui,,61,59,103,120,128,223,0,1
distillery,distillery,,6,1,10,7,18,17,2,1
emulation,emulation,,50,45,102,95,202,197,3,1
gulp-autoprefixer,gulp-autoprefixer,,0,1,1,1,4,2,1,1
selectize.js,selectize.js,,13,10,35,23,90,58,1,1
nsimage,nsimage,,9,7,14,16,32,30,13,1
server-migration,server-migration,,0,0,4,0,4,4,3,1
updatecheck,updatecheck,,0,0,0,0,3,0,13,1
android-dialog,android-dialog,,26,17,47,43,81,90,3,1
email-notifications,email-notifications,,30,13,64,43,123,107,4,1
chartkick,chartkick,,16,15,25,31,51,56,12,1
upnp,upnp,,2,2,10,4,16,14,9,1
cling,cling,,2,0,2,2,6,4,9,1
self-join,self-join,,20,22,55,42,105,97,4,10
python-c-api,python-c-api,,44,24,54,68,72,122,0,1
flask-login,flask-login,,20,29,75,49,82,124,0,45
volumes,volumes,,8,11,16,19,27,35,6,37.5
ngoninit,ngoninit,,7,10,25,17,41,42,1,42.857143
mean,mean,,94,90,206,184,406,390,0,1
difflib,difflib,,10,10,18,20,41,38,0,1
ampps,ampps,,7,1,12,8,26,20,4,1
mingw,mingw,,77,95,222,172,415,394,9,23.376623
kodi,kodi,,6,8,14,14,29,28,0,33.333333
solrj,solrj,,36,37,72,73,136,145,2,2.777778
routerlink,routerlink,,17,10,22,27,88,49,1,1
disassembly,disassembly,,29,33,63,62,110,125,9,13.793103
shellcode,shellcode,,13,16,34,29,60,63,9,23.076923
geocode,geocode,,12,15,42,27,67,69,1,25
lipo,lipo,,0,1,3,1,5,4,13,1
swift-extensions,swift-extensions,,4,7,20,11,57,31,13,75
converter,converter,,0,0,0,0,348,0,0,1
android-contentresolver,android-contentresolver,,17,14,45,31,69,76,3,1
url-parameters,url-parameters,,29,17,43,46,85,89,4,1
kotlin-exposed,kotlin-exposed,,14,9,14,23,19,37,3,1
windbg,windbg,,35,24,72,59,158,131,9,1
lattice,lattice,,29,20,42,49,77,91,0,1
rack-cors,rack-cors,,1,1,3,2,15,5,12,1
tktable,tktable,,1,1,0,2,2,2,0,1
memory-mapped-files,memory-mapped-files,,13,12,37,25,58,62,9,1
taskcompletionsource,taskcompletionsource,,3,0,6,3,6,9,8,1
asp.net-core-1.0,asp.net-core-1.0,,5,5,8,10,43,18,8,1
kube-proxy,kube-proxy,,4,7,21,11,25,32,6,75
leveldb,leveldb,,9,11,33,20,51,53,1,22.222222
total.js,total.js,,3,2,8,5,5,13,1,1
size-t,size-t,,3,4,8,7,22,15,9,33.333333
operationalerror,operationalerror,,3,2,5,5,12,10,0,1
mymaps,mymaps,,1,3,7,4,5,11,1,200
where-clause,where-clause,,65,100,118,165,254,283,4,53.846154
fpu,fpu,,7,4,4,11,17,15,9,1
mousecapture,mousecapture,,2,1,2,3,2,5,8,1
downcast,downcast,,4,5,31,9,48,40,9,25
pymodbus3,pymodbus3,,0,1,7,1,18,8,0,1
aggregateroot,aggregateroot,,8,10,24,18,53,42,8,25
jquery-waypoints,jquery-waypoints,,15,10,10,25,40,35,1,1
android-appcompat,android-appcompat,,34,41,62,75,176,137,3,20.588235
openacc,openacc,,10,6,13,16,48,29,0,1
split-apply-combine,split-apply-combine,,5,3,14,8,19,22,0,1
tqdm,tqdm,,22,29,30,51,47,81,0,31.818182
refresh-token,refresh-token,,49,31,69,80,90,149,4,1
symfony-3.2,symfony-3.2,,0,2,10,2,60,12,4,100
odata-v4,odata-v4,,14,6,16,20,29,36,8,1
instanceof,instanceof,,18,6,33,24,81,57,3,1
notifydatasetchanged,notifydatasetchanged,,11,6,25,17,60,42,3,1
modem,modem,,19,9,36,28,45,64,9,1
transmission,transmission,,10,7,13,17,20,30,9,1
analog-digital-converter,analog-digital-converter,,0,0,0,0,5,0,9,1
modulation,modulation,,1,2,9,3,9,12,0,100
unix-timestamp,unix-timestamp,,41,40,103,81,191,184,0,1
fswatch,fswatch,,1,2,2,3,6,5,9,100
multi-factor,multi-factor,,2,2,7,4,30,11,8,1
subdirectory,subdirectory,,50,46,94,96,192,190,0,1
informix,informix,,40,24,68,64,139,132,4,1
social-networking,social-networking,,15,19,41,34,83,75,0,26.666667
community-translations,community-translations,,0,0,2,0,2,2,6,1
union-all,union-all,,17,16,23,33,77,56,4,1
katana,katana,,2,5,9,7,20,16,8,150
nao-robot,nao-robot,,11,12,33,23,72,56,0,9.090909
gradle-plugin,gradle-plugin,,73,53,122,126,228,248,3,1
tapply,tapply,,5,1,10,6,42,16,0,1
fee,fee,,7,7,19,14,27,33,4,1
lighthouse,lighthouse,,32,42,52,74,46,126,1,31.25
ext2,ext2,,3,1,3,4,1,7,9,1
superblock,superblock,,2,0,2,2,1,4,9,1
crystal-reports-xi,crystal-reports-xi,,9,7,23,16,37,39,8,1
cron-task,cron-task,,25,17,51,42,83,93,4,1
emacs23,emacs23,,0,0,0,0,1,0,9,1
maven-invoker-plugin,maven-invoker-plugin,,1,2,5,3,3,8,3,100
user-activity,user-activity,,2,3,3,5,5,8,4,50
hosts,hosts,,26,12,45,38,70,83,4,1
okta,okta,,70,64,91,134,169,225,8,1
sqlsrv,sqlsrv,,23,57,50,80,112,130,4,147.826087
visual-studio-macros,visual-studio-macros,,1,2,2,3,11,5,8,100
ytplayerview,ytplayerview,,0,0,6,0,11,6,13,1
qweb,qweb,,18,31,37,49,101,86,0,72.222222
dmz,dmz,,5,4,12,9,7,21,8,1
columnstore,columnstore,,8,10,13,18,25,31,4,25
defragmentation,defragmentation,,0,0,4,0,3,4,4,1
geb,geb,,10,3,36,13,82,49,3,1
notepad++,notepad++,,113,99,217,212,513,429,0,1
freepbx,freepbx,,2,4,9,6,28,15,13,100
reportbuilder3.0,reportbuilder3.0,,24,14,32,38,90,70,4,1
google-cloud-pubsub,google-cloud-pubsub,,114,118,194,232,320,426,6,3.508772
octoprint,octoprint,,2,3,4,5,6,9,3,50
akavache,akavache,,2,3,4,5,18,9,8,50
node-mysql,node-mysql,,9,15,18,24,48,42,1,66.666667
linq-to-twitter,linq-to-twitter,,2,1,3,3,18,6,8,1
blazy,blazy,,2,0,0,2,2,2,1,1
system.reflection,system.reflection,,31,30,51,61,106,112,8,1
kindle,kindle,,5,3,3,8,5,11,3,1
litho,litho,,3,0,5,3,10,8,3,1
android-sdcard,android-sdcard,,12,10,20,22,78,42,3,1
sf,sf,,55,59,100,114,160,214,0,7.272727
urlfetch,urlfetch,,10,20,27,30,41,57,5,100
coverity,coverity,,3,4,16,7,26,23,9,33.333333
bleu,bleu,,2,1,3,3,5,6,0,1
docker-ingress,docker-ingress,,2,2,0,4,18,4,6,1
openapi,openapi,,125,139,203,264,209,467,3,11.2
react-boilerplate,react-boilerplate,,15,9,27,24,63,51,1,1
discord.py,discord.py,,257,178,550,435,619,985,0,1
react-dom-server,react-dom-server,,1,5,2,6,15,8,1,400
horizontalscrollview,horizontalscrollview,,4,8,23,12,50,35,3,100
dynamic-tables,dynamic-tables,,7,3,9,10,23,19,1,1
google-location-services,google-location-services,,12,5,23,17,62,40,3,1
period,period,,11,7,25,18,36,43,0,1
item-decoration,item-decoration,,7,8,5,15,11,20,3,14.285714
zend-servicemanager,zend-servicemanager,,2,0,1,2,9,3,4,1
ngcordova,ngcordova,,3,0,5,3,23,8,1,1
glut,glut,,47,40,56,87,109,143,9,1
freeglut,freeglut,,10,6,11,16,29,27,9,1
catransition,catransition,,1,1,2,2,8,4,13,1
jrebel,jrebel,,4,4,7,8,28,15,3,1
apache-airflow,apache-airflow,,0,0,0,0,117,0,0,1
android-assets,android-assets,,7,5,13,12,37,25,3,1
gnome,gnome,,20,30,56,50,85,106,9,50
aws-sdk-cpp,aws-sdk-cpp,,8,4,11,12,22,23,6,1
synapse,synapse,,3,3,12,6,10,18,14,1
xml2js,xml2js,,10,4,14,14,20,28,1,1
dictionary-comprehension,dictionary-comprehension,,32,25,42,57,90,99,0,1
adodb,adodb,,41,39,84,80,136,164,5,1
recordset,recordset,,26,19,36,45,90,81,5,1
radio,radio,,22,30,58,52,121,110,1,36.363636
docopt,docopt,,4,4,5,8,9,13,0,1
.net-4.5,.net-4.5,,24,26,61,50,140,111,8,8.333333
treeset,treeset,,12,8,24,20,46,44,3,1
sonarqube-scan,sonarqube-scan,,57,48,118,105,313,223,3,1
sonarlint,sonarlint,,20,15,46,35,99,81,3,1
mediacodec,mediacodec,,23,31,44,54,82,98,3,34.782609
restlet,restlet,,8,11,36,19,36,55,3,37.5
specs2,specs2,,2,6,5,8,10,13,2,200
line-count,line-count,,1,0,0,1,4,1,0,1
viewpoint,viewpoint,,1,1,1,2,3,3,12,1
colon,colon,,8,2,8,10,24,18,0,1
cordova-plugin-file,cordova-plugin-file,,9,7,11,16,26,27,1,1
apache2.4,apache2.4,,30,39,93,69,140,162,4,30
mod-perl,mod-perl,,0,1,4,1,9,5,4,1
rhel7,rhel7,,37,36,73,73,128,146,9,1
styled-components,styled-components,,205,193,297,398,346,695,1,1
hunspell,hunspell,,10,9,9,19,15,28,0,1
whitelist,whitelist,,17,12,28,29,50,57,4,1
longtable,longtable,,3,0,0,3,5,3,0,1
smarty,smarty,,45,35,85,80,234,165,4,1
uitabbar,uitabbar,,42,22,68,64,147,132,13,1
full-outer-join,full-outer-join,,7,6,4,13,20,17,4,1
paintcomponent,paintcomponent,,14,8,29,22,67,51,3,1
azure-deployment-slots,azure-deployment-slots,,5,4,13,9,20,22,8,1
google-image-search,google-image-search,,3,4,12,7,18,19,0,33.333333
iterm2,iterm2,,22,25,59,47,89,106,9,13.636364
pane,pane,,6,3,18,9,31,27,3,1
bytestring,bytestring,,11,4,21,15,47,36,0,1
gtfs,gtfs,,9,11,10,20,22,30,0,22.222222
spring-cloud-netflix,spring-cloud-netflix,,39,28,87,67,237,154,3,1
realurl,realurl,,4,3,10,7,36,17,4,1
xlink,xlink,,2,3,11,5,16,16,1,50
angularjs-routing,angularjs-routing,,3,2,12,5,35,17,1,1
gimp,gimp,,12,12,35,24,66,59,0,1
levels,levels,,8,9,20,17,48,37,0,12.5
hierarchical-data,hierarchical-data,,38,32,69,70,172,139,4,1
versions,versions,,0,0,0,0,24,0,0,1
saxon,saxon,,24,33,84,57,167,141,3,37.5
xslt-3.0,xslt-3.0,,26,10,25,36,62,61,3,1
google-container-registry,google-container-registry,,14,13,27,27,80,54,6,1
vml,vml,,4,2,9,6,18,15,1,1
ihtmldocument2,ihtmldocument2,,3,0,1,3,6,4,8,1
rcppparallel,rcppparallel,,5,1,7,6,11,13,0,1
except,except,,11,11,30,22,39,52,0,1
rxtx,rxtx,,3,3,15,6,20,21,3,1
jssc,jssc,,1,4,7,5,12,12,3,300
dita-ot,dita-ot,,0,2,8,2,17,10,3,100
gdata,gdata,,3,1,3,4,7,7,5,1
httpbuilder-ng,httpbuilder-ng,,1,0,2,1,6,3,3,1
messagebroker,messagebroker,,16,19,32,35,53,67,3,18.75
nicescroll,nicescroll,,1,1,5,2,9,7,1,1
email-integration,email-integration,,19,17,58,36,93,94,4,1
xlib,xlib,,22,21,28,43,41,71,9,1
immutables-library,immutables-library,,3,3,8,6,17,14,3,1
react-bootstrap-table,react-bootstrap-table,,22,22,31,44,55,75,1,1
surf,surf,,14,8,21,22,29,43,0,1
shelljs,shelljs,,7,6,11,13,18,24,1,1
state-machine,state-machine,,30,28,56,58,116,114,9,1
undo-redo,undo-redo,,6,5,11,11,22,22,13,1
uitextfielddelegate,uitextfielddelegate,,5,3,22,8,54,30,13,1
python-sockets,python-sockets,,22,9,27,31,54,58,0,1
python-cmd,python-cmd,,0,0,4,0,7,4,0,1
nsnotifications,nsnotifications,,1,4,12,5,13,17,13,300
video-conferencing,video-conferencing,,5,5,6,10,17,16,1,1
scalamock,scalamock,,4,5,5,9,23,14,2,25
scatter-plot,scatter-plot,,84,84,180,168,290,348,0,1
data-objects,data-objects,,1,0,2,1,6,3,4,1
lucee,lucee,,12,17,15,29,67,44,4,41.666667
boost-polygon,boost-polygon,,0,0,1,0,7,1,9,1
confuserex,confuserex,,3,0,2,3,10,5,8,1
underscore.js,underscore.js,,35,21,77,56,295,133,1,1
mkannotationview,mkannotationview,,12,9,23,21,64,44,13,1
mapkitannotation,mapkitannotation,,12,12,22,24,38,46,13,1
thunderbird,thunderbird,,11,13,26,24,25,50,4,18.181818
memorystream,memorystream,,29,18,55,47,86,102,8,1
google-fit-sdk,google-fit-sdk,,17,10,18,27,25,45,3,1
uivisualeffectview,uivisualeffectview,,4,2,8,6,27,14,13,1
uivibrancyeffect,uivibrancyeffect,,0,1,1,1,4,2,13,1
date-comparison,date-comparison,,7,5,20,12,41,32,0,1
relational-operators,relational-operators,,3,1,3,4,6,7,0,1
nodemon,nodemon,,34,40,70,74,160,144,1,17.647059
hdinsight,hdinsight,,30,20,61,50,136,111,8,1
tez,tez,,0,0,0,0,33,0,2,1
haddock,haddock,,1,1,7,2,14,9,2,1
state-monad,state-monad,,10,6,18,16,30,34,2,1
back,back,,19,16,48,35,65,83,3,1
google-chrome-app,google-chrome-app,,27,33,60,60,133,120,1,22.222222
google-console-developer,google-console-developer,,14,20,30,34,44,64,3,42.857143
realm-object-server,realm-object-server,,3,0,1,3,36,4,13,1
self,self,,27,29,51,56,100,107,0,7.407407
matlab-uitable,matlab-uitable,,1,0,1,1,4,2,0,1
playback,playback,,36,24,73,60,109,133,3,1
keyboardinterrupt,keyboardinterrupt,,11,7,16,18,20,34,0,1
cql,cql,,36,30,71,66,206,137,2,1
cqlsh,cqlsh,,16,17,35,33,105,68,2,6.25
azkaban,azkaban,,4,2,4,6,8,10,2,1
semi-join,semi-join,,3,0,3,3,3,6,0,1
os.walk,os.walk,,18,17,37,35,79,72,0,1
boot2docker,boot2docker,,5,7,17,12,40,29,6,40
arm64,arm64,,43,45,82,88,87,170,9,4.651163
thumb,thumb,,3,3,9,6,17,15,9,1
sony,sony,,2,1,13,3,42,16,3,1
sony-camera-api,sony-camera-api,,1,0,2,1,24,3,3,1
alpacajs,alpacajs,,2,1,11,3,23,14,1,1
redefinition,redefinition,,4,3,5,7,14,12,9,1
secure-gateway,secure-gateway,,2,0,0,2,17,2,6,1
args,args,,24,11,50,35,80,85,0,1
start-activity,start-activity,,5,9,12,14,31,26,3,80
chunked-encoding,chunked-encoding,,10,8,13,18,35,31,4,1
na,na,,81,72,172,153,308,325,0,1
omniauth-facebook,omniauth-facebook,,4,4,6,8,23,14,12,1
openframeworks,openframeworks,,3,8,11,11,25,22,9,166.666667
particles,particles,,15,12,34,27,61,61,1,1
google-fonts,google-fonts,,16,12,28,28,60,56,1,1
rails-admin,rails-admin,,8,13,24,21,73,45,12,62.5
internet-connection,internet-connection,,8,6,19,14,43,33,3,1
custom-component,custom-component,,10,7,19,17,32,36,1,1
retina-display,retina-display,,2,4,15,6,20,21,1,100
cfiledialog,cfiledialog,,0,1,1,1,5,2,9,1
pypy,pypy,,21,11,32,32,50,64,0,1
actionlistener,actionlistener,,48,15,83,63,184,146,3,1
react-native-maps,react-native-maps,,69,74,131,143,177,274,1,7.246377
sql-query-store,sql-query-store,,9,11,13,20,30,33,4,22.222222
playframework-2.5,playframework-2.5,,1,4,4,5,37,9,2,300
aws-direct-connect,aws-direct-connect,,0,5,5,5,7,10,6,400
azure-batch,azure-batch,,24,7,36,31,66,67,8,1
referrer,referrer,,11,7,18,18,27,36,4,1
tidyeval,tidyeval,,26,20,38,46,74,84,0,1
datepart,datepart,,2,4,12,6,23,18,4,100
contracts,contracts,,0,0,0,0,4,0,3,1
drive,drive,,38,24,54,62,83,116,5,1
angularjs-digest,angularjs-digest,,2,0,4,2,16,6,1,1
operator-overloading,operator-overloading,,141,115,264,256,544,520,9,1
git-tfs,git-tfs,,2,4,6,6,17,12,8,100
javafxports,javafxports,,14,8,26,22,57,48,3,1
elasticsearch-hadoop,elasticsearch-hadoop,,2,4,5,6,13,11,2,100
uicolor,uicolor,,21,34,28,55,100,83,13,61.904762
online-algorithm,online-algorithm,,2,3,0,5,2,5,0,50
netbios,netbios,,2,2,1,4,6,5,9,1
folly,folly,,3,4,3,7,11,10,9,33.333333
ontouchlistener,ontouchlistener,,27,19,43,46,104,89,3,1
multi-touch,multi-touch,,11,4,18,15,31,33,3,1
pth,pth,,0,0,0,0,6,0,0,1
sharpdx,sharpdx,,8,8,33,16,64,49,8,1
truststore,truststore,,18,18,43,36,42,79,6,1
webpack-file-loader,webpack-file-loader,,8,17,31,25,74,56,1,112.5
css-transforms,css-transforms,,67,65,117,132,246,249,1,1
dispatch-async,dispatch-async,,8,6,9,14,35,23,13,1
apache-arrow,apache-arrow,,10,17,15,27,16,42,0,70
adobe-analytics,adobe-analytics,,11,9,27,20,57,47,1,1
bloom,bloom,,0,1,1,1,5,2,9,1
executionexception,executionexception,,1,0,1,1,2,2,3,1
type-alias,type-alias,,8,7,19,15,50,34,9,1
epub,epub,,12,13,17,25,41,42,3,8.333333
text-align,text-align,,15,5,14,20,38,34,1,1
column-family,column-family,,1,1,2,2,5,4,2,1
uac,uac,,8,11,24,19,48,43,8,37.5
template10,template10,,3,1,7,4,21,11,8,1
reason-react,reason-react,,6,12,14,18,39,32,9,100
django-rest-framework-jwt,django-rest-framework-jwt,,12,7,33,19,34,52,0,1
netfilter,netfilter,,6,4,25,10,34,35,9,1
netflix,netflix,,12,5,28,17,50,45,3,1
case-conversion,case-conversion,,0,0,3,0,2,3,0,1
datagrip,datagrip,,20,17,27,37,61,64,4,1
mingw-w64,mingw-w64,,46,39,99,85,134,184,9,1
lcd,lcd,,19,11,44,30,39,74,9,1
microsoft-r,microsoft-r,,2,3,21,5,33,26,0,50
lapply,lapply,,136,111,244,247,481,491,0,1
elisp,elisp,,11,8,7,19,52,26,9,1
putchar,putchar,,4,4,9,8,18,17,9,1
skscene,skscene,,9,8,22,17,69,39,13,1
fusedlocationproviderapi,fusedlocationproviderapi,,13,13,31,26,68,57,3,1
seamonkey,seamonkey,,0,1,0,1,1,1,1,1
passport-github2,passport-github2,,0,2,0,2,4,2,1,100
mpi,mpi,,164,122,235,286,536,521,9,1
fortran90,fortran90,,21,17,49,38,102,87,9,1
contiguous,contiguous,,3,3,5,6,16,11,9,1
maintenance-plan,maintenance-plan,,2,2,2,4,12,6,4,1
matlab-compiler,matlab-compiler,,1,5,17,6,33,23,0,400
stateflow,stateflow,,0,4,10,4,9,14,0,300
viewgroup,viewgroup,,8,1,4,9,26,13,3,1
orchardcms,orchardcms,,12,16,25,28,86,53,8,33.333333
orchardcms-1.8,orchardcms-1.8,,0,2,6,2,5,8,8,100
ansible-2.x,ansible-2.x,,76,63,124,139,220,263,6,1
pyvmomi,pyvmomi,,10,5,12,15,25,27,6,1
vmware-tools,vmware-tools,,2,2,6,4,11,10,6,1
prawn,prawn,,11,7,29,18,33,47,12,1
greedy,greedy,,30,13,50,43,77,93,0,1
wincc,wincc,,2,2,4,4,6,8,5,1
struts-1,struts-1,,9,13,28,22,45,50,3,44.444444
att,att,,25,14,54,39,91,93,9,1
jtapplecalendar,jtapplecalendar,,1,0,6,1,21,7,13,1
segments,segments,,0,0,2,0,10,2,0,1
ghci,ghci,,19,6,34,25,88,59,2,1
piecewise,piecewise,,8,7,13,15,40,28,0,1
chart.js2,chart.js2,,30,21,45,51,86,96,1,1
cksubscription,cksubscription,,1,0,4,1,6,5,13,1
jboss-cli,jboss-cli,,4,5,2,9,20,11,3,25
bootcompleted,bootcompleted,,3,1,3,4,15,7,3,1
system-services,system-services,,3,2,1,5,6,6,3,1
pfx,pfx,,18,17,33,35,62,68,6,1
singly-linked-list,singly-linked-list,,55,84,105,139,208,244,9,52.727273
r-grid,r-grid,,6,7,18,13,37,31,0,16.666667
get-request,get-request,,13,14,26,27,41,53,4,7.692308
password-policy,password-policy,,2,1,7,3,3,10,8,1
jruby,jruby,,10,14,29,24,93,53,12,40
xorg,xorg,,7,8,35,15,40,50,9,14.285714
xpack,xpack,,3,2,5,5,15,10,6,1
elasticsearch-x-pack,elasticsearch-x-pack,,9,5,14,14,44,28,6,1
karma-coverage,karma-coverage,,8,8,20,16,31,36,1,1
jquery-calculation,jquery-calculation,,0,1,1,1,7,2,1,1
fosoauthserverbundle,fosoauthserverbundle,,4,5,8,9,12,17,4,25
aurelia-router,aurelia-router,,4,1,9,5,36,14,1,1
xlwings,xlwings,,29,39,57,68,88,125,0,34.482759
nsdecimalnumber,nsdecimalnumber,,7,1,7,8,16,15,13,1
static-members,static-members,,10,5,13,15,30,28,9,1
static-functions,static-functions,,6,2,4,8,10,12,9,1
tabulator,tabulator,,52,48,80,100,14,180,1,1
subsequence,subsequence,,7,7,18,14,27,32,0,1
websharper,websharper,,2,0,10,2,12,12,8,1
assembly-binding-redirect,assembly-binding-redirect,,7,5,14,12,22,26,8,1
server-communication,server-communication,,0,2,2,2,2,4,9,100
json-rpc,json-rpc,,19,13,37,32,53,69,6,1
bitcoind,bitcoind,,14,7,21,21,35,42,6,1
brunch,brunch,,0,8,7,8,30,15,1,700
parentheses,parentheses,,20,18,33,38,80,71,0,1
android-5.0-lollipop,android-5.0-lollipop,,11,8,17,19,59,36,3,1
ussd,ussd,,12,11,18,23,27,41,3,1
node.js-tape,node.js-tape,,1,0,1,1,9,2,1,1
devstack,devstack,,6,10,18,16,38,34,6,66.666667
openstack-glance,openstack-glance,,0,0,1,0,13,1,6,1
ostringstream,ostringstream,,3,0,3,3,13,6,9,1
reloaddata,reloaddata,,10,12,15,22,48,37,13,20
powerpc,powerpc,,9,8,24,17,67,41,9,1
xlc,xlc,,1,2,4,3,15,7,9,100
altivec,altivec,,0,1,3,1,15,4,9,1
web-sql,web-sql,,8,6,8,14,30,22,1,1
cocos2d-android,cocos2d-android,,1,3,4,4,11,8,3,200
ifstream,ifstream,,34,23,72,57,169,129,9,1
interpreter,interpreter,,25,30,75,55,119,130,0,20
metacircular,metacircular,,0,0,0,0,2,0,0,1
isaserver,isaserver,,0,0,0,0,3,0,1,1
hour,hour,,12,10,12,22,36,34,0,1
extjs4.1,extjs4.1,,1,3,3,4,22,7,1,200
sumoselect.js,sumoselect.js,,2,5,5,7,13,12,1,150
icinga2,icinga2,,3,4,11,7,32,18,6,33.333333
mysql.sock,mysql.sock,,1,0,1,1,3,2,4,1
redis-cache,redis-cache,,9,6,9,15,16,24,3,1
datetime-conversion,datetime-conversion,,8,7,13,15,45,28,0,1
mako,mako,,1,2,4,3,13,7,0,100
materialized-views,materialized-views,,16,19,47,35,54,82,4,18.75
treetable,treetable,,4,2,19,6,16,25,1,1
rollingfileappender,rollingfileappender,,7,8,14,15,26,29,3,14.285714
persian,persian,,1,0,11,1,43,12,0,1
persian-calendar,persian-calendar,,4,4,6,8,14,14,8,1
buttonclick,buttonclick,,12,14,44,26,89,70,3,16.666667
nunit-console,nunit-console,,10,5,19,15,34,34,8,1
fatal-error,fatal-error,,30,18,67,48,163,115,4,1
daphne,daphne,,11,12,23,23,35,46,0,9.090909
higher-order-components,higher-order-components,,16,20,70,36,123,106,1,25
qtextedit,qtextedit,,12,23,11,35,64,46,0,91.666667
swift-playground,swift-playground,,64,24,52,88,154,140,13,1
snmp4j,snmp4j,,12,3,19,15,16,34,9,1
azure-container-service,azure-container-service,,10,5,32,15,142,47,8,1
windows-container,windows-container,,13,18,28,31,63,59,6,38.461538
blur,blur,,24,40,53,64,128,117,1,66.666667
twisted.web,twisted.web,,5,2,5,7,14,12,0,1
ansible-inventory,ansible-inventory,,48,55,76,103,116,179,6,14.583333
symlink,symlink,,57,41,100,98,180,198,9,1
rowid,rowid,,6,1,8,7,19,15,4,1
esapi,esapi,,7,6,11,13,22,24,3,1
peewee,peewee,,27,33,65,60,148,125,0,22.222222
deezer,deezer,,5,1,3,6,12,9,3,1
control-characters,control-characters,,7,4,9,11,24,20,0,1
android-statusbar,android-statusbar,,11,14,28,25,50,53,3,27.272727
android-navigation-bar,android-navigation-bar,,10,6,10,16,20,26,3,1
httpexception,httpexception,,3,4,3,7,10,10,8,33.333333
v-select,v-select,,8,12,12,20,15,32,1,50
android-theme,android-theme,,46,41,72,87,121,159,3,1
pylint,pylint,,57,65,99,122,156,221,0,14.035088
fixture,fixture,,0,0,0,0,13,0,0,1
watin,watin,,0,0,0,0,4,0,8,1
arcgis-js-api,arcgis-js-api,,17,43,38,60,42,98,1,152.941176
arcgis-server,arcgis-server,,2,7,13,9,14,22,0,250
createjs,createjs,,16,20,38,36,73,74,1,25
wechat,wechat,,9,5,19,14,41,33,1,1
preloadjs,preloadjs,,2,1,1,3,8,4,1,1
application-pool,application-pool,,18,8,27,26,59,53,8,1
plupload,plupload,,8,6,8,14,19,22,1,1
ssms-2012,ssms-2012,,4,4,5,8,25,13,4,1
bigint,bigint,,20,11,24,31,54,55,4,1
flashdevelop,flashdevelop,,5,6,4,11,9,15,13,20
pde,pde,,7,8,13,15,33,28,0,14.285714
voyager,voyager,,41,34,51,75,82,126,4,1
deferred-rendering,deferred-rendering,,3,2,8,5,10,13,9,1
lateral-join,lateral-join,,6,3,8,9,12,17,4,1
go-swagger,go-swagger,,2,5,2,7,9,9,3,150
wowza-transcoder,wowza-transcoder,,0,1,9,1,5,10,13,1
oryx,oryx,,0,0,0,0,1,0,1,1
mongodb-php,mongodb-php,,3,0,23,3,28,26,1,1
php-mongodb,php-mongodb,,10,5,24,15,39,39,1,1
dialogfragment,dialogfragment,,10,14,21,24,53,45,3,40
google-oauth2,google-oauth2,,116,119,244,235,349,479,5,2.586207
google-oauth-java-client,google-oauth-java-client,,3,0,8,3,10,11,5,1
malware-detection,malware-detection,,7,3,10,10,23,20,4,1
antimalware,antimalware,,2,3,3,5,5,8,4,50
jboss-eap-7,jboss-eap-7,,30,31,52,61,114,113,3,3.333333
securitydomain,securitydomain,,0,1,0,1,1,1,3,1
hint,hint,,9,1,15,10,16,25,3,1
detailview,detailview,,6,6,6,12,16,18,0,1
process-management,process-management,,1,0,9,1,8,10,1,1
wsse,wsse,,3,4,15,7,12,22,3,33.333333
pushkit,pushkit,,11,4,13,15,33,28,13,1
finder,finder,,11,6,26,17,47,43,13,1
pojo,pojo,,41,48,107,89,191,196,3,17.073171
npm-publish,npm-publish,,13,7,13,20,36,33,1,1
npmjs,npmjs,,7,6,6,13,18,19,1,1
mod-ssl,mod-ssl,,1,1,2,2,13,4,4,1
sonarlint-eclipse,sonarlint-eclipse,,4,2,3,6,24,9,3,1
qsort,qsort,,10,9,17,19,61,36,9,1
angular-mock,angular-mock,,0,2,2,2,10,4,1,100
app-config,app-config,,42,40,89,82,171,171,8,1
ionic4,ionic4,,1095,1052,753,2147,99,2900,1,1
yarn,yarn,,102,118,287,220,567,507,2,15.686275
icmp,icmp,,14,7,19,21,38,40,9,1
ttl,ttl,,11,13,28,24,64,52,3,18.181818
traceroute,traceroute,,8,6,11,14,12,25,9,1
walmart-api,walmart-api,,3,1,5,4,12,9,4,1
jupyterhub,jupyterhub,,40,40,80,80,64,160,0,1
pypyodbc,pypyodbc,,5,8,17,13,34,30,0,60
svnadmin,svnadmin,,0,0,0,0,2,0,6,1
svn-administraton,svn-administraton,,0,1,0,1,1,1,6,1
android-bluetooth,android-bluetooth,,55,57,117,112,192,229,3,3.636364
ibeacon-android,ibeacon-android,,13,7,16,20,39,36,3,1
cornerradius,cornerradius,,2,11,16,13,34,29,13,450
breadth-first-search,breadth-first-search,,70,33,105,103,194,208,0,1
opticalflow,opticalflow,,11,9,19,20,37,39,0,1
spatial-interpolation,spatial-interpolation,,3,3,5,6,5,11,0,1
google-cloud-speech,google-cloud-speech,,24,44,54,68,104,122,6,83.333333
thingworx,thingworx,,1,2,6,3,18,9,8,100
between,between,,24,22,56,46,103,102,4,1
ndk-build,ndk-build,,11,16,33,27,63,60,3,45.454545
mockmvc,mockmvc,,26,30,50,56,107,106,3,15.384615
spring-auto-restdocs,spring-auto-restdocs,,0,2,1,2,9,3,3,100
universal-analytics,universal-analytics,,6,1,5,7,20,12,5,1
gojs,gojs,,11,13,16,24,48,40,1,18.181818
2-way-object-databinding,2-way-object-databinding,,7,6,17,13,27,30,3,1
caliburn,caliburn,,2,0,3,2,13,5,8,1
asyncstorage,asyncstorage,,41,49,86,90,123,176,1,19.512195
ggpubr,ggpubr,,21,26,42,47,35,89,0,23.809524
youtrack,youtrack,,5,3,8,8,25,16,6,1
ember-charts,ember-charts,,0,0,0,0,1,0,1,1
office-2016,office-2016,,3,5,7,8,21,15,5,66.666667
icloneable,icloneable,,0,0,0,0,1,0,8,1
windows-security,windows-security,,2,2,11,4,15,15,8,1
dummy-variable,dummy-variable,,42,26,45,68,124,113,0,1
legend-properties,legend-properties,,17,13,20,30,41,50,0,1
tcpserver,tcpserver,,12,10,26,22,68,48,9,1
atoi,atoi,,10,3,10,13,30,23,9,1
jitsi,jitsi,,6,3,14,9,18,23,13,1
bundle-identifier,bundle-identifier,,5,6,24,11,22,35,13,20
app.xaml,app.xaml,,4,2,12,6,17,18,8,1
spring-mongo,spring-mongo,,6,4,17,10,28,27,3,1
invoke-sqlcmd,invoke-sqlcmd,,7,8,9,15,20,24,8,14.285714
intel-edison,intel-edison,,1,0,1,1,21,2,9,1
smartadmin,smartadmin,,5,5,8,10,14,18,1,1
stockquotes,stockquotes,,3,2,5,5,36,10,0,1
google-javascript-api,google-javascript-api,,3,5,8,8,13,16,5,66.666667
listcollectionview,listcollectionview,,2,0,2,2,4,4,8,1
modelica,modelica,,35,28,51,63,83,114,0,1
openmodelica,openmodelica,,24,21,31,45,44,76,0,1
atmelstudio,atmelstudio,,8,13,16,21,38,37,9,62.5
guzzle6,guzzle6,,12,18,31,30,60,61,4,50
ember-bootstrap,ember-bootstrap,,3,1,3,4,2,7,1,1
reboot,reboot,,9,11,22,20,42,42,9,22.222222
busybox,busybox,,14,13,29,27,47,56,9,1
oracle-data-integrator,oracle-data-integrator,,9,25,23,34,35,57,4,177.777778
dynamicform,dynamicform,,6,4,15,10,23,25,1,1
has-many,has-many,,16,12,23,28,63,51,12,1
active-record-query,active-record-query,,1,0,3,1,7,4,12,1
pdflatex,pdflatex,,21,22,45,43,71,88,0,4.761905
chemistry,chemistry,,8,4,15,12,18,27,0,1
dll-injection,dll-injection,,8,9,21,17,31,38,9,12.5
thread-local-storage,thread-local-storage,,7,6,8,13,19,21,9,1
evict,evict,,1,0,4,1,5,5,3,1
backslash,backslash,,18,20,40,38,69,78,0,11.111111
azure-devops-extensions,azure-devops-extensions,,19,15,36,34,56,70,8,1
blogger-dynamic-views,blogger-dynamic-views,,1,0,4,1,10,5,1,1
resourcedictionary,resourcedictionary,,9,9,27,18,60,45,8,1
doubleanimation,doubleanimation,,2,2,5,4,11,9,8,1
cardview,cardview,,26,25,58,51,114,109,3,1
absolute,absolute,,14,15,53,29,105,82,1,7.142857
rcurl,rcurl,,10,15,29,25,71,54,0,50
sbyte,sbyte,,1,1,0,2,2,2,8,1
parallel.foreach,parallel.foreach,,27,13,54,40,98,94,8,1
hard-drive,hard-drive,,6,11,13,17,21,30,9,83.333333
heroku-toolbelt,heroku-toolbelt,,3,2,10,5,47,15,1,1
heroku-cli,heroku-cli,,21,37,66,58,124,124,1,76.190476
tilde,tilde,,3,1,6,4,13,10,0,1
razor-pages,razor-pages,,232,187,302,419,354,721,8,1
google-developer-tools,google-developer-tools,,7,7,8,14,23,22,1,1
horizontal-scrolling,horizontal-scrolling,,22,18,58,40,93,98,1,1
listviewitem,listviewitem,,9,14,32,23,77,55,3,55.555556
double-click,double-click,,11,5,32,16,49,48,1,1
flags,flags,,37,28,57,65,112,122,9,1
waitforsingleobject,waitforsingleobject,,1,1,3,2,5,5,9,1
nodatime,nodatime,,6,6,13,12,27,25,8,1
django-template-filters,django-template-filters,,13,5,16,18,40,34,0,1
angular-resource,angular-resource,,2,2,4,4,25,8,1,1
android-location,android-location,,29,24,49,53,105,102,3,1
revel,revel,,5,3,13,8,12,21,6,1
http-parameters,http-parameters,,0,1,4,1,9,5,1,1
pymongo-3.x,pymongo-3.x,,7,14,39,21,50,60,1,100
database-first,database-first,,1,1,9,2,11,11,8,1
google-play-console,google-play-console,,84,136,140,220,176,360,3,61.904762
http-response-codes,http-response-codes,,6,10,19,16,34,35,4,66.666667
auto,auto,,39,40,89,79,126,168,9,2.564103
c++03,c++03,,10,11,32,21,55,53,9,10
size-type,size-type,,0,1,1,1,4,2,9,1
xmppframework,xmppframework,,7,5,24,12,52,36,13,1
pop3,pop3,,7,6,32,13,44,45,4,1
f5,f5,,12,11,16,23,41,39,6,1
preserve,preserve,,3,0,6,3,8,9,1,1
sharepoint-jsom,sharepoint-jsom,,6,4,20,10,26,30,8,1
istream-iterator,istream-iterator,,4,1,2,5,11,7,9,1
powerpoint-vba,powerpoint-vba,,41,54,79,95,195,174,5,31.707317
nonblocking,nonblocking,,22,16,48,38,102,86,3,1
wrk,wrk,,2,0,2,2,7,4,9,1
uifont,uifont,,11,4,16,15,28,31,13,1
nsfont,nsfont,,0,1,0,1,5,1,13,1
macwire,macwire,,0,1,1,1,13,2,2,1
hashlib,hashlib,,13,9,22,22,40,44,0,1
fastboot,fastboot,,0,5,4,5,11,9,3,400
pico,pico,,2,0,3,2,6,5,3,1
inverse-transform,inverse-transform,,2,3,0,5,8,5,0,50
qsqltablemodel,qsqltablemodel,,2,5,11,7,20,18,9,150
list-initialization,list-initialization,,6,9,25,15,31,40,9,50
hook-form-alter,hook-form-alter,,5,0,0,5,4,5,4,1
form-alter,form-alter,,0,0,0,0,1,0,4,1
mojolicious,mojolicious,,16,13,32,29,68,61,9,1
nexus-6p,nexus-6p,,0,0,1,0,2,1,3,1
picker,picker,,44,51,69,95,128,164,1,15.909091
mschart,mschart,,7,22,35,29,51,64,8,214.285714
alchemyapi,alchemyapi,,0,0,0,0,2,0,6,1
diskspace,diskspace,,8,13,18,21,49,39,9,62.5
fsutil,fsutil,,5,1,0,6,6,6,9,1
file-locking,file-locking,,6,4,6,10,22,16,3,1
modal-window,modal-window,,1,2,2,3,11,5,1,100
dragula,dragula,,9,7,18,16,30,34,1,1
brute-force,brute-force,,20,11,32,31,76,63,0,1
typo3-extensions,typo3-extensions,,23,24,53,47,122,100,4,4.347826
date-range,date-range,,30,43,63,73,133,136,0,43.333333
google-closure-compiler,google-closure-compiler,,14,15,20,29,52,49,1,7.142857
javax,javax,,0,0,0,0,69,0,3,1
phpoffice,phpoffice,,19,10,26,29,42,55,4,1
phpspreadsheet,phpspreadsheet,,59,56,124,115,152,239,4,1
cfnetwork,cfnetwork,,3,2,4,5,13,9,13,1
video-capture,video-capture,,52,33,90,85,171,175,13,1
ng2-file-upload,ng2-file-upload,,8,4,18,12,39,30,1,1
custom-titlebar,custom-titlebar,,1,0,1,1,1,2,9,1
tibco,tibco,,35,26,47,61,84,108,3,1
businessworks,businessworks,,1,0,1,1,3,2,3,1
tibco-business-works,tibco-business-works,,13,14,17,27,25,44,3,7.692308
allocatable-array,allocatable-array,,1,2,6,3,5,9,9,100
nominatim,nominatim,,10,15,19,25,27,44,1,50
puma,puma,,43,27,76,70,128,146,12,1
lightweight-processes,lightweight-processes,,1,0,2,1,3,3,13,1
zipkin,zipkin,,30,18,43,48,91,91,3,1
spring-cloud-sleuth,spring-cloud-sleuth,,20,21,53,41,86,94,3,5
rails-i18n,rails-i18n,,20,8,24,28,64,52,12,1
jboss-mdb,jboss-mdb,,1,3,2,4,6,6,3,200
galen,galen,,3,2,4,5,12,9,3,1
hyperion,hyperion,,4,3,7,7,17,14,5,1
brio,brio,,0,0,1,0,2,1,5,1
urhosharp,urhosharp,,3,4,7,7,11,14,8,33.333333
urho3d,urho3d,,1,2,3,3,1,6,8,100
jmh,jmh,,14,7,19,21,40,40,3,1
compare-and-swap,compare-and-swap,,7,4,10,11,25,21,9,1
atomic-long,atomic-long,,2,0,2,2,3,4,3,1
ctest,ctest,,11,5,17,16,32,33,9,1
solid-principles,solid-principles,,31,20,50,51,104,101,3,1
nested-function,nested-function,,8,12,18,20,42,38,0,50
pythoninterpreter,pythoninterpreter,,7,4,10,11,22,21,0,1
visual-foxpro,visual-foxpro,,17,10,31,27,67,58,4,1
blender,blender,,65,62,138,127,265,265,0,1
diagonal,diagonal,,9,5,25,14,68,39,0,1
ngx-leaflet,ngx-leaflet,,11,2,25,13,53,38,1,1
rigid-bodies,rigid-bodies,,9,6,27,15,31,42,8,1
poker,poker,,13,3,9,16,27,25,0,1
dynamics-crm-2013,dynamics-crm-2013,,1,6,13,7,53,20,8,500
hystrix,hystrix,,31,30,74,61,143,135,3,1
appauth,appauth,,12,8,26,20,34,46,13,1
maven-assembly-plugin,maven-assembly-plugin,,19,20,44,39,66,83,3,5.263158
sql-view,sql-view,,17,24,48,41,72,89,4,41.176471
hostname,hostname,,23,24,49,47,88,96,4,4.347826
rapidminer,rapidminer,,6,7,17,13,46,30,0,16.666667
alpha,alpha,,23,23,51,46,92,97,13,1
ssziparchive,ssziparchive,,2,1,2,3,4,5,13,1
wp-nav-menu-item,wp-nav-menu-item,,2,2,5,4,12,9,4,1
sphinx,sphinx,,15,13,37,28,92,65,4,1
jsplumb,jsplumb,,6,14,15,20,33,35,1,133.333333
restframeworkmongoengine,restframeworkmongoengine,,3,0,1,3,8,4,0,1
flexjson,flexjson,,0,1,1,1,3,2,3,1
.net-assembly,.net-assembly,,66,60,108,126,247,234,8,1
flask-mysql,flask-mysql,,1,4,10,5,14,15,0,300
sparkling-water,sparkling-water,,5,2,13,7,40,20,0,1
exponent,exponent,,15,9,26,24,50,50,0,1
significant-digits,significant-digits,,2,4,6,6,11,12,0,100
replaceall,replaceall,,12,11,24,23,69,47,0,1
volume,volume,,33,34,80,67,111,147,6,3.030303
strlen,strlen,,15,11,25,26,33,51,9,1
apk-expansion-files,apk-expansion-files,,6,4,17,10,27,27,3,1
wine,wine,,16,18,24,34,56,58,9,12.5
windev,windev,,6,4,3,10,5,13,4,1
urlretrieve,urlretrieve,,3,3,2,6,20,8,0,1
network-protocols,network-protocols,,14,8,20,22,47,42,9,1
hue,hue,,32,35,35,67,89,102,2,9.375
jsch,jsch,,39,39,74,78,170,152,3,1
mysql-connector,mysql-connector,,39,52,103,91,149,194,4,33.333333
synchronous,synchronous,,39,18,64,57,154,121,1,1
parcelable,parcelable,,41,27,61,68,165,129,3,1
caption,caption,,17,13,28,30,35,58,1,1
electronics,electronics,,13,11,14,24,26,38,9,1
amazon-kinesis,amazon-kinesis,,104,94,141,198,211,339,6,1
biztalk-2009,biztalk-2009,,0,0,1,0,5,1,8,1
oracle10g,oracle10g,,87,34,119,121,279,240,4,1
user-permissions,user-permissions,,20,31,50,51,114,101,3,55
margins,margins,,15,13,29,28,45,57,1,1
git-stash,git-stash,,9,10,17,19,53,36,6,11.111111
angularjs-ng-form,angularjs-ng-form,,0,1,3,1,9,4,1,1
promisekit,promisekit,,14,8,28,22,51,50,13,1
moya,moya,,14,9,34,23,43,57,13,1
leaflet.draw,leaflet.draw,,17,22,29,39,41,68,1,29.411765
revision-history,revision-history,,1,3,7,4,15,11,6,200
sockjs,sockjs,,20,14,35,34,55,69,3,1
clojure.test,clojure.test,,0,0,1,0,4,1,2,1
woothemes,woothemes,,0,6,5,6,12,11,4,500
qtstylesheets,qtstylesheets,,22,20,38,42,58,80,9,1
eabi,eabi,,0,0,3,0,6,3,9,1
sfinae,sfinae,,60,58,95,118,186,213,9,1
mobile-data,mobile-data,,3,4,9,7,16,16,3,33.333333
kif-framework,kif-framework,,1,0,0,1,7,1,13,1
fal,fal,,2,3,8,5,17,13,4,50
dce,dce,,1,1,2,2,4,4,4,1
sha512,sha512,,14,11,21,25,50,46,6,1
allure,allure,,40,47,81,87,123,168,3,17.5
alertifyjs,alertifyjs,,2,4,4,6,8,10,1,100
payload,payload,,30,29,55,59,62,114,4,1
dynamics-crm-2011,dynamics-crm-2011,,10,11,31,21,65,52,8,10
xajax,xajax,,0,1,0,1,1,1,4,1
executors,executors,,0,0,4,0,13,4,3,1
ioctl,ioctl,,12,12,32,24,46,56,9,1
coreml,coreml,,51,43,114,94,168,208,13,1
doctrine-query,doctrine-query,,9,10,25,19,33,44,4,11.111111
kdb,kdb,,12,20,40,32,119,72,0,66.666667
q-lang,q-lang,,0,0,0,0,63,0,0,1
overhead,overhead,,3,2,10,5,14,15,9,1
spiral,spiral,,5,4,14,9,26,23,0,1
html-renderer,html-renderer,,3,1,2,4,7,6,8,1
roo-gem,roo-gem,,1,1,6,2,10,8,12,1
natural-sort,natural-sort,,4,6,8,10,16,18,0,50
extension-function,extension-function,,4,4,8,8,19,16,3,1
wiredtiger,wiredtiger,,4,5,12,9,19,21,1,25
restcomm,restcomm,,3,2,12,5,29,17,3,1
jain-sip,jain-sip,,3,6,2,9,9,11,13,100
mobicents,mobicents,,0,0,4,0,9,4,3,1
jain-slee,jain-slee,,2,3,2,5,3,7,3,50
android-savedstate,android-savedstate,,4,6,14,10,24,24,3,50
office-addins,office-addins,,76,109,147,185,207,332,5,43.421053
symfony-validator,symfony-validator,,3,4,4,7,14,11,4,33.333333
jvm-arguments,jvm-arguments,,19,10,25,29,31,54,3,1
rcharts,rcharts,,4,3,3,7,11,10,0,1
htmlwidgets,htmlwidgets,,23,9,44,32,73,76,0,1
foreach-loop-container,foreach-loop-container,,10,7,7,17,14,24,4,1
purescript,purescript,,8,11,11,19,46,30,2,37.5
nixos,nixos,,12,14,36,26,84,62,2,16.666667
heapsort,heapsort,,18,5,22,23,45,45,0,1
audacity,audacity,,5,6,3,11,21,14,13,20
nested-table,nested-table,,7,6,8,13,12,21,4,1
oracle-type,oracle-type,,0,0,0,0,3,0,4,1
crc32,crc32,,7,10,24,17,35,41,9,42.857143
pybind11,pybind11,,33,37,68,70,72,138,9,12.121212
cgi-bin,cgi-bin,,4,3,6,7,11,13,4,1
predicate,predicate,,34,35,88,69,142,157,3,2.941176
radiobuttonlist,radiobuttonlist,,4,3,10,7,33,17,8,1
win32-process,win32-process,,1,4,10,5,24,15,9,300
block,block,,42,28,80,70,189,150,4,1
systemdynamics,systemdynamics,,1,0,3,1,5,4,3,1
optaplanner,optaplanner,,18,30,56,48,105,104,3,66.666667
syntax-highlighting,syntax-highlighting,,34,43,116,77,172,193,9,26.470588
pinterest,pinterest,,8,11,33,19,49,52,4,37.5
vaadin4spring,vaadin4spring,,1,0,1,1,9,2,3,1
ripple,ripple,,14,5,12,19,37,31,3,1
dynamic-columns,dynamic-columns,,7,2,12,9,19,21,4,1
displayfor,displayfor,,1,0,0,1,4,1,8,1
nattable,nattable,,9,12,6,21,25,27,3,33.333333
sails-permissions,sails-permissions,,0,0,1,0,1,1,1,1
android-networking,android-networking,,14,22,36,36,74,72,3,57.142857
android-jobscheduler,android-jobscheduler,,26,33,86,59,199,145,3,26.923077
spring-boot-gradle-plugin,spring-boot-gradle-plugin,,9,10,12,19,37,31,3,11.111111
access-rights,access-rights,,6,2,13,8,32,21,4,1
android-notification-bar,android-notification-bar,,12,1,14,13,20,27,3,1
fragment-shader,fragment-shader,,37,26,79,63,114,142,9,1
metal,metal,,92,82,222,174,310,396,13,1
infinispan,infinispan,,23,20,42,43,90,85,3,1
ngroute,ngroute,,8,12,19,20,72,39,1,50
ormlite-servicestack,ormlite-servicestack,,13,6,22,19,62,41,8,1
subform,subform,,3,10,18,13,22,31,5,233.333333
pull-to-refresh,pull-to-refresh,,7,9,26,16,45,42,13,28.571429
zebra-printers,zebra-printers,,13,18,27,31,64,58,3,38.461538
epl,epl,,3,5,4,8,18,12,14,66.666667
mail-server,mail-server,,11,11,32,22,42,54,4,1
james,james,,3,1,9,4,6,13,4,1
openerp-7,openerp-7,,6,3,7,9,18,16,0,1
dotnetzip,dotnetzip,,9,10,15,19,16,34,8,11.111111
firefox-os,firefox-os,,3,0,1,3,9,4,1,1
string-parsing,string-parsing,,12,12,34,24,87,58,0,1
secret-key,secret-key,,17,11,26,28,49,54,6,1
azure-keyvault,azure-keyvault,,73,94,147,167,228,314,8,28.767123
method-missing,method-missing,,0,0,1,0,4,1,12,1
google-api-client,google-api-client,,40,29,81,69,151,150,5,1
android-gradle-3.0,android-gradle-3.0,,2,4,11,6,72,17,3,100
bugzilla,bugzilla,,5,4,13,9,17,22,9,1
pcregrep,pcregrep,,4,5,1,9,6,10,9,25
calabash,calabash,,2,0,11,2,16,13,3,1
calabash-android,calabash-android,,2,1,5,3,19,8,3,1
serialversionuid,serialversionuid,,2,0,5,2,7,7,3,1
bucket,bucket,,36,32,53,68,88,121,6,1
boost-dynamic-bitset,boost-dynamic-bitset,,0,1,6,1,3,7,9,1
boost-bimap,boost-bimap,,1,0,1,1,9,2,9,1
nsdictionary,nsdictionary,,16,12,44,28,140,72,13,1
axis-labels,axis-labels,,52,34,63,86,148,149,0,1
apache-cayenne,apache-cayenne,,0,0,5,0,7,5,3,1
cinema-4d,cinema-4d,,1,1,5,2,12,7,0,1
onhover,onhover,,4,3,6,7,16,13,1,1
rserve,rserve,,3,6,9,9,25,18,0,100
androidhttpclient,androidhttpclient,,2,0,11,2,23,13,3,1
discord.net,discord.net,,21,24,63,45,98,108,8,14.285714
codesign,codesign,,16,7,32,23,33,55,13,1
appstore-sandbox,appstore-sandbox,,2,1,19,3,40,22,13,1
browserstack,browserstack,,31,23,43,54,76,97,3,1
iisnode,iisnode,,13,25,22,38,39,60,1,92.307692
separator,separator,,21,17,19,38,62,57,0,1
envelope,envelope,,5,2,10,7,14,17,5,1
watir-webdriver,watir-webdriver,,0,0,0,0,27,0,12,1
libphonenumber,libphonenumber,,7,5,12,12,31,24,3,1
src,src,,28,24,68,52,123,120,1,1
afnetworking,afnetworking,,12,9,29,21,95,50,13,1
laravel-echo,laravel-echo,,26,39,63,65,81,128,4,50
angularjs-forms,angularjs-forms,,2,2,2,4,25,6,1,1
vb.net-to-c#,vb.net-to-c#,,1,1,4,2,6,6,8,1
http-proxy-middleware,http-proxy-middleware,,8,12,18,20,17,38,1,50
forcats,forcats,,8,9,14,17,26,31,0,12.5
openjfx,openjfx,,28,21,65,49,9,114,3,1
replicaset,replicaset,,18,22,45,40,60,85,1,22.222222
plural,plural,,5,3,4,8,8,12,13,1
android-progressbar,android-progressbar,,35,25,62,60,144,122,3,1
rpg,rpg,,3,1,4,4,14,8,4,1
falcon,falcon,,1,4,2,5,6,7,0,300
neomodel,neomodel,,0,3,15,3,8,18,2,200
runas,runas,,5,7,9,12,22,21,9,40
xmlhttprequest-level2,xmlhttprequest-level2,,0,0,1,0,2,1,1,1
hbbtv,hbbtv,,0,0,6,0,5,6,1,1
spek,spek,,2,2,5,4,28,9,3,1
log4perl,log4perl,,1,0,1,1,9,2,9,1
docker-for-windows,docker-for-windows,,72,57,131,129,233,260,6,1
docker-desktop,docker-desktop,,24,10,29,34,12,63,6,1
qtranslate,qtranslate,,0,2,3,2,9,5,4,100
wms,wms,,15,12,25,27,42,52,1,1
getfeatureinfo,getfeatureinfo,,1,1,2,2,7,4,1,1
try-except,try-except,,35,17,36,52,78,88,0,1
disk-partitioning,disk-partitioning,,6,1,11,7,24,18,9,1
imx6,imx6,,9,9,27,18,61,45,9,1
filezilla,filezilla,,11,6,21,17,52,38,4,1
dendrogram,dendrogram,,18,9,43,27,53,70,0,1
ape-phylo,ape-phylo,,3,2,8,5,7,13,0,1
dtrace,dtrace,,3,1,10,4,17,14,13,1
xhtml2pdf,xhtml2pdf,,6,4,15,10,15,25,0,1
uncss,uncss,,0,1,4,1,5,5,1,1
scenegraph,scenegraph,,1,9,13,10,27,23,5,800
google-api-python-client,google-api-python-client,,33,29,61,62,131,123,5,1
reticulate,reticulate,,43,19,38,62,47,100,0,1
doc,doc,,21,16,24,37,37,61,0,1
active-model-serializers,active-model-serializers,,22,9,29,31,80,60,12,1
actioncable,actioncable,,36,32,82,68,141,150,12,1
acpi,acpi,,3,5,3,8,10,11,9,66.666667
windows-mobile-6.5,windows-mobile-6.5,,1,0,1,1,10,2,8,1
core-image,core-image,,21,23,73,44,111,117,13,9.52381
cifilter,cifilter,,11,14,31,25,56,56,13,27.272727
modx,modx,,8,5,15,13,43,28,4,1
modx-revolution,modx-revolution,,4,4,6,8,21,14,4,1
modx-plugins,modx-plugins,,0,0,0,0,1,0,4,1
actionmailer,actionmailer,,15,10,47,25,126,72,12,1
paho,paho,,37,55,82,92,154,174,6,48.648649
simplesamlphp,simplesamlphp,,13,12,25,25,48,50,8,1
onelogin,onelogin,,22,21,45,43,74,88,8,1
symbol-table,symbol-table,,5,3,16,8,14,24,9,1
defaultdict,defaultdict,,15,10,40,25,86,65,0,1
slick-3.0,slick-3.0,,7,9,25,16,55,41,2,28.571429
fragmentmanager,fragmentmanager,,22,16,35,38,74,73,3,1
imagemap,imagemap,,7,8,17,15,36,32,1,14.285714
glyphicons,glyphicons,,9,6,18,15,66,33,1,1
urlhelper,urlhelper,,1,1,5,2,4,7,8,1
android-timepicker,android-timepicker,,10,12,13,22,30,35,3,20
template-specialization,template-specialization,,39,36,58,75,143,133,9,1
angular2-toaster,angular2-toaster,,0,0,1,0,7,1,1,1
nsxpcconnection,nsxpcconnection,,1,2,6,3,4,9,13,100
modbus,modbus,,37,28,74,65,107,139,0,1
alphanumeric,alphanumeric,,10,8,20,18,54,38,0,1
pouchdb,pouchdb,,33,23,100,56,204,156,1,1
find-in-set,find-in-set,,5,0,8,5,12,13,4,1
nppexec,nppexec,,1,2,1,3,6,4,0,100
autocad,autocad,,36,42,52,78,117,130,5,16.666667
relativelayout,relativelayout,,13,25,13,38,38,51,3,92.307692
c-preprocessor,c-preprocessor,,76,60,143,136,270,279,9,1
bottle,bottle,,22,26,68,48,114,116,0,18.181818
boot-clj,boot-clj,,1,2,5,3,9,8,2,100
gameplay-kit,gameplay-kit,,5,4,9,9,26,18,13,1
javafx-2,javafx-2,,16,13,37,29,127,66,3,1
django-registration,django-registration,,6,9,6,15,29,21,0,50
tlb,tlb,,5,3,16,8,24,24,9,1
catia,catia,,11,15,25,26,54,51,5,36.363636
caa,caa,,2,2,2,4,7,6,5,1
projection,projection,,46,38,71,84,168,155,0,1
azure-search-.net-sdk,azure-search-.net-sdk,,7,10,18,17,30,35,8,42.857143
viewstate,viewstate,,6,9,19,15,34,34,8,50
angular-universal,angular-universal,,93,95,181,188,336,369,1,2.150538
facebook-unity-sdk,facebook-unity-sdk,,7,4,10,11,36,21,8,1
angular-http-auth,angular-http-auth,,0,0,0,0,5,0,1,1
flycheck,flycheck,,0,3,5,3,7,8,9,200
form-fields,form-fields,,8,7,11,15,12,26,1,1
openpyxl,openpyxl,,194,202,257,396,527,653,0,4.123711
npm-link,npm-link,,11,7,13,18,30,31,1,1
socket-timeout-exception,socket-timeout-exception,,8,9,8,17,27,25,3,12.5
uidevice,uidevice,,2,0,2,2,13,4,13,1
cucumber-serenity,cucumber-serenity,,23,15,33,38,40,71,3,1
scenebuilder,scenebuilder,,100,47,153,147,300,300,3,1
boilerplate,boilerplate,,13,14,26,27,47,53,8,7.692308
extended-properties,extended-properties,,4,0,5,4,4,9,8,1
iconv,iconv,,5,15,23,20,40,43,0,200
fence-plots,fence-plots,,0,0,0,0,3,0,0,1
brush,brush,,5,3,11,8,19,19,1,1
wxpython,wxpython,,126,107,177,233,392,410,0,1
bigcommerce,bigcommerce,,18,16,44,34,110,78,1,1
shortcuts,shortcuts,,0,0,0,0,27,0,3,1
android-static-shortcuts,android-static-shortcuts,,0,0,2,0,3,2,3,1
android-dynamic-shortcuts,android-dynamic-shortcuts,,0,0,1,0,2,1,3,1
tools.jar,tools.jar,,1,1,5,2,6,7,3,1
crystal-reports-viewer,crystal-reports-viewer,,0,2,1,2,3,3,8,100
kylin,kylin,,16,5,11,21,17,32,2,1
dymo,dymo,,3,5,3,8,12,11,1,66.666667
imageicon,imageicon,,12,10,27,22,44,49,3,1
tint,tint,,6,4,11,10,15,21,13,1
slackware,slackware,,1,0,7,1,6,8,9,1
laravel-collection,laravel-collection,,13,6,39,19,53,58,4,1
erb,erb,,31,27,77,58,127,135,12,1
form-for,form-for,,5,14,15,19,30,34,12,180
websphere-portal,websphere-portal,,4,5,11,9,33,20,3,25
jsr286,jsr286,,0,0,0,0,1,0,9,1
uislider,uislider,,17,22,42,39,104,81,13,29.411765
probability-distribution,probability-distribution,,17,18,22,35,36,57,0,5.882353
c3.js,c3.js,,29,48,79,77,193,156,1,65.517241
kiosk,kiosk,,10,7,32,17,38,49,3,1
kiosk-mode,kiosk-mode,,11,17,24,28,56,52,3,54.545455
qnx,qnx,,9,13,35,22,22,57,9,44.444444
can-bus,can-bus,,37,40,81,77,93,158,9,8.108108
canopen,canopen,,0,5,9,5,8,14,9,400
fluent-assertions,fluent-assertions,,8,8,18,16,36,34,8,1
seetest,seetest,,4,0,5,4,3,9,3,1
fluent-migrator,fluent-migrator,,6,5,6,11,20,17,8,1
twilio-functions,twilio-functions,,28,27,37,55,44,92,13,1
dbplyr,dbplyr,,12,15,23,27,73,50,0,25
android-drawer,android-drawer,,1,0,5,1,9,6,3,1
void,void,,24,23,49,47,137,96,9,1
beanshell,beanshell,,27,20,35,47,146,82,3,1
uft14,uft14,,10,15,22,25,22,47,5,50
messageid,messageid,,1,0,2,1,7,3,4,1
openblas,openblas,,13,11,11,24,33,35,9,1
algorithmic-trading,algorithmic-trading,,17,31,31,48,75,79,0,82.352941
moc,moc,,3,1,3,4,8,7,9,1
html5-template,html5-template,,1,0,4,1,10,5,1,1
siteminder,siteminder,,1,2,8,3,16,11,3,100
solar,solar,,3,4,7,7,4,14,0,33.333333
pic32,pic32,,4,7,5,11,17,16,9,75
keycloak-services,keycloak-services,,19,27,55,46,89,101,3,42.105263
nsevent,nsevent,,3,3,4,6,16,10,13,1
filesaver.js,filesaver.js,,16,22,29,38,57,67,1,37.5
device-tree,device-tree,,14,20,37,34,64,71,9,42.857143
bottom-sheet,bottom-sheet,,53,57,101,110,130,211,3,7.54717
lektor,lektor,,0,0,2,0,4,2,0,1
throws,throws,,2,4,10,6,14,16,3,100
jradiobutton,jradiobutton,,1,0,8,1,10,9,3,1
binaries,binaries,,7,3,8,10,10,18,8,1
qtandroidextras,qtandroidextras,,1,2,3,3,3,6,9,100
angulartics,angulartics,,0,0,3,0,5,3,5,1
google-analytics-userid,google-analytics-userid,,4,6,2,10,2,12,5,50
azure-data-sync,azure-data-sync,,6,5,3,11,7,14,8,1
braintree,braintree,,31,54,90,85,173,175,4,74.193548
sqlite-net,sqlite-net,,15,11,24,26,30,50,8,1
httplib,httplib,,1,4,5,5,11,10,0,300
basehttprequesthandler,basehttprequesthandler,,5,0,8,5,10,13,0,1
visual-c++-2013,visual-c++-2013,,1,0,1,1,1,2,9,1
eager-loading,eager-loading,,37,17,65,54,116,119,4,1
lost-focus,lost-focus,,4,1,2,5,11,7,8,1
xml2,xml2,,17,10,21,27,36,48,0,1
visual-studio-debugging,visual-studio-debugging,,41,21,90,62,167,152,8,1
proguard,proguard,,82,107,191,189,355,380,3,30.487805
azureportal,azureportal,,27,32,69,59,106,128,8,18.518519
shieldui,shieldui,,2,1,12,3,12,15,1,1
jquery-globalize,jquery-globalize,,1,0,4,1,8,5,8,1
retro-computing,retro-computing,,0,1,2,1,4,3,9,1
zxspectrum,zxspectrum,,0,1,0,1,1,1,9,1
tosca,tosca,,2,5,7,7,11,14,3,150
guard,guard,,14,18,34,32,50,66,4,28.571429
accelerated-mobile-page,accelerated-mobile-page,,0,0,7,0,71,7,1,1
stimulsoft,stimulsoft,,10,15,25,25,28,50,8,50
text-parsing,text-parsing,,15,18,34,33,91,67,0,20
service-discovery,service-discovery,,26,16,58,42,73,100,3,1
wifip2p,wifip2p,,11,9,25,20,35,45,3,1
uinavigationitem,uinavigationitem,,13,13,27,26,115,53,13,1
worker,worker,,32,30,57,62,84,119,1,1
find-replace,find-replace,,6,4,14,10,20,24,0,1
php-5.5,php-5.5,,1,6,16,7,30,23,4,500
companion-object,companion-object,,5,6,13,11,37,24,2,20
xpath-2.0,xpath-2.0,,14,13,13,27,51,40,3,1
jetty-9,jetty-9,,17,22,36,39,52,75,3,29.411765
splitstackshape,splitstackshape,,1,1,0,2,12,2,0,1
pattern-layout,pattern-layout,,1,1,3,2,9,5,3,1
web-user-controls,web-user-controls,,0,0,0,0,3,0,8,1
getrusage,getrusage,,0,2,1,2,6,3,9,100
qunit,qunit,,9,5,19,14,44,33,1,1
validating,validating,,0,0,0,0,2,0,8,1
log4net,log4net,,53,55,131,108,235,239,8,3.773585
common.logging,common.logging,,1,0,2,1,3,3,8,1
adobe-illustrator,adobe-illustrator,,27,32,48,59,79,107,1,18.518519
rvalue,rvalue,,9,18,23,27,49,50,9,100
avplayeritem,avplayeritem,,5,8,13,13,36,26,13,60
vertica,vertica,,36,37,71,73,149,144,4,2.777778
neo4j.rb,neo4j.rb,,2,0,1,2,9,3,2,1
file-transfer,file-transfer,,42,28,78,70,116,148,1,1
clearfix,clearfix,,2,1,0,3,7,3,1,1
avl-tree,avl-tree,,32,7,29,39,68,68,0,1
ls,ls,,26,19,61,45,104,106,9,1
emq,emq,,3,3,12,6,11,18,6,1
wireless,wireless,,19,28,35,47,74,82,9,47.368421
windows-iot-core-10,windows-iot-core-10,,12,15,48,27,86,75,8,25
android-accessibility,android-accessibility,,25,24,38,49,44,87,3,1
xpages-extlib,xpages-extlib,,10,4,3,14,28,17,5,1
code-behind,code-behind,,12,16,35,28,75,63,8,33.333333
octopress,octopress,,0,0,1,0,2,1,1,1
jekyll-paginator,jekyll-paginator,,1,1,1,2,11,3,1,1
api-platform.com,api-platform.com,,66,99,110,165,105,275,4,50
expand,expand,,23,14,42,37,83,79,1,1
html5-validation,html5-validation,,2,2,7,4,23,11,1,1
html5-input-number,html5-input-number,,1,1,2,2,10,4,1,1
facebook-sdk-4.0,facebook-sdk-4.0,,17,8,47,25,82,72,13,1
canvg,canvg,,8,4,3,12,9,15,1,1
network-driver,network-driver,,0,0,0,0,8,0,9,1
pdfmake,pdfmake,,22,28,45,50,74,95,1,27.272727
pannellum,pannellum,,2,1,4,3,7,7,1,1
remote-debugging,remote-debugging,,57,58,110,115,202,225,9,1.754386
sonatype,sonatype,,13,11,34,24,48,58,3,1
facebook-comments,facebook-comments,,4,8,10,12,31,22,13,100
ddms,ddms,,1,0,2,1,15,3,3,1
ghost-blog,ghost-blog,,12,15,20,27,30,47,6,25
ghost,ghost,,0,0,0,0,37,0,6,1
prismjs,prismjs,,7,2,9,9,12,18,1,1
curve,curve,,21,25,57,46,95,103,0,19.047619
manifest.json,manifest.json,,24,20,46,44,95,90,1,1
sumifs,sumifs,,29,20,82,49,127,131,5,1
id3,id3,,6,5,14,11,29,25,0,1
accord.net,accord.net,,7,13,25,20,56,45,8,85.714286
windows-update,windows-update,,3,7,20,10,48,30,8,133.333333
cocos2d-js,cocos2d-js,,4,9,13,13,15,26,3,125
django-allauth,django-allauth,,59,48,54,107,143,161,0,1
django-rest-auth,django-rest-auth,,29,28,52,57,85,109,0,1
akka.net-persistence,akka.net-persistence,,1,0,4,1,11,5,8,1
r-highcharter,r-highcharter,,33,26,59,59,82,118,0,1
d3heatmap,d3heatmap,,0,0,2,0,5,2,0,1
heatmaply,heatmaply,,0,4,4,4,17,8,0,300
file-watcher,file-watcher,,17,11,20,28,55,48,8,1
ng-idle,ng-idle,,2,1,6,3,6,9,1,1
minizinc,minizinc,,3,8,23,11,38,34,0,166.666667
i18next,i18next,,45,35,59,80,71,139,1,1
avaloniaui,avaloniaui,,4,8,6,12,5,18,8,100
express-session,express-session,,59,54,98,113,159,211,1,1
bisect,bisect,,1,1,4,2,5,6,0,1
spring-security-ldap,spring-security-ldap,,11,18,17,29,28,46,3,63.636364
session-storage,session-storage,,22,28,57,50,83,107,1,27.272727
treeviewitem,treeviewitem,,3,3,15,6,18,21,8,1
namevaluecollection,namevaluecollection,,1,3,2,4,6,6,8,200
vue-chartjs,vue-chartjs,,21,17,24,38,47,62,1,1
react-native-router-flux,react-native-router-flux,,31,40,88,71,164,159,1,29.032258
varchar,varchar,,18,20,28,38,89,66,4,11.111111
sql-convert,sql-convert,,0,1,3,1,17,4,4,1
keyword-search,keyword-search,,5,3,13,8,29,21,0,1
nstimer,nstimer,,11,8,35,19,74,54,13,1
information-extraction,information-extraction,,11,5,17,16,34,33,0,1
google-analytics-api,google-analytics-api,,80,99,179,179,353,358,5,23.75
google-analytics-firebase,google-analytics-firebase,,11,10,44,21,63,65,5,1
actionscript,actionscript,,20,15,33,35,104,68,13,1
jags,jags,,8,13,20,21,43,41,0,62.5
data-class,data-class,,13,26,24,39,33,63,3,100
getcomputedstyle,getcomputedstyle,,3,2,6,5,10,11,1,1
orbeon,orbeon,,3,9,19,12,68,31,1,200
lang,lang,,9,11,21,20,38,41,1,22.222222
hls.js,hls.js,,6,12,13,18,18,31,13,100
getorgchart,getorgchart,,3,0,4,3,22,7,1,1
quantile,quantile,,28,15,37,43,85,80,0,1
zshrc,zshrc,,6,10,24,16,26,40,9,66.666667
angular2-ngfor,angular2-ngfor,,0,0,0,0,4,0,1,1
behat,behat,,22,23,40,45,89,85,4,4.545455
lxc,lxc,,21,19,23,40,50,63,6,1
application-restart,application-restart,,8,2,3,10,19,13,8,1
hiredis,hiredis,,7,8,4,15,13,19,3,14.285714
azure-bot-service,azure-bot-service,,37,59,99,96,167,195,8,59.459459
fiware,fiware,,43,16,58,59,143,117,6,1
hotkeys,hotkeys,,16,16,37,32,62,69,8,1
http-1.1,http-1.1,,4,8,9,12,15,21,4,100
system.net.httpwebrequest,system.net.httpwebrequest,,6,7,19,13,14,32,8,16.666667
mink,mink,,6,8,8,14,28,22,4,33.333333
kaminari,kaminari,,5,6,16,11,30,27,12,20
aggregate-functions,aggregate-functions,,107,87,176,194,368,370,4,1
fmdb,fmdb,,4,6,11,10,37,21,13,50
hololens,hololens,,88,51,111,139,179,250,8,1
shibboleth,shibboleth,,9,16,33,25,49,58,8,77.777778
kotlin-dokka,kotlin-dokka,,6,7,4,13,16,17,3,16.666667
remoting,remoting,,3,2,23,5,34,28,8,1
sql-like,sql-like,,54,43,125,97,219,222,4,1
github3.py,github3.py,,0,1,2,1,5,3,6,1
plsqldeveloper,plsqldeveloper,,25,30,62,55,156,117,4,20
lvm,lvm,,8,2,12,10,14,22,9,1
nana,nana,,2,3,0,5,4,5,9,50
vagrant-provision,vagrant-provision,,6,5,14,11,25,25,4,1
shelve,shelve,,7,4,20,11,24,31,0,1
swarm,swarm,,11,13,44,24,67,68,6,18.181818
ubercart,ubercart,,2,0,0,2,4,2,4,1
django-ajax-selects,django-ajax-selects,,1,5,1,6,7,7,0,400
sanitize,sanitize,,7,3,11,10,19,21,4,1
reactive-kafka,reactive-kafka,,0,6,2,6,13,8,2,500
cim,cim,,3,3,2,6,15,8,8,1
openvpn,openvpn,,60,39,49,99,49,148,6,1
android-security,android-security,,16,16,44,32,49,76,3,1
android-binding-adapter,android-binding-adapter,,5,5,12,10,11,22,3,1
exists,exists,,32,19,61,51,108,112,4,1
memoryview,memoryview,,8,1,8,9,18,17,0,1
tabcontainer,tabcontainer,,1,2,2,3,3,5,8,100
internet-radio,internet-radio,,1,2,21,3,9,24,13,100
oasis,oasis,,1,2,2,3,6,5,0,100
warbler,warbler,,1,1,2,2,6,4,12,1
rspec-puppet,rspec-puppet,,2,0,3,2,7,5,6,1
code-translation,code-translation,,7,4,15,11,26,26,0,1
maxmsp,maxmsp,,0,1,1,1,3,2,0,1
gridpane,gridpane,,18,10,24,28,59,52,3,1
accessoryview,accessoryview,,1,0,2,1,8,3,13,1
.htpasswd,.htpasswd,,10,8,22,18,33,40,4,1
classnotfoundexception,classnotfoundexception,,31,28,74,59,149,133,3,1
blocking,blocking,,28,19,69,47,107,116,3,1
header-files,header-files,,52,52,103,104,236,207,9,1
one-definition-rule,one-definition-rule,,6,9,16,15,36,31,9,50
nuance,nuance,,1,1,4,2,7,6,6,1
superglobals,superglobals,,2,2,13,4,15,17,4,1
rdf4j,rdf4j,,7,3,12,10,20,22,2,1
topbraid-composer,topbraid-composer,,1,0,0,1,5,1,2,1
spin-rdf,spin-rdf,,0,0,0,0,2,0,2,1
telnetlib,telnetlib,,14,12,18,26,34,44,0,1
checksum,checksum,,46,26,72,72,143,144,9,1
percona,percona,,15,13,24,28,66,52,4,1
telepot,telepot,,11,8,11,19,11,30,0,1
propertygrid,propertygrid,,17,8,29,25,34,54,8,1
download-manager,download-manager,,5,11,14,16,35,30,3,120
webmethod,webmethod,,10,15,42,25,79,67,8,50
pester,pester,,7,13,11,20,49,31,8,85.714286
jdialog,jdialog,,13,11,17,24,39,41,3,1
recv,recv,,17,10,11,27,40,38,9,1
vacuum,vacuum,,7,5,10,12,38,22,4,1
autovacuum,autovacuum,,5,2,11,7,15,18,4,1
elki,elki,,2,3,6,5,15,11,0,50
pycaffe,pycaffe,,10,9,33,19,110,52,0,1
lzma,lzma,,6,8,5,14,17,19,0,33.333333
lz4,lz4,,5,3,11,8,23,19,0,1
hot-module-replacement,hot-module-replacement,,11,12,26,23,37,49,1,9.090909
antbuilder,antbuilder,,4,2,3,6,5,9,3,1
repaint,repaint,,15,11,22,26,48,48,3,1
2048,2048,,2,3,3,5,8,8,0,50
price,price,,46,25,83,71,196,154,4,1
row-number,row-number,,22,14,63,36,116,99,4,1
partition-by,partition-by,,8,5,12,13,25,25,4,1
gdi,gdi,,18,31,45,49,87,94,9,72.222222
angular-mdl,angular-mdl,,0,0,2,0,3,2,1,1
asset-management,asset-management,,1,0,1,1,5,2,4,1
ui-select,ui-select,,13,6,15,19,47,34,1,1
xmi,xmi,,2,2,2,4,11,6,3,1
five9,five9,,0,0,0,0,3,0,0,1
faker,faker,,25,19,50,44,67,94,4,1
factory-boy,factory-boy,,11,11,17,22,45,39,0,1
posix-ere,posix-ere,,1,2,3,3,10,6,9,100
olap,olap,,32,21,46,53,79,99,4,1
leaflet-routing-machine,leaflet-routing-machine,,3,0,6,3,13,9,1,1
dpi,dpi,,16,18,52,34,85,86,8,12.5
beam,beam,,9,11,18,20,31,38,6,22.222222
managementeventwatcher,managementeventwatcher,,0,0,0,0,3,0,8,1
computed-properties,computed-properties,,21,23,50,44,64,94,1,9.52381
stdarray,stdarray,,9,12,24,21,44,45,9,33.333333
cocoon-gem,cocoon-gem,,10,7,20,17,52,37,12,1
eonasdan-datetimepicker,eonasdan-datetimepicker,,4,3,16,7,60,23,1,1
liquibase-hibernate,liquibase-hibernate,,3,10,13,13,21,26,3,233.333333
sl4a,sl4a,,3,3,1,6,11,7,0,1
tortoisegit,tortoisegit,,12,12,30,24,89,54,6,1
sinopia,sinopia,,1,0,2,1,9,3,1,1
bufferedwriter,bufferedwriter,,10,7,25,17,63,42,3,1
qvector,qvector,,3,4,9,7,20,16,9,33.333333
constexpr,constexpr,,66,67,130,133,238,263,9,1.515152
post-build-event,post-build-event,,12,6,15,18,37,33,8,1
brackets,brackets,,15,10,38,25,117,63,0,1
database-optimization,database-optimization,,2,3,4,5,20,9,4,50
certbot,certbot,,43,31,77,74,99,151,6,1
marklogic-9,marklogic-9,,54,40,117,94,137,211,3,1
doi,doi,,2,2,3,4,7,7,4,1
ms-access-2007,ms-access-2007,,16,14,49,30,94,79,5,1
qodbc,qodbc,,1,1,9,2,5,11,5,1
ssrs-2008-r2,ssrs-2008-r2,,25,29,72,54,149,126,4,16
contextpath,contextpath,,5,4,6,9,14,15,3,1
partial-specialization,partial-specialization,,6,3,7,9,24,16,9,1
entities,entities,,14,12,24,26,44,50,4,1
destructor,destructor,,43,36,87,79,208,166,9,1
mimekit,mimekit,,12,9,31,21,25,52,8,1
trunk,trunk,,3,0,5,3,8,8,6,1
vlan,vlan,,6,6,13,12,19,25,9,1
xmltodict,xmltodict,,7,7,10,14,10,24,0,1
coordinate-transformation,coordinate-transformation,,21,14,50,35,108,85,0,1
meta,meta,,40,36,81,76,116,157,1,1
shell-exec,shell-exec,,22,16,35,38,81,73,4,1
ada,ada,,48,22,68,70,170,138,9,1
nmap,nmap,,25,18,35,43,55,78,9,1
xlsx,xlsx,,96,124,204,220,374,424,5,29.166667
http-status-code-308,http-status-code-308,,1,1,0,2,2,2,4,1
moodle,moodle,,43,49,109,92,174,201,4,13.953488
moodle-api,moodle-api,,9,11,23,20,39,43,4,22.222222
moodle-mobile,moodle-mobile,,3,1,7,4,15,11,4,1
qsharedpointer,qsharedpointer,,1,0,3,1,5,4,9,1
tizen-wearable-sdk,tizen-wearable-sdk,,15,9,9,24,44,33,13,1
web-inspector,web-inspector,,7,13,11,20,36,31,1,85.714286
android-augmented-reality,android-augmented-reality,,25,10,33,35,49,68,3,1
triangular,triangular,,5,0,6,5,27,11,0,1
rooted,rooted,,1,1,1,2,4,3,3,1
glass-mapper,glass-mapper,,2,3,5,5,16,10,8,50
linux-containers,linux-containers,,7,1,17,8,21,25,6,1
enable-if,enable-if,,17,15,31,32,41,63,9,1
dji-sdk,dji-sdk,,50,25,77,75,94,152,3,1
key-value-store,key-value-store,,13,12,16,25,41,41,0,1
whiptail,whiptail,,3,0,0,3,7,3,9,1
fibers,fibers,,2,4,6,6,11,12,9,100
coldfusion-9,coldfusion-9,,5,3,10,8,51,18,4,1
cfqueryparam,cfqueryparam,,0,3,0,3,4,3,4,200
rack,rack,,6,6,28,12,46,40,12,1
iterm,iterm,,6,5,11,11,26,22,9,1
swiftbond,swiftbond,,0,3,4,3,5,7,13,200
libc++,libc++,,8,9,30,17,42,47,9,12.5
varnish-vcl,varnish-vcl,,9,7,28,16,50,44,4,1
boost-thread,boost-thread,,6,4,3,10,25,13,9,1
apostrophe,apostrophe,,7,5,22,12,42,34,1,1
apostrophe-cms,apostrophe-cms,,19,8,22,27,59,49,1,1
autodesk-inventor,autodesk-inventor,,6,3,14,9,8,23,14,1
openfl,openfl,,3,2,2,5,34,7,9,1
mailman,mailman,,0,2,1,2,2,3,4,100
http-method,http-method,,16,5,21,21,36,42,4,1
screensharing,screensharing,,3,8,17,11,29,28,1,166.666667
min,min,,69,48,133,117,242,250,0,1
pulp,pulp,,40,35,50,75,98,125,0,1
network-drive,network-drive,,9,9,11,18,32,29,8,1
ashx,ashx,,4,3,6,7,27,13,8,1
grails-plugin,grails-plugin,,11,11,8,22,42,30,3,1
scrapinghub,scrapinghub,,10,11,8,21,43,29,0,10
plotmath,plotmath,,2,5,9,7,17,16,0,150
availability,availability,,5,4,11,9,19,20,13,1
oozie-workflow,oozie-workflow,,16,14,49,30,53,79,2,1
ws-security,ws-security,,13,10,28,23,47,51,3,1
luajit,luajit,,5,11,21,16,32,37,9,120
nine-patch,nine-patch,,4,0,9,4,19,13,3,1
spring-mybatis,spring-mybatis,,25,17,41,42,73,83,3,1
greenlock,greenlock,,0,0,5,0,8,5,1,1
android-screen,android-screen,,1,1,1,2,11,3,3,1
non-type,non-type,,1,6,6,7,12,13,9,500
dailymotion-api,dailymotion-api,,3,3,5,6,13,11,1,1
adwords-apiv201402,adwords-apiv201402,,4,2,3,6,16,9,5,1
opencv3.2,opencv3.2,,2,0,3,2,13,5,0,1
cascading-deletes,cascading-deletes,,5,8,20,13,33,33,4,60
malformed,malformed,,3,1,6,4,11,10,4,1
azure-notificationhub,azure-notificationhub,,23,15,47,38,92,85,8,1
chi-squared,chi-squared,,25,19,45,44,68,89,0,1
stack-overflow,stack-overflow,,61,60,123,121,289,244,3,1
direct2d,direct2d,,11,13,20,24,37,44,9,18.181818
module-pattern,module-pattern,,2,1,4,3,7,7,1,1
delimited-text,delimited-text,,6,8,13,14,27,27,0,33.333333
postback,postback,,28,12,41,40,65,81,8,1
findcontrol,findcontrol,,2,2,4,4,8,8,8,1
qstring,qstring,,10,7,13,17,58,30,9,1
casablanca,casablanca,,7,1,4,8,25,12,9,1
csh,csh,,21,18,33,39,75,72,9,1
trix,trix,,8,10,9,18,22,27,12,25
html5-history,html5-history,,17,10,31,27,64,58,1,1
address-operator,address-operator,,0,2,3,2,7,5,9,100
fuse,fuse,,22,18,31,40,62,71,9,1
bluetooth-gatt,bluetooth-gatt,,25,34,39,59,61,98,3,36
mkv,mkv,,5,14,15,19,25,34,13,180
gitolite,gitolite,,1,0,5,1,18,6,6,1
git-commands,git-commands,,1,1,13,2,21,15,6,1
text-styling,text-styling,,6,3,7,9,14,16,1,1
angular-ui-datepicker,angular-ui-datepicker,,0,1,1,1,6,2,1,1
hspec,hspec,,0,2,7,2,11,9,2,100
docker-stack,docker-stack,,7,9,29,16,58,45,6,28.571429
google-cast-sdk,google-cast-sdk,,23,13,21,36,52,57,13,1
imagejpeg,imagejpeg,,2,1,3,3,9,6,4,1
apache-commons-math,apache-commons-math,,5,7,8,12,15,20,3,40
suitescript2.0,suitescript2.0,,64,47,123,111,130,234,14,1
web-analytics,web-analytics,,2,4,5,6,13,11,5,100
filepath,filepath,,58,60,124,118,256,242,0,3.448276
datalist,datalist,,25,13,22,38,61,60,1,1
indices,indices,,19,20,35,39,80,74,0,5.263158
filenotfoundexception,filenotfoundexception,,33,18,51,51,123,102,3,1
cosmos,cosmos,,8,6,11,14,16,25,8,1
talkback,talkback,,23,20,42,43,36,85,3,1
nvidia-titan,nvidia-titan,,0,0,1,0,4,1,0,1
cpu-load,cpu-load,,1,1,2,2,4,4,14,1
s3cmd,s3cmd,,3,1,10,4,11,14,6,1
applet,applet,,38,28,73,66,145,139,3,1
spline,spline,,31,37,56,68,86,124,0,19.354839
httppostedfilebase,httppostedfilebase,,5,3,5,8,15,13,8,1
rspec3,rspec3,,5,5,19,10,21,29,12,1
automake,automake,,17,8,29,25,65,54,9,1
evaluator,evaluator,,2,4,2,6,3,8,2,100
lookbehind,lookbehind,,7,4,25,11,35,36,0,1
capturing-group,capturing-group,,4,2,13,6,23,19,0,1
php-ini,php-ini,,5,3,19,8,42,27,4,1
matplotlib-widget,matplotlib-widget,,9,3,14,12,22,26,0,1
ntvs,ntvs,,0,1,0,1,3,1,1,1
one-time-password,one-time-password,,21,21,44,42,61,86,3,1
reset-password,reset-password,,7,12,23,19,44,42,4,71.428571
clickatell,clickatell,,0,3,3,3,11,6,4,200
body-parser,body-parser,,48,35,88,83,138,171,1,1
uimenucontroller,uimenucontroller,,3,4,7,7,14,14,13,33.333333
notificationcenter,notificationcenter,,5,6,26,11,33,37,13,20
concurrent-mark-sweep,concurrent-mark-sweep,,1,3,1,4,4,5,3,200
modulus,modulus,,12,11,27,23,63,50,0,1
throttling,throttling,,25,27,53,52,101,105,4,8
let,let,,19,18,33,37,79,70,1,1
aria2,aria2,,4,1,2,5,8,7,9,1
google-my-business-api,google-my-business-api,,7,14,17,21,23,38,5,100
propel,propel,,3,4,9,7,20,16,4,33.333333
downloadfile,downloadfile,,11,26,11,37,38,48,8,136.363636
autocorrect,autocorrect,,4,6,12,10,17,22,0,50
mockery,mockery,,18,7,30,25,45,55,4,1
subscribe,subscribe,,41,30,78,71,155,149,1,1
scnscene,scnscene,,1,5,10,6,29,16,13,400
apache-commons-lang3,apache-commons-lang3,,3,6,5,9,15,14,3,100
sql-function,sql-function,,18,12,39,30,59,69,4,1
rtti,rtti,,11,9,19,20,45,39,9,1
rbenv,rbenv,,23,14,36,37,72,73,12,1
jgrasp,jgrasp,,3,1,11,4,41,15,3,1
super,super,,38,40,66,78,134,144,9,5.263158
autodesk,autodesk,,16,15,52,31,74,83,14,1
autodesk-navisworks,autodesk-navisworks,,5,3,3,8,6,11,14,1
suspend,suspend,,3,3,12,6,31,18,3,1
hotlinking,hotlinking,,2,4,10,6,13,16,4,100
apollo-server,apollo-server,,140,123,180,263,164,443,1,1
apollostack,apollostack,,2,0,5,2,10,7,1,1
karate,karate,,93,81,138,174,169,312,3,1
otto,otto,,0,0,2,0,2,2,3,1
jack,jack,,5,6,6,11,18,17,13,20
exadmin,exadmin,,0,0,0,0,4,0,2,1
carriage-return,carriage-return,,21,24,22,45,63,67,9,14.285714
multilinestring,multilinestring,,9,5,16,14,17,30,0,1
discriminated-union,discriminated-union,,14,7,21,21,44,42,1,1
event-loop,event-loop,,29,27,64,56,121,120,1,1
wmic,wmic,,23,31,43,54,71,97,9,34.782609
arraycollection,arraycollection,,6,1,15,7,13,22,4,1
atlassian-crucible,atlassian-crucible,,1,1,4,2,7,6,6,1
julia-jump,julia-jump,,23,14,24,37,34,61,0,1
sublist,sublist,,17,9,38,26,62,64,0,1
elevation,elevation,,10,2,15,12,19,27,3,1
heightmap,heightmap,,2,6,9,8,8,17,8,200
jpql,jpql,,77,62,181,139,373,320,3,1
hp-performance-center,hp-performance-center,,1,0,2,1,8,3,3,1
xcodeproj,xcodeproj,,2,3,5,5,8,10,13,50
nginx-location,nginx-location,,81,65,127,146,220,273,6,1
udpclient,udpclient,,8,8,32,16,41,48,9,1
move,move,,70,67,151,137,271,288,9,1
smartcard,smartcard,,36,40,62,76,126,138,3,11.111111
javacard,javacard,,12,10,24,22,52,46,3,1
globalplatform,globalplatform,,5,8,3,13,14,16,3,60
tinymce-plugins,tinymce-plugins,,8,7,26,15,24,41,1,1
gomobile,gomobile,,5,3,7,8,10,15,6,1
fxmlloader,fxmlloader,,13,7,19,20,41,39,3,1
safaridriver,safaridriver,,7,8,22,15,26,37,3,14.285714
dozer,dozer,,2,17,13,19,47,32,3,750
checked,checked,,12,7,27,19,62,46,1,1
exceljs,exceljs,,18,22,33,40,42,73,1,22.222222
ws-federation,ws-federation,,10,13,24,23,46,47,8,30
laravel-response,laravel-response,,1,1,3,2,18,5,4,1
svg-sprite,svg-sprite,,1,3,9,4,8,13,1,200
ami,ami,,28,20,57,48,83,105,6,1
variant,variant,,31,25,66,56,95,122,9,1
rodbc,rodbc,,26,15,37,41,102,78,0,1
lift-json,lift-json,,1,1,4,2,8,6,2,1
ssrs-expression,ssrs-expression,,4,3,4,7,11,11,4,1
microsoft-reporting,microsoft-reporting,,3,1,3,4,6,7,4,1
gpu-programming,gpu-programming,,15,12,31,27,52,58,0,1
dot,dot,,33,30,39,63,91,102,0,1
circos,circos,,0,1,4,1,10,5,0,1
react-native-image,react-native-image,,8,5,13,13,28,26,1,1
react-image,react-image,,2,2,4,4,9,8,1,1
strtok,strtok,,24,16,53,40,110,93,9,1
face-recognition,face-recognition,,53,71,111,124,162,235,0,33.962264
resx,resx,,13,10,44,23,50,67,8,1
xelement,xelement,,8,6,15,14,52,29,8,1
cmyk,cmyk,,5,3,6,8,22,14,8,1
channel-api,channel-api,,1,0,0,1,3,1,3,1
youtube-analytics-api,youtube-analytics-api,,17,8,21,25,31,46,5,1
jacoco,jacoco,,68,58,101,126,208,227,3,1
local,local,,79,81,137,160,246,297,4,2.531646
nsnotification,nsnotification,,0,0,0,0,16,0,13,1
libv8,libv8,,0,1,4,1,7,5,1,1
azure-template,azure-template,,9,4,73,13,48,86,8,1
datediff,datediff,,33,24,62,57,123,119,4,1
apache-tiles,apache-tiles,,3,1,7,4,15,11,3,1
distributed-testing,distributed-testing,,2,1,10,3,14,13,3,1
sanity-check,sanity-check,,0,1,1,1,7,2,9,1
beego,beego,,32,3,19,35,31,54,6,1
replicate,replicate,,3,9,14,12,25,26,0,200
transpiler,transpiler,,16,19,46,35,59,81,1,18.75
apl,apl,,7,5,9,12,27,21,0,1
geotools,geotools,,16,12,35,28,40,63,3,1
jts,jts,,4,5,11,9,13,20,3,25
alter,alter,,18,14,25,32,67,57,4,1
kotlin-generics,kotlin-generics,,0,0,1,0,17,1,3,1
nsurl,nsurl,,9,8,14,17,62,31,13,1
nsurlrequest,nsurlrequest,,7,6,12,13,39,25,13,1
react-intl,react-intl,,15,21,40,36,63,76,1,40
office-store,office-store,,5,5,18,10,28,28,5,1
next.js,next.js,,323,332,451,655,180,1106,1,2.786378
qtabbar,qtabbar,,2,0,6,2,11,8,9,1
router-outlet,router-outlet,,23,15,44,38,87,82,1,1
gets,gets,,8,1,11,9,32,20,9,1
forward,forward,,13,13,25,26,44,51,4,1
tuckey-urlrewrite-filter,tuckey-urlrewrite-filter,,1,0,8,1,12,9,3,1
dotcms,dotcms,,2,0,0,2,5,2,4,1
numberformatexception,numberformatexception,,14,12,35,26,79,61,3,1
cmdlets,cmdlets,,6,7,16,13,55,29,8,16.666667
scientific-notation,scientific-notation,,14,14,29,28,60,57,0,1
tic-tac-toe,tic-tac-toe,,24,16,61,40,108,101,0,1
negamax,negamax,,3,1,1,4,8,5,0,1
appstats,appstats,,0,0,0,0,2,0,6,1
google-cloud-stackdriver,google-cloud-stackdriver,,47,74,98,121,146,219,6,57.446809
fody,fody,,10,7,9,17,17,26,8,1
type-families,type-families,,3,7,17,10,44,27,2,133.333333
extendscript,extendscript,,28,24,42,52,60,94,1,1
python-mock,python-mock,,13,17,16,30,41,46,0,30.769231
xmp,xmp,,7,2,12,9,9,21,8,1
pdfa,pdfa,,4,8,15,12,15,27,8,100
typechecking,typechecking,,19,23,33,42,83,75,9,21.052632
isometric,isometric,,8,5,10,13,17,23,1,1
objectbox,objectbox,,3,5,33,8,64,41,3,66.666667
itunes-search-api,itunes-search-api,,2,0,1,2,3,3,13,1
nesper,nesper,,1,1,3,2,9,5,14,1
here-api,here-api,,99,93,187,192,157,379,3,1
flock,flock,,9,8,8,17,21,25,9,1
boost-geometry,boost-geometry,,9,3,20,12,39,32,9,1
dynamics-crm-online,dynamics-crm-online,,23,19,67,42,146,109,8,1
django-serializer,django-serializer,,69,52,97,121,119,218,0,1
drawrect,drawrect,,3,10,13,13,29,26,13,233.333333
cgcontext,cgcontext,,6,10,8,16,26,24,13,66.666667
permanent,permanent,,1,1,3,2,11,5,4,1
amd,amd,,32,24,60,56,121,116,1,1
perf,perf,,24,23,48,47,103,95,9,1
build-dependencies,build-dependencies,,6,3,7,9,12,16,3,1
execvp,execvp,,5,1,20,6,24,26,9,1
crystal-lang,crystal-lang,,16,7,28,23,102,51,9,1
dingo-api,dingo-api,,5,2,9,7,50,16,4,1
gallery,gallery,,40,33,110,73,182,183,1,1
mplot3d,mplot3d,,5,11,24,16,31,40,0,120
file-search,file-search,,6,5,7,11,15,18,0,1
spritebatch,spritebatch,,4,1,6,5,7,11,8,1
spritefont,spritefont,,0,0,1,0,2,1,8,1
symfony-sonata,symfony-sonata,,10,3,20,13,33,33,4,1
sonata-user-bundle,sonata-user-bundle,,4,1,7,5,20,12,4,1
decodable,decodable,,42,35,95,77,185,172,13,1
sitefinity,sitefinity,,14,8,21,22,66,43,8,1
widechar,widechar,,3,2,6,5,8,11,9,1
transcoding,transcoding,,7,3,9,10,24,19,13,1
svelte,svelte,,29,100,11,129,30,140,1,244.827586
cherrypy,cherrypy,,18,19,36,37,58,73,0,5.555556
coredump,coredump,,20,19,48,39,71,87,9,1
hubot,hubot,,6,5,14,11,29,25,1,1
haptic-feedback,haptic-feedback,,6,4,10,10,14,20,13,1
mac-office,mac-office,,0,0,0,0,3,0,5,1
iunknown,iunknown,,2,0,1,2,5,3,8,1
web-development-server,web-development-server,,46,35,87,81,130,168,4,1
react-tabs,react-tabs,,5,3,1,8,4,9,1,1
azure-cognitive-services,azure-cognitive-services,,66,61,103,127,154,230,8,1
fireworks,fireworks,,0,1,0,1,1,1,3,1
bitnami,bitnami,,48,28,69,76,168,145,4,1
hibernate-validator,hibernate-validator,,17,26,50,43,113,93,3,52.941176
32bit-64bit,32bit-64bit,,35,40,73,75,118,148,9,14.285714
model-fitting,model-fitting,,17,12,21,29,40,50,0,1
chronicle,chronicle,,4,5,19,9,31,28,3,25
chronicle-queue,chronicle-queue,,2,4,13,6,23,19,3,100
disabled-input,disabled-input,,8,6,20,14,54,34,1,1
grpc-java,grpc-java,,37,47,53,84,89,137,6,27.027027
capnproto,capnproto,,1,4,9,5,15,14,9,300
dhtml,dhtml,,4,0,3,4,6,7,1,1
urlparse,urlparse,,3,5,5,8,26,13,0,66.666667
bmp,bmp,,24,15,28,39,66,67,9,1
fseek,fseek,,5,2,6,7,27,13,9,1
jwplayer7,jwplayer7,,4,2,6,6,7,12,1,1
rabin-karp,rabin-karp,,4,2,4,6,9,10,0,1
logstash-jdbc,logstash-jdbc,,12,23,18,35,26,53,6,91.666667
simplehttpserver,simplehttpserver,,9,7,8,16,32,24,0,1
basehttpserver,basehttpserver,,2,3,8,5,13,13,0,50
platform,platform,,18,15,39,33,52,72,3,1
go-gorm,go-gorm,,39,55,89,94,109,183,6,41.025641
pseudo-class,pseudo-class,,14,15,18,29,71,47,1,7.142857
multiparty,multiparty,,5,1,3,6,8,9,1,1
mser,mser,,1,1,2,2,10,4,0,1
grunt-plugins,grunt-plugins,,0,0,2,0,3,2,1,1
foreign-data-wrapper,foreign-data-wrapper,,2,2,7,4,17,11,4,1
postgres-fdw,postgres-fdw,,4,6,15,10,21,25,4,50
podcast,podcast,,9,1,8,10,9,18,4,1
alexa-app,alexa-app,,26,12,29,38,54,67,6,1
interprocess,interprocess,,10,6,15,16,31,31,9,1
i18n-gem,i18n-gem,,2,0,2,2,7,4,12,1
stringdist,stringdist,,3,8,7,11,21,18,0,166.666667
sonarqube-ops,sonarqube-ops,,4,4,3,8,70,11,3,1
visio,visio,,30,38,41,68,87,109,5,26.666667
wrappanel,wrappanel,,3,4,4,7,12,11,8,33.333333
xamarin.mac,xamarin.mac,,13,12,35,25,60,60,8,1
chatterbot,chatterbot,,22,16,25,38,33,63,0,1
angular-redux,angular-redux,,6,0,18,6,29,24,1,1
nsregularexpression,nsregularexpression,,6,15,25,21,43,46,13,150
wakanda,wakanda,,3,3,2,6,16,8,1,1
bean-io,bean-io,,5,6,6,11,22,17,3,20
model.matrix,model.matrix,,3,5,4,8,15,12,0,66.666667
ojs,ojs,,2,2,4,4,5,8,4,1
size-classes,size-classes,,5,4,9,9,19,18,13,1
pheatmap,pheatmap,,5,10,16,15,22,31,0,100
popper.js,popper.js,,17,23,48,40,66,88,1,35.294118
xelatex,xelatex,,16,7,12,23,20,35,0,1
sitefinity-5,sitefinity-5,,0,0,1,0,3,1,8,1
ibm-datapower,ibm-datapower,,6,7,20,13,20,33,3,16.666667
exslt,exslt,,3,3,6,6,9,12,3,1
cloudcannon,cloudcannon,,1,0,0,1,1,1,1,1
computed-field,computed-field,,2,2,1,4,8,5,0,1
right-to-left,right-to-left,,31,23,103,54,150,157,3,1
lower-bound,lower-bound,,4,2,13,6,19,19,9,1
upperbound,upperbound,,1,1,3,2,14,5,9,1
childviews,childviews,,1,0,1,1,4,2,13,1
payara-micro,payara-micro,,7,4,8,11,15,19,3,1
instanceid,instanceid,,2,0,5,2,5,7,13,1
date-pipe,date-pipe,,5,7,6,12,21,18,1,40
spring-batch,spring-batch,,227,239,421,466,760,887,3,5.286344
zipcode,zipcode,,8,4,12,12,22,24,0,1
traversal,traversal,,33,20,60,53,111,113,0,1
google-foobar,google-foobar,,0,2,2,2,11,4,0,100
stocks,stocks,,0,0,23,0,47,23,0,1
asx,asx,,0,0,0,0,1,0,1,1
apache-commons-exec,apache-commons-exec,,0,0,2,0,10,2,3,1
lerna,lerna,,37,36,60,73,65,133,1,1
spring-ws,spring-ws,,23,20,52,43,88,95,3,1
vao,vao,,2,3,7,5,17,12,9,50
servicestack.redis,servicestack.redis,,3,2,6,5,19,11,8,1
html-parsing,html-parsing,,57,68,155,125,266,280,0,19.298246
mechanicalturk,mechanicalturk,,8,11,20,19,26,39,6,37.5
smtpclient,smtpclient,,27,21,45,48,90,93,8,1
require-once,require-once,,3,5,7,8,21,15,4,66.666667
screen-scraping,screen-scraping,,85,80,151,165,235,316,0,1
tapestry,tapestry,,11,5,16,16,32,32,3,1
rowwise,rowwise,,6,3,9,9,17,18,0,1
importerror,importerror,,71,86,152,157,305,309,0,21.126761
zodb,zodb,,1,0,4,1,4,5,0,1
excel-pivot,excel-pivot,,2,2,4,4,7,8,5,1
colorfilter,colorfilter,,2,5,3,7,6,10,3,150
numerical-methods,numerical-methods,,54,39,117,93,155,210,0,1
cors-anywhere,cors-anywhere,,3,4,3,7,10,10,1,33.333333
vsync,vsync,,4,2,2,6,14,8,3,1
textinput,textinput,,33,35,56,68,124,124,1,6.060606
word-spacing,word-spacing,,0,0,0,0,5,0,1,1
stateful-actor-service,stateful-actor-service,,1,0,0,1,4,1,8,1
em,em,,6,2,10,8,19,18,1,1
transcription,transcription,,4,6,12,10,16,22,6,50
xmldocument,xmldocument,,15,15,28,30,64,58,8,1
xmlnode,xmlnode,,10,4,14,14,26,28,8,1
selectsinglenode,selectsinglenode,,0,1,2,1,11,3,8,1
facet,facet,,33,39,66,72,118,138,0,18.181818
mismatch,mismatch,,10,9,16,19,44,35,5,1
transparent,transparent,,21,16,46,37,96,83,1,1
invisible,invisible,,5,6,12,11,37,23,1,20
photography,photography,,1,2,5,3,6,8,0,100
codacy,codacy,,3,2,7,5,11,12,6,1
shift,shift,,16,18,41,34,63,75,0,12.5
pragma,pragma,,14,13,24,27,46,51,9,1
nim-lang,nim-lang,,8,6,23,14,54,37,9,1
symantec,symantec,,2,0,4,2,13,6,6,1
demorgans-law,demorgans-law,,1,2,3,3,1,6,0,100
roots-sage,roots-sage,,3,3,10,6,20,16,4,1
pdftk,pdftk,,12,6,14,18,42,32,8,1
vsixmanifest,vsixmanifest,,1,3,5,4,8,9,8,200
facebook-social-plugins,facebook-social-plugins,,0,1,8,1,12,9,13,1
exit,exit,,51,42,85,93,181,178,0,1
scrapy-shell,scrapy-shell,,7,8,12,15,17,27,0,14.285714
numberformatter,numberformatter,,3,9,5,12,12,17,13,200
asp.net-web-api-routing,asp.net-web-api-routing,,20,19,35,39,99,74,8,1
func,func,,26,28,49,54,78,103,8,7.692308
angular-datatables,angular-datatables,,29,26,73,55,130,128,1,1
airbnb,airbnb,,9,4,17,13,32,30,1,1
chrono,chrono,,28,21,49,49,91,98,9,1
exit-handler,exit-handler,,0,1,0,1,2,1,1,1
heroku-postgres,heroku-postgres,,42,43,69,85,84,154,1,2.380952
automator,automator,,19,25,55,44,80,99,13,31.578947
document-body,document-body,,3,3,7,6,15,13,1,1
put,put,,54,62,109,116,181,225,4,14.814815
linkage,linkage,,15,11,19,26,43,45,9,1
angularjs-ng-route,angularjs-ng-route,,3,4,8,7,37,15,1,33.333333
dbus-python,dbus-python,,0,0,3,0,3,3,9,1
oracle-xe,oracle-xe,,10,9,7,19,23,26,4,1
distribute,distribute,,0,1,3,1,10,4,0,1
jython-2.7,jython-2.7,,7,5,21,12,19,33,0,1
samsung-knox,samsung-knox,,0,4,5,4,8,9,3,300
xpath-3.0,xpath-3.0,,0,3,2,3,6,5,3,200
delphi-xe2,delphi-xe2,,6,8,11,14,30,25,9,33.333333
shift-reduce-conflict,shift-reduce-conflict,,1,1,10,2,14,12,9,1
ml-yacc,ml-yacc,,0,0,0,0,1,0,9,1
espn,espn,,0,1,3,1,2,4,0,1
angular-formly,angular-formly,,9,4,27,13,40,40,1,1
hapi,hapi,,22,18,46,40,23,86,1,1
coercion,coercion,,5,10,24,15,42,39,0,100
maven-dependency-plugin,maven-dependency-plugin,,4,16,11,20,35,31,3,300
varnish-4,varnish-4,,4,1,5,5,24,10,4,1
yield,yield,,31,32,72,63,120,135,0,3.225806
delve,delve,,12,7,15,19,35,34,6,1
message,message,,54,61,120,115,167,235,4,12.962963
elasticsearch-java-api,elasticsearch-java-api,,8,13,17,21,28,38,6,62.5
bower,bower,,18,22,45,40,164,85,1,22.222222
ocg,ocg,,0,0,0,0,3,0,8,1
ado.net-entity-data-model,ado.net-entity-data-model,,2,2,8,4,20,12,8,1
viewport-units,viewport-units,,6,4,9,10,27,19,1,1
canny-operator,canny-operator,,14,12,10,26,35,36,0,1
fade,fade,,18,14,23,32,62,55,1,1
ycsb,ycsb,,5,3,5,8,10,13,1,1
wxpython-phoenix,wxpython-phoenix,,20,18,42,38,68,80,0,1
bulk-email,bulk-email,,0,0,7,0,4,7,4,1
mamp-pro,mamp-pro,,11,7,22,18,60,40,4,1
built-in,built-in,,29,23,36,52,97,88,0,1
lm,lm,,74,44,100,118,182,218,0,1
flexible-array-member,flexible-array-member,,8,0,11,8,9,19,9,1
maven-2,maven-2,,15,12,46,27,99,73,3,1
android-architecture-lifecycle,android-architecture-lifecycle,,3,0,6,3,37,9,3,1
laravel-4.2,laravel-4.2,,6,2,11,8,33,19,4,1
yajra-datatable,yajra-datatable,,25,19,31,44,44,75,4,1
portable-executable,portable-executable,,14,12,35,26,62,61,9,1
code-completion,code-completion,,10,16,25,26,45,51,3,60
oomph,oomph,,3,2,3,5,10,8,3,1
shellexecuteex,shellexecuteex,,3,1,6,4,4,10,9,1
eclipse-cdt,eclipse-cdt,,50,52,117,102,234,219,3,4
seeding,seeding,,12,12,33,24,37,57,4,1
minimagick,minimagick,,5,4,24,9,33,33,12,1
nt,nt,,3,4,3,7,4,10,9,33.333333
value-categories,value-categories,,8,4,4,12,7,16,9,1
hashset,hashset,,47,31,85,78,176,163,3,1
linkedhashset,linkedhashset,,1,0,11,1,12,12,3,1
git-filter-branch,git-filter-branch,,5,19,24,24,31,48,6,280
bootstrap-tabs,bootstrap-tabs,,4,3,10,7,26,17,1,1
member,member,,18,23,50,41,110,91,9,27.777778
bank,bank,,5,4,8,9,12,17,4,1
info,info,,8,5,8,13,18,21,13,1
wav,wav,,78,74,129,152,202,281,13,1
uidocument,uidocument,,9,5,8,14,31,22,13,1
delphi-2010,delphi-2010,,6,14,17,20,31,37,9,133.333333
javax.xml,javax.xml,,2,4,6,6,9,12,3,100
codeblocks,codeblocks,,80,87,165,167,315,332,9,8.75
dsc,dsc,,15,7,31,22,59,53,8,1
akka-cluster,akka-cluster,,11,11,25,22,61,47,2,1
cad,cad,,17,12,35,29,45,64,0,1
gradle-dependencies,gradle-dependencies,,10,2,21,12,37,33,3,1
django-modeladmin,django-modeladmin,,3,4,6,7,10,13,0,33.333333
tsc,tsc,,29,21,62,50,128,112,1,1
design-time,design-time,,6,2,8,8,15,16,8,1
speech-synthesis,speech-synthesis,,19,19,38,38,40,76,3,1
alexa-voice-service,alexa-voice-service,,24,19,36,43,111,79,6,1
ssml,ssml,,11,11,28,22,20,50,6,1
max-heap,max-heap,,2,4,11,6,12,17,0,100
channels,channels,,18,17,47,35,59,82,0,1
erd,erd,,29,18,48,47,82,95,4,1
substr,substr,,17,24,42,41,122,83,4,41.176471
telephonymanager,telephonymanager,,22,20,39,42,57,81,3,1
clover,clover,,5,3,8,8,22,16,3,1
software-quality,software-quality,,9,4,11,13,27,24,3,1
pdf-conversion,pdf-conversion,,6,7,11,13,21,24,8,16.666667
httplistener,httplistener,,9,4,26,13,42,39,8,1
snort,snort,,6,6,13,12,28,25,9,1
intrusion-detection,intrusion-detection,,7,3,5,10,10,15,9,1
gspread,gspread,,34,31,63,65,78,128,0,1
bitcore,bitcore,,2,1,10,3,15,13,6,1
mql4,mql4,,12,21,26,33,73,59,7,75
metatrader4,metatrader4,,8,14,16,22,46,38,7,75
forex,forex,,5,8,15,13,23,28,0,60
soft-keyboard,soft-keyboard,,6,10,8,16,25,24,3,66.666667
hadoopy,hadoopy,,0,0,1,0,1,1,0,1
adlds,adlds,,3,1,8,4,12,12,8,1
llc,llc,,3,1,3,4,6,7,9,1
cairo,cairo,,34,22,53,56,77,109,9,1
contain,contain,,0,0,0,0,26,0,0,1
jinternalframe,jinternalframe,,3,2,6,5,12,11,3,1
jdesktoppane,jdesktoppane,,0,1,0,1,4,1,3,1
box2d,box2d,,21,15,63,36,89,99,3,1
alphabet,alphabet,,7,5,13,12,19,25,0,1
orientation,orientation,,44,32,91,76,175,167,3,1
android-background,android-background,,11,8,29,19,38,48,3,1
url-shortener,url-shortener,,6,4,12,10,32,22,4,1
httpconnection,httpconnection,,5,11,9,16,28,25,3,120
ssl-client-authentication,ssl-client-authentication,,4,9,13,13,23,26,6,125
svd,svd,,26,21,33,47,65,80,0,1
react-hot-loader,react-hot-loader,,8,5,10,13,46,23,1,1
android-broadcastreceiver,android-broadcastreceiver,,16,0,108,16,209,124,3,1
itunes,itunes,,18,16,47,34,107,81,13,1
ole,ole,,21,12,34,33,73,67,5,1
template-literals,template-literals,,18,24,27,42,69,69,1,33.333333
mobile-browser,mobile-browser,,8,6,8,14,31,22,1,1
bootstrap-popover,bootstrap-popover,,12,6,25,18,52,43,1,1
android-studio-2.1,android-studio-2.1,,0,0,0,0,6,0,3,1
dma,dma,,25,25,44,50,50,94,9,1
pci-e,pci-e,,10,15,25,25,44,50,9,50
dpdk,dpdk,,14,12,26,26,43,52,9,1
websocket-sharp,websocket-sharp,,5,6,7,11,20,18,8,20
webapi2,webapi2,,3,3,22,6,24,28,8,1
openstack-neutron,openstack-neutron,,10,5,24,15,41,39,6,1
jint,jint,,6,6,2,12,9,14,8,1
branch-prediction,branch-prediction,,8,4,18,12,29,30,9,1
contentful,contentful,,35,38,44,73,90,117,1,8.571429
proximityapi,proximityapi,,0,0,2,0,2,2,3,1
pure-virtual,pure-virtual,,7,7,13,14,27,27,9,1
ruby-rice,ruby-rice,,0,0,0,0,1,0,9,1
stingray,stingray,,0,0,0,0,1,0,9,1
objective-grid,objective-grid,,0,0,0,0,1,0,9,1
react-360,react-360,,4,3,16,7,34,23,1,1
in-clause,in-clause,,2,3,7,5,20,12,4,50
git-rebase,git-rebase,,30,33,58,63,107,121,6,10
snappy,snappy,,13,11,17,24,52,41,2,1
ng-storage,ng-storage,,0,0,2,0,8,2,1,1
satellizer,satellizer,,0,0,1,0,5,1,1,1
mysqlconnection,mysqlconnection,,2,5,11,7,14,18,4,150
distributed-database,distributed-database,,12,9,12,21,31,33,4,1
boost-intrusive,boost-intrusive,,0,1,4,1,2,5,9,1
rational-rsa,rational-rsa,,0,0,2,0,9,2,3,1
named-parameters,named-parameters,,8,4,11,12,22,23,3,1
modulo,modulo,,21,22,57,43,113,100,0,4.761905
fresco,fresco,,9,9,25,18,55,43,3,1
progressive,progressive,,1,0,3,1,11,4,1,1
timepicker,timepicker,,32,24,64,56,124,120,1,1
service-broker,service-broker,,10,6,20,16,41,36,4,1
data-extraction,data-extraction,,25,26,49,51,96,100,0,4
tomcat8.5,tomcat8.5,,23,10,27,33,38,60,3,1
angular-file-upload,angular-file-upload,,4,3,7,7,24,14,1,1
crystal-reports-2008,crystal-reports-2008,,10,21,34,31,42,65,8,110
tornado-motor,tornado-motor,,3,2,3,5,5,8,1,1
mysqlnd,mysqlnd,,1,1,7,2,9,9,4,1
libmysql,libmysql,,0,2,8,2,9,10,4,100
ajaxhelper,ajaxhelper,,0,0,0,0,3,0,8,1
klipfolio,klipfolio,,4,2,2,6,11,8,4,1
html-imports,html-imports,,1,1,7,2,22,9,1,1
egit,egit,,8,17,39,25,84,64,6,112.5
github-desktop,github-desktop,,10,0,19,10,40,29,6,1
localtime,localtime,,8,7,19,15,46,34,3,1
android-view-invalidate,android-view-invalidate,,1,0,3,1,2,4,3,1
phpexcelreader,phpexcelreader,,2,3,8,5,11,13,4,50
open-with,open-with,,1,4,2,5,6,7,13,300
intercom,intercom,,9,5,17,14,23,31,1,1
intercom-ios,intercom-ios,,1,0,1,1,2,2,13,1
servant,servant,,5,7,8,12,29,20,2,40
stackage,stackage,,0,1,5,1,7,6,2,1
friend-function,friend-function,,5,5,14,10,28,24,9,1
taskbar,taskbar,,14,15,26,29,34,55,8,7.142857
app-route,app-route,,1,0,4,1,15,5,1,1
compiler-specific,compiler-specific,,1,2,3,3,5,6,9,100
solr4,solr4,,7,7,20,14,44,34,2,1
heapster,heapster,,3,1,7,4,25,11,6,1
mcisendstring,mcisendstring,,2,1,1,3,1,4,8,1
mq,mq,,23,12,17,35,34,52,3,1
data-distribution-service,data-distribution-service,,6,3,2,9,32,11,9,1
opendds,opendds,,5,0,6,5,11,11,9,1
mozilla,mozilla,,27,37,61,64,113,125,1,37.037037
qtwebkit,qtwebkit,,4,3,5,7,13,12,9,1
background-task,background-task,,13,14,40,27,55,67,8,7.692308
fortify,fortify,,18,34,49,52,78,101,3,88.888889
encoder,encoder,,16,20,25,36,64,61,0,25
tf-idf,tf-idf,,49,53,96,102,159,198,0,8.163265
nerddinner,nerddinner,,0,0,0,0,1,0,8,1
pre-trained-model,pre-trained-model,,33,22,47,55,62,102,0,1
facebook-pop,facebook-pop,,0,0,0,0,1,0,13,1
net-snmp,net-snmp,,11,15,33,26,51,59,9,36.363636
tensorflow-datasets,tensorflow-datasets,,154,122,247,276,376,523,0,1
react-google-maps,react-google-maps,,39,28,46,67,128,113,1,1
pageviews,pageviews,,9,4,13,13,15,26,5,1
collectionviewsource,collectionviewsource,,4,2,12,6,23,18,8,1
smoke-testing,smoke-testing,,2,1,3,3,6,6,3,1
expander,expander,,6,4,14,10,20,24,8,1
gio,gio,,6,2,6,8,20,14,9,1
gjs,gjs,,3,5,9,8,13,17,9,66.666667
telemetry,telemetry,,12,6,12,18,45,30,8,1
picasa,picasa,,2,0,3,2,15,5,5,1
tvml,tvml,,6,4,13,10,21,23,13,1
v-model,v-model,,31,13,31,44,38,75,1,1
personalization,personalization,,6,2,4,8,12,12,4,1
wdk,wdk,,8,8,24,16,49,40,9,1
poloniex,poloniex,,0,3,6,3,44,9,4,200
aws-storage-gateway,aws-storage-gateway,,2,2,4,4,8,8,6,1
skiasharp,skiasharp,,18,21,36,39,75,75,8,16.666667
block-storage,block-storage,,0,1,0,1,4,1,6,1
angular-providers,angular-providers,,9,5,11,14,32,25,1,1
jpa-2.1,jpa-2.1,,17,22,39,39,62,78,3,29.411765
fileopendialog,fileopendialog,,0,0,4,0,8,4,8,1
pykd,pykd,,3,0,7,3,6,10,9,1
recurring,recurring,,3,4,5,7,21,12,4,33.333333
flurry,flurry,,4,9,8,13,26,21,3,125
flurry-analytics,flurry-analytics,,3,5,6,8,9,14,3,66.666667
resourcemanager,resourcemanager,,4,6,17,10,24,27,2,50
autolink,autolink,,0,0,1,0,8,1,3,1
clickablespan,clickablespan,,0,1,5,1,8,6,3,1
private-constructor,private-constructor,,1,3,1,4,6,5,3,200
cglib,cglib,,7,6,14,13,34,27,3,1
360-panorama,360-panorama,,5,7,12,12,27,24,1,40
facebook-group,facebook-group,,2,1,8,3,12,11,13,1
internet-explorer-9,internet-explorer-9,,8,5,14,13,43,27,1,1
safearealayoutguide,safearealayoutguide,,10,6,40,16,136,56,13,1
curly-braces,curly-braces,,7,10,23,17,43,40,0,42.857143
x264,x264,,7,4,12,11,28,23,13,1
gstreamer-1.0,gstreamer-1.0,,26,25,45,51,41,96,13,1
spring-mongodb,spring-mongodb,,22,14,39,36,61,75,3,1
foreground-service,foreground-service,,47,45,88,92,74,180,3,1
highdpi,highdpi,,5,7,24,12,16,36,8,40
qicon,qicon,,2,2,8,4,7,12,9,1
roweditor,roweditor,,0,0,3,0,3,3,3,1
parallel-python,parallel-python,,1,2,1,3,3,4,0,100
symbolic-math,symbolic-math,,37,32,68,69,145,137,0,1
mtom,mtom,,3,3,18,6,28,24,3,1
cxf-codegen-plugin,cxf-codegen-plugin,,7,4,13,11,14,24,3,1
suitecommerce,suitecommerce,,5,4,4,9,17,13,14,1
mt4,mt4,,2,12,6,14,23,20,7,500
cell-array,cell-array,,8,15,24,23,87,47,0,87.5
polymorphic-associations,polymorphic-associations,,22,15,30,37,64,67,12,1
qlayout,qlayout,,5,3,14,8,26,22,9,1
swagger-editor,swagger-editor,,15,18,44,33,58,77,3,20
qualcomm,qualcomm,,8,2,15,10,29,25,3,1
amazon-dynamodb-streams,amazon-dynamodb-streams,,11,21,28,32,41,60,6,90.909091
clearinterval,clearinterval,,14,11,32,25,40,57,1,1
void-pointers,void-pointers,,20,8,43,28,101,71,9,1
roku,roku,,10,47,29,57,60,86,5,370
brightscript,brightscript,,8,46,26,54,51,80,5,475
arbitrary-precision,arbitrary-precision,,10,3,12,13,17,25,0,1
cpu-usage,cpu-usage,,61,57,116,118,199,234,9,1
composite-key,composite-key,,6,9,20,15,33,35,3,50
x11,x11,,64,56,96,120,203,216,9,1
survival,survival,,20,17,30,37,56,67,0,1
android-doze,android-doze,,9,5,27,14,37,41,3,1
android-doze-and-standby,android-doze-and-standby,,1,1,14,2,16,16,3,1
routerlinkactive,routerlinkactive,,4,2,7,6,17,13,1,1
mysql-5.7,mysql-5.7,,34,47,89,81,110,170,4,38.235294
mysql-error-1055,mysql-error-1055,,0,0,0,0,8,0,4,1
google-chrome-os,google-chrome-os,,14,12,36,26,57,62,3,1
mule-studio,mule-studio,,30,20,61,50,85,111,14,1
mule-component,mule-component,,21,16,48,37,97,85,14,1
mule-el,mule-el,,6,2,11,8,30,19,14,1
mule-esb,mule-esb,,39,26,75,65,154,140,14,1
masstransit,masstransit,,72,42,57,114,134,171,8,1
datainputstream,datainputstream,,10,3,4,13,23,17,3,1
inputstreamreader,inputstreamreader,,5,3,10,8,17,18,3,1
httpd.conf,httpd.conf,,47,46,136,93,213,229,4,1
vscode-code-runner,vscode-code-runner,,4,11,6,15,9,21,9,175
consumer,consumer,,17,28,39,45,63,84,3,64.705882
jobservice,jobservice,,20,13,26,33,46,59,3,1
git-untracked,git-untracked,,0,1,4,1,8,5,6,1
enter,enter,,8,11,31,19,45,50,1,37.5
onkeyup,onkeyup,,1,3,11,4,39,15,1,200
python-watchdog,python-watchdog,,7,13,17,20,16,37,0,85.714286
swiftr,swiftr,,0,0,1,0,1,1,8,1
object-lifetime,object-lifetime,,8,7,14,15,36,29,9,1
font-size,font-size,,44,38,71,82,151,153,1,1
go-templates,go-templates,,31,24,40,55,72,95,6,1
fiware-sth-comet,fiware-sth-comet,,1,1,1,2,7,3,6,1
darwin,darwin,,9,9,18,18,28,36,13,1
ios8,ios8,,1,1,5,2,24,7,13,1
vue-material,vue-material,,11,15,15,26,48,41,1,36.363636
relocation,relocation,,7,5,9,12,16,21,9,1
system.interactive,system.interactive,,1,0,1,1,2,2,8,1
bootstrap-typeahead,bootstrap-typeahead,,6,12,15,18,48,33,1,100
ngx-bootstrap,ngx-bootstrap,,58,55,106,113,279,219,1,1
parallels,parallels,,8,6,11,14,23,25,13,1
azure-queues,azure-queues,,5,14,26,19,36,45,8,180
stored-functions,stored-functions,,30,31,39,61,72,100,4,3.333333
aiohttp,aiohttp,,70,74,157,144,199,301,0,5.714286
draw2d-js,draw2d-js,,2,0,0,2,3,2,1,1
system.drawing,system.drawing,,8,18,47,26,66,73,8,125
componentone,componentone,,1,1,3,2,9,5,8,1
vapid,vapid,,4,3,4,7,6,11,13,1
datepickerdialog,datepickerdialog,,4,6,19,10,30,29,3,50
rotational-matrices,rotational-matrices,,7,3,20,10,20,30,0,1
google-earth-engine,google-earth-engine,,25,37,36,62,60,98,0,48
key-value-observing,key-value-observing,,8,12,28,20,69,48,13,50
sigkill,sigkill,,2,4,6,6,10,12,9,100
typed-arrays,typed-arrays,,4,7,22,11,26,33,1,75
uint8array,uint8array,,3,5,14,8,20,22,1,66.666667
system-verilog-dpi,system-verilog-dpi,,2,3,2,5,10,7,9,50
cgal,cgal,,38,21,81,59,101,140,9,1
sql-server-2016-express,sql-server-2016-express,,1,2,2,3,27,5,4,100
kendo-ui-grid,kendo-ui-grid,,4,9,20,13,39,33,1,125
android-wear-2.0,android-wear-2.0,,8,9,30,17,53,47,3,12.5
uipopovercontroller,uipopovercontroller,,3,4,11,7,29,18,13,33.333333
freertos,freertos,,42,21,54,63,105,117,9,1
lwip,lwip,,24,10,19,34,20,53,9,1
floyd-warshall,floyd-warshall,,6,2,8,8,11,16,0,1
next,next,,33,38,49,71,89,120,1,15.151515
rx-cocoa,rx-cocoa,,12,10,20,22,68,42,13,1
drag,drag,,38,37,74,75,113,149,1,1
android-homebutton,android-homebutton,,1,3,6,4,19,10,3,200
summarization,summarization,,13,8,15,21,43,36,0,1
whmcs,whmcs,,15,7,20,22,60,42,4,1
jenkins-cli,jenkins-cli,,24,20,58,44,75,102,6,1
response-headers,response-headers,,15,8,21,23,52,44,4,1
jqxhr,jqxhr,,3,2,4,5,15,9,1,1
cross-thread,cross-thread,,1,0,1,1,11,2,8,1
apscheduler,apscheduler,,27,21,49,48,72,97,0,1
gamma,gamma,,8,8,7,16,11,23,0,1
cpython,cpython,,33,38,77,71,131,148,0,15.151515
session-state-provider,session-state-provider,,1,1,4,2,2,6,8,1
qgraphicsscene,qgraphicsscene,,27,27,46,54,73,100,9,1
autosys,autosys,,5,4,15,9,35,24,9,1
jil,jil,,2,1,8,3,9,11,8,1
cartesian-product,cartesian-product,,26,12,31,38,79,69,0,1
coldbox,coldbox,,1,2,2,3,15,5,4,100
git-tower,git-tower,,0,2,1,2,5,3,6,100
core-location,core-location,,46,44,90,90,209,180,13,1
population,population,,3,5,14,8,21,22,0,66.666667
vaadin-push,vaadin-push,,0,0,0,0,2,0,3,1
broom,broom,,9,15,22,24,52,46,0,66.666667
kotlin-extension,kotlin-extension,,20,13,48,33,95,81,3,1
lotus-domino,lotus-domino,,58,44,70,102,143,172,5,1
visualforce,visualforce,,31,22,45,53,87,98,14,1
visual-format-language,visual-format-language,,1,0,3,1,12,4,13,1
scaletransform,scaletransform,,3,8,8,11,17,19,8,166.666667
erase-remove-idiom,erase-remove-idiom,,2,2,4,4,6,8,9,1
ipa,ipa,,27,16,59,43,120,102,13,1
runner,runner,,4,6,8,10,16,18,6,50
mypy,mypy,,44,57,93,101,128,194,0,29.545455
typeshed,typeshed,,1,0,0,1,4,1,0,1
qt-quick,qt-quick,,10,11,23,21,69,44,9,10
setupapi,setupapi,,4,2,8,6,14,14,9,1
visual-sourcesafe,visual-sourcesafe,,3,2,6,5,15,11,8,1
desktop-background,desktop-background,,0,1,1,1,1,2,0,1
android-photoview,android-photoview,,4,1,9,5,16,14,3,1
nstabview,nstabview,,3,1,2,4,12,6,13,1
facelets,facelets,,5,5,11,10,19,21,3,1
rabbitmq-exchange,rabbitmq-exchange,,11,9,20,20,39,40,3,1
ros,ros,,121,141,222,262,284,484,9,16.528926
structured-bindings,structured-bindings,,5,4,7,9,36,16,9,1
vhd,vhd,,4,1,14,5,15,19,8,1
nodelist,nodelist,,6,10,24,16,33,40,1,66.666667
rack-test,rack-test,,0,0,0,0,5,0,12,1
jointable,jointable,,23,13,46,36,85,82,4,1
import-from-excel,import-from-excel,,17,16,19,33,52,52,5,1
rails-routing,rails-routing,,3,8,6,11,27,17,12,166.666667
metatrader5,metatrader5,,5,3,18,8,51,26,7,1
dcl,dcl,,0,1,0,1,5,1,9,1
generic-method,generic-method,,3,1,11,4,11,15,3,1
ico,ico,,4,4,8,8,25,16,6,1
nfc-p2p,nfc-p2p,,0,1,9,1,9,10,3,1
mssql-jdbc,mssql-jdbc,,23,13,44,36,70,80,3,1
aws-access-policy,aws-access-policy,,3,2,4,5,5,9,6,1
cakephp-2.6,cakephp-2.6,,2,0,1,2,4,3,4,1
quota,quota,,25,15,29,40,37,69,5,1
short-url,short-url,,0,2,3,2,6,5,4,100
aforge,aforge,,20,11,25,31,62,56,8,1
mopub,mopub,,5,4,22,9,18,31,3,1
microsoft-flow,microsoft-flow,,27,44,54,71,55,125,8,62.962963
asp.net-webhooks,asp.net-webhooks,,4,4,8,8,13,16,8,1
spring-framework-beans,spring-framework-beans,,16,11,24,27,32,51,3,1
hl7,hl7,,10,9,19,19,59,38,14,1
cda,cda,,1,1,4,2,8,6,14,1
android-mapview,android-mapview,,16,19,40,35,89,75,3,18.75
alt-tab,alt-tab,,2,0,2,2,2,4,8,1
qlikview,qlikview,,20,39,41,59,81,100,5,95
set-analysis,set-analysis,,1,8,1,9,5,10,5,700
mousepress,mousepress,,0,3,1,3,3,4,1,200
soapformatter,soapformatter,,0,0,0,0,2,0,8,1
dc.js,dc.js,,35,28,71,63,191,134,1,1
crossfilter,crossfilter,,30,17,37,47,143,84,1,1
sencha-touch,sencha-touch,,6,2,28,8,43,36,1,1
lumen-5.2,lumen-5.2,,0,1,2,1,4,3,4,1
scrollmagic,scrollmagic,,26,20,45,46,57,91,1,1
stride,stride,,0,6,10,6,24,16,0,500
yii-components,yii-components,,2,3,2,5,18,7,4,50
listeners,listeners,,0,0,0,0,26,0,3,1
videogular,videogular,,4,4,19,8,27,27,1,1
osx-elcapitan,osx-elcapitan,,4,5,7,9,44,16,13,25
jide,jide,,1,3,3,4,3,7,3,200
silent-notification,silent-notification,,0,3,4,3,18,7,13,200
eclipse-memory-analyzer,eclipse-memory-analyzer,,3,1,5,4,11,9,3,1
cpuid,cpuid,,1,1,8,2,14,10,9,1
named-entity-extraction,named-entity-extraction,,4,4,8,8,7,16,0,1
lexikjwtauthbundle,lexikjwtauthbundle,,10,10,25,20,44,45,4,1
node-gyp,node-gyp,,33,34,77,67,84,144,1,3.030303
xvfb,xvfb,,15,9,22,24,33,46,3,1
qabstractitemmodel,qabstractitemmodel,,9,5,17,14,32,31,9,1
distributed-cache,distributed-cache,,3,3,2,6,9,8,3,1
contao,contao,,3,2,2,5,28,7,4,1
contentcontrol,contentcontrol,,7,7,10,14,19,24,8,1
cobol.net,cobol.net,,0,0,1,0,1,1,8,1
gesture,gesture,,50,36,75,86,115,161,13,1
resource-adapter,resource-adapter,,2,2,2,4,4,6,3,1
chained,chained,,0,1,4,1,7,5,1,1
sapui5-opa,sapui5-opa,,0,0,1,0,4,1,1,1
android-input-method,android-input-method,,8,7,15,15,24,30,3,1
nss,nss,,3,3,8,6,20,14,6,1
lalr,lalr,,3,2,2,5,10,7,0,1
azure-vm-templates,azure-vm-templates,,1,3,6,4,11,10,8,200
sub-array,sub-array,,16,15,24,31,43,55,1,1
servicebus,servicebus,,27,11,35,38,93,73,8,1
gdk,gdk,,7,7,9,14,18,23,9,1
gdkpixbuf,gdkpixbuf,,2,4,2,6,7,8,9,100
nswindowcontroller,nswindowcontroller,,6,4,16,10,23,26,13,1
monkey,monkey,,1,1,5,2,11,7,3,1
member-function-pointers,member-function-pointers,,20,10,22,30,50,52,9,1
android-fragmentactivity,android-fragmentactivity,,38,22,71,60,143,131,3,1
aws-sdk-js,aws-sdk-js,,22,32,42,54,77,96,6,45.454545
vlc,vlc,,58,50,131,108,163,239,13,1
event-log,event-log,,23,14,52,37,70,89,8,1
openshift-origin,openshift-origin,,36,27,74,63,150,137,6,1
dynamicobject,dynamicobject,,2,1,3,3,17,6,8,1
gm,gm,,2,3,10,5,28,15,1,50
android-wallpaper,android-wallpaper,,5,3,11,8,21,19,3,1
postgresql-extensions,postgresql-extensions,,2,0,2,2,4,4,4,1
boxing,boxing,,9,8,14,17,41,31,3,1
opencv4android,opencv4android,,41,20,51,61,73,112,3,1
er-diagrams,er-diagrams,,6,2,10,8,12,18,4,1
multi-tenant,multi-tenant,,93,77,164,170,226,334,3,1
grails-3.3.0,grails-3.3.0,,0,1,0,1,2,1,3,1
drc,drc,,5,2,3,7,9,10,0,1
listobject,listobject,,11,15,27,26,30,53,5,36.363636
docushare,docushare,,1,0,1,1,1,2,3,1
browser-automation,browser-automation,,28,22,62,50,110,112,3,1
controllers,controllers,,0,0,0,0,63,0,4,1
jdoodle,jdoodle,,2,0,1,2,4,3,9,1
bcrypt,bcrypt,,60,55,153,115,207,268,1,1
nsfilemanager,nsfilemanager,,18,15,41,33,95,74,13,1
arscnview,arscnview,,7,6,17,13,26,30,13,1
back-stack,back-stack,,7,9,21,16,51,37,3,28.571429
rvalue-reference,rvalue-reference,,21,25,31,46,76,77,9,19.047619
partials,partials,,8,9,18,17,31,35,12,12.5
php-5.3,php-5.3,,6,4,27,10,47,37,4,1
topological-sort,topological-sort,,8,3,14,11,17,25,0,1
file-sharing,file-sharing,,10,7,13,17,34,30,3,1
transfer-encoding,transfer-encoding,,1,3,6,4,17,10,4,200
quoted-printable,quoted-printable,,2,2,4,4,6,8,4,1
geany,geany,,6,5,11,11,29,22,0,1
phabricator,phabricator,,5,5,14,10,30,24,6,1
arcanist,arcanist,,2,3,7,5,9,12,6,50
multinomial,multinomial,,13,19,29,32,42,61,0,46.153846
quicklook,quicklook,,7,8,20,15,21,35,13,14.285714
django-i18n,django-i18n,,6,4,13,10,23,23,0,1
apxs2,apxs2,,0,0,1,0,1,1,4,1
fabric-digits,fabric-digits,,0,0,0,0,2,0,3,1
nrpe,nrpe,,2,3,5,5,15,10,6,50
image-rotation,image-rotation,,20,16,26,36,53,62,0,1
m2eclipse,m2eclipse,,13,12,8,25,49,33,3,1
m2e,m2e,,6,0,14,6,41,20,3,1
side-effects,side-effects,,6,14,20,20,37,40,9,133.333333
splat,splat,,2,6,3,8,11,11,12,200
codelens,codelens,,2,1,4,3,14,7,8,1
angular-bootstrap-calendar,angular-bootstrap-calendar,,0,1,5,1,6,6,1,1
repeatingalarm,repeatingalarm,,3,1,6,4,18,10,3,1
realm-migration,realm-migration,,6,5,12,11,39,23,13,1
redux-observable,redux-observable,,44,29,72,73,204,145,1,1
laravel-dusk,laravel-dusk,,45,29,60,74,128,134,4,1
osmand,osmand,,1,0,1,1,4,2,3,1
strongname,strongname,,4,4,10,8,8,18,8,1
state-space,state-space,,14,5,8,19,12,27,0,1
iis-6,iis-6,,17,6,16,23,33,39,8,1
ajax.beginform,ajax.beginform,,6,0,9,6,15,15,8,1
pycrypto,pycrypto,,18,25,51,43,64,94,0,38.888889
coldfusion-11,coldfusion-11,,22,10,24,32,47,56,4,1
jboss6.x,jboss6.x,,15,21,46,36,59,82,3,40
high-load,high-load,,1,0,4,1,7,5,3,1
compass-geolocation,compass-geolocation,,5,5,3,10,12,13,3,1
azure-configuration,azure-configuration,,4,2,5,6,4,11,8,1
azure-log-analytics,azure-log-analytics,,45,45,70,90,78,160,8,1
addchild,addchild,,1,4,3,5,10,8,13,300
sendasync,sendasync,,2,2,3,4,8,7,8,1
strict-aliasing,strict-aliasing,,10,13,22,23,62,45,9,30
nlme,nlme,,18,13,37,31,35,68,0,1
wso2-am,wso2-am,,88,58,161,146,274,307,14,1
onsen-ui,onsen-ui,,13,9,27,22,48,49,1,1
monaca,monaca,,0,0,6,0,14,6,1,1
spring-repositories,spring-repositories,,19,20,29,39,45,68,3,5.263158
logical-or,logical-or,,2,1,3,3,8,6,0,1
compatibility-mode,compatibility-mode,,2,0,0,2,1,2,3,1
qqmlcomponent,qqmlcomponent,,4,2,11,6,21,17,9,1
qqmlapplicationengine,qqmlapplicationengine,,0,3,0,3,14,3,9,200
glmnet,glmnet,,13,18,38,31,94,69,0,38.461538
zone.js,zone.js,,4,10,14,14,44,28,1,150
to-date,to-date,,7,5,16,12,29,28,4,1
airflow-scheduler,airflow-scheduler,,72,68,99,140,177,239,0,1
cabal,cabal,,21,11,53,32,101,85,2,1
akamai,akamai,,7,3,12,10,20,22,4,1
ng-options,ng-options,,13,7,13,20,68,33,1,1
sql-server-2000,sql-server-2000,,5,5,10,10,32,20,4,1
trace,trace,,56,45,120,101,149,221,9,1
oracle-apex-5.1,oracle-apex-5.1,,44,27,96,71,211,167,4,1
dylib,dylib,,14,15,36,29,46,65,13,7.142857
retrywhen,retrywhen,,5,2,9,7,12,16,1,1
nsfetchedresultscontroller,nsfetchedresultscontroller,,22,12,32,34,85,66,13,1
sections,sections,,12,17,31,29,65,60,13,41.666667
sqldatasource,sqldatasource,,7,7,16,14,26,30,8,1
jdbc-pool,jdbc-pool,,2,0,1,2,8,3,3,1
nib,nib,,10,7,16,17,35,33,13,1
lucidworks,lucidworks,,3,0,8,3,5,11,2,1
bytearrayoutputstream,bytearrayoutputstream,,6,5,9,11,17,20,3,1
grequests,grequests,,6,3,9,9,13,18,0,1
mod-headers,mod-headers,,2,1,3,3,9,6,4,1
weblate,weblate,,1,0,5,1,6,6,6,1
box-shadow,box-shadow,,19,15,28,34,74,62,1,1
drop-shadow,drop-shadow,,0,0,0,0,4,0,1,1
partition,partition,,53,54,97,107,171,204,4,1.886792
desktop-bridge,desktop-bridge,,28,22,57,50,113,107,8,1
recursive-datastructures,recursive-datastructures,,8,11,17,19,47,36,0,37.5
android-textureview,android-textureview,,3,4,6,7,6,13,3,33.333333
radium,radium,,3,2,4,5,10,9,1,1
facet-wrap,facet-wrap,,25,24,40,49,92,89,0,1
inputbox,inputbox,,6,6,14,12,42,26,5,1
tastypie,tastypie,,5,7,9,12,22,21,0,40
nstoolbar,nstoolbar,,4,1,10,5,11,15,13,1
nstoolbaritem,nstoolbaritem,,1,2,4,3,3,7,13,100
getcwd,getcwd,,2,3,1,5,6,6,0,50
sitefinity-10,sitefinity-10,,2,0,6,2,31,8,8,1
angular-library,angular-library,,30,45,71,75,37,146,1,50
alex,alex,,1,1,2,2,7,4,2,1
isomorphic-fetch-api,isomorphic-fetch-api,,5,0,5,5,12,10,1,1
goroutine,goroutine,,52,40,93,92,218,185,6,1
metamask,metamask,,14,20,31,34,50,65,6,42.857143
popupwindow,popupwindow,,23,20,52,43,114,95,1,1
shallow-clone,shallow-clone,,1,0,6,1,7,7,6,1
lua-table,lua-table,,17,21,41,38,100,79,9,23.529412
uiappearance,uiappearance,,4,7,14,11,19,25,13,75
uibackgroundcolor,uibackgroundcolor,,2,1,4,3,11,7,13,1
grayscale,grayscale,,24,10,26,34,61,60,0,1
argb,argb,,1,4,2,5,11,7,3,300
hbitmap,hbitmap,,0,4,2,4,7,6,9,300
getjson,getjson,,15,18,29,33,99,62,1,20
clipboardmanager,clipboardmanager,,2,1,2,3,11,5,3,1
device-driver,device-driver,,9,15,28,24,41,52,9,66.666667
cdc,cdc,,13,9,39,22,51,61,4,1
inf,inf,,6,4,6,10,9,16,9,1
device-manager,device-manager,,1,3,7,4,8,11,9,200
libusbdotnet,libusbdotnet,,0,2,4,2,8,6,3,100
hive-serde,hive-serde,,10,3,22,13,34,35,2,1
stackedbarseries,stackedbarseries,,5,2,10,7,12,17,0,1
rooted-device,rooted-device,,1,1,5,2,13,7,3,1
ad-hoc-distribution,ad-hoc-distribution,,6,7,9,13,25,22,13,16.666667
jquery-events,jquery-events,,14,27,23,41,54,64,1,92.857143
android-bundle,android-bundle,,5,8,20,13,31,33,3,60
calllog,calllog,,5,6,12,11,20,23,3,20
datamapper,datamapper,,6,5,10,11,19,21,4,1
regex-recursion,regex-recursion,,1,1,3,2,6,5,0,1
targeting,targeting,,0,4,5,4,19,9,1,300
butterknife,butterknife,,16,8,34,24,84,58,3,1
bodymovin,bodymovin,,6,9,12,15,21,27,1,50
sjplot,sjplot,,10,13,8,23,18,31,0,30
configure,configure,,31,31,60,62,98,122,9,1
cleardb,cleardb,,5,6,17,11,33,28,1,20
poppler,poppler,,13,11,27,24,18,51,0,1
dense-rank,dense-rank,,14,6,18,20,35,38,4,1
openoffice-basic,openoffice-basic,,0,4,0,4,8,4,5,300
google-cloud-spanner,google-cloud-spanner,,12,16,47,28,94,75,6,33.333333
firebase-test-lab,firebase-test-lab,,20,16,32,36,56,68,3,1
codevisionavr,codevisionavr,,4,0,2,4,3,6,9,1
photokit,photokit,,12,5,13,17,17,30,13,1
flume,flume,,19,18,45,37,97,82,2,1
flume-ng,flume-ng,,6,8,27,14,50,41,2,33.333333
gatling,gatling,,77,59,70,136,167,206,2,1
scala-gatling,scala-gatling,,32,26,25,58,65,83,2,1
nonce,nonce,,12,7,28,19,33,47,4,1
weasyprint,weasyprint,,12,10,18,22,31,40,0,1
zipalign,zipalign,,2,4,3,6,11,9,3,100
members,members,,0,0,0,0,15,0,9,1
jquery-ui-selectable,jquery-ui-selectable,,3,3,9,6,15,15,1,1
bootstrap-accordion,bootstrap-accordion,,13,8,22,21,44,43,1,1
cpan,cpan,,6,20,28,26,62,54,9,233.333333
java-module,java-module,,31,33,87,64,177,151,3,6.451613
module-path,module-path,,1,1,4,2,11,6,3,1
lucene.net,lucene.net,,15,11,19,26,43,45,2,1
cl,cl,,8,9,20,17,38,37,9,12.5
coff,coff,,0,2,5,2,8,7,9,100
omf,omf,,0,0,1,0,2,1,9,1
applinks,applinks,,10,8,24,18,51,42,3,1
xpinc,xpinc,,0,0,0,0,5,0,5,1
cakephp-2.1,cakephp-2.1,,1,2,1,3,3,4,4,100
css-specificity,css-specificity,,5,5,10,10,23,20,1,1
armv6,armv6,,1,2,5,3,4,8,9,100
ng-modules,ng-modules,,15,4,28,19,32,47,1,1
distributed-lock,distributed-lock,,0,0,2,0,2,2,3,1
on-prem,on-prem,,6,7,13,13,20,26,8,16.666667
dynamic-text,dynamic-text,,2,3,1,5,8,6,13,50
msvcrt,msvcrt,,10,9,13,19,24,32,9,1
graphics32,graphics32,,1,1,4,2,5,6,9,1
accessor,accessor,,8,8,25,16,39,41,4,1
ng-dialog,ng-dialog,,1,0,3,1,6,4,1,1
appsource,appsource,,3,3,6,6,19,12,8,1
array-push,array-push,,16,6,17,22,30,39,4,1
django-filter,django-filter,,54,55,71,109,114,180,0,1.851852
d,d,,17,12,60,29,78,89,9,1
google-earth,google-earth,,15,4,16,19,32,35,1,1
snapkit,snapkit,,14,7,29,21,45,50,13,1
bit-fields,bit-fields,,24,19,24,43,62,67,9,1
method-invocation,method-invocation,,3,2,4,5,8,9,3,1
dcom,dcom,,0,1,12,1,14,13,8,1
toad,toad,,21,34,46,55,79,101,4,61.904762
pushstate,pushstate,,6,5,15,11,24,26,1,1
multiset,multiset,,11,5,7,16,26,23,9,1
tizen,tizen,,45,32,63,77,142,140,13,1
auto-renewing,auto-renewing,,6,4,11,10,16,21,13,1
unknown-host,unknown-host,,2,1,8,3,13,11,3,1
entity-attribute-value,entity-attribute-value,,11,11,45,22,42,67,4,1
icheck,icheck,,3,1,7,4,22,11,1,1
spacing,spacing,,16,16,31,32,61,63,1,1
dynamics-crm-365,dynamics-crm-365,,28,17,59,45,142,104,8,1
kubernetes-helm,kubernetes-helm,,217,229,390,446,338,836,6,5.529954
post-format,post-format,,0,0,3,0,4,3,4,1
angular-e2e,angular-e2e,,14,14,44,28,31,72,3,1
angular-test,angular-test,,42,33,84,75,103,159,1,1
tdm-mingw,tdm-mingw,,3,1,0,4,2,4,9,1
windowing,windowing,,9,12,17,21,16,38,0,33.333333
dendextend,dendextend,,4,2,11,6,23,17,0,1
hidden-field,hidden-field,,13,10,18,23,41,41,1,1
servicehost,servicehost,,1,1,1,2,5,3,8,1
glyph-substitution,glyph-substitution,,0,0,0,0,2,0,3,1
multimethod,multimethod,,0,1,1,1,2,2,2,1
doctrine-odm,doctrine-odm,,14,12,19,26,37,45,4,1
document-versioning,document-versioning,,0,1,2,1,1,3,8,1
tryparse,tryparse,,5,4,13,9,18,22,8,1
binning,binning,,24,21,36,45,66,81,0,1
dom-traversal,dom-traversal,,4,3,3,7,10,10,1,1
meteor-up,meteor-up,,0,0,4,0,18,4,1,1
bullet,bullet,,7,9,20,16,30,36,0,28.571429
bytebuffer,bytebuffer,,7,17,32,24,62,56,3,142.857143
device-orientation,device-orientation,,13,8,21,21,27,42,13,1
iphone-6-plus,iphone-6-plus,,0,0,0,0,3,0,13,1
uint16,uint16,,2,1,8,3,17,11,0,1
ushort,ushort,,0,0,3,0,4,3,8,1
pushviewcontroller,pushviewcontroller,,6,5,5,11,30,16,13,1
navigationcontroller,navigationcontroller,,6,10,10,16,38,26,13,66.666667
easy-install,easy-install,,5,3,10,8,36,18,0,1
rxalamofire,rxalamofire,,9,2,3,11,10,14,13,1
pyarango,pyarango,,1,1,1,2,5,3,2,1
android-alarms,android-alarms,,19,15,27,34,82,61,3,1
apache-kudu,apache-kudu,,12,3,18,15,33,33,2,1
jql,jql,,14,12,19,26,40,45,6,1
lapack,lapack,,16,7,29,23,75,52,9,1
gganimate,gganimate,,43,32,78,75,26,153,0,1
ggrepel,ggrepel,,17,4,20,21,33,41,0,1
underline,underline,,4,8,15,12,43,27,1,100
flash-message,flash-message,,8,5,14,13,45,27,4,1
decoding,decoding,,49,39,67,88,136,155,0,1
nse,nse,,8,7,15,15,70,30,0,1
r-s3,r-s3,,2,1,5,3,17,8,0,1
getopt,getopt,,8,8,23,16,64,39,9,1
connection-pool,connection-pool,,5,11,8,16,25,24,3,120
elasticsearch-rails,elasticsearch-rails,,3,2,4,5,16,9,6,1
jwilder-nginx-proxy,jwilder-nginx-proxy,,11,7,23,18,38,41,6,1
autofilter,autofilter,,14,24,41,38,89,79,5,71.428571
simplecursoradapter,simplecursoradapter,,4,3,10,7,25,17,3,1
django-media,django-media,,5,6,7,11,12,18,0,20
bitmapimage,bitmapimage,,8,12,27,20,42,47,3,50
cssnext,cssnext,,1,1,3,2,9,5,1,1
vnc,vnc,,13,16,33,29,42,62,9,23.076923
tegra,tegra,,0,0,2,0,7,2,13,1
rfb-protocol,rfb-protocol,,0,0,1,0,5,1,9,1
cells,cells,,0,0,0,0,90,0,5,1
rtmp,rtmp,,37,42,77,79,107,156,13,13.513514
sunburst-diagram,sunburst-diagram,,15,7,14,22,28,36,1,1
uiwebviewdelegate,uiwebviewdelegate,,4,0,4,4,15,8,13,1
pygithub,pygithub,,13,8,12,21,18,33,6,1
oracle-enterprise-linux,oracle-enterprise-linux,,0,0,0,0,3,0,9,1
text-manipulation,text-manipulation,,8,8,6,16,24,22,9,1
nsurlcache,nsurlcache,,1,3,8,4,11,12,13,200
time.h,time.h,,6,6,15,12,20,27,9,1
windows-subsystem-for-linux,windows-subsystem-for-linux,,134,163,246,297,316,543,9,21.641791
cordova-3,cordova-3,,0,5,7,5,13,12,1,400
karma-webpack,karma-webpack,,10,4,19,14,51,33,1,1
unions,unions,,24,14,64,38,138,102,9,1
alexa-slot,alexa-slot,,10,13,42,23,79,65,6,30
sleep,sleep,,58,53,92,111,189,203,0,1
google-app-engine-launch,google-app-engine-launch,,0,0,0,0,4,0,6,1
taglib,taglib,,9,7,15,16,40,31,3,1
countif,countif,,50,66,100,116,178,216,5,32
xml-serialization,xml-serialization,,30,27,70,57,121,127,8,1
azure-sdk-.net,azure-sdk-.net,,6,12,24,18,34,42,8,100
database-backups,database-backups,,31,31,70,62,145,132,4,1
alwayson,alwayson,,11,7,14,18,29,32,4,1
sni,sni,,7,9,20,16,38,36,6,28.571429
domaincontroller,domaincontroller,,10,4,16,14,30,30,8,1
wss,wss,,11,6,12,17,27,29,1,1
svg-filters,svg-filters,,11,21,31,32,64,63,1,90.909091
acrobat,acrobat,,35,37,72,72,139,144,8,5.714286
micropython,micropython,,27,25,47,52,67,99,0,1
mongoid,mongoid,,32,31,58,63,147,121,12,1
game-loop,game-loop,,6,8,16,14,41,30,3,33.333333
window.open,window.open,,17,19,41,36,74,77,1,11.764706
manage.py,manage.py,,6,3,8,9,20,17,0,1
makemigrations,makemigrations,,1,5,5,6,13,11,0,400
biginteger,biginteger,,35,33,72,68,130,140,3,1
ng-admin,ng-admin,,0,0,1,0,9,1,1,1
bad-request,bad-request,,16,14,37,30,53,67,4,1
tinyxml,tinyxml,,0,0,4,0,5,4,9,1
conways-game-of-life,conways-game-of-life,,16,9,20,25,44,45,0,1
dam,dam,,1,2,5,3,10,8,3,100
ms-access-2013,ms-access-2013,,26,18,72,44,201,116,5,1
jszip,jszip,,11,18,25,29,44,54,1,63.636364
actionscript-2,actionscript-2,,2,4,6,6,16,12,13,100
aws-powershell,aws-powershell,,10,0,6,10,16,16,6,1
typesafe-activator,typesafe-activator,,1,0,4,1,7,5,2,1
aspdotnetstorefront,aspdotnetstorefront,,0,0,0,0,1,0,3,1
ssh2-exec,ssh2-exec,,2,1,4,3,10,7,4,1
kendo-chart,kendo-chart,,8,9,18,17,35,35,1,12.5
pyvisa,pyvisa,,6,10,15,16,17,31,0,66.666667
instantiation,instantiation,,48,35,74,83,148,157,9,1
azure-devops-rest-api,azure-devops-rest-api,,61,86,123,147,168,270,8,40.983607
slam,slam,,6,9,12,15,26,27,0,50
docker-exec,docker-exec,,3,1,5,4,9,9,6,1
syslog-ng,syslog-ng,,6,9,17,15,24,32,9,50
jquery-hover,jquery-hover,,2,5,11,7,16,18,1,150
libpqxx,libpqxx,,7,8,13,15,20,28,9,14.285714
android-textinputedittext,android-textinputedittext,,19,18,30,37,48,67,3,1
thrust,thrust,,15,14,36,29,48,65,0,1
tail,tail,,17,20,45,37,71,82,9,17.647059
stopwatch,stopwatch,,7,10,34,17,52,51,8,42.857143
deep-residual-networks,deep-residual-networks,,4,1,7,5,11,12,0,1
modelsim,modelsim,,20,18,36,38,61,74,9,1
rjava,rjava,,16,12,25,28,94,53,0,1
android-priority-jobqueue,android-priority-jobqueue,,0,0,1,0,3,1,3,1
shopify-app,shopify-app,,53,46,110,99,172,209,1,1
aliexpress,aliexpress,,1,1,1,2,9,3,4,1
query-by-example,query-by-example,,4,2,6,6,12,12,3,1
fileutils,fileutils,,3,3,14,6,19,20,3,1
folium,folium,,61,48,96,109,97,205,0,1
android-broadcast,android-broadcast,,22,13,48,35,64,83,3,1
jfreechart,jfreechart,,36,30,65,66,98,131,3,1
timeserieschart,timeserieschart,,12,15,27,27,50,54,0,25
apiblueprint,apiblueprint,,2,2,14,4,21,18,4,1
apiary.io,apiary.io,,0,3,11,3,12,14,4,200
apiary,apiary,,1,4,9,5,14,14,4,300
carplay,carplay,,7,5,14,12,9,26,13,1
google-assistant-sdk,google-assistant-sdk,,84,48,133,132,259,265,13,1
webpack-handlebars-loader,webpack-handlebars-loader,,1,0,1,1,6,2,1,1
lens,lens,,8,9,25,17,56,42,2,12.5
protocol-oriented,protocol-oriented,,0,2,2,2,8,4,13,100
xmlserializer,xmlserializer,,24,16,64,40,110,104,8,1
adafruit,adafruit,,22,22,45,44,66,89,9,1
firebase-cloud-functions,firebase-cloud-functions,,0,0,0,0,5,0,13,1
htmlcontrols,htmlcontrols,,0,0,1,0,5,1,8,1
data-loss,data-loss,,6,1,14,7,11,21,6,1
npoi,npoi,,21,12,41,33,45,74,8,1
homography,homography,,16,18,28,34,51,62,0,12.5
chunked,chunked,,3,8,19,11,24,30,4,166.666667
geom-text,geom-text,,15,21,26,36,60,62,0,40
recursiveiterator,recursiveiterator,,1,1,1,2,3,3,4,1
semaphore-ci,semaphore-ci,,3,1,3,4,4,7,6,1
github-for-windows,github-for-windows,,9,5,18,14,38,32,6,1
grace-ioc,grace-ioc,,0,1,0,1,2,1,8,1
manpage,manpage,,4,8,14,12,27,26,9,100
dynamic-pivot,dynamic-pivot,,4,2,4,6,13,10,4,1
pywikibot,pywikibot,,3,2,6,5,10,11,0,1
compass-sass,compass-sass,,5,5,6,10,23,16,1,1
android-window,android-window,,3,1,4,4,9,8,3,1
gmp,gmp,,20,24,28,44,64,72,9,20
mediabrowserservice,mediabrowserservice,,3,1,4,4,9,8,3,1
mediabrowserservicecompat,mediabrowserservicecompat,,3,2,6,5,15,11,3,1
mediabrowser,mediabrowser,,3,1,2,4,5,6,3,1
regexp-replace,regexp-replace,,14,21,41,35,53,76,4,50
cagradientlayer,cagradientlayer,,14,6,30,20,57,50,13,1
windows-8.1,windows-8.1,,9,4,17,13,60,30,8,1
windows-explorer,windows-explorer,,7,3,14,10,27,24,9,1
taskkill,taskkill,,7,2,13,9,27,22,9,1
avplayerviewcontroller,avplayerviewcontroller,,13,4,38,17,73,55,13,1
jlist,jlist,,14,11,37,25,69,62,3,1
cran,cran,,25,20,40,45,62,85,0,1
gpsd,gpsd,,2,3,11,5,14,16,3,50
google-guava-cache,google-guava-cache,,0,0,2,0,27,2,3,1
simavr,simavr,,0,0,0,0,1,0,9,1
datadog,datadog,,28,14,35,42,60,77,6,1
jfilechooser,jfilechooser,,9,11,29,20,59,49,3,22.222222
knife,knife,,3,6,13,9,39,22,12,100
gemspecs,gemspecs,,2,0,2,2,6,4,12,1
tsvector,tsvector,,5,1,6,6,7,12,4,1
pg-trgm,pg-trgm,,1,3,8,4,12,12,4,200
get-wmiobject,get-wmiobject,,8,10,11,18,33,29,8,25
remoteview,remoteview,,9,6,11,15,27,26,3,1
collider,collider,,10,8,24,18,34,42,8,1
web-mediarecorder,web-mediarecorder,,10,15,18,25,23,43,1,50
android-unity-plugin,android-unity-plugin,,4,0,4,4,9,8,8,1
custom-field-type,custom-field-type,,3,1,3,4,6,7,4,1
dbpedia,dbpedia,,34,22,47,56,105,103,2,1
makefile-errors,makefile-errors,,3,1,5,4,12,9,9,1
debezium,debezium,,30,41,40,71,40,111,2,36.666667
simplexml,simplexml,,34,31,84,65,195,149,4,1
rdp,rdp,,32,32,84,64,103,148,8,1
webclient-download,webclient-download,,6,9,12,15,37,27,8,50
json-schema-validator,json-schema-validator,,29,23,30,52,77,82,1,1
aem-6,aem-6,,20,19,37,39,36,76,3,1
flask-security,flask-security,,7,7,13,14,46,27,0,1
ssrs-grouping,ssrs-grouping,,3,6,10,9,12,19,4,100
git-rewrite-history,git-rewrite-history,,8,4,7,12,28,19,6,1
bfg-repo-cleaner,bfg-repo-cleaner,,7,2,9,9,22,18,6,1
windows-server-2012,windows-server-2012,,29,25,65,54,161,119,8,1
fitnesse,fitnesse,,4,6,14,10,28,24,3,50
fitnesse-slim,fitnesse-slim,,3,1,7,4,12,11,3,1
selenium-fitnesse-bridge,selenium-fitnesse-bridge,,0,0,0,0,2,0,3,1
glsles,glsles,,9,5,10,14,20,24,9,1
opengl-es-3.0,opengl-es-3.0,,8,10,11,18,30,29,3,25
shadow-mapping,shadow-mapping,,2,3,6,5,19,11,9,50
tm,tm,,26,18,52,44,144,96,0,1
quanteda,quanteda,,24,23,39,47,84,86,0,1
text2vec,text2vec,,3,3,13,6,35,19,0,1
youtube-iframe-api,youtube-iframe-api,,22,35,53,57,72,110,5,59.090909
kde,kde,,19,20,40,39,45,79,9,5.263158
kdevelop,kdevelop,,3,4,7,7,21,14,9,33.333333
spring-security-rest,spring-security-rest,,5,6,29,11,22,40,3,20
java-threads,java-threads,,38,26,72,64,149,136,3,1
.obj,.obj,,10,1,15,11,35,26,1,1
podspec,podspec,,19,23,24,42,36,66,13,21.052632
live-streaming,live-streaming,,59,37,89,96,135,185,13,1
vlcj,vlcj,,7,6,16,13,17,29,3,1
anychart,anychart,,14,7,16,21,39,37,1,1
full-width,full-width,,4,1,9,5,10,14,1,1
manytomanyfield,manytomanyfield,,12,7,27,19,40,46,0,1
thread-priority,thread-priority,,1,3,6,4,10,10,3,200
bintray,bintray,,4,10,21,14,65,35,3,150
livecode,livecode,,0,0,6,0,9,6,4,1
sublimetext2,sublimetext2,,8,9,24,17,60,41,0,12.5
qwt,qwt,,7,6,10,13,23,23,9,1
macdeployqt,macdeployqt,,3,1,2,4,4,6,9,1
graphlab,graphlab,,7,2,11,9,28,20,0,1
ssis-2016,ssis-2016,,14,4,12,18,28,30,4,1
non-static,non-static,,13,6,12,19,41,31,9,1
string-length,string-length,,26,15,47,41,79,88,0,1
kaa,kaa,,3,2,6,5,29,11,8,1
jenkins-declarative-pipeline,jenkins-declarative-pipeline,,35,15,48,50,83,98,6,1
stable-sort,stable-sort,,0,0,0,0,6,0,1,1
icann,icann,,1,0,1,1,3,2,4,1
ntlm,ntlm,,20,19,64,39,83,103,8,1
cisco-axl,cisco-axl,,0,2,1,2,5,3,6,100
cucm,cucm,,1,4,3,5,7,8,6,300
openoffice-writer,openoffice-writer,,2,4,4,6,12,10,5,100
holtwinters,holtwinters,,5,5,12,10,23,22,0,1
ojdbc,ojdbc,,29,8,43,37,76,80,3,1
psd,psd,,1,6,10,7,20,17,1,500
tga,tga,,2,0,4,2,4,6,9,1
twelvemonkeys,twelvemonkeys,,3,2,2,5,4,7,3,1
tramp,tramp,,1,1,5,2,6,7,9,1
buildozer,buildozer,,38,32,55,70,102,125,0,1
jsonpickle,jsonpickle,,3,5,6,8,10,14,0,66.666667
ujson,ujson,,2,3,3,5,4,8,0,50
errbot,errbot,,3,0,2,3,8,5,0,1
stax,stax,,8,12,15,20,35,35,3,50
foundation,foundation,,12,17,44,29,63,73,13,41.666667
customstringconvertible,customstringconvertible,,0,1,1,1,2,2,13,1
codehighlighter,codehighlighter,,2,0,2,2,3,4,13,1
project-server,project-server,,8,6,6,14,9,20,8,1
ms-project-server-2016,ms-project-server-2016,,2,0,3,2,5,5,8,1
primality-test,primality-test,,6,1,5,7,14,12,0,1
mootools,mootools,,8,4,4,12,9,16,1,1
squeezebox,squeezebox,,0,0,0,0,1,0,1,1
sbt-plugin,sbt-plugin,,6,3,10,9,43,19,2,1
iphone7plus,iphone7plus,,0,2,2,2,6,4,13,100
angular-ngmodel,angular-ngmodel,,31,19,70,50,151,120,1,1
performbatchupdates,performbatchupdates,,1,0,3,1,6,4,13,1
recurring-billing,recurring-billing,,4,7,19,11,31,30,4,75
emberfire,emberfire,,2,3,4,5,9,9,1,50
executor,executor,,9,15,25,24,45,49,3,66.666667
azure-functions-runtime,azure-functions-runtime,,24,15,66,39,102,105,8,1
composite-component,composite-component,,4,4,4,8,24,12,3,1
vmware-clarity,vmware-clarity,,21,18,58,39,88,97,1,1
selenium-grid,selenium-grid,,51,44,108,95,216,203,3,1
undefined-variable,undefined-variable,,3,3,11,6,11,17,4,1
offsetof,offsetof,,1,2,2,3,10,5,9,100
android-things-console,android-things-console,,1,1,5,2,15,7,3,1
proxy-classes,proxy-classes,,1,1,2,2,5,4,8,1
user-roles,user-roles,,43,20,62,63,92,125,4,1
security-roles,security-roles,,0,1,6,1,7,7,8,1
excel-tables,excel-tables,,7,6,19,13,54,32,5,1
member-hiding,member-hiding,,0,1,1,1,5,2,9,1
nfs,nfs,,41,42,73,83,110,156,9,2.439024
sphinx4,sphinx4,,1,3,2,4,11,6,6,200
android-gradle-2.0,android-gradle-2.0,,0,0,2,0,3,2,3,1
virtual-destructor,virtual-destructor,,2,2,6,4,10,10,9,1
paint-code,paint-code,,2,1,3,3,6,6,13,1
python-os,python-os,,18,22,39,40,58,79,0,22.222222
ribbonx,ribbonx,,5,7,28,12,22,40,5,40
sitecore8,sitecore8,,8,6,24,14,87,38,8,1
sitecore8.2,sitecore8.2,,2,0,14,2,26,16,8,1
roc,roc,,52,40,99,92,108,191,0,1
proc-r-package,proc-r-package,,5,2,3,7,4,10,0,1
skphysicsbody,skphysicsbody,,5,6,26,11,68,37,13,20
fosrestbundle,fosrestbundle,,12,10,29,22,84,51,4,1
webusb,webusb,,8,8,14,16,25,30,1,1
git-p4,git-p4,,1,1,3,2,9,5,6,1
tabbing,tabbing,,0,0,1,0,3,1,1,1
vimeo,vimeo,,46,40,98,86,124,184,1,1
vimeo-player,vimeo-player,,11,13,17,24,26,41,1,18.181818
purely-functional,purely-functional,,0,3,8,3,26,11,2,200
spring-websocket,spring-websocket,,56,51,100,107,172,207,3,1
spring-rabbitmq,spring-rabbitmq,,46,43,67,89,130,156,3,1
pretzo,pretzo,,0,0,0,0,1,0,9,1
kendo-treeview,kendo-treeview,,14,17,14,31,31,45,1,21.428571
isnumeric,isnumeric,,2,2,8,4,14,12,5,1
google-font-api,google-font-api,,5,8,16,13,31,29,1,60
jquery-dropkick,jquery-dropkick,,0,0,0,0,1,0,1,1
hdfstore,hdfstore,,2,2,6,4,15,10,0,1
git-remote,git-remote,,19,15,35,34,76,69,6,1
pyhdfs-client,pyhdfs-client,,2,0,0,2,3,2,0,1
replaykit,replaykit,,11,10,44,21,50,65,13,1
gms-licenses-plugin,gms-licenses-plugin,,0,0,0,0,2,0,3,1
mysqldatareader,mysqldatareader,,2,1,6,3,9,9,8,1
youtube-javascript-api,youtube-javascript-api,,15,10,52,25,51,77,5,1
vimdiff,vimdiff,,5,3,6,8,11,14,6,1
property-observer,property-observer,,2,1,3,3,15,6,13,1
azure-servicebus-queues,azure-servicebus-queues,,42,25,55,67,133,122,8,1
qstandarditemmodel,qstandarditemmodel,,9,9,13,18,28,31,9,1
apache-drill,apache-drill,,9,20,34,29,78,63,4,122.222222
word-embedding,word-embedding,,80,77,118,157,201,275,0,1
haskell-pipes,haskell-pipes,,0,1,6,1,4,7,2,1
xcode-server,xcode-server,,2,4,9,6,34,15,13,100
constant-expression,constant-expression,,3,5,9,8,15,17,9,66.666667
sumo,sumo,,29,36,48,65,81,113,9,24.137931
cortana,cortana,,9,5,31,14,79,45,8,1
cortana-skills-kit,cortana-skills-kit,,5,5,17,10,33,27,8,1
browsermob-proxy,browsermob-proxy,,16,14,36,30,39,66,3,1
google-docs-api,google-docs-api,,35,41,44,76,47,120,5,17.142857
yield-return,yield-return,,1,2,16,3,17,19,8,100
rake,rake,,29,33,57,62,146,119,12,13.793103
git-refspec,git-refspec,,0,2,1,2,5,3,6,100
ipfs,ipfs,,23,21,50,44,62,94,1,1
email-analytics,email-analytics,,0,0,0,0,2,0,4,1
jailbreak,jailbreak,,18,12,14,30,36,44,13,1
generic-list,generic-list,,16,16,18,32,34,50,8,1
xsuperobject,xsuperobject,,0,0,0,0,1,0,9,1
fluid-dynamics,fluid-dynamics,,0,6,6,6,14,12,0,500
image-scaling,image-scaling,,5,7,13,12,33,25,1,40
custom-scrolling,custom-scrolling,,1,7,7,8,9,15,1,600
math.net,math.net,,4,8,4,12,19,16,8,100
lookback,lookback,,1,0,1,1,2,2,1,1
hta,hta,,13,18,23,31,77,54,1,38.461538
vb.net-2010,vb.net-2010,,20,18,46,38,81,84,8,1
ng-bind,ng-bind,,6,1,1,7,14,8,1,1
tablelayoutpanel,tablelayoutpanel,,6,4,16,10,20,26,8,1
templatetags,templatetags,,6,4,11,10,23,21,0,1
scene2d,scene2d,,3,1,6,4,41,10,3,1
chatroom,chatroom,,6,3,10,9,12,19,1,1
licode,licode,,1,0,0,1,5,1,13,1
qt3d,qt3d,,19,16,43,35,75,78,9,1
histogram2d,histogram2d,,4,3,7,7,12,14,0,1
overflowexception,overflowexception,,1,0,1,1,7,2,8,1
react-leaflet,react-leaflet,,28,34,75,62,86,137,1,21.428571
django-generic-views,django-generic-views,,10,12,22,22,37,44,0,20
kinect-sdk,kinect-sdk,,5,11,7,16,27,23,8,120
hindley-milner,hindley-milner,,5,0,1,5,15,6,2,1
recursion-schemes,recursion-schemes,,8,1,5,9,18,14,2,1
subplot,subplot,,56,61,104,117,162,221,0,8.928571
sentence,sentence,,8,8,18,16,28,34,0,1
typesetting,typesetting,,0,0,2,0,4,2,0,1
android-gesture,android-gesture,,2,2,8,4,14,12,3,1
gtktextview,gtktextview,,0,1,1,1,1,2,9,1
mailing,mailing,,3,3,10,6,11,16,4,1
skspritenode,skspritenode,,16,13,48,29,140,77,13,1
tfvc,tfvc,,27,28,59,55,164,114,8,3.703704
precompute,precompute,,0,0,0,0,2,0,0,1
unrecognized-selector,unrecognized-selector,,2,5,9,7,35,16,13,150
detailsview,detailsview,,3,2,6,5,14,11,8,1
class-based-views,class-based-views,,2,3,6,5,8,11,0,50
anonymous-users,anonymous-users,,2,1,5,3,7,8,0,1
squirrel-sql,squirrel-sql,,2,4,10,6,25,16,4,100
double-pointer,double-pointer,,11,3,16,14,27,30,9,1
pointer-to-pointer,pointer-to-pointer,,6,2,12,8,18,20,9,1
git-tag,git-tag,,14,14,21,28,43,49,6,1
resume,resume,,9,7,19,16,31,35,3,1
leanback,leanback,,27,25,41,52,56,93,3,1
blank-nodes,blank-nodes,,1,0,4,1,9,5,2,1
mezzanine,mezzanine,,3,6,20,9,35,29,0,100
u-boot,u-boot,,23,20,45,43,102,88,9,1
quandl,quandl,,15,8,32,23,49,55,0,1
ignore,ignore,,10,13,37,23,67,60,6,30
inferred-type,inferred-type,,2,2,4,4,4,8,3,1
signalr-hub,signalr-hub,,41,37,76,78,132,154,8,1
dimensions,dimensions,,22,17,42,39,104,81,0,1
table-per-hierarchy,table-per-hierarchy,,2,0,3,2,7,5,8,1
pythonanywhere,pythonanywhere,,36,35,51,71,118,122,0,1
ieee-754,ieee-754,,28,24,50,52,102,102,0,1
eslint-config-airbnb,eslint-config-airbnb,,12,6,33,18,62,51,1,1
uiblureffect,uiblureffect,,5,0,7,5,20,12,13,1
formflow,formflow,,2,0,26,2,46,28,8,1
angularjs-orderby,angularjs-orderby,,4,1,2,5,24,7,1,1
haversine,haversine,,11,15,14,26,27,40,0,36.363636
asynctaskloader,asynctaskloader,,4,0,7,4,30,11,3,1
dynamic-library,dynamic-library,,4,5,25,9,25,34,9,25
boost-regex,boost-regex,,6,0,4,6,9,10,9,1
android-framelayout,android-framelayout,,20,13,34,33,82,67,3,1
singular,singular,,5,2,6,7,10,13,0,1
zipinputstream,zipinputstream,,1,5,5,6,12,11,3,400
drawingcache,drawingcache,,0,1,0,1,1,1,3,1
send,send,,30,18,42,48,124,90,4,1
mouseleave,mouseleave,,5,3,12,8,26,20,1,1
integer-overflow,integer-overflow,,25,13,33,38,78,71,9,1
heap-corruption,heap-corruption,,9,6,9,15,23,24,9,1
postgresql-9.3,postgresql-9.3,,21,15,65,36,148,101,4,1
reverse-shell,reverse-shell,,4,3,6,7,7,13,9,1
simpledom,simpledom,,1,0,3,1,5,4,4,1
pem,pem,,31,25,36,56,85,92,6,1
typeof,typeof,,11,7,20,18,61,38,1,1
google-chrome-console,google-chrome-console,,7,1,12,8,26,20,1,1
wsh,wsh,,7,9,18,16,49,34,5,28.571429
jlabel,jlabel,,42,25,85,67,159,152,3,1
letter,letter,,6,4,27,10,22,37,0,1
ckerror,ckerror,,1,1,0,2,5,2,13,1
ckfetchnotificationchange,ckfetchnotificationchange,,0,0,0,0,1,0,13,1
jqueryform,jqueryform,,0,1,3,1,6,4,1,1
gammu,gammu,,3,3,9,6,11,15,3,1
openjdk,openjdk,,0,0,0,0,64,0,3,1
screen-rotation,screen-rotation,,5,8,7,13,33,20,3,60
apache-crunch,apache-crunch,,0,0,4,0,7,4,2,1
undertow,undertow,,17,17,51,34,66,85,3,1
media-player,media-player,,33,38,83,71,151,154,3,15.151515
google-text-to-speech,google-text-to-speech,,34,12,40,46,49,86,3,1
android-task,android-task,,7,1,12,8,12,20,3,1
payara,payara,,33,27,65,60,112,125,3,1
device-name,device-name,,0,0,1,0,1,1,3,1
timedelta,timedelta,,28,30,67,58,134,125,0,7.142857
getch,getch,,2,5,7,7,27,14,9,150
solr6,solr6,,7,2,16,9,39,25,2,1
android-viewgroup,android-viewgroup,,6,5,10,11,18,21,3,1
ecto,ecto,,61,53,111,114,310,225,2,1
mlm,mlm,,1,2,3,3,8,6,4,100
git-revert,git-revert,,9,12,30,21,39,51,6,33.333333
systemc,systemc,,4,2,9,6,28,15,9,1
redis-cli,redis-cli,,11,11,21,22,36,43,3,1
didset,didset,,2,3,5,5,20,10,13,50
bernoulli-probability,bernoulli-probability,,2,7,7,9,7,16,0,250
steam,steam,,36,15,62,51,86,113,8,1
ocsp,ocsp,,11,5,23,16,22,39,6,1
autoresize,autoresize,,9,11,15,20,41,35,13,22.222222
querystringparameter,querystringparameter,,6,3,8,9,13,17,4,1
drupal-views,drupal-views,,14,9,28,23,49,51,4,1
organic-groups,organic-groups,,0,0,0,0,5,0,4,1
timthumb,timthumb,,0,1,1,1,1,2,4,1
dryioc,dryioc,,6,8,11,14,27,25,8,33.333333
rule,rule,,0,0,0,0,47,0,4,1
jsondate,jsondate,,0,1,1,1,2,2,1,1
debugdiag,debugdiag,,4,3,3,7,7,10,8,1
debug-diagnostic-tool,debug-diagnostic-tool,,2,2,1,4,2,5,8,1
matlab-guide,matlab-guide,,25,15,38,40,90,78,0,1
youtube-livestreaming-api,youtube-livestreaming-api,,8,7,26,15,21,41,5,1
livestreamer,livestreamer,,0,1,0,1,2,1,13,1
alpakka,alpakka,,30,13,30,43,41,73,2,1
weather-api,weather-api,,18,11,24,29,46,53,1,1
app-transport-security,app-transport-security,,3,6,8,9,24,17,13,100
font-family,font-family,,9,18,23,27,58,50,1,100
flowlayout,flowlayout,,4,6,8,10,20,18,3,50
angularjs-ng-options,angularjs-ng-options,,4,1,10,5,33,15,1,1
protocol-extension,protocol-extension,,2,1,2,3,14,5,13,1
swift3.2,swift3.2,,1,0,7,1,53,8,13,1
implicits,implicits,,0,0,0,0,31,0,2,1
amazon-kcl,amazon-kcl,,5,3,10,8,20,18,6,1
cortex-m,cortex-m,,45,28,39,73,94,112,9,1
javascript-inheritance,javascript-inheritance,,1,0,2,1,3,3,1,1
maxscale,maxscale,,1,2,3,3,7,6,4,100
asp.net-controls,asp.net-controls,,0,0,0,0,3,0,8,1
onscrolllistener,onscrolllistener,,7,7,10,14,20,24,3,1
dllregistration,dllregistration,,2,1,4,3,5,7,8,1
hibernate-annotations,hibernate-annotations,,5,4,10,9,25,19,3,1
jenkins-slave,jenkins-slave,,12,9,40,21,69,61,6,1
ddos,ddos,,16,21,31,37,65,68,4,31.25
mod-security,mod-security,,14,15,22,29,25,51,4,7.142857
relational,relational,,5,5,12,10,34,22,4,1
restify,restify,,7,19,33,26,55,59,1,171.428571
equinox,equinox,,8,3,20,11,19,31,3,1
keyframe,keyframe,,22,20,53,42,86,95,1,1
revealing-module-pattern,revealing-module-pattern,,1,3,3,4,13,7,1,200
stk,stk,,1,1,2,2,6,4,0,1
xlabs,xlabs,,1,1,2,2,8,4,8,1
xamarin.forms.labs,xamarin.forms.labs,,0,1,0,1,6,1,8,1
azure-management-api,azure-management-api,,3,4,20,7,29,27,8,33.333333
infrastructure,infrastructure,,14,10,27,24,43,51,6,1
vhosts,vhosts,,16,16,67,32,92,99,4,1
editablegrid,editablegrid,,0,1,5,1,3,6,1,1
collation,collation,,12,26,61,38,126,99,4,116.666667
georgian,georgian,,0,0,2,0,2,2,4,1
two-columns,two-columns,,1,1,3,2,20,5,0,1
named-scope,named-scope,,2,1,4,3,9,7,12,1
python-newspaper,python-newspaper,,0,8,15,8,25,23,0,700
memory-fragmentation,memory-fragmentation,,0,1,2,1,8,3,9,1
massif,massif,,3,6,6,9,11,15,9,100
mongodb-csharp-2.0,mongodb-csharp-2.0,,6,4,11,10,19,21,1,1
indexoutofrangeexception,indexoutofrangeexception,,7,10,20,17,46,37,0,42.857143
integer-promotion,integer-promotion,,4,7,4,11,16,15,9,75
redux-store,redux-store,,6,2,17,8,16,25,1,1
circuit,circuit,,7,7,21,14,23,35,0,1
jenkins-api,jenkins-api,,16,12,19,28,31,47,6,1
state.go,state.go,,0,0,1,0,4,1,1,1
nuitka,nuitka,,5,3,7,8,16,15,0,1
fitbit,fitbit,,7,3,18,10,25,28,4,1
xcode7,xcode7,,3,0,5,3,18,8,13,1
docbook,docbook,,2,0,6,2,27,8,3,1
docbook-5,docbook-5,,0,0,0,0,9,0,3,1
android-viewflipper,android-viewflipper,,3,1,3,4,5,7,3,1
ninject-extensions,ninject-extensions,,1,0,5,1,13,6,8,1
median,median,,43,29,53,72,128,125,0,1
ora-00979,ora-00979,,1,0,0,1,1,1,4,1
xlsm,xlsm,,11,13,14,24,22,38,5,18.181818
cyclejs,cyclejs,,0,1,7,1,12,8,1,1
mysql.data,mysql.data,,5,2,1,7,6,8,8,1
best-fit-curve,best-fit-curve,,2,1,7,3,5,10,0,1
chartist.js,chartist.js,,7,7,23,14,41,37,1,1
implicit,implicit,,32,40,74,72,146,146,2,25
fingerprint,fingerprint,,34,26,90,60,143,150,3,1
symfony-security,symfony-security,,5,9,15,14,30,29,4,80
segment-tree,segment-tree,,8,5,11,13,20,24,0,1
rmq,rmq,,2,1,2,3,6,5,0,1
android-vision,android-vision,,4,5,16,9,26,25,3,25
definitelytyped,definitelytyped,,8,11,24,19,66,43,1,37.5
spring-session,spring-session,,38,23,73,61,100,134,3,1
androidinjector,androidinjector,,0,1,3,1,4,4,3,1
remote-validation,remote-validation,,1,2,10,3,10,13,8,100
librsvg,librsvg,,1,1,6,2,4,8,1,1
workbox,workbox,,53,60,96,113,135,209,1,13.207547
gdi+,gdi+,,31,31,67,62,130,129,8,1
google-search,google-search,,39,28,53,67,107,120,4,1
lifetime,lifetime,,48,45,110,93,172,203,9,1
android-appwidget,android-appwidget,,4,5,16,9,33,25,3,25
custom-font,custom-font,,3,15,18,18,34,36,3,400
eventbrite,eventbrite,,7,6,15,13,18,28,4,1
angular2-databinding,angular2-databinding,,0,0,1,0,12,1,1,1
fasttext,fasttext,,24,25,35,49,62,84,0,4.166667
scrapysharp,scrapysharp,,0,0,4,0,4,4,8,1
freeze,freeze,,24,24,69,48,134,117,3,1
data-files,data-files,,4,4,12,8,21,20,0,1
pch,pch,,4,4,6,8,12,14,9,1
rightbarbuttonitem,rightbarbuttonitem,,3,0,2,3,11,5,13,1
memset,memset,,7,5,22,12,30,34,9,1
finite-element-analysis,finite-element-analysis,,8,5,16,13,22,29,0,1
multi-master-replication,multi-master-replication,,4,3,10,7,7,17,4,1
mining,mining,,9,6,32,15,39,47,0,1
wufoo,wufoo,,0,0,1,0,3,1,4,1
vue-resource,vue-resource,,6,3,19,9,71,28,1,1
gnome-terminal,gnome-terminal,,9,4,28,13,40,41,9,1
web-project,web-project,,5,4,7,9,6,16,3,1
google-reporting-api,google-reporting-api,,6,3,6,9,25,15,5,1
gmaps.js,gmaps.js,,0,4,5,4,7,9,1,300
laravel-queue,laravel-queue,,29,30,50,59,54,109,4,3.448276
pretty-print,pretty-print,,22,18,30,40,62,70,0,1
go-html-template,go-html-template,,3,1,4,4,5,8,6,1
custom-validators,custom-validators,,0,0,0,0,57,0,1,1
slim-3,slim-3,,21,22,61,43,106,104,4,4.761905
thephpleague,thephpleague,,4,5,10,9,5,19,4,25
apache-spark-standalone,apache-spark-standalone,,7,7,12,14,30,26,2,1
opentk,opentk,,14,22,38,36,47,74,9,57.142857
bluez,bluez,,24,14,63,38,91,101,3,1
rfcomm,rfcomm,,9,7,10,16,26,26,3,1
mkannotation,mkannotation,,6,8,29,14,75,43,13,33.333333
pythagorean,pythagorean,,2,2,10,4,13,14,0,1
2d-vector,2d-vector,,1,8,7,9,14,16,9,700
mongoid6,mongoid6,,1,2,4,3,9,7,12,100
scoping,scoping,,12,12,24,24,59,48,0,1
sql-scripts,sql-scripts,,7,9,18,16,29,34,4,28.571429
hana-sql-script,hana-sql-script,,4,4,11,8,22,19,5,1
clang-static-analyzer,clang-static-analyzer,,9,6,13,15,35,28,9,1
wpf-controls,wpf-controls,,43,42,107,85,163,192,8,1
ng-grid,ng-grid,,1,0,4,1,13,5,1,1
autodeploy,autodeploy,,0,3,3,3,7,6,6,200
self-hosting,self-hosting,,9,17,22,26,43,48,8,88.888889
servicepointmanager,servicepointmanager,,1,2,3,3,8,6,8,100
session-cookies,session-cookies,,151,117,235,268,375,503,4,1
localized,localized,,1,0,1,1,2,2,13,1
neo4jrb,neo4jrb,,0,1,1,1,4,2,2,1
codable,codable,,80,89,211,169,375,380,13,11.25
uitest,uitest,,10,8,24,18,42,42,13,1
toupper,toupper,,1,3,5,4,9,9,9,200
grizzly,grizzly,,3,5,14,8,27,22,3,66.666667
vue-i18n,vue-i18n,,25,29,27,54,46,81,1,16
bootstrap-multiselect,bootstrap-multiselect,,12,7,28,19,52,47,1,1
collectionfs,collectionfs,,0,1,1,1,6,2,1,1
preferencefragment,preferencefragment,,9,7,17,16,23,33,3,1
corruption,corruption,,15,10,25,25,54,50,9,1
nsbezierpath,nsbezierpath,,2,0,6,2,7,8,13,1
hardware-acceleration,hardware-acceleration,,13,11,19,24,36,43,3,1
attr,attr,,12,15,26,27,66,53,1,25
mailmessage,mailmessage,,3,4,12,7,26,19,8,33.333333
traceback,traceback,,9,11,23,20,50,43,0,22.222222
commonjs,commonjs,,27,20,37,47,90,84,1,1
psychopy,psychopy,,14,8,14,22,56,36,0,1
stdtuple,stdtuple,,12,10,26,22,39,48,9,1
evernote,evernote,,9,12,23,21,50,44,3,33.333333
evernote-app-notebook,evernote-app-notebook,,1,1,1,2,5,3,3,1
wamp-protocol,wamp-protocol,,1,2,6,3,12,9,0,100
actionview,actionview,,5,5,13,10,20,23,12,1
gnupg,gnupg,,44,42,95,86,167,181,6,1
settext,settext,,7,7,24,14,46,38,3,1
arel,arel,,2,6,18,8,32,26,12,200
camel-sql,camel-sql,,2,3,7,5,18,12,3,50
synology,synology,,19,5,30,24,64,54,9,1
chisel,chisel,,9,11,31,20,60,51,2,22.222222
processing-efficiency,processing-efficiency,,9,10,21,19,53,40,0,11.111111
cpu-cycles,cpu-cycles,,2,1,1,3,7,4,9,1
classcastexception,classcastexception,,24,24,53,48,110,101,3,1
gsettings,gsettings,,0,1,2,1,6,3,9,1
couchbase-lite,couchbase-lite,,9,7,13,16,67,29,3,1
qtlocation,qtlocation,,5,1,6,6,10,12,9,1
sbcl,sbcl,,12,11,23,23,51,46,0,1
quicklisp,quicklisp,,4,2,5,6,15,11,0,1
asdf,asdf,,4,8,9,12,7,21,0,100
linkedhashmap,linkedhashmap,,13,7,30,20,63,50,3,1
procedural-generation,procedural-generation,,11,10,18,21,49,39,0,1
dropbox-sdk,dropbox-sdk,,2,7,13,9,13,22,4,250
typescript-decorator,typescript-decorator,,14,11,13,25,22,38,1,1
integral,integral,,17,11,35,28,69,63,0,1
video-recording,video-recording,,15,22,13,37,48,50,3,46.666667
tensorflowsharp,tensorflowsharp,,4,2,7,6,8,13,0,1
lightroom,lightroom,,3,1,2,4,6,6,13,1
arp,arp,,13,11,24,24,47,48,9,1
personal-hotspot,personal-hotspot,,1,2,9,3,8,12,3,100
virtual-attribute,virtual-attribute,,1,0,3,1,3,4,12,1
enhanced-ecommerce,enhanced-ecommerce,,9,9,15,18,27,33,5,1
dbset,dbset,,4,1,8,5,15,13,8,1
tomcat9,tomcat9,,79,91,106,170,85,276,3,15.189873
ispconfig,ispconfig,,2,1,9,3,11,12,4,1
shinyapps,shinyapps,,55,75,29,130,47,159,0,36.363636
luhn,luhn,,1,3,5,4,11,9,9,200
latex-environment,latex-environment,,7,4,9,11,15,20,0,1
internal,internal,,0,0,0,0,51,0,4,1
android-layout-weight,android-layout-weight,,10,1,13,11,40,24,3,1
facebook-php-webdriver,facebook-php-webdriver,,1,6,3,7,12,10,3,500
sql-server-2012-express,sql-server-2012-express,,2,3,3,5,15,8,4,50
mixed-content,mixed-content,,9,5,21,14,54,35,4,1
android-image,android-image,,30,18,42,48,87,90,3,1
image-loading,image-loading,,0,4,12,4,30,16,3,300
savefiledialog,savefiledialog,,4,5,17,9,35,26,8,25
corecursion,corecursion,,1,0,0,1,5,1,2,1
wxformbuilder,wxformbuilder,,2,2,5,4,1,9,9,1
mysql-error-1054,mysql-error-1054,,2,1,6,3,10,9,4,1
eclipse-rap,eclipse-rap,,4,1,4,5,7,9,3,1
uidatepicker,uidatepicker,,17,20,37,37,102,74,13,17.647059
google-search-api,google-search-api,,15,10,18,25,31,43,4,1
houndify,houndify,,0,0,1,0,4,1,6,1
adview,adview,,6,6,8,12,13,20,3,1
adbannerview,adbannerview,,2,3,3,5,4,8,3,50
gadfly,gadfly,,1,0,1,1,10,2,0,1
laravel-authorization,laravel-authorization,,13,6,23,19,37,42,4,1
supervisord,supervisord,,42,48,94,90,179,184,0,14.285714
arraybuffer,arraybuffer,,8,10,44,18,63,62,1,25
unrar,unrar,,1,2,6,3,6,9,0,100
pycryptodome,pycryptodome,,9,12,27,21,31,48,0,33.333333
jbcrypt,jbcrypt,,1,0,2,1,6,3,3,1
wcag2.0,wcag2.0,,8,5,13,13,30,26,13,1
zillow,zillow,,3,9,7,12,12,19,0,200
matrix-inverse,matrix-inverse,,11,7,13,18,42,31,0,1
ical4j,ical4j,,0,2,5,2,9,7,3,100
bit-framework,bit-framework,,2,1,0,3,4,3,8,1
spyne,spyne,,3,11,12,14,15,26,0,266.666667
gbk,gbk,,1,0,2,1,6,3,0,1
cout,cout,,20,23,62,43,122,105,9,15
xmllint,xmllint,,16,11,10,27,24,37,9,1
beast,beast,,4,1,3,5,8,8,9,1
conflict,conflict,,10,9,28,19,56,47,6,1
standards-compliance,standards-compliance,,5,4,6,9,13,15,9,1
color-space,color-space,,9,5,15,14,48,29,0,1
texture-mapping,texture-mapping,,24,14,38,38,54,76,9,1
pbr,pbr,,1,3,5,4,8,9,13,200
mjpeg,mjpeg,,7,9,22,16,37,38,13,28.571429
react-native-flexbox,react-native-flexbox,,4,7,13,11,39,24,1,75
fqdn,fqdn,,2,4,10,6,15,16,4,100
vegan,vegan,,18,14,34,32,79,66,0,1
multi-dimensional-scaling,multi-dimensional-scaling,,5,1,2,6,4,8,0,1
recurrence,recurrence,,18,14,44,32,71,76,0,1
alpine,alpine,,107,76,138,183,204,321,6,1
sqlx,sqlx,,7,8,22,15,19,37,6,14.285714
gameobject,gameobject,,28,15,32,43,77,75,8,1
azure-machine-learning-studio,azure-machine-learning-studio,,20,18,67,38,136,105,8,1
usergroups,usergroups,,9,6,16,15,34,31,0,1
mongify,mongify,,0,0,3,0,3,3,12,1
spatialite,spatialite,,6,7,13,13,11,26,3,16.666667
unicode-string,unicode-string,,10,16,26,26,52,52,0,60
streamwriter,streamwriter,,22,11,49,33,105,82,8,1
microsoft-translator,microsoft-translator,,14,12,22,26,31,48,8,1
calendarview,calendarview,,12,11,13,23,30,36,3,1
sql-job,sql-job,,6,15,28,21,25,49,4,150
mousedown,mousedown,,8,2,16,10,26,26,1,1
emgucv,emgucv,,56,44,110,100,162,210,8,1
frequency-distribution,frequency-distribution,,7,4,4,11,24,15,0,1
image-resizing,image-resizing,,39,39,67,78,156,145,1,1
browser-extension,browser-extension,,19,15,21,34,35,55,1,1
spectral,spectral,,6,4,9,10,9,19,0,1
itemscontrol,itemscontrol,,17,8,35,25,62,60,8,1
flask-socketio,flask-socketio,,28,42,55,70,116,125,0,50
type-promotion,type-promotion,,3,2,3,5,12,8,9,1
singleton-type,singleton-type,,0,6,12,6,19,18,2,500
quartus,quartus,,26,10,33,36,50,69,9,1
android-4.4-kitkat,android-4.4-kitkat,,19,8,23,27,69,50,3,1
insertion-sort,insertion-sort,,31,12,45,43,81,88,0,1
fine-uploader,fine-uploader,,4,0,24,4,53,28,1,1
rx.net,rx.net,,7,11,16,18,44,34,8,57.142857
backbone.js-collections,backbone.js-collections,,1,2,0,3,11,3,1,100
backbone-model,backbone-model,,1,1,1,2,8,3,1,1
flex-lexer,flex-lexer,,42,21,88,63,149,151,9,1
google-shopping-api,google-shopping-api,,4,6,7,10,8,17,5,50
punctuation,punctuation,,5,6,20,11,36,31,0,20
column-alias,column-alias,,9,5,5,14,12,19,4,1
package-private,package-private,,1,2,2,3,6,5,3,100
nosuchmethoderror,nosuchmethoderror,,11,7,24,18,53,42,3,1
http-compression,http-compression,,3,5,15,8,13,23,4,66.666667
function-coverage,function-coverage,,0,0,0,0,2,0,4,1
multiple-insert,multiple-insert,,1,0,6,1,7,7,4,1
detachedcriteria,detachedcriteria,,2,2,8,4,10,12,3,1
plpgsql,plpgsql,,93,74,182,167,355,349,4,1
mapbox-android,mapbox-android,,48,46,86,94,88,180,1,1
ruby-on-rails-4.2,ruby-on-rails-4.2,,8,7,18,15,35,33,12,1
slidingmenu,slidingmenu,,2,0,5,2,4,7,3,1
vmd,vmd,,0,0,2,0,8,2,0,1
modularity,modularity,,14,14,20,28,54,48,3,1
bitwise-and,bitwise-and,,4,3,11,7,23,18,9,1
bcd,bcd,,4,3,2,7,15,9,9,1
android-database,android-database,,19,25,42,44,77,86,3,31.578947
wt,wt,,2,2,5,4,10,9,9,1
android-api-levels,android-api-levels,,13,12,29,25,34,54,3,1
transitive-closure,transitive-closure,,5,1,7,6,10,13,0,1
mixpanel,mixpanel,,9,15,22,24,47,46,3,66.666667
sentinel,sentinel,,12,9,15,21,48,36,0,1
twitter-login,twitter-login,,5,1,3,6,18,9,13,1
aapt,aapt,,9,13,28,22,68,50,3,44.444444
fann,fann,,2,1,4,3,7,7,9,1
base-url,base-url,,7,5,19,12,31,31,4,1
kryo,kryo,,7,6,21,13,45,34,2,1
twig-extension,twig-extension,,5,4,18,9,24,27,4,1
bezier,bezier,,20,15,33,35,54,68,0,1
exploded,exploded,,0,0,2,0,2,2,3,1
telerik-ajax,telerik-ajax,,2,1,2,3,4,5,8,1
radlistbox,radlistbox,,0,0,1,0,1,1,8,1
telerik-radlistbox,telerik-radlistbox,,1,0,0,1,2,1,8,1
git-bundle,git-bundle,,1,2,1,3,5,4,6,100
google-ranking,google-ranking,,2,3,0,5,5,5,3,50
facet-grid,facet-grid,,38,32,42,70,62,112,0,1
exponentiation,exponentiation,,2,6,9,8,28,17,0,200
freetds,freetds,,7,19,13,26,37,39,4,171.428571
jboss5.x,jboss5.x,,5,5,11,10,19,21,3,1
ddl,ddl,,57,49,110,106,183,216,4,1
osdev,osdev,,32,26,53,58,73,111,9,1
http-host,http-host,,1,1,2,2,4,4,4,1
react-native-text,react-native-text,,1,3,1,4,9,5,1,200
banner-ads,banner-ads,,3,4,15,7,29,22,3,33.333333
applovin,applovin,,3,3,5,6,9,11,3,1
android-loadermanager,android-loadermanager,,5,4,6,9,17,15,3,1
string.format,string.format,,9,8,15,17,46,32,0,1
propagation,propagation,,5,2,14,7,14,21,3,1
gecode,gecode,,2,2,2,4,7,6,0,1
appsettings,appsettings,,23,19,52,42,97,94,8,1
javacc,javacc,,10,1,20,11,22,31,3,1
select-function,select-function,,0,0,0,0,1,0,9,1
select-case,select-case,,1,3,4,4,12,8,5,200
custom-theme,custom-theme,,6,7,5,13,12,18,4,16.666667
onmouseout,onmouseout,,5,1,6,6,17,12,1,1
powerline,powerline,,4,5,5,9,12,14,9,25
invoke,invoke,,23,26,70,49,98,119,8,13.043478
pfsense,pfsense,,6,4,12,10,18,22,9,1
bigdecimal,bigdecimal,,34,17,57,51,116,108,3,1
digest,digest,,11,1,24,12,26,36,6,1
geonames,geonames,,7,4,7,11,7,18,1,1
city,city,,4,0,12,4,20,16,0,1
uistoryboardsegue,uistoryboardsegue,,23,10,31,33,98,64,13,1
django-crispy-forms,django-crispy-forms,,18,19,33,37,49,70,0,5.555556
clojure.spec,clojure.spec,,5,7,19,12,37,31,2,40
public,public,,21,21,51,42,94,93,9,1
modifier,modifier,,2,3,7,5,16,12,9,50
tel,tel,,4,7,11,11,16,22,1,75
openshift-cartridge,openshift-cartridge,,1,1,0,2,4,2,6,1
undefined-index,undefined-index,,9,7,11,16,29,27,4,1
namedtuple,namedtuple,,16,13,33,29,52,62,0,1
recordtype,recordtype,,0,2,2,2,7,4,4,100
cp,cp,,13,15,28,28,63,56,9,15.384615
adobecreativesdk,adobecreativesdk,,1,0,7,1,8,8,3,1
creative-cloud,creative-cloud,,0,0,1,0,3,1,1,1
image-registration,image-registration,,11,6,13,17,15,30,0,1
rosalind,rosalind,,1,1,2,2,6,4,0,1
passive-event-listeners,passive-event-listeners,,4,3,4,7,8,11,1,1
clause,clause,,5,3,8,8,14,16,4,1
knowledge-base-population,knowledge-base-population,,0,0,0,0,2,0,0,1
7zip,7zip,,45,32,53,77,90,130,0,1
irfanview,irfanview,,0,1,0,1,3,1,0,1
root,root,,58,59,121,117,194,238,9,1.724138
su,su,,10,5,10,15,35,25,9,1
pywavelets,pywavelets,,2,4,6,6,3,12,0,100
appendchild,appendchild,,22,14,31,36,87,67,1,1
putimagedata,putimagedata,,3,1,5,4,8,9,1,1
google-distancematrix-api,google-distancematrix-api,,21,26,36,47,74,83,1,23.809524
cql3,cql3,,2,1,9,3,38,12,2,1
plumber,plumber,,21,21,25,42,39,67,0,1
vcard,vcard,,11,11,11,22,32,33,3,1
biblatex,biblatex,,5,6,11,11,11,22,0,20
imshow,imshow,,32,28,42,60,79,102,0,1
select-n-plus-1,select-n-plus-1,,1,2,2,3,5,5,12,100
xhtmlrenderer,xhtmlrenderer,,3,1,0,4,6,4,3,1
micro-optimization,micro-optimization,,23,24,32,47,78,79,9,4.347826
jackrabbit,jackrabbit,,12,7,23,19,26,42,3,1
jackrabbit-oak,jackrabbit-oak,,3,6,14,9,19,23,3,100
fb.ui,fb.ui,,2,0,4,2,5,6,13,1
dataformat,dataformat,,9,14,14,23,23,37,0,55.555556
intel-pmu,intel-pmu,,5,2,12,7,13,19,9,1
oncreate,oncreate,,15,5,34,20,60,54,3,1
range-v3,range-v3,,13,9,30,22,28,52,9,1
revmob,revmob,,0,0,0,0,2,0,3,1
timepickerdialog,timepickerdialog,,3,0,4,3,6,7,3,1
sign-extension,sign-extension,,6,1,3,7,6,10,9,1
repr,repr,,6,5,13,11,23,24,0,1
tcpdump,tcpdump,,17,21,34,38,98,72,9,23.529412
bitrate,bitrate,,1,5,13,6,16,19,13,400
floating,floating,,16,13,34,29,47,63,3,1
type-level-computation,type-level-computation,,11,7,25,18,39,43,2,1
decoupling,decoupling,,2,5,5,7,25,12,3,150
face-api,face-api,,15,16,25,31,49,56,8,6.666667
isnull,isnull,,14,8,28,22,73,50,4,1
meteor-autoform,meteor-autoform,,1,1,3,2,23,5,1,1
kinematics,kinematics,,7,3,6,10,14,16,0,1
homogenous-transformation,homogenous-transformation,,1,2,5,3,9,8,0,100
direct-line-botframework,direct-line-botframework,,27,33,60,60,112,120,8,22.222222
kotlin-coroutines,kotlin-coroutines,,141,223,72,364,57,436,3,58.156028
proto,proto,,20,30,21,50,34,71,6,50
proto3,proto3,,5,3,10,8,16,18,6,1
data-sharing,data-sharing,,7,8,7,15,19,22,1,14.285714
test-data,test-data,,4,7,10,11,17,21,0,75
python-curses,python-curses,,11,10,17,21,20,38,0,1
wit.ai,wit.ai,,3,4,6,7,31,13,8,33.333333
ansi-sql,ansi-sql,,5,3,12,8,21,20,4,1
fadeout,fadeout,,14,8,21,22,56,43,1,1
docker-api,docker-api,,11,7,22,18,21,40,6,1
openshift-3,openshift-3,,17,12,27,29,92,56,6,1
coinbase-api,coinbase-api,,22,18,26,40,103,66,4,1
dwt,dwt,,6,3,3,9,8,12,0,1
cloud9-ide,cloud9-ide,,9,6,19,15,68,34,6,1
wearables,wearables,,5,3,11,8,21,19,3,1
php-parse-error,php-parse-error,,2,1,2,3,8,5,4,1
babel-register,babel-register,,1,4,8,5,7,13,1,300
dpkg,dpkg,,8,14,17,22,54,39,9,75
undeclared-identifier,undeclared-identifier,,1,2,8,3,8,11,9,100
least-squares,least-squares,,33,28,57,61,90,118,0,1
popupmenu,popupmenu,,15,10,26,25,43,51,3,1
ember-cli-addons,ember-cli-addons,,1,0,3,1,5,4,1,1
flask-mail,flask-mail,,13,13,17,26,22,43,0,1
rocketmq,rocketmq,,6,0,9,6,11,15,3,1
sdl-image,sdl-image,,0,4,3,4,9,7,9,300
node-deasync,node-deasync,,1,0,0,1,3,1,1,1
spray-json,spray-json,,11,4,19,15,39,34,2,1
tensorflow-slim,tensorflow-slim,,4,4,14,8,66,22,0,1
graphiql,graphiql,,13,13,21,26,33,47,1,1
gate,gate,,2,5,8,7,24,15,3,150
g2o,g2o,,0,2,4,2,5,6,9,100
real-mode,real-mode,,10,3,15,13,18,28,9,1
smp,smp,,0,4,4,4,9,8,9,300
project-online,project-online,,4,4,5,8,5,13,8,1
insert-id,insert-id,,2,0,1,2,3,3,4,1
seekg,seekg,,0,1,2,1,4,3,9,1
zoo,zoo,,26,21,57,47,147,104,0,1
sticky-footer,sticky-footer,,3,7,10,10,27,20,1,133.333333
offline-browsing,offline-browsing,,0,0,6,0,4,6,1,1
gmsautocomplete,gmsautocomplete,,2,0,3,2,4,5,13,1
photoimage,photoimage,,2,4,8,6,15,14,0,100
git-checkout,git-checkout,,23,21,33,44,109,77,6,1
absolute-path,absolute-path,,13,7,23,20,48,43,4,1
kramdown,kramdown,,4,3,10,7,12,17,1,1
suffix-tree,suffix-tree,,2,4,1,6,8,7,0,100
scrollviewer,scrollviewer,,17,9,27,26,52,53,8,1
readline,readline,,51,46,91,97,163,188,0,1
t-test,t-test,,17,14,35,31,48,66,0,1
twitter-rest-api,twitter-rest-api,,1,1,5,2,12,7,0,1
pointerlock,pointerlock,,0,0,2,0,10,2,1,1
alarm,alarm,,19,15,42,34,112,76,3,1
jenkins-shared-libraries,jenkins-shared-libraries,,8,7,16,15,25,31,6,1
adminlte,adminlte,,18,22,35,40,75,75,1,22.222222
qtabwidget,qtabwidget,,5,11,14,16,43,30,0,120
isolation-level,isolation-level,,15,14,30,29,51,59,3,1
ng2-smart-table,ng2-smart-table,,26,17,37,43,67,80,1,1
transformation,transformation,,75,64,140,139,254,279,0,1
jta,jta,,10,12,49,22,62,71,3,20
lockfile,lockfile,,2,1,6,3,13,9,1,1
safari-web-inspector,safari-web-inspector,,4,4,8,8,21,16,1,1
vbox,vbox,,2,6,11,8,26,19,3,200
sigsegv,sigsegv,,21,22,35,43,83,78,9,4.761905
mailkit,mailkit,,25,18,45,43,66,88,8,1
discountasp,discountasp,,0,0,0,0,1,0,8,1
realm-java,realm-java,,5,0,8,5,28,13,13,1
default-value,default-value,,27,25,70,52,138,122,4,1
mediainfo,mediainfo,,4,5,6,9,21,15,13,25
aws-certificate-manager,aws-certificate-manager,,15,15,17,30,30,47,6,1
closest-points,closest-points,,2,2,3,4,9,7,0,1
ifconfig,ifconfig,,5,2,7,7,22,14,9,1
redhat-containers,redhat-containers,,3,3,2,6,15,8,6,1
black-box-testing,black-box-testing,,2,2,5,4,13,9,3,1
chocolatey,chocolatey,,15,20,29,35,60,64,8,33.333333
rootscope,rootscope,,1,0,6,1,9,7,1,1
hash-collision,hash-collision,,1,5,11,6,15,17,12,400
phpseclib,phpseclib,,10,14,30,24,91,54,4,40
remote-access,remote-access,,57,62,116,119,236,235,9,8.77193
obd-ii,obd-ii,,5,6,19,11,30,30,3,20
keyup,keyup,,10,12,31,22,73,53,1,20
touch-event,touch-event,,24,44,29,68,88,97,3,83.333333
materialdrawer,materialdrawer,,0,4,3,4,9,7,3,300
argumentexception,argumentexception,,5,2,6,7,9,13,8,1
fileoutputstream,fileoutputstream,,12,20,40,32,82,72,3,66.666667
properties-file,properties-file,,42,24,74,66,142,140,3,1
texas-instruments,texas-instruments,,10,9,21,19,32,40,9,1
gaussianblur,gaussianblur,,7,5,5,12,36,17,0,1
swagger-codegen,swagger-codegen,,51,52,96,103,163,199,3,1.960784
crosswalk,crosswalk,,0,3,16,3,44,19,1,200
google-query-language,google-query-language,,11,69,32,80,65,112,5,527.272727
batik,batik,,13,8,19,21,24,40,3,1
jni4net,jni4net,,4,2,5,6,8,11,3,1
chutzpah,chutzpah,,3,1,9,4,13,13,1,1
redux-promise,redux-promise,,0,1,1,1,19,2,1,1
redux-promise-middleware,redux-promise-middleware,,3,0,2,3,10,5,1,1
bcs,bcs,,0,0,4,0,2,4,8,1
vulcan,vulcan,,0,0,1,0,1,1,1,1
inner-product,inner-product,,2,0,0,2,4,2,0,1
maven-resources-plugin,maven-resources-plugin,,9,2,10,11,23,21,3,1
maven-remote-resources,maven-remote-resources,,0,0,1,0,4,1,3,1
tumblr,tumblr,,14,8,47,22,66,69,1,1
jumblr,jumblr,,0,0,1,0,2,1,3,1
fflush,fflush,,5,2,9,7,8,16,9,1
query-builder,query-builder,,104,57,126,161,243,287,4,1
concurrentmodification,concurrentmodification,,11,9,18,20,41,38,3,1
openmpi,openmpi,,35,28,53,63,118,116,9,1
locationlistener,locationlistener,,1,6,12,7,25,19,3,500
vlfeat,vlfeat,,2,0,2,2,5,4,0,1
mathcad,mathcad,,1,0,0,1,3,1,0,1
dummy-data,dummy-data,,2,3,5,5,12,10,0,50
gnutls,gnutls,,4,6,14,10,12,24,6,50
activity-finish,activity-finish,,5,4,8,9,20,17,3,1
administrator,administrator,,15,11,27,26,41,53,9,1
open-banking,open-banking,,2,1,1,3,2,4,4,1
bottombar,bottombar,,3,3,9,6,17,15,3,1
module-info,module-info,,3,4,20,7,37,27,3,33.333333
atl,atl,,9,13,18,22,45,40,9,44.444444
bho,bho,,3,1,5,4,5,9,1,1
applicationdomain,applicationdomain,,0,0,0,0,2,0,8,1
safehandle,safehandle,,0,1,2,1,6,3,8,1
sbt-0.13,sbt-0.13,,1,0,7,1,2,8,2,1
quoting,quoting,,14,11,27,25,100,52,9,1
android-gui,android-gui,,1,1,3,2,6,5,3,1
tthread,tthread,,1,0,3,1,2,4,9,1
windows-phone-8.1,windows-phone-8.1,,1,1,2,2,34,4,8,1
data-access-object,data-access-object,,2,0,1,2,2,3,8,1
knights-tour,knights-tour,,2,3,3,5,15,8,0,50
pass-by-value,pass-by-value,,17,14,46,31,77,77,9,1
juju,juju,,8,4,7,12,7,19,6,1
jls,jls,,3,8,10,11,21,21,3,166.666667
aginity,aginity,,4,5,8,9,12,17,4,25
rcc,rcc,,1,1,0,2,5,2,9,1
directxmath,directxmath,,2,1,2,3,2,5,9,1
directxtk,directxtk,,2,3,6,5,6,11,9,50
sendinblue,sendinblue,,3,5,4,8,11,12,4,66.666667
c#-3.0,c#-3.0,,14,12,30,26,89,56,8,1
css-filters,css-filters,,10,9,14,19,31,33,1,1
steam-web-api,steam-web-api,,19,12,22,31,40,53,8,1
steamworks-api,steamworks-api,,4,6,20,10,19,30,8,50
allegro5,allegro5,,9,4,10,13,15,23,9,1
pyzmq,pyzmq,,25,14,34,39,61,73,0,1
onload,onload,,28,27,56,55,123,111,1,1
b-tree-index,b-tree-index,,2,4,1,6,7,7,4,100
dataprovider,dataprovider,,8,6,14,14,36,28,3,1
lifecycleexception,lifecycleexception,,0,0,0,0,2,0,3,1
spree-3.1,spree-3.1,,0,0,0,0,1,0,12,1
core-foundation,core-foundation,,7,4,13,11,30,24,13,1
gnustep,gnustep,,1,1,0,2,2,2,13,1
grails-2.0,grails-2.0,,5,10,5,15,36,20,3,100
qtimer,qtimer,,8,6,20,14,32,34,9,1
ios10.3,ios10.3,,1,1,3,2,16,5,13,1
cgaffinetransform,cgaffinetransform,,7,12,26,19,57,45,13,71.428571
yo,yo,,7,2,7,9,16,16,1,1
gsap,gsap,,41,34,62,75,104,137,1,1
tweenmax,tweenmax,,14,12,32,26,48,58,1,1
scala-2.11,scala-2.11,,1,2,1,3,11,4,2,100
jshint,jshint,,12,5,17,17,55,34,1,1
corespotlight,corespotlight,,9,2,5,11,15,16,13,1
office365-apps,office365-apps,,8,8,27,16,36,43,8,1
rtc,rtc,,0,0,0,0,40,0,3,1
ibm-jazz,ibm-jazz,,2,3,3,5,13,8,3,50
scmmanager,scmmanager,,1,0,1,1,2,2,6,1
rjson,rjson,,4,6,9,10,14,19,0,50
anorm,anorm,,3,1,4,4,19,8,2,1
zeit-now,zeit-now,,18,24,27,42,13,69,1,33.333333
jackson-dataformat-xml,jackson-dataformat-xml,,17,18,19,35,38,54,3,5.882353
graphml,graphml,,1,3,3,4,25,7,0,200
node-commander,node-commander,,2,5,6,7,14,13,1,150
oidc-client-js,oidc-client-js,,13,17,16,30,29,46,8,30.769231
cadisplaylink,cadisplaylink,,4,4,0,8,10,8,13,1
glkview,glkview,,1,1,1,2,5,3,13,1
check-constraints,check-constraints,,25,8,31,33,34,64,4,1
bindparam,bindparam,,4,3,14,7,35,21,4,1
decimal-point,decimal-point,,9,5,19,14,34,33,0,1
nullable,nullable,,44,28,65,72,152,137,8,1
mysql-event,mysql-event,,2,3,12,5,25,17,4,50
database-events,database-events,,0,0,0,0,1,0,4,1
threadgroup,threadgroup,,4,5,5,9,12,14,3,25
asp.net-mvc-controller,asp.net-mvc-controller,,3,3,4,6,11,10,8,1
illegalstateexception,illegalstateexception,,31,18,38,49,92,87,3,1
nltk-book,nltk-book,,1,0,3,1,14,4,0,1
gun,gun,,2,6,8,8,24,16,1,200
gundb,gundb,,2,1,5,3,5,8,1,1
xtable,xtable,,4,4,13,8,28,21,0,1
kable,kable,,38,34,68,72,142,140,0,1
tablesorter,tablesorter,,12,11,48,23,70,71,1,1
reactive-streams,reactive-streams,,10,25,26,35,76,61,3,150
zmodem,zmodem,,1,0,3,1,2,4,9,1
cakephp-1.3,cakephp-1.3,,1,2,12,3,9,15,4,100
cakephp-1.2,cakephp-1.2,,0,1,1,1,3,2,4,1
turbo-c++,turbo-c++,,13,18,9,31,28,40,9,38.461538
convention,convention,,0,0,0,0,27,0,3,1
android-imagebutton,android-imagebutton,,7,8,14,15,63,29,3,14.285714
prettier,prettier,,53,39,99,92,78,191,9,1
rpy2,rpy2,,37,31,64,68,107,132,0,1
external,external,,53,26,122,79,179,201,1,1
ms-project-server-2013,ms-project-server-2013,,2,0,5,2,6,7,8,1
pyuic,pyuic,,4,1,6,5,9,11,0,1
nsdatecomponents,nsdatecomponents,,6,5,8,11,24,19,13,1
mathml,mathml,,14,3,16,17,26,33,1,1
ios-app-group,ios-app-group,,7,7,9,14,20,23,13,1
positioning,positioning,,16,13,32,29,88,61,1,1
qthread,qthread,,38,38,74,76,143,150,0,1
activejdbc,activejdbc,,0,3,8,3,46,11,3,200
javalite,javalite,,2,3,15,5,35,20,3,50
accelerate-framework,accelerate-framework,,3,1,6,4,17,10,13,1
cvpixelbuffer,cvpixelbuffer,,7,7,23,14,28,37,13,1
vimage,vimage,,1,2,1,3,5,4,13,100
django-filer,django-filer,,1,3,2,4,9,6,0,200
layout-gravity,layout-gravity,,2,2,7,4,8,11,3,1
negative-number,negative-number,,12,7,21,19,40,40,0,1
fork-join,fork-join,,14,12,13,26,57,39,1,1
qfile,qfile,,4,1,8,5,34,13,9,1
computation-theory,computation-theory,,12,6,19,18,39,37,0,1
tmpfs,tmpfs,,4,0,8,4,10,12,9,1
xmlreader,xmlreader,,12,12,25,24,53,49,8,1
case-when,case-when,,34,36,47,70,99,117,4,5.882353
charindex,charindex,,8,7,14,15,28,29,4,1
patindex,patindex,,2,5,7,7,11,14,4,150
qitemdelegate,qitemdelegate,,1,1,6,2,13,8,9,1
url-for,url-for,,6,4,6,10,15,16,0,1
android-architecture,android-architecture,,2,4,8,6,24,14,3,100
accepts-nested-attributes,accepts-nested-attributes,,2,2,4,4,14,8,12,1
sunos,sunos,,1,1,10,2,12,12,9,1
scrypt,scrypt,,5,6,11,11,10,22,1,20
autofixture,autofixture,,11,9,20,20,35,40,8,1
copying,copying,,7,9,17,16,27,33,5,28.571429
public-key,public-key,,28,23,60,51,78,111,6,1
xlwt,xlwt,,7,15,28,22,56,50,0,114.285714
gtrendsr,gtrendsr,,3,4,4,7,10,11,0,33.333333
nsexpression,nsexpression,,5,3,2,8,13,10,13,1
alternate-data-stream,alternate-data-stream,,0,0,3,0,3,3,9,1
relaxng,relaxng,,0,1,4,1,5,5,3,1
html5-data,html5-data,,2,0,1,2,2,3,1,1
couchdb-lucene,couchdb-lucene,,0,1,0,1,1,1,1,1
account,account,,41,22,71,63,105,134,4,1
google-account,google-account,,9,12,12,21,34,33,3,33.333333
quartz-composer,quartz-composer,,0,0,0,0,4,0,13,1
stackview,stackview,,8,4,10,12,41,22,13,1
kernel-extension,kernel-extension,,8,11,17,19,50,36,13,37.5
angularjs-e2e,angularjs-e2e,,3,1,5,4,25,9,3,1
double-quotes,double-quotes,,22,21,51,43,94,94,0,1
single-quotes,single-quotes,,9,9,19,18,40,37,0,1
kvm,kvm,,23,25,44,48,91,92,9,8.695652
wand,wand,,18,15,19,33,48,52,0,1
hotswap,hotswap,,5,5,13,10,24,23,3,1
mediawiki,mediawiki,,45,65,103,110,156,213,4,44.444444
infobox,infobox,,1,1,1,2,8,3,1,1
semantic-mediawiki,semantic-mediawiki,,2,3,2,5,7,7,4,50
sbt-assembly,sbt-assembly,,17,3,32,20,70,52,2,1
dxf,dxf,,6,11,13,17,28,30,0,83.333333
trimesh,trimesh,,3,5,2,8,3,10,0,66.666667
coefficients,coefficients,,23,17,33,40,62,73,0,1
selenium-grid2,selenium-grid2,,6,5,16,11,13,27,3,1
tor,tor,,37,27,56,64,107,120,0,1
polipo,polipo,,1,1,4,2,2,6,0,1
privoxy,privoxy,,3,0,1,3,9,4,0,1
azure-storage-emulator,azure-storage-emulator,,5,4,16,9,16,25,8,1
frm,frm,,0,0,1,0,2,1,4,1
aurelia-validation,aurelia-validation,,0,3,5,3,25,8,1,200
resource-loading,resource-loading,,0,0,2,0,3,2,3,1
google-fusion-tables,google-fusion-tables,,5,2,5,7,38,12,1,1
bare-metal,bare-metal,,10,8,20,18,41,38,9,1
resque-scheduler,resque-scheduler,,4,3,4,7,8,11,12,1
ammap,ammap,,3,2,6,5,9,11,1,1
phone-call,phone-call,,10,21,25,31,49,56,3,110
fat,fat,,2,3,3,5,10,8,9,50
ntfs-mft,ntfs-mft,,3,3,7,6,5,13,9,1
object-storage,object-storage,,9,8,34,17,78,51,6,1
data-science-experience,data-science-experience,,5,8,12,13,68,25,0,60
personality-insights,personality-insights,,1,1,4,2,9,6,6,1
policies,policies,,6,5,13,11,15,24,4,1
google-classroom,google-classroom,,12,16,28,28,44,56,5,33.333333
advapi32,advapi32,,0,1,7,1,6,8,8,1
indoor-positioning-system,indoor-positioning-system,,6,6,16,12,29,28,3,1
irc,irc,,11,7,21,18,23,39,9,1
word-boundary,word-boundary,,3,4,6,7,13,13,0,33.333333
nstableview,nstableview,,24,22,57,46,126,103,13,1
login-page,login-page,,3,3,5,6,10,11,8,1
android-json,android-json,,14,12,12,26,59,38,3,1
nextjs,nextjs,,0,0,0,0,144,0,1,1
concurrent.futures,concurrent.futures,,32,31,52,63,85,115,0,1
tcpsocket,tcpsocket,,9,5,6,14,21,20,9,1
luasocket,luasocket,,2,1,4,3,16,7,9,1
php-socket,php-socket,,4,1,5,5,9,10,4,1
oracle11gr2,oracle11gr2,,10,10,17,20,33,37,4,1
tns,tns,,9,4,15,13,21,28,4,1
meteor-accounts,meteor-accounts,,6,2,8,8,59,16,1,1
angular-service-worker,angular-service-worker,,35,39,66,74,91,140,1,11.428571
edges,edges,,15,11,14,26,43,40,0,1
hkobserverquery,hkobserverquery,,0,0,1,0,6,1,13,1
jsonstore,jsonstore,,2,3,1,5,10,6,13,50
hangout,hangout,,9,6,13,15,11,28,5,1
parallel-foreach,parallel-foreach,,2,7,14,9,28,23,0,250
system.speech.recognition,system.speech.recognition,,2,1,2,3,5,5,8,1
postcss-loader,postcss-loader,,8,1,12,9,28,21,1,1
ssi,ssi,,4,4,14,8,13,22,4,1
code-cleanup,code-cleanup,,16,9,28,25,46,53,3,1
thin,thin,,6,2,6,8,9,14,12,1
force.com,force.com,,4,3,9,7,23,16,14,1
nwjs,nwjs,,10,13,17,23,51,40,1,30
elm-reactor,elm-reactor,,0,0,2,0,3,2,1,1
edeliver,edeliver,,0,1,6,1,7,7,2,1
jquery-isotope,jquery-isotope,,8,11,17,19,41,36,1,37.5
isotope,isotope,,11,14,21,25,54,46,1,27.272727
custom-errors,custom-errors,,3,5,9,8,15,17,8,66.666667
pywin32,pywin32,,43,54,90,97,146,187,0,25.581395
spotify-app,spotify-app,,1,10,5,11,10,16,4,900
avx,avx,,30,29,52,59,115,111,9,1
sse2,sse2,,0,3,20,3,11,23,9,200
jdbctemplate,jdbctemplate,,69,62,127,131,208,258,3,1
flush,flush,,10,14,46,24,79,70,3,40
packagist,packagist,,3,3,11,6,29,17,4,1
hivecontext,hivecontext,,2,1,4,3,31,7,2,1
fstab,fstab,,4,4,7,8,10,15,9,1
google-polyline,google-polyline,,14,9,28,23,54,51,1,1
bloburls,bloburls,,0,1,3,1,7,4,1,1
nextcloud,nextcloud,,22,19,38,41,58,79,4,1
jquery-ui-draggable,jquery-ui-draggable,,15,14,50,29,113,79,1,1
maven-docker-plugin,maven-docker-plugin,,2,1,1,3,8,4,3,1
hashcode,hashcode,,33,29,70,62,113,132,3,1
bootable,bootable,,1,0,1,1,6,2,6,1
zoneddatetime,zoneddatetime,,14,14,20,28,53,48,3,1
roblox,roblox,,31,38,61,69,95,130,9,22.580645
firebase-job-dispatcher,firebase-job-dispatcher,,10,1,32,11,68,43,3,1
nonlinear-optimization,nonlinear-optimization,,28,37,51,65,104,116,0,32.142857
region,region,,13,5,30,18,45,48,6,1
qtquickcontrols2,qtquickcontrols2,,9,8,31,17,83,48,9,1
url-encoding,url-encoding,,11,0,34,11,90,45,4,1
netflix-ribbon,netflix-ribbon,,22,10,23,32,66,55,3,1
ellipsis,ellipsis,,11,9,24,20,65,44,1,1
certificate-authority,certificate-authority,,7,4,11,11,13,22,6,1
autopostback,autopostback,,1,1,1,2,9,3,8,1
urdu,urdu,,1,4,6,5,12,11,0,300
route-provider,route-provider,,1,2,5,3,12,8,1,100
kafka-python,kafka-python,,19,16,18,35,42,53,2,1
termux,termux,,22,13,19,35,32,54,3,1
multi-tier,multi-tier,,2,2,2,4,7,6,3,1
data-representation,data-representation,,2,7,9,9,16,18,0,250
event-binding,event-binding,,6,1,7,7,21,14,1,1
workspace,workspace,,20,14,40,34,73,74,3,1
checkin,checkin,,4,2,12,6,21,18,8,1
assemblyinfo,assemblyinfo,,4,3,3,7,11,10,8,1
post-redirect-get,post-redirect-get,,2,3,3,5,8,8,4,50
type-definition,type-definition,,3,4,13,7,19,20,1,33.333333
ipywidgets,ipywidgets,,38,53,48,91,76,139,0,39.473684
wikidata,wikidata,,73,53,73,126,135,199,2,1
twistd,twistd,,3,0,1,3,7,4,0,1
gluon-mobile,gluon-mobile,,30,20,39,50,107,89,3,1
android-radiogroup,android-radiogroup,,7,0,29,7,33,36,3,1
nsset,nsset,,1,2,3,3,9,6,13,100
nsmutableset,nsmutableset,,0,0,0,0,4,0,13,1
azure-container-instances,azure-container-instances,,25,24,34,49,47,83,8,1
quickbooks-online,quickbooks-online,,14,17,22,31,58,53,4,21.428571
nameerror,nameerror,,20,23,45,43,115,88,0,15
webpack-html-loader,webpack-html-loader,,2,1,9,3,15,12,1,1
proximity,proximity,,8,5,8,13,18,21,3,1
android-contentprovider,android-contentprovider,,24,46,95,70,190,165,3,91.666667
keytool,keytool,,24,26,63,50,112,113,6,8.333333
telegram-webhook,telegram-webhook,,11,8,6,19,41,25,0,1
onactivityresult,onactivityresult,,22,20,45,42,88,87,3,1
modelform,modelform,,31,19,38,50,73,88,0,1
pyathena,pyathena,,0,6,4,6,4,10,6,500
genetic-algorithm,genetic-algorithm,,53,37,88,90,201,178,0,1
jqmath,jqmath,,1,1,0,2,4,2,3,1
dacpac,dacpac,,9,17,23,26,47,49,4,88.888889
hostapd,hostapd,,3,3,9,6,18,15,3,1
redis-rails,redis-rails,,1,1,2,2,2,4,12,1
bounds,bounds,,16,12,24,28,61,52,13,1
ffprobe,ffprobe,,17,11,18,28,46,46,13,1
objectcontext,objectcontext,,1,1,3,2,6,5,8,1
convex-optimization,convex-optimization,,11,11,15,22,30,37,0,1
convex,convex,,3,7,7,10,10,17,0,133.333333
rnotebook,rnotebook,,4,12,23,16,45,39,0,200
jsonbuilder,jsonbuilder,,1,0,4,1,6,5,3,1
phantom-reference,phantom-reference,,2,5,1,7,4,8,3,150
abstract-data-type,abstract-data-type,,10,9,20,19,25,39,9,1
n-queens,n-queens,,4,4,22,8,22,30,0,1
controltemplate,controltemplate,,10,8,35,18,54,53,8,1
coreos,coreos,,3,4,18,7,48,25,6,33.333333
google-suggest,google-suggest,,0,0,0,0,2,0,1,1
avr-gcc,avr-gcc,,13,6,19,19,50,38,9,1
watson-discovery,watson-discovery,,10,6,30,16,50,46,6,1
openpower,openpower,,0,0,0,0,1,0,9,1
dbi,dbi,,22,22,51,44,55,95,9,1
flume-twitter,flume-twitter,,2,0,3,2,8,5,2,1
vdproj,vdproj,,3,0,2,3,4,5,8,1
web3,web3,,74,78,176,152,276,328,6,5.405405
jscrollpane,jscrollpane,,25,16,31,41,95,72,3,1
delete-operator,delete-operator,,21,18,38,39,95,77,9,1
client-library,client-library,,0,0,4,0,11,4,6,1
jboss-wildfly-11,jboss-wildfly-11,,2,0,2,2,12,4,3,1
windows-embedded-compact,windows-embedded-compact,,4,0,5,4,14,9,8,1
windows-embedded,windows-embedded,,0,2,1,2,8,3,8,100
windows-embedded-standard,windows-embedded-standard,,0,0,0,0,2,0,8,1
unwrap,unwrap,,3,3,13,6,17,19,13,1
go-chi,go-chi,,2,5,2,7,5,9,6,150
infinity,infinity,,9,4,11,13,22,24,0,1
cjson,cjson,,4,3,6,7,13,13,9,1
unreal-development-kit,unreal-development-kit,,0,1,4,1,9,5,9,1
iron,iron,,1,0,4,1,12,5,9,1
linear-search,linear-search,,7,0,10,7,29,17,0,1
dxgi,dxgi,,4,8,16,12,28,28,9,100
desktop-duplication,desktop-duplication,,3,1,4,4,10,8,9,1
mips32,mips32,,22,10,41,32,63,73,9,1
ete3,ete3,,1,1,3,2,9,5,0,1
intel-fpga,intel-fpga,,16,15,14,31,33,45,9,1
leiningen,leiningen,,14,7,39,21,67,60,2,1
facebook-apps,facebook-apps,,14,3,31,17,47,48,13,1
cgbitmapcontextcreate,cgbitmapcontextcreate,,0,1,0,1,3,1,13,1
ceylon,ceylon,,1,0,0,1,12,1,2,1
ksoap2,ksoap2,,12,5,16,17,29,33,3,1
gregorian-calendar,gregorian-calendar,,2,5,14,7,24,21,3,150
hijri,hijri,,3,2,8,5,15,13,3,1
android-snackbar,android-snackbar,,14,6,30,20,50,50,3,1
omniauth,omniauth,,18,8,35,26,83,61,12,1
openni,openni,,5,7,13,12,15,25,0,40
web-standards,web-standards,,2,3,1,5,5,6,1,50
smil,smil,,9,5,6,14,13,20,1,1
signing,signing,,27,22,47,49,103,96,3,1
jjs,jjs,,0,0,1,0,6,1,3,1
sas-dis,sas-dis,,2,2,0,4,5,4,0,1
cppsharp,cppsharp,,0,0,0,0,2,0,8,1
cartopy,cartopy,,32,48,43,80,73,123,0,50
requestscope,requestscope,,2,3,6,5,5,11,3,50
http-authentication,http-authentication,,6,9,12,15,26,27,4,50
street-address,street-address,,7,6,15,13,28,28,0,1
directed-graph,directed-graph,,23,14,27,37,50,64,0,1
comtypes,comtypes,,3,4,7,7,20,14,0,33.333333
mybb,mybb,,3,3,4,6,15,10,4,1
units-of-measurement,units-of-measurement,,12,10,16,22,32,38,0,1
qqmlengine,qqmlengine,,1,0,4,1,2,5,9,1
isis,isis,,4,1,6,5,11,11,3,1
uicontrol,uicontrol,,5,5,14,10,23,24,13,1
auto-populate,auto-populate,,8,3,3,11,17,14,5,1
python-idle,python-idle,,20,23,62,43,94,105,0,15
q-municate,q-municate,,0,0,1,0,11,1,3,1
docker-cloud,docker-cloud,,3,0,4,3,25,7,6,1
flac,flac,,5,5,11,10,14,21,13,1
nuget-server,nuget-server,,4,7,11,11,30,22,8,75
receipt-validation,receipt-validation,,11,10,14,21,32,35,13,1
snappydata,snappydata,,4,1,5,5,37,10,2,1
m4a,m4a,,4,4,13,8,16,21,13,1
hololens-emulator,hololens-emulator,,4,6,12,10,7,22,8,50
pjax,pjax,,7,6,28,13,27,41,4,1
levenshtein-distance,levenshtein-distance,,16,25,29,41,81,70,0,56.25
tarantool,tarantool,,1,9,2,10,13,12,9,800
web-animations,web-animations,,2,2,4,4,17,8,1,1
cardlayout,cardlayout,,8,6,11,14,24,25,3,1
kudu,kudu,,14,17,29,31,61,60,8,21.428571
sigaction,sigaction,,5,3,3,8,10,11,9,1
file-recovery,file-recovery,,3,2,9,5,9,14,9,1
show-hide,show-hide,,31,24,58,55,126,113,1,1
declaration,declaration,,54,56,79,110,208,189,9,3.703704
kie,kie,,16,27,36,43,74,79,3,68.75
kie-workbench,kie-workbench,,6,10,17,16,23,33,3,66.666667
kie-server,kie-server,,2,4,7,6,17,13,3,100
minimum-cut,minimum-cut,,0,0,2,0,2,2,0,1
template-function,template-function,,0,0,1,0,16,1,9,1
argument-unpacking,argument-unpacking,,5,5,8,10,16,18,0,1
fullcalendar-scheduler,fullcalendar-scheduler,,37,21,50,58,103,108,1,1
commandbutton,commandbutton,,2,6,8,8,40,16,5,200
cassandra-2.1,cassandra-2.1,,8,0,22,8,37,30,2,1
service-accounts,service-accounts,,49,40,90,89,105,179,5,1
nanomsg,nanomsg,,2,1,4,3,13,7,9,1
quantmod,quantmod,,18,23,61,41,117,102,0,27.777778
stock,stock,,41,25,68,66,105,134,4,1
performanceanalytics,performanceanalytics,,4,2,8,6,29,14,0,1
aruco,aruco,,17,11,31,28,47,59,0,1
epsilon,epsilon,,1,2,8,3,14,11,0,100
temp,temp,,15,12,22,27,35,49,4,1
argument-deduction,argument-deduction,,6,3,8,9,15,17,9,1
particles.js,particles.js,,12,11,29,23,39,52,1,1
uibackgroundtask,uibackgroundtask,,2,0,4,2,7,6,13,1
activemerchant,activemerchant,,2,0,6,2,13,8,12,1
ord,ord,,1,4,7,5,14,12,0,300
tableau-server,tableau-server,,40,22,60,62,110,122,4,1
tableau-online,tableau-online,,25,14,26,39,36,65,4,1
portrait,portrait,,4,3,7,7,15,14,3,1
phar,phar,,3,4,7,7,17,14,4,33.333333
meteor-tracker,meteor-tracker,,0,0,2,0,7,2,1,1
tcp-rst,tcp-rst,,0,0,2,0,2,2,9,1
stackify,stackify,,0,1,4,1,3,5,8,1
code-profiling,code-profiling,,1,0,2,1,5,3,8,1
typetraits,typetraits,,34,21,57,55,81,112,9,1
taskset,taskset,,1,1,1,2,4,3,9,1
rowdetails,rowdetails,,0,0,0,0,3,0,8,1
criterion,criterion,,1,0,2,1,6,3,2,1
aws-directory-services,aws-directory-services,,1,2,2,3,8,5,6,100
hyperledger-sawtooth,hyperledger-sawtooth,,9,18,46,27,35,73,6,100
webos,webos,,7,5,12,12,17,24,3,1
quadratic,quadratic,,8,2,12,10,35,22,0,1
mouse-buttons,mouse-buttons,,0,1,0,1,4,1,1,1
st-monad,st-monad,,1,0,2,1,5,3,2,1
starray,starray,,0,0,0,0,1,0,2,1
centos6.5,centos6.5,,2,0,8,2,14,10,9,1
moai,moai,,0,0,0,0,1,0,9,1
msp430,msp430,,13,6,32,19,40,51,9,1
instruction-set,instruction-set,,11,14,36,25,51,61,9,27.272727
teechart,teechart,,8,17,16,25,49,41,9,112.5
preg-match-all,preg-match-all,,38,21,48,59,119,107,4,1
iron-elements,iron-elements,,0,0,0,0,5,0,1,1
spread,spread,,29,24,23,53,38,76,0,1
laravel-migrations,laravel-migrations,,10,22,34,32,50,66,4,120
advertisement-server,advertisement-server,,2,1,6,3,5,9,3,1
wso2dss,wso2dss,,7,19,19,26,29,45,14,171.428571
swingutilities,swingutilities,,2,4,1,6,7,7,3,100
text-alignment,text-alignment,,14,16,23,30,72,53,1,14.285714
fetchxml,fetchxml,,13,11,22,24,36,46,8,1
password-hash,password-hash,,20,13,35,33,67,68,4,1
string-hashing,string-hashing,,2,0,5,2,12,7,12,1
fiware-orion,fiware-orion,,21,16,40,37,93,77,6,1
ebean,ebean,,10,9,28,19,55,47,2,1
cmsis,cmsis,,6,7,6,13,17,19,9,16.666667
chibios,chibios,,0,1,1,1,2,2,9,1
stack-navigator,stack-navigator,,21,19,45,40,143,85,1,1
skype,skype,,34,24,69,58,126,127,8,1
window.opener,window.opener,,2,3,4,5,6,9,1,50
laravel-valet,laravel-valet,,13,10,26,23,46,49,4,1
writexl,writexl,,0,3,2,3,3,5,0,200
activexobject,activexobject,,3,9,15,12,25,27,5,200
mautic,mautic,,6,9,13,15,20,28,4,50
actionevent,actionevent,,10,4,6,14,25,20,3,1
tms,tms,,2,2,3,4,9,7,9,1
log4net-appender,log4net-appender,,10,9,24,19,27,43,8,1
spy,spy,,16,15,35,31,52,66,1,1
asp.net-mail,asp.net-mail,,0,0,0,0,1,0,8,1
cordova-ios,cordova-ios,,11,10,19,21,23,40,1,1
core-motion,core-motion,,19,8,21,27,56,48,13,1
devicemotion,devicemotion,,4,2,5,6,9,11,1,1
timertask,timertask,,16,10,34,26,43,60,3,1
octobercms-backend,octobercms-backend,,21,12,36,33,66,69,4,1
multipeer-connectivity,multipeer-connectivity,,7,9,19,16,40,35,13,28.571429
nutch,nutch,,19,14,61,33,104,94,2,1
beagleboneblack,beagleboneblack,,34,14,68,48,141,116,9,1
inappbrowser,inappbrowser,,30,39,72,69,122,141,1,30
vimeo-android,vimeo-android,,1,0,1,1,12,2,1,1
pcf,pcf,,19,24,39,43,46,82,3,26.315789
pcfdev,pcfdev,,4,12,18,16,30,34,3,200
taylor-series,taylor-series,,7,1,14,8,23,22,0,1
primefaces-extensions,primefaces-extensions,,12,5,13,17,28,30,3,1
fading,fading,,1,1,4,2,9,6,1,1
avkit,avkit,,14,10,40,24,38,64,13,1
heightforrowatindexpath,heightforrowatindexpath,,0,1,2,1,12,3,13,1
nsbundle,nsbundle,,2,3,7,5,22,12,13,50
dlopen,dlopen,,14,15,25,29,65,54,9,7.142857
dlsym,dlsym,,3,3,3,6,19,9,9,1
pygrib,pygrib,,1,2,2,3,11,5,0,100
shared,shared,,18,18,45,36,91,81,9,1
overwrite,overwrite,,27,31,66,58,104,124,0,14.814815
keyvaluepair,keyvaluepair,,12,19,30,31,50,61,8,58.333333
thinking-sphinx,thinking-sphinx,,5,5,3,10,12,13,12,1
android-fusedlocation,android-fusedlocation,,9,13,26,22,62,48,3,44.444444
hwclock,hwclock,,1,0,1,1,4,2,9,1
ckrecord,ckrecord,,2,4,5,6,9,11,13,100
screen-lock,screen-lock,,3,2,4,5,4,9,3,1
iconic,iconic,,0,3,1,3,3,4,1,200
jquery-ui-tabs,jquery-ui-tabs,,7,4,10,11,27,21,1,1
sprockets,sprockets,,7,5,12,12,38,24,12,1
source-maps,source-maps,,32,35,62,67,111,129,1,9.375
scrollspy,scrollspy,,5,9,14,14,47,28,1,80
reactjs-native,reactjs-native,,1,2,4,3,4,7,1,100
dialogresult,dialogresult,,0,1,4,1,6,5,8,1
fastlane,fastlane,,66,51,102,117,180,219,13,1
fastlane-pilot,fastlane-pilot,,0,0,0,0,7,0,13,1
firefox-developer-tools,firefox-developer-tools,,15,18,20,33,80,53,1,20
bootstrapper,bootstrapper,,7,11,27,18,30,45,8,57.142857
mtu,mtu,,4,7,10,11,11,21,9,75
libstdc++,libstdc++,,13,17,34,30,58,64,9,30.769231
matplotlib-basemap,matplotlib-basemap,,48,49,70,97,184,167,0,2.083333
mousewheel,mousewheel,,15,17,33,32,61,65,1,13.333333
phpdocumentor2,phpdocumentor2,,3,0,1,3,7,4,4,1
getimagesize,getimagesize,,1,2,3,3,9,6,4,100
yii-extensions,yii-extensions,,4,2,6,6,36,12,4,1
vertical-scrolling,vertical-scrolling,,14,15,24,29,44,53,1,7.142857
topic-modeling,topic-modeling,,44,31,79,75,117,154,0,1
smarty3,smarty3,,6,8,10,14,28,24,4,33.333333
jtabbedpane,jtabbedpane,,10,8,18,18,34,36,3,1
tinyproxy,tinyproxy,,0,2,0,2,3,2,6,100
rhel5,rhel5,,2,2,3,4,11,7,9,1
difftime,difftime,,6,3,14,9,25,23,0,1
android-inflate,android-inflate,,9,6,20,15,43,35,3,1
wcf-rest,wcf-rest,,4,2,7,6,15,13,8,1
ibatis,ibatis,,17,9,22,26,56,48,3,1
django-ckeditor,django-ckeditor,,3,6,10,9,8,19,0,100
uiviewanimationtransition,uiviewanimationtransition,,4,10,13,14,25,27,13,150
kurento,kurento,,23,7,44,30,47,74,1,1
google-translation-api,google-translation-api,,20,22,30,42,27,72,1,10
iasyncresult,iasyncresult,,3,4,1,7,2,8,8,33.333333
fasta,fasta,,32,14,48,46,75,94,0,1
lottie,lottie,,31,35,41,66,87,107,13,12.903226
jeditorpane,jeditorpane,,3,3,10,6,16,16,3,1
smartcard-reader,smartcard-reader,,8,7,12,15,33,27,3,1
spread-syntax,spread-syntax,,16,12,57,28,95,85,1,1
puppet-enterprise,puppet-enterprise,,8,7,15,15,37,30,6,1
jscript,jscript,,16,24,58,40,89,98,1,50
custom-tag,custom-tag,,0,1,4,1,3,5,1,1
wireshark-dissector,wireshark-dissector,,11,11,10,22,25,32,9,1
performancecounter,performancecounter,,16,9,20,25,59,45,8,1
apple-vpp,apple-vpp,,3,1,2,4,7,6,13,1
nsbox,nsbox,,1,0,4,1,3,5,13,1
nsstackview,nsstackview,,1,5,3,6,4,9,13,400
multipart,multipart,,56,58,114,114,166,228,3,3.571429
c-libraries,c-libraries,,0,0,2,0,5,2,9,1
postgresql-9.2,postgresql-9.2,,13,4,17,17,59,34,4,1
cancellation,cancellation,,20,13,30,33,65,63,8,1
elasticsearch-2.0,elasticsearch-2.0,,5,3,16,8,32,24,6,1
autodesk-designautomation,autodesk-designautomation,,12,13,21,25,14,46,14,8.333333
mshtml,mshtml,,7,6,6,13,26,19,8,1
iwebbrowser2,iwebbrowser2,,4,2,5,6,12,11,9,1
redash,redash,,6,9,11,15,15,26,4,50
webpage-rendering,webpage-rendering,,0,2,3,2,14,5,1,100
proof-of-correctness,proof-of-correctness,,7,3,4,10,10,14,2,1
activex,activex,,46,39,86,85,183,171,5,1
lossless-compression,lossless-compression,,2,2,9,4,17,13,0,1
android-seekbar,android-seekbar,,12,21,35,33,76,68,3,75
difference-between-rows,difference-between-rows,,0,0,1,0,1,1,4,1
font-face,font-face,,41,42,66,83,175,149,1,2.439024
leadtools-sdk,leadtools-sdk,,2,2,3,4,8,7,8,1
dockerpy,dockerpy,,7,6,17,13,28,30,6,1
java-calendar,java-calendar,,4,4,7,8,14,15,3,1
angular-permission,angular-permission,,1,0,3,1,2,4,1,1
windows-xp,windows-xp,,7,6,30,13,67,43,9,1
notification-icons,notification-icons,,1,0,2,1,7,3,13,1
icecast,icecast,,6,10,25,16,53,41,13,66.666667
smartsvn,smartsvn,,0,1,3,1,2,4,6,1
falconframework,falconframework,,17,7,17,24,36,41,0,1
autoplay,autoplay,,18,17,51,35,90,86,1,1
lcov,lcov,,12,7,15,19,26,34,9,1
blockingqueue,blockingqueue,,8,14,12,22,46,34,3,75
socket.io-java-client,socket.io-java-client,,2,1,1,3,8,4,1,1
find-occurrences,find-occurrences,,11,8,20,19,44,39,0,1
dojox.grid.datagrid,dojox.grid.datagrid,,3,2,14,5,20,19,1,1
nunit-3.0,nunit-3.0,,23,11,41,34,88,75,8,1
ng-container,ng-container,,8,4,10,12,12,22,1,1
magnitude,magnitude,,5,1,3,6,8,9,0,1
vagrant-windows,vagrant-windows,,6,5,20,11,31,31,4,1
scoreloop,scoreloop,,0,0,1,0,1,1,8,1
angular-leaflet-directive,angular-leaflet-directive,,2,0,6,2,17,8,1,1
xml-attribute,xml-attribute,,4,6,10,10,16,20,3,50
tinyxml2,tinyxml2,,1,3,5,4,10,9,9,200
acaccount,acaccount,,0,0,1,0,1,1,13,1
slrequest,slrequest,,0,0,0,0,1,0,13,1
angular5,angular5,,264,113,1189,377,4813,1566,1,1
vp9,vp9,,3,1,6,4,12,10,13,1
page-load-time,page-load-time,,4,4,6,8,29,14,1,1
httpwatch,httpwatch,,0,0,1,0,2,1,1,1
visualvm,visualvm,,10,5,21,15,39,36,3,1
titanium-alloy,titanium-alloy,,6,3,8,9,25,17,13,1
vcs-checkout,vcs-checkout,,0,0,3,0,19,3,6,1
skyscanner,skyscanner,,0,0,2,0,2,2,4,1
xlutils,xlutils,,1,0,5,1,8,6,0,1
pairing,pairing,,2,8,21,10,31,31,3,300
java-money,java-money,,1,0,4,1,7,5,3,1
threadabortexception,threadabortexception,,2,1,1,3,7,4,8,1
thread-exceptions,thread-exceptions,,2,0,4,2,4,6,3,1
atlassian-localstack,atlassian-localstack,,17,10,18,27,19,45,6,1
aws-sam-cli,aws-sam-cli,,33,24,47,57,68,104,6,1
configurable-product,configurable-product,,2,3,3,5,15,8,4,50
insert-into,insert-into,,18,2,42,20,108,62,4,1
ring,ring,,6,5,10,11,29,21,2,1
devextreme,devextreme,,29,35,64,64,105,128,1,20.689655
dimensional,dimensional,,3,1,3,4,10,7,1,1
effects,effects,,10,9,22,19,49,41,1,1
projector,projector,,3,2,3,5,11,8,0,1
campaign-monitor,campaign-monitor,,1,4,5,5,13,10,4,300
actionbardrawertoggle,actionbardrawertoggle,,0,1,1,1,2,2,3,1
clpfd,clpfd,,13,3,16,16,34,32,0,1
checklistbox,checklistbox,,3,1,11,4,13,15,8,1
api-versioning,api-versioning,,9,5,12,14,29,26,8,1
failed-installation,failed-installation,,14,31,40,45,119,85,0,121.428571
maven-jaxb2-plugin,maven-jaxb2-plugin,,4,5,16,9,32,25,3,25
nightwatch.js,nightwatch.js,,68,50,110,118,285,228,3,1
robocopy,robocopy,,28,24,54,52,77,106,9,1
redisclient,redisclient,,3,1,3,4,4,7,3,1
gnu-parallel,gnu-parallel,,22,18,34,40,66,74,9,1
overlapping-matches,overlapping-matches,,1,0,1,1,7,2,0,1
facebook-sharer,facebook-sharer,,2,1,10,3,23,13,13,1
weak-linking,weak-linking,,2,0,0,2,6,2,9,1
ampl,ampl,,17,19,25,36,26,61,0,11.764706
twitter4j,twitter4j,,16,10,30,26,65,56,3,1
projection-matrix,projection-matrix,,7,3,12,10,19,22,0,1
deprecation-warning,deprecation-warning,,14,12,24,26,60,50,3,1
flexdashboard,flexdashboard,,38,40,66,78,84,144,0,5.263158
laradock,laradock,,21,18,35,39,46,74,6,1
drush,drush,,15,7,15,22,24,37,4,1
type-deduction,type-deduction,,5,14,25,19,40,44,9,180
array-filter,array-filter,,5,9,22,14,45,36,1,80
atlassian-connect,atlassian-connect,,1,2,0,3,9,3,6,100
composite,composite,,18,15,25,33,62,58,3,1
httpfs,httpfs,,1,0,3,1,4,4,2,1
sicp,sicp,,16,7,13,23,38,36,0,1
chicken-scheme,chicken-scheme,,0,2,6,2,13,8,0,100
scope-identity,scope-identity,,3,1,2,4,9,6,4,1
throw,throw,,24,6,34,30,72,64,3,1
msmq,msmq,,10,13,25,23,63,48,8,30
mojo,mojo,,7,6,4,13,11,17,3,1
horizontal-scaling,horizontal-scaling,,4,5,15,9,24,24,6,25
amazon-rekognition,amazon-rekognition,,24,20,39,44,80,83,6,1
building,building,,10,10,23,20,29,43,9,1
scala-generics,scala-generics,,0,0,0,0,24,0,2,1
imebra,imebra,,1,0,1,1,2,2,13,1
akka.net-streams,akka.net-streams,,1,1,2,2,4,4,8,1
griddle,griddle,,0,1,4,1,10,5,1,1
albumart,albumart,,3,2,5,5,16,10,3,1
ruby-1.9.3,ruby-1.9.3,,1,0,2,1,6,3,12,1
grails-2.3,grails-2.3,,0,1,1,1,2,2,3,1
grails-2.4,grails-2.4,,1,1,2,2,7,4,3,1
grails-2.2,grails-2.2,,5,5,2,10,10,12,3,1
pg,pg,,19,16,45,35,68,80,4,1
ibm-doors,ibm-doors,,9,10,5,19,12,24,5,11.111111
delphi-xe7,delphi-xe7,,6,3,16,9,31,25,9,1
joomla-template,joomla-template,,2,1,1,3,3,4,4,1
joomla-component,joomla-component,,1,2,0,3,8,3,4,100
ios-bluetooth,ios-bluetooth,,12,8,22,20,40,42,13,1
app-themes,app-themes,,0,0,0,0,7,0,3,1
jquery-hotkeys,jquery-hotkeys,,0,0,0,0,1,0,1,1
google-contacts-api,google-contacts-api,,19,19,49,38,78,87,5,1
webdriverwait,webdriverwait,,162,202,265,364,97,629,3,24.691358
google-vision,google-vision,,48,55,89,103,150,192,3,14.583333
certificate-error,certificate-error,,0,1,2,1,2,3,3,1
ext4,ext4,,7,4,13,11,20,24,9,1
command-substitution,command-substitution,,4,0,8,4,13,12,9,1
uiactivityviewcontroller,uiactivityviewcontroller,,19,18,42,37,94,79,13,1
strstr,strstr,,2,3,11,5,16,16,9,50
bootstrap-select,bootstrap-select,,18,19,43,37,78,80,1,5.555556
bootstrap-selectpicker,bootstrap-selectpicker,,17,16,41,33,59,74,1,1
angularjs-http,angularjs-http,,9,7,7,16,46,23,1,1
angularjs-q,angularjs-q,,4,0,0,4,1,4,1,1
imagebutton,imagebutton,,13,14,34,27,60,61,3,7.692308
offlineapps,offlineapps,,5,7,14,12,44,26,1,40
oracle-fdw,oracle-fdw,,0,1,3,1,4,4,4,1
xml-documentation,xml-documentation,,5,9,12,14,23,26,8,80
weighted,weighted,,14,22,21,36,38,57,0,57.142857
jfrog-cli,jfrog-cli,,22,13,25,35,68,60,6,1
sling,sling,,16,11,32,27,81,59,3,1
stackpanel,stackpanel,,6,4,13,10,24,23,8,1
identity-column,identity-column,,7,6,10,13,18,23,4,1
packer,packer,,25,30,51,55,102,106,6,20
post-processor,post-processor,,3,1,6,4,2,10,3,1
readonly-attribute,readonly-attribute,,2,9,10,11,17,21,1,350
six,six,,4,2,3,6,18,9,0,1
signalr.client,signalr.client,,28,22,46,50,86,96,8,1
absolutelayout,absolutelayout,,3,2,8,5,8,13,8,1
boost-ublas,boost-ublas,,1,2,0,3,4,3,9,100
insertion,insertion,,12,8,21,20,35,41,0,1
cc,cc,,7,6,9,13,21,22,9,1
odoo-wizard,odoo-wizard,,0,0,0,0,2,0,0,1
google-maps-react,google-maps-react,,12,11,20,23,22,43,1,1
hapi-fhir,hapi-fhir,,7,3,6,10,13,16,14,1
snomed-ct,snomed-ct,,0,1,3,1,7,4,2,1
dhtmlx-scheduler,dhtmlx-scheduler,,4,2,6,6,9,12,1,1
iphone-softkeyboard,iphone-softkeyboard,,2,1,1,3,2,4,13,1
applicative,applicative,,19,12,29,31,51,60,2,1
slide,slide,,16,13,30,29,71,59,1,1
cox-regression,cox-regression,,18,21,30,39,47,69,0,16.666667
ng2-admin,ng2-admin,,1,0,1,1,3,2,1,1
blur-admin,blur-admin,,2,0,1,2,6,3,1,1
android-recents,android-recents,,1,3,10,4,15,14,3,200
ng-ckeditor,ng-ckeditor,,0,0,1,0,4,1,1,1
jitter,jitter,,5,2,16,7,22,23,0,1
betfair,betfair,,2,0,5,2,5,7,0,1
runtimeexception,runtimeexception,,16,16,43,32,90,75,3,1
react-native-sound,react-native-sound,,3,5,9,8,5,17,1,66.666667
cisco,cisco,,33,30,45,63,89,108,6,1
twitter-share,twitter-share,,1,2,2,3,9,5,0,100
compare-contrast,compare-contrast,,1,0,1,1,1,2,0,1
file-read,file-read,,15,15,39,30,58,69,0,1
vision,vision,,38,28,57,66,58,123,0,1
azure-cdn,azure-cdn,,20,22,38,42,42,80,8,10
brokenimage,brokenimage,,1,1,3,2,8,5,1,1
lazyload,lazyload,,8,22,19,30,18,49,1,175
sql-server-2014-express,sql-server-2014-express,,7,3,14,10,33,24,4,1
django-pipeline,django-pipeline,,2,0,0,2,5,2,0,1
comparable,comparable,,23,21,46,44,99,90,3,1
ringdroid,ringdroid,,0,0,0,0,1,0,3,1
nsnumberformatter,nsnumberformatter,,4,4,9,8,32,17,13,1
cloning,cloning,,3,6,14,9,27,23,6,100
ply,ply,,9,3,23,12,39,35,0,1
exec-maven-plugin,exec-maven-plugin,,7,5,10,12,22,22,3,1
str-to-date,str-to-date,,3,0,7,3,13,10,4,1
django-mptt,django-mptt,,6,2,15,8,30,23,0,1
mockserver,mockserver,,8,8,14,16,20,30,3,1
dotvvm,dotvvm,,1,5,3,6,18,9,8,400
atg,atg,,7,2,14,9,28,23,3,1
dynamics-ax-2012,dynamics-ax-2012,,10,13,28,23,53,51,8,30
request-headers,request-headers,,10,21,39,31,63,70,4,110
notsupportedexception,notsupportedexception,,1,2,6,3,10,9,8,100
grepl,grepl,,24,34,53,58,82,111,0,41.666667
serenity-js,serenity-js,,10,3,13,13,14,26,3,1
ruby-on-rails-4.1,ruby-on-rails-4.1,,0,0,2,0,4,2,12,1
maven-reactor,maven-reactor,,3,1,2,4,6,6,3,1
greenrobot-eventbus-3.0,greenrobot-eventbus-3.0,,4,1,5,5,11,10,3,1
cruisecontrol,cruisecontrol,,1,0,0,1,2,1,8,1
dinghy,dinghy,,0,0,1,0,2,1,6,1
iron-router,iron-router,,2,1,5,3,25,8,1,1
garmin,garmin,,4,4,6,8,12,14,3,1
connectiq,connectiq,,2,2,3,4,3,7,3,1
react-native-snap-carousel,react-native-snap-carousel,,3,6,4,9,11,13,1,100
dynamic-linq,dynamic-linq,,9,6,16,15,35,31,8,1
typeinitializeexception,typeinitializeexception,,0,0,1,0,6,1,8,1
pygame-clock,pygame-clock,,5,3,0,8,6,8,0,1
pygame-tick,pygame-tick,,0,0,1,0,2,1,0,1
choice,choice,,7,5,24,12,32,36,0,1
input-buffer,input-buffer,,2,1,2,3,6,5,9,1
security-context,security-context,,5,2,5,7,8,12,3,1
easynetq,easynetq,,11,6,12,17,12,29,8,1
rabbitmqctl,rabbitmqctl,,7,4,4,11,30,15,3,1
azure-files,azure-files,,18,14,25,32,41,57,8,1
columnheader,columnheader,,3,5,7,8,12,15,0,66.666667
emftext,emftext,,0,0,0,0,2,0,3,1
jamopp,jamopp,,1,0,0,1,1,1,3,1
mysql-8.0,mysql-8.0,,34,48,70,82,66,152,4,41.176471
nsvisualeffectview,nsvisualeffectview,,1,1,2,2,6,4,13,1
powershell-workflow,powershell-workflow,,4,1,6,5,14,11,8,1
generated,generated,,2,3,6,5,12,11,13,50
spool,spool,,3,4,11,7,23,18,4,33.333333
openfire,openfire,,14,7,33,21,81,54,3,1
aleph,aleph,,1,0,0,1,8,1,0,1
variadic,variadic,,16,15,25,31,46,56,9,1
serverless-architecture,serverless-architecture,,3,6,8,9,34,17,6,100
codex,codex,,2,2,0,4,8,4,4,1
r-xlsx,r-xlsx,,6,5,7,11,22,18,0,1
uninstall,uninstall,,23,26,61,49,137,110,8,13.043478
exoplayer2.x,exoplayer2.x,,66,57,71,123,101,194,3,1
android-textattributes,android-textattributes,,0,0,3,0,5,3,3,1
pscustomobject,pscustomobject,,8,1,2,9,14,11,8,1
tripledes,tripledes,,7,6,11,13,16,24,6,1
digital-design,digital-design,,1,2,3,3,6,6,9,100
xwpf,xwpf,,6,2,15,8,22,23,3,1
oneplusx,oneplusx,,0,0,2,0,1,2,3,1
simscape,simscape,,1,4,7,5,5,12,0,300
dbml,dbml,,1,1,5,2,9,7,8,1
switchery,switchery,,0,1,2,1,3,3,1,1
meteor-cordova,meteor-cordova,,0,0,1,0,2,1,1,1
verify,verify,,15,16,26,31,53,57,4,6.666667
pydrive,pydrive,,13,14,13,27,39,40,0,7.692308
sessionfactory,sessionfactory,,7,0,16,7,29,23,3,1
nsurlconnectiondelegate,nsurlconnectiondelegate,,1,0,1,1,2,2,13,1
antlrworks,antlrworks,,1,1,0,2,12,2,0,1
adsense-api,adsense-api,,8,9,7,17,10,24,3,12.5
pawn,pawn,,0,0,0,0,4,0,0,1
assembla,assembla,,0,0,3,0,5,3,6,1
flask-admin,flask-admin,,32,26,46,58,78,104,0,1
fuzzy,fuzzy,,13,10,25,23,32,48,0,1
fileloadexception,fileloadexception,,1,0,3,1,7,4,8,1
intl-tel-input,intl-tel-input,,7,9,12,16,18,28,1,28.571429
ota,ota,,11,11,13,22,27,35,9,1
mongo-shell,mongo-shell,,16,18,23,34,67,57,1,12.5
jboss-developer-studio,jboss-developer-studio,,2,2,10,4,22,14,3,1
teiid,teiid,,2,3,3,5,23,8,3,50
wordpress-admin,wordpress-admin,,9,4,12,13,24,25,4,1
recyclerview-layout,recyclerview-layout,,46,20,97,66,189,163,3,1
photo-gallery,photo-gallery,,12,7,17,19,38,36,13,1
sample-data,sample-data,,3,2,6,5,7,11,0,1
memory-alignment,memory-alignment,,21,19,45,40,78,85,9,1
pointer-conversion,pointer-conversion,,1,1,2,2,1,4,9,1
sinch,sinch,,10,5,35,15,59,50,13,1
db2-luw,db2-luw,,28,26,51,54,118,105,4,1
magento-1.4,magento-1.4,,0,3,4,3,4,7,4,200
freeradius,freeradius,,16,17,39,33,50,72,9,6.25
string-operations,string-operations,,1,4,3,5,13,8,0,300
name-mangling,name-mangling,,5,5,11,10,9,21,9,1
extern-c,extern-c,,1,3,2,4,4,6,9,200
jquery-ui-slider-pips,jquery-ui-slider-pips,,0,0,2,0,3,2,1,1
web-frameworks,web-frameworks,,8,12,13,20,28,33,0,50
fasterxml,fasterxml,,14,11,36,25,62,61,3,1
kendo-tooltip,kendo-tooltip,,2,2,1,4,9,5,1,1
live-tile,live-tile,,0,1,1,1,5,2,8,1
twitch,twitch,,20,13,53,33,90,86,1,1
nclob,nclob,,1,0,2,1,3,3,4,1
message-channel,message-channel,,0,0,6,0,4,6,1,1
mobilefirst-adapters,mobilefirst-adapters,,1,1,14,2,46,16,13,1
radcombobox,radcombobox,,5,3,5,8,7,13,8,1
ansible-tower,ansible-tower,,20,20,31,40,21,71,6,1
android-tabbed-activity,android-tabbed-activity,,2,8,6,10,20,16,3,300
openstack-nova,openstack-nova,,9,9,27,18,47,45,6,1
testthat,testthat,,13,12,24,25,43,49,0,1
findviewbyid,findviewbyid,,7,9,18,16,58,34,3,28.571429
scrollable,scrollable,,8,8,16,16,28,32,1,1
ansible-ad-hoc,ansible-ad-hoc,,2,0,2,2,3,4,6,1
android-sharing,android-sharing,,5,2,6,7,35,13,3,1
authorize-attribute,authorize-attribute,,8,7,19,15,32,34,8,1
form-authentication,form-authentication,,0,0,0,0,17,0,8,1
vqmod,vqmod,,2,0,3,2,5,5,4,1
opencart2.3,opencart2.3,,3,12,12,15,53,27,4,300
blocked,blocked,,5,5,4,10,14,14,4,1
pre-commit-hook,pre-commit-hook,,11,9,18,20,41,38,6,1
progress-indicator,progress-indicator,,0,2,3,2,9,5,3,100
splfileobject,splfileobject,,1,0,1,1,5,2,4,1
mutating-table,mutating-table,,3,0,3,3,6,6,4,1
concordion,concordion,,0,1,3,1,7,4,3,1
unique-index,unique-index,,5,6,8,11,30,19,4,20
winjs,winjs,,1,3,8,4,29,12,8,200
ifnull,ifnull,,5,4,5,9,13,14,4,1
matchmaking,matchmaking,,2,0,4,2,7,6,8,1
acid,acid,,8,6,19,14,23,33,3,1
orchardcms-1.10,orchardcms-1.10,,0,2,9,2,16,11,8,100
launchmode,launchmode,,1,1,6,2,19,8,3,1
gopath,gopath,,3,0,16,3,18,19,6,1
azure-container-registry,azure-container-registry,,22,14,37,36,57,73,8,1
virtuoso,virtuoso,,11,9,14,20,58,34,2,1
federated-identity,federated-identity,,9,10,21,19,51,40,6,11.111111
android-nestedscrollview,android-nestedscrollview,,33,38,77,71,155,148,3,15.151515
linq.js,linq.js,,2,1,2,3,6,5,1,1
google-analytics-filters,google-analytics-filters,,7,13,23,20,30,43,5,85.714286
lerp,lerp,,5,2,20,7,22,27,8,1
dhcp,dhcp,,15,23,43,38,54,81,9,53.333333
my.cnf,my.cnf,,3,0,8,3,16,11,4,1
google-url-shortener,google-url-shortener,,3,1,9,4,27,13,4,1
extjs6.2,extjs6.2,,7,4,6,11,28,17,1,1
itemselector,itemselector,,1,0,2,1,5,3,1,1
amazon-rds-aurora,amazon-rds-aurora,,54,56,98,110,143,208,6,3.703704
dill,dill,,8,14,20,22,33,42,0,75
scalacheck,scalacheck,,8,2,6,10,19,16,2,1
iformfile,iformfile,,6,6,13,12,13,25,8,1
google-cloud-logging,google-cloud-logging,,5,15,18,20,31,38,6,200
hyphen,hyphen,,25,33,11,58,29,69,0,32
datacontractserializer,datacontractserializer,,6,1,14,7,38,21,8,1
jquery-knob,jquery-knob,,1,2,1,3,4,4,1,100
android-5.1.1-lollipop,android-5.1.1-lollipop,,1,8,9,9,23,18,3,700
nmea,nmea,,6,7,12,13,22,25,3,16.666667
ipdb,ipdb,,7,7,9,14,21,23,0,1
bandpass-filter,bandpass-filter,,3,1,5,4,7,9,0,1
butterworth,butterworth,,2,2,8,4,13,12,0,1
borrowing,borrowing,,12,14,40,26,42,66,9,16.666667
rmdir,rmdir,,2,1,2,3,12,5,9,1
bootstrapvalidator,bootstrapvalidator,,6,4,12,10,30,22,1,1
smartscreen,smartscreen,,4,2,3,6,7,9,13,1
azure-availability-set,azure-availability-set,,2,2,6,4,12,10,8,1
summarize,summarize,,28,21,42,49,86,91,0,1
elastica,elastica,,9,3,13,12,17,25,4,1
xmlwriter,xmlwriter,,4,6,15,10,20,25,8,50
hyperjaxb,hyperjaxb,,1,0,1,1,3,2,3,1
html5-filesystem,html5-filesystem,,3,2,9,5,11,14,1,1
styledtext,styledtext,,0,0,0,0,3,0,3,1
getopts,getopts,,12,9,13,21,50,34,9,1
msys2,msys2,,29,20,64,49,86,113,9,1
gconf,gconf,,0,0,0,0,2,0,9,1
hdf,hdf,,15,14,21,29,45,50,0,1
django-swagger,django-swagger,,3,1,2,4,5,6,0,1
django-rest-swagger,django-rest-swagger,,3,3,6,6,14,12,0,1
react-router-relay,react-router-relay,,0,0,0,0,1,0,1,1
kotlin-reflect,kotlin-reflect,,1,6,18,7,23,25,3,500
android-instrumentation,android-instrumentation,,22,21,44,43,59,87,3,1
expresso,expresso,,1,0,1,1,4,2,3,1
nsdocument,nsdocument,,4,4,19,8,26,27,13,1
nscoder,nscoder,,3,1,4,4,16,8,13,1
chunks,chunks,,24,34,50,58,90,108,0,41.666667
memory-efficient,memory-efficient,,10,2,16,12,45,28,0,1
exim,exim,,6,5,9,11,23,20,4,1
kparts,kparts,,0,0,1,0,1,1,9,1
multi-project,multi-project,,13,4,11,17,32,28,3,1
rocksdb,rocksdb,,31,21,41,52,35,93,2,1
web-frontend,web-frontend,,37,13,92,50,122,142,1,1
jtextpane,jtextpane,,7,4,25,11,28,36,3,1
symfony-2.1,symfony-2.1,,0,2,12,2,29,14,4,100
objectdb,objectdb,,0,1,3,1,7,4,3,1
p-value,p-value,,22,30,53,52,61,105,0,36.363636
file-put-contents,file-put-contents,,8,4,20,12,24,32,4,1
react-css-modules,react-css-modules,,5,7,17,12,32,29,1,40
babel-plugin-react-css-modules,babel-plugin-react-css-modules,,0,2,7,2,13,9,1,100
microsoft-cognitive,microsoft-cognitive,,48,53,107,101,300,208,8,10.416667
jtds,jtds,,7,9,18,16,23,34,3,28.571429
xbox,xbox,,8,10,31,18,27,49,8,25
xbox-one,xbox-one,,7,6,9,13,27,22,8,1
graph-visualization,graph-visualization,,20,14,27,34,48,61,0,1
dagre,dagre,,5,1,2,6,10,8,1,1
webfont-loader,webfont-loader,,0,6,3,6,6,9,1,500
zpl-ii,zpl-ii,,2,4,9,6,18,15,3,100
custom-url,custom-url,,4,0,4,4,8,8,13,1
arr,arr,,9,11,16,20,40,36,8,22.222222
television,television,,18,17,28,35,43,63,3,1
smart-tv,smart-tv,,7,7,7,14,17,21,3,1
mongodb-update,mongodb-update,,2,2,3,4,15,7,1,1
breeze-sharp,breeze-sharp,,0,0,2,0,3,2,8,1
bbc-microbit,bbc-microbit,,7,8,13,15,18,28,0,14.285714
kotlin-reified-type-parameters,kotlin-reified-type-parameters,,2,3,5,5,10,10,3,50
twain,twain,,5,4,13,9,16,22,8,1
wia,wia,,4,3,7,7,16,14,8,1
android-maps-utils,android-maps-utils,,2,2,4,4,7,8,3,1
node-fetch,node-fetch,,9,11,23,20,31,43,1,22.222222
postgresql-9.5,postgresql-9.5,,49,43,147,92,177,239,4,1
sqoop2,sqoop2,,12,3,15,15,18,30,2,1
custom-data-attribute,custom-data-attribute,,16,12,45,28,108,73,1,1
android-looper,android-looper,,6,4,7,10,20,17,3,1
oracle-adf,oracle-adf,,38,22,88,60,118,148,3,1
oracle-ebs,oracle-ebs,,14,9,20,23,21,43,4,1
jfrog-mission-control,jfrog-mission-control,,1,2,0,3,7,3,6,100
string-interpolation,string-interpolation,,24,30,60,54,106,114,1,25
ringtone,ringtone,,7,6,12,13,26,25,3,1
display-manager,display-manager,,1,2,4,3,5,7,9,100
event-viewer,event-viewer,,6,9,19,15,35,34,8,50
httpverbs,httpverbs,,3,5,7,8,18,15,8,66.666667
mknod,mknod,,1,0,1,1,2,2,9,1
model-view,model-view,,4,5,6,9,19,15,9,25
netbeans-7,netbeans-7,,0,1,6,1,12,7,3,1
asp.net-mvc-2,asp.net-mvc-2,,4,3,3,7,9,10,8,1
onscroll,onscroll,,7,4,17,11,26,28,1,1
dsymutil,dsymutil,,0,0,1,0,1,1,13,1
google-smart-home,google-smart-home,,9,13,25,22,38,47,13,44.444444
augeas,augeas,,0,0,1,0,5,1,6,1
msxml6,msxml6,,4,6,3,10,7,13,5,50
celementtree,celementtree,,3,1,6,4,7,10,0,1
python-attrs,python-attrs,,3,2,10,5,15,15,0,1
galsim,galsim,,1,0,1,1,2,2,0,1
smartsheet-api,smartsheet-api,,10,13,26,23,53,49,8,30
datacolumn,datacolumn,,3,4,2,7,17,9,8,33.333333
zapier,zapier,,56,52,102,108,177,210,4,1
identifier,identifier,,11,7,27,18,72,45,9,1
yuv,yuv,,14,11,41,25,69,66,3,1
sofia-sip,sofia-sip,,0,0,1,0,1,1,9,1
as.date,as.date,,8,14,19,22,40,41,0,75
x3d,x3d,,3,2,4,5,10,9,1,1
vrml,vrml,,5,1,0,6,6,6,0,1
idl-programming-language,idl-programming-language,,7,7,13,14,30,27,0,1
gdl,gdl,,0,0,0,0,3,0,0,1
time4j,time4j,,2,1,0,3,5,3,3,1
winsock2,winsock2,,19,23,34,42,74,76,9,21.052632
shared-worker,shared-worker,,1,0,3,1,12,4,1,1
lovefield,lovefield,,0,0,0,0,3,0,1,1
area,area,,25,25,47,50,100,97,0,1
dotspatial,dotspatial,,2,0,4,2,8,6,8,1
mxgraph,mxgraph,,33,35,45,68,64,113,1,6.060606
elasticsearch-api,elasticsearch-api,,4,3,1,7,6,8,6,1
omniorb,omniorb,,6,2,1,8,6,9,9,1
xmonad,xmonad,,5,1,8,6,12,14,2,1
git-flow,git-flow,,31,28,51,59,122,110,6,1
ngresource,ngresource,,4,5,4,9,18,13,1,25
presentviewcontroller,presentviewcontroller,,9,7,14,16,55,30,13,1
sql-manager,sql-manager,,2,0,2,2,3,4,4,1
viper,viper,,4,5,8,9,16,17,13,25
countdownlatch,countdownlatch,,7,1,6,8,14,14,3,1
rythm,rythm,,0,0,0,0,2,0,3,1
nnet,nnet,,2,9,4,11,17,15,0,350
jpa-2.0,jpa-2.0,,32,39,80,71,141,151,3,21.875
avconv,avconv,,7,3,3,10,22,13,13,1
opensaml,opensaml,,8,10,17,18,39,35,8,25
watchpoint,watchpoint,,2,0,5,2,8,7,9,1
orika,orika,,7,5,5,12,25,17,3,1
callable-object,callable-object,,3,3,2,6,10,8,0,1
cldr,cldr,,1,1,5,2,7,7,9,1
webfaction,webfaction,,3,1,6,4,12,10,0,1
bittorrent,bittorrent,,9,10,25,19,39,44,9,11.111111
torrent,torrent,,6,8,20,14,24,34,9,33.333333
magnet-uri,magnet-uri,,1,2,5,3,6,8,9,100
dynamic-arrays,dynamic-arrays,,31,16,54,47,129,101,9,1
stretch,stretch,,5,4,18,9,34,27,1,1
matcher,matcher,,10,22,27,32,66,59,3,120
pybluez,pybluez,,7,8,16,15,21,31,3,14.285714
skaction,skaction,,9,2,20,11,47,31,13,1
payumoney,payumoney,,8,12,24,20,49,44,4,50
pg-promise,pg-promise,,14,20,38,34,91,72,1,42.857143
iscroll,iscroll,,3,3,1,6,8,7,1,1
mkmapview,mkmapview,,33,27,71,60,200,131,13,1
mutation-observers,mutation-observers,,20,14,36,34,69,70,1,1
r-bigmemory,r-bigmemory,,1,2,7,3,21,10,0,100
visnetwork,visnetwork,,10,13,27,23,37,50,0,30
teradata-aster,teradata-aster,,0,0,3,0,4,3,4,1
aster,aster,,0,0,6,0,3,6,4,1
pwm,pwm,,18,7,27,25,46,52,9,1
kdc,kdc,,4,4,2,8,2,10,2,1
avcapture,avcapture,,6,7,14,13,19,27,13,16.666667
avcapturemoviefileoutput,avcapturemoviefileoutput,,1,1,2,2,6,4,13,1
system.timers.timer,system.timers.timer,,4,1,10,5,10,15,8,1
wp-list-categories,wp-list-categories,,0,2,8,2,10,10,4,100
googlemock,googlemock,,16,15,21,31,50,52,9,1
business-layer,business-layer,,1,0,1,1,4,2,8,1
django-tables2,django-tables2,,23,23,45,46,77,91,0,1
node.js-addon,node.js-addon,,16,7,33,23,37,56,1,1
mobiledoc-kit,mobiledoc-kit,,0,0,1,0,2,1,1,1
extending-classes,extending-classes,,1,1,3,2,8,5,9,1
dust.js,dust.js,,1,2,7,3,12,10,1,100
math.h,math.h,,7,3,17,10,22,27,9,1
oledbdataadapter,oledbdataadapter,,3,1,7,4,21,11,8,1
ati,ati,,1,0,3,1,4,4,9,1
graphite,graphite,,23,16,54,39,78,93,6,1
graphite-carbon,graphite-carbon,,2,2,11,4,20,15,6,1
self-referencing-table,self-referencing-table,,2,1,5,3,11,8,4,1
dcg,dcg,,9,3,13,12,22,25,0,1
qgridlayout,qgridlayout,,2,5,11,7,19,18,0,150
reactiveui,reactiveui,,35,34,58,69,110,127,8,1
jquery-scrollify,jquery-scrollify,,1,3,9,4,13,13,1,200
createelement,createelement,,10,11,22,21,36,43,1,10
getattr,getattr,,3,8,16,11,29,27,0,166.666667
maven-tomcat-plugin,maven-tomcat-plugin,,0,1,10,1,15,11,3,1
checkeditems,checkeditems,,0,0,0,0,2,0,8,1
fpm,fpm,,12,21,55,33,91,88,4,75
paginator,paginator,,10,12,27,22,29,49,1,20
expandablelistadapter,expandablelistadapter,,5,4,10,9,55,19,3,1
junit5,junit5,,130,124,250,254,346,504,3,1
playing-cards,playing-cards,,3,5,10,8,34,18,0,66.666667
database-restore,database-restore,,6,15,29,21,58,50,4,150
onerror,onerror,,9,4,18,13,23,31,1,1
rdfs,rdfs,,10,4,24,14,62,38,2,1
triplestore,triplestore,,7,0,8,7,28,15,2,1
forward-engineer,forward-engineer,,1,2,2,3,2,5,4,100
webservice-client,webservice-client,,23,19,44,42,53,86,3,1
single-instance,single-instance,,4,1,5,5,10,10,3,1
spidermonkey,spidermonkey,,8,2,6,10,14,16,1,1
lexical-scope,lexical-scope,,4,2,9,6,30,15,1,1
cross-reference,cross-reference,,10,7,13,17,26,30,0,1
xdotool,xdotool,,3,5,10,8,15,18,9,66.666667
netcat,netcat,,17,21,49,38,81,87,9,23.529412
statsd,statsd,,9,12,15,21,30,36,6,33.333333
gambling,gambling,,0,1,2,1,15,3,0,1
junit-jupiter,junit-jupiter,,5,3,21,8,14,29,3,1
rfc822,rfc822,,5,4,4,9,6,13,4,1
toolbox,toolbox,,7,7,15,14,18,29,8,1
msbuild-task,msbuild-task,,10,8,38,18,48,56,8,1
maskedinput,maskedinput,,4,0,4,4,4,8,1,1
cider,cider,,1,1,14,2,15,16,2,1
nrepl,nrepl,,0,0,2,0,6,2,2,1
figwheel,figwheel,,2,6,4,8,14,12,2,200
bc,bc,,5,6,14,11,22,25,9,20
dwscript,dwscript,,0,1,2,1,3,3,9,1
payment-processing,payment-processing,,13,7,17,20,38,37,4,1
profiles,profiles,,0,0,0,0,9,0,3,1
apparmor,apparmor,,5,2,9,7,10,16,6,1
nms,nms,,7,6,3,13,6,16,8,1
affiliate,affiliate,,5,5,9,10,28,19,4,1
cncontactpicker,cncontactpicker,,0,0,4,0,5,4,13,1
drupal-taxonomy,drupal-taxonomy,,1,2,7,3,9,10,4,100
autoloader,autoloader,,9,4,12,13,23,25,4,1
psr-4,psr-4,,11,4,16,15,34,31,4,1
restheart,restheart,,1,0,7,1,21,8,1,1
delphi-5,delphi-5,,5,4,4,9,14,13,9,1
autoresizingmask,autoresizingmask,,1,0,2,1,9,3,13,1
amazon-systems-manager,amazon-systems-manager,,7,3,4,10,14,14,6,1
twilio-programmable-chat,twilio-programmable-chat,,21,21,49,42,64,91,13,1
egg,egg,,8,6,12,14,22,26,0,1
pygresql,pygresql,,1,0,4,1,3,5,0,1
content-values,content-values,,0,1,2,1,5,3,3,1
unity3d-unet,unity3d-unet,,17,18,37,35,47,72,8,5.882353
xbox-live,xbox-live,,1,5,6,6,13,12,8,400
non-standard-evaluation,non-standard-evaluation,,5,4,8,9,31,17,0,1
quova,quova,,0,0,0,0,1,0,3,1
reusability,reusability,,15,13,21,28,56,49,1,1
melt,melt,,27,30,45,57,101,102,0,11.111111
amazon-swf,amazon-swf,,0,1,4,1,17,5,6,1
ncurses,ncurses,,46,24,81,70,123,151,9,1
secondary-indexes,secondary-indexes,,2,2,2,4,11,6,6,1
foursquare,foursquare,,10,14,25,24,40,49,4,40
dockerhub,dockerhub,,44,23,51,67,86,118,6,1
timeslots,timeslots,,0,1,5,1,8,6,1,1
angularjs-select,angularjs-select,,12,2,1,14,21,15,1,1
bootsfaces,bootsfaces,,7,4,13,11,32,24,3,1
respect-validation,respect-validation,,4,2,6,6,10,12,4,1
mbstring,mbstring,,1,3,6,4,21,10,4,200
spring-social-facebook,spring-social-facebook,,4,2,9,6,22,15,3,1
ascom,ascom,,0,0,0,0,2,0,0,1
favicon,favicon,,38,32,68,70,112,138,1,1
universe,universe,,1,2,7,3,12,10,9,100
amazonads,amazonads,,1,1,2,2,6,4,6,1
filechooser,filechooser,,8,14,17,22,44,39,3,75
sklightnode,sklightnode,,1,1,1,2,3,3,13,1
utc,utc,,57,58,87,115,187,202,0,1.754386
tfs-sdk,tfs-sdk,,12,3,19,15,40,34,8,1
google-cloud-datalab,google-cloud-datalab,,19,13,32,32,109,64,6,1
creation,creation,,3,6,15,9,23,24,0,100
turbolinks-5,turbolinks-5,,1,1,6,2,11,8,12,1
shadow-dom,shadow-dom,,67,53,108,120,136,228,1,1
reagent,reagent,,4,9,17,13,47,30,2,125
dapper-simplecrud,dapper-simplecrud,,0,2,3,2,3,5,8,100
sqlanywhere,sqlanywhere,,13,8,24,21,39,45,4,1
z3,z3,,43,64,102,107,186,209,0,48.837209
winzip,winzip,,1,1,3,2,7,5,9,1
app-startup,app-startup,,3,1,7,4,9,11,8,1
openal,openal,,11,11,9,22,14,31,9,1
policy,policy,,38,40,79,78,88,157,6,5.263158
react-rails,react-rails,,5,15,16,20,34,36,12,200
tofixed,tofixed,,5,3,7,8,22,15,1,1
normalize,normalize,,15,20,23,35,55,58,0,33.333333
rbenv-vars,rbenv-vars,,0,0,1,0,2,1,12,1
monary,monary,,0,0,1,0,3,1,1,1
groovyshell,groovyshell,,8,3,11,11,23,22,3,1
word-break,word-break,,1,2,7,3,16,10,1,100
infinite,infinite,,17,6,36,23,72,59,0,1
opera-extension,opera-extension,,2,0,1,2,8,3,1,1
microsoft-edge-extension,microsoft-edge-extension,,9,4,18,13,38,31,1,1
formit,formit,,0,0,1,0,5,1,4,1
webpack-encore,webpack-encore,,29,26,58,55,67,113,4,1
trailing-slash,trailing-slash,,5,3,11,8,23,19,4,1
recode,recode,,14,12,25,26,63,51,0,1
anonymize,anonymize,,1,0,6,1,11,7,0,1
effect,effect,,14,8,21,22,47,43,1,1
divide,divide,,15,9,31,24,47,55,0,1
bosh-deployer,bosh-deployer,,0,0,1,0,3,1,3,1
360-virtual-reality,360-virtual-reality,,7,4,17,11,29,28,8,1
facebook-page,facebook-page,,4,6,16,10,52,26,13,50
jboss-seam,jboss-seam,,1,0,0,1,3,1,3,1
pycurl,pycurl,,13,10,29,23,52,52,0,1
pocketmine,pocketmine,,0,0,0,0,6,0,6,1
datetime-format,datetime-format,,75,72,156,147,342,303,0,1
angular2-ngcontent,angular2-ngcontent,,4,2,9,6,19,15,1,1
theorem-proving,theorem-proving,,17,11,24,28,44,52,2,1
mddialog,mddialog,,2,0,15,2,40,17,1,1
measure,measure,,28,32,49,60,51,109,5,14.285714
zappa,zappa,,13,15,22,28,38,50,6,15.384615
generated-code,generated-code,,8,5,6,13,18,19,3,1
unique-constraint,unique-constraint,,27,24,43,51,106,94,4,1
pari,pari,,2,6,2,8,12,10,0,200
gp,gp,,3,1,7,4,7,11,8,1
imagenet,imagenet,,11,8,9,19,37,28,0,1
xargs,xargs,,32,23,62,55,104,117,9,1
perspectivecamera,perspectivecamera,,5,6,26,11,38,37,0,20
package-lock.json,package-lock.json,,11,9,21,20,38,41,1,1
hibernate-spatial,hibernate-spatial,,4,2,6,6,15,12,3,1
encryption-asymmetric,encryption-asymmetric,,11,11,21,22,35,43,6,1
elliptic-curve,elliptic-curve,,23,17,20,40,80,60,6,1
fips,fips,,11,5,22,16,40,38,6,1
chef-template,chef-template,,0,0,4,0,4,4,12,1
custompaging,custompaging,,0,3,2,3,1,5,8,200
kleisli,kleisli,,1,2,0,3,3,3,2,100
viewdidload,viewdidload,,7,2,14,9,32,23,13,1
cffile,cffile,,2,2,2,4,5,6,4,1
nsopenpanel,nsopenpanel,,4,2,2,6,12,8,13,1
xjb,xjb,,1,1,4,2,3,6,3,1
jaxb2-simplify-plugin,jaxb2-simplify-plugin,,0,0,0,0,2,0,3,1
smime,smime,,14,6,26,20,26,46,6,1
error-messaging,error-messaging,,6,3,16,9,25,25,4,1
postscript,postscript,,15,14,24,29,57,53,8,1
watchman,watchman,,6,9,4,15,31,19,1,50
disaster-recovery,disaster-recovery,,8,8,11,16,18,27,6,1
swingbuilder,swingbuilder,,2,2,1,4,8,5,3,1
sublime-text-plugin,sublime-text-plugin,,9,8,29,17,73,46,0,1
keyword-argument,keyword-argument,,12,9,14,21,26,35,0,1
elasticsearch-py,elasticsearch-py,,6,9,20,15,23,35,6,50
elasticsearch-bulk-api,elasticsearch-bulk-api,,2,0,5,2,8,7,6,1
revolution-slider,revolution-slider,,10,12,42,22,32,64,1,20
mpich,mpich,,16,6,7,22,35,29,9,1
parallel-testing,parallel-testing,,8,9,10,17,26,27,3,12.5
function-prototypes,function-prototypes,,4,2,4,6,16,10,9,1
shaka,shaka,,6,8,6,14,10,20,13,33.333333
placement-new,placement-new,,7,9,23,16,23,39,9,28.571429
ms-app-analytics,ms-app-analytics,,1,1,2,2,13,4,8,1
s2i,s2i,,7,2,5,9,7,14,6,1
color-palette,color-palette,,4,3,13,7,30,20,0,1
xpcshell,xpcshell,,0,0,0,0,1,0,1,1
square,square,,21,24,58,45,94,103,4,14.285714
data-recovery,data-recovery,,7,6,16,13,24,29,4,1
directx-9,directx-9,,14,13,26,27,29,53,9,1
stackframe,stackframe,,2,7,11,9,20,20,9,250
x-ray,x-ray,,2,1,9,3,7,12,1,1
zscaler,zscaler,,4,0,3,4,4,7,6,1
skphysicscontact,skphysicscontact,,1,0,4,1,8,5,13,1
stdatomic,stdatomic,,22,13,9,35,26,44,9,1
windows-scripting,windows-scripting,,10,7,22,17,51,39,8,1
oxyplot,oxyplot,,10,18,27,28,53,55,8,80
vst,vst,,4,4,5,8,7,13,9,1
juce,juce,,5,2,19,7,33,26,9,1
synthesizer,synthesizer,,4,3,8,7,13,15,13,1
sound-synthesis,sound-synthesis,,1,2,2,3,7,5,13,100
fluidsynth,fluidsynth,,5,2,9,7,6,16,0,1
scaladoc,scaladoc,,3,4,7,7,4,14,2,33.333333
ansible-template,ansible-template,,33,20,43,53,62,96,6,1
for-comprehension,for-comprehension,,9,14,16,23,30,39,2,55.555556
blender-2.76,blender-2.76,,0,0,1,0,2,1,0,1
asprintf,asprintf,,0,0,0,0,6,0,9,1
cocos2d-x-3.x,cocos2d-x-3.x,,1,2,4,3,4,7,3,100
rpmbuild,rpmbuild,,14,16,34,30,63,64,9,14.285714
rpm-spec,rpm-spec,,15,15,32,30,45,62,9,1
reductio,reductio,,0,3,1,3,8,4,1,200
http.client,http.client,,4,2,4,6,14,10,0,1
hyperhtml,hyperhtml,,1,0,9,1,18,10,1,1
ember-qunit,ember-qunit,,1,2,2,3,8,5,1,100
numeric,numeric,,51,51,98,102,176,200,0,1
lookup-tables,lookup-tables,,18,13,32,31,61,63,0,1
livequery,livequery,,1,1,6,2,7,8,13,1
jquery-1.3,jquery-1.3,,0,0,0,0,2,0,13,1
gitattributes,gitattributes,,6,11,12,17,22,29,6,83.333333
git-filter,git-filter,,1,2,2,3,9,5,6,100
apache-flex,apache-flex,,14,4,17,18,75,35,13,1
flexbuilder,flexbuilder,,0,0,0,0,1,0,13,1
react-slingshot,react-slingshot,,1,0,3,1,5,4,1,1
react-fiber,react-fiber,,1,1,5,2,19,7,1,1
fabric.io,fabric.io,,2,3,14,5,28,19,3,50
web3js,web3js,,48,55,116,103,200,219,6,14.583333
coq-tactic,coq-tactic,,13,6,31,19,72,50,2,1
r-dbi,r-dbi,,12,6,22,18,58,40,0,1
w3c-validation,w3c-validation,,7,8,11,15,45,26,1,14.285714
cross-join,cross-join,,12,15,20,27,35,47,4,25
android-pay,android-pay,,1,3,16,4,27,20,3,200
msysgit,msysgit,,1,0,2,1,6,3,6,1
cgpoint,cgpoint,,5,4,6,9,32,15,13,1
yahoo-oauth,yahoo-oauth,,0,0,5,0,7,5,4,1
dynamicmethod,dynamicmethod,,1,2,6,3,8,9,8,100
cyanogenmod,cyanogenmod,,1,0,3,1,6,4,3,1
kendo-autocomplete,kendo-autocomplete,,2,0,2,2,8,4,1,1
sudoers,sudoers,,3,3,12,6,18,18,9,1
opentracing,opentracing,,27,25,24,52,22,76,3,1
brave,brave,,5,3,8,8,12,16,3,1
advanced-filter,advanced-filter,,5,6,3,11,17,14,5,20
hlist,hlist,,0,3,7,3,14,10,2,200
constraint-kinds,constraint-kinds,,1,2,2,3,6,5,2,100
r-daisy,r-daisy,,0,0,1,0,7,1,0,1
many-to-one,many-to-one,,20,13,57,33,83,90,3,1
hydration,hydration,,3,1,4,4,11,8,4,1
drawable,drawable,,36,33,77,69,144,146,3,1
thor,thor,,1,1,7,2,10,9,12,1
croppie,croppie,,7,5,10,12,28,22,1,1
msr,msr,,3,2,4,5,4,9,9,1
error-correction,error-correction,,6,5,6,11,14,17,9,1
react-tsx,react-tsx,,23,22,23,45,21,68,1,1
programmatically,programmatically,,14,17,43,31,97,74,13,21.428571
recycle,recycle,,3,1,14,4,19,18,3,1
servo,servo,,14,13,19,27,36,46,9,1
jprogressbar,jprogressbar,,2,7,12,9,15,21,3,250
fisheye,fisheye,,3,7,12,10,18,22,0,133.333333
object.observe,object.observe,,0,0,0,0,1,0,6,1
html5lib,html5lib,,1,1,3,2,10,5,0,1
bleach,bleach,,0,0,2,0,5,2,0,1
stm32f0,stm32f0,,3,6,11,9,11,20,9,100
curves,curves,,0,0,0,0,16,0,0,1
matrix-transform,matrix-transform,,1,3,4,4,5,8,8,200
supercsv,supercsv,,2,1,3,3,12,6,3,1
node-request,node-request,,8,11,32,19,49,51,1,37.5
networkstream,networkstream,,10,12,17,22,42,39,8,20
deeplink,deeplink,,17,16,33,33,51,66,3,1
hy,hy,,0,2,4,2,6,6,0,100
express-checkout,express-checkout,,8,7,11,15,40,26,4,1
irb,irb,,6,10,15,16,28,31,12,66.666667
pry,pry,,5,5,21,10,31,31,12,1
fzf,fzf,,7,1,12,8,13,20,9,1
passport-saml,passport-saml,,5,6,9,11,14,20,1,20
alasql,alasql,,7,5,10,12,33,22,1,1
gunzip,gunzip,,3,5,5,8,17,13,9,66.666667
jgit,jgit,,28,24,25,52,87,77,6,1
git-notes,git-notes,,1,0,3,1,3,4,6,1
web-reference,web-reference,,9,1,8,10,10,18,8,1
rep,rep,,5,3,4,8,23,12,0,1
eclipse-gemini,eclipse-gemini,,1,1,1,2,3,3,3,1
swagger-php,swagger-php,,8,10,13,18,19,31,3,25
strptime,strptime,,23,13,32,36,95,68,0,1
endeca,endeca,,1,1,3,2,17,5,3,1
oracle-commerce,oracle-commerce,,3,0,5,3,13,8,3,1
pfquery,pfquery,,2,2,4,4,15,8,13,1
pfobject,pfobject,,0,0,2,0,3,2,13,1
satellite,satellite,,10,6,4,16,19,20,0,1
orbital-mechanics,orbital-mechanics,,6,6,8,12,11,20,0,1
satellite-navigation,satellite-navigation,,1,0,1,1,1,2,0,1
apprtc,apprtc,,4,3,8,7,25,15,1,1
windows-10-mobile,windows-10-mobile,,0,1,6,1,38,7,8,1
eventsource,eventsource,,11,17,19,28,49,47,3,54.545455
shell32,shell32,,2,2,4,4,6,8,8,1
shell32.dll,shell32.dll,,1,1,2,2,4,4,8,1
ownership,ownership,,13,23,26,36,53,62,9,76.923077
robo3t,robo3t,,22,15,28,37,62,65,1,1
angularjs-ng-change,angularjs-ng-change,,3,0,3,3,30,6,1,1
neto,neto,,1,0,2,1,2,3,4,1
mms,mms,,3,9,24,12,27,36,3,200
avassetwriterinput,avassetwriterinput,,0,2,7,2,5,9,13,100
dalvik,dalvik,,10,8,10,18,23,28,3,1
iqkeyboardmanager,iqkeyboardmanager,,4,7,6,11,30,17,13,75
coldfusion-10,coldfusion-10,,11,6,18,17,48,35,4,1
mura,mura,,6,1,4,7,17,11,4,1
fstream,fstream,,56,35,100,91,190,191,9,1
dbase,dbase,,6,4,9,10,18,19,4,1
xbase,xbase,,2,0,6,2,6,8,3,1
ngtoast,ngtoast,,0,2,2,2,1,4,1,100
subscriber,subscriber,,6,11,6,17,28,23,1,83.333333
monkeyrunner,monkeyrunner,,2,0,13,2,14,15,3,1
lotus-formula,lotus-formula,,4,13,8,17,21,25,5,225
using-directives,using-directives,,5,8,6,13,11,19,9,60
angular-google-maps,angular-google-maps,,16,23,49,39,69,88,1,43.75
google-cloud-print,google-cloud-print,,4,4,9,8,21,17,1,1
edge-detection,edge-detection,,23,17,53,40,97,93,0,1
updateprogress,updateprogress,,0,0,2,0,13,2,8,1
sqlalchemy-migrate,sqlalchemy-migrate,,3,1,6,4,8,10,0,1
neat,neat,,13,8,21,21,34,42,0,1
http-streaming,http-streaming,,3,1,3,4,12,7,8,1
j,j,,3,1,3,4,18,7,0,1
codebase,codebase,,2,2,1,4,5,5,3,1
js-xlsx,js-xlsx,,11,9,17,20,25,37,1,1
jenkins-blueocean,jenkins-blueocean,,7,9,27,16,70,43,6,28.571429
storekit,storekit,,20,20,57,40,71,97,13,1
yeoman-generator-angular,yeoman-generator-angular,,1,1,2,2,10,4,1,1
protobuff.net,protobuff.net,,0,0,1,0,2,1,8,1
xts,xts,,44,26,87,70,194,157,0,1
pear,pear,,16,6,24,22,56,46,4,1
windows-community-toolkit,windows-community-toolkit,,16,13,27,29,61,56,8,1
eventlog-source,eventlog-source,,2,0,4,2,8,6,8,1
google-maps-sdk-ios,google-maps-sdk-ios,,17,19,46,36,92,82,13,11.764706
iphone-5,iphone-5,,0,0,1,0,4,1,13,1
react-native-web,react-native-web,,20,30,22,50,36,72,1,50
tweetinvi,tweetinvi,,2,2,2,4,13,6,8,1
qaction,qaction,,5,4,3,9,17,12,9,1
datamaps,datamaps,,4,1,7,5,11,12,1,1
rollback,rollback,,28,21,47,49,115,96,3,1
gitpython,gitpython,,20,19,34,39,37,73,6,1
web-accessibility,web-accessibility,,12,10,16,22,35,38,13,1
deeplearning4j,deeplearning4j,,20,6,34,26,65,60,3,1
facebook-authentication,facebook-authentication,,17,14,35,31,35,66,13,1
torii,torii,,0,0,2,0,1,2,1,1
facebook-authorization,facebook-authorization,,0,0,0,0,4,0,13,1
google-people,google-people,,7,7,23,14,73,37,5,1
gidsignin,gidsignin,,4,0,6,4,8,10,13,1
angularjs-components,angularjs-components,,7,8,19,15,73,34,1,14.285714
rackspace-cloud,rackspace-cloud,,0,2,1,2,4,3,4,100
rackspace,rackspace,,0,2,3,2,6,5,4,100
json-server,json-server,,26,40,37,66,50,103,1,53.846154
mediatr,mediatr,,17,15,35,32,33,67,8,1
lotus,lotus,,20,11,24,31,41,55,5,1
pygooglechart,pygooglechart,,3,2,7,5,16,12,1,1
wso2mb,wso2mb,,0,2,7,2,7,9,14,100
cg,cg,,3,8,14,11,23,25,9,166.666667
pentaho-cde,pentaho-cde,,6,18,27,24,49,51,4,200
pentaho-ctools,pentaho-ctools,,0,4,0,4,4,4,4,300
ccc,ccc,,0,0,0,0,2,0,4,1
database-mirroring,database-mirroring,,1,3,4,4,5,8,4,200
cgridview,cgridview,,1,1,1,2,6,3,4,1
extjs4.2,extjs4.2,,4,5,15,9,52,24,1,25
sax,sax,,17,16,34,33,72,67,3,1
role-base-authorization,role-base-authorization,,4,4,9,8,17,17,8,1
self-signed,self-signed,,18,10,45,28,97,73,6,1
log4net-configuration,log4net-configuration,,9,4,29,13,39,42,8,1
c#-6.0,c#-6.0,,7,4,27,11,57,38,8,1
pycuda,pycuda,,14,18,21,32,55,53,0,28.571429
recurring-events,recurring-events,,3,4,8,7,11,15,5,33.333333
tizen-web-app,tizen-web-app,,18,17,34,35,56,69,13,1
supportmapfragment,supportmapfragment,,2,3,8,5,16,13,3,50
google-cloud-ml,google-cloud-ml,,64,31,120,95,304,215,0,1
nativescript-telerik-ui,nativescript-telerik-ui,,18,7,45,25,53,70,1,1
tdb,tdb,,3,0,3,3,14,6,2,1
flatpickr,flatpickr,,16,15,27,31,29,58,1,1
attention-model,attention-model,,26,21,45,47,36,92,0,1
schtasks,schtasks,,4,3,7,7,16,14,9,1
date-arithmetic,date-arithmetic,,14,9,26,23,35,49,4,1
selectors-api,selectors-api,,10,4,16,14,37,30,1,1
adal4j,adal4j,,4,3,12,7,11,19,8,1
runtime-configuration,runtime-configuration,,0,0,1,0,2,1,8,1
event-tracking,event-tracking,,14,9,18,23,44,41,5,1
fancybox-3,fancybox-3,,18,15,25,33,92,58,1,1
pointfree,pointfree,,3,5,13,8,19,21,2,66.666667
joi,joi,,52,46,93,98,71,191,1,1
infrared,infrared,,6,8,11,14,23,25,0,33.333333
codeship,codeship,,4,8,19,12,21,31,6,100
toplevel,toplevel,,7,3,17,10,40,27,0,1
liferay-6,liferay-6,,14,8,25,22,107,47,3,1
gettime,gettime,,2,3,5,5,7,10,0,50
spark-graphx,spark-graphx,,13,11,31,24,86,55,2,1
remarkjs,remarkjs,,6,4,8,10,14,18,0,1
transclusion,transclusion,,3,2,7,5,17,12,1,1
cmis,cmis,,4,4,15,8,44,23,3,1
cmis-workbench,cmis-workbench,,0,1,1,1,7,2,3,1
diagnostic-tools,diagnostic-tools,,2,0,1,2,3,3,8,1
acr122,acr122,,4,3,1,7,13,8,3,1
pylucene,pylucene,,2,2,8,4,7,12,2,1
pecl,pecl,,13,13,33,26,56,59,4,1
icu,icu,,20,13,32,33,44,65,9,1
intl,intl,,7,10,21,17,35,38,4,42.857143
multi-select,multi-select,,64,45,110,109,165,219,1,1
iife,iife,,24,11,31,35,68,66,1,1
phpstorm-2017.1,phpstorm-2017.1,,0,0,0,0,7,0,4,1
pass-data,pass-data,,6,8,14,14,22,28,13,33.333333
ansi-escape,ansi-escape,,9,9,17,18,16,35,9,1
jnetpcap,jnetpcap,,2,3,6,5,4,11,3,50
sigfpe,sigfpe,,2,0,1,2,7,3,9,1
networkcredentials,networkcredentials,,2,0,6,2,11,8,8,1
hdl,hdl,,17,7,39,24,72,63,9,1
php-internals,php-internals,,6,8,9,14,22,23,4,33.333333
mutation,mutation,,20,20,41,40,69,81,1,1
crossover,crossover,,2,2,10,4,9,14,0,1
shapely,shapely,,37,44,60,81,98,141,0,18.918919
r-tree,r-tree,,4,7,12,11,15,23,0,75
knockout-kendo,knockout-kendo,,0,0,0,0,2,0,1,1
ibm-wcm,ibm-wcm,,2,0,3,2,2,5,3,1
correspondence-analysis,correspondence-analysis,,2,4,3,6,6,9,0,100
string-substitution,string-substitution,,5,7,11,12,20,23,0,40
android-scroll,android-scroll,,2,5,6,7,11,13,3,150
android-swipe,android-swipe,,2,0,5,2,8,7,3,1
freeipa,freeipa,,6,2,14,8,12,22,8,1
tcomport,tcomport,,0,0,5,0,7,5,9,1
ansistring,ansistring,,2,0,1,2,5,3,9,1
react-async,react-async,,2,1,5,3,2,8,1,1
bi-publisher,bi-publisher,,16,18,31,34,59,65,4,12.5
nsarray,nsarray,,20,9,34,29,131,63,13,1
uiinterfaceorientation,uiinterfaceorientation,,3,3,9,6,11,15,13,1
richeditbox,richeditbox,,0,2,8,2,12,10,8,100
clisp,clisp,,4,4,9,8,34,17,0,1
msaa,msaa,,2,0,3,2,4,5,9,1
episerver,episerver,,12,10,23,22,45,45,8,1
restrictions,restrictions,,0,0,0,0,22,0,2,1
branching-strategy,branching-strategy,,4,5,4,9,11,13,6,25
sparkle,sparkle,,1,0,12,1,4,13,13,1
certificate-store,certificate-store,,9,5,6,14,7,20,6,1
ansible-handlers,ansible-handlers,,2,1,1,3,4,4,6,1
wpmu,wpmu,,3,6,3,9,4,12,4,100
servicemanager,servicemanager,,2,1,1,3,4,4,4,1
xms,xms,,0,0,2,0,13,2,3,1
buffering,buffering,,5,6,11,11,22,22,9,20
python-pika,python-pika,,6,4,11,10,9,21,3,1
multiple-conditions,multiple-conditions,,14,21,16,35,43,51,0,50
webcola,webcola,,0,0,4,0,6,4,1,1
zoho,zoho,,24,26,51,50,75,101,4,8.333333
onselect,onselect,,1,3,1,4,8,5,1,200
entitylisteners,entitylisteners,,1,2,5,3,15,8,3,100
worldpay,worldpay,,3,2,6,5,16,11,4,1
flask-restplus,flask-restplus,,32,33,58,65,71,123,0,3.125
maxscript,maxscript,,3,3,11,6,31,17,0,1
mipmaps,mipmaps,,4,1,8,5,16,13,9,1
background-thread,background-thread,,2,5,4,7,25,11,3,150
nhibernate-criteria,nhibernate-criteria,,1,1,2,2,2,4,8,1
code-analysis,code-analysis,,20,14,38,34,108,72,8,1
sequel,sequel,,5,6,13,11,77,24,12,20
quantreg,quantreg,,4,3,4,7,11,11,0,1
nativequery,nativequery,,10,11,29,21,32,50,3,10
sqlresultsetmapping,sqlresultsetmapping,,1,1,4,2,9,6,3,1
slicers,slicers,,24,17,33,41,60,74,5,1
excel-udf,excel-udf,,0,0,2,0,9,2,5,1
http-status-code-415,http-status-code-415,,3,3,15,6,10,21,3,1
multiple-projects,multiple-projects,,1,2,4,3,6,7,8,100
zos,zos,,11,11,27,22,63,49,4,1
openrowset,openrowset,,8,3,19,11,29,30,4,1
yii2-user,yii2-user,,0,3,2,3,24,5,4,200
dd,dd,,9,3,7,12,21,19,9,1
rowname,rowname,,5,7,7,12,24,19,0,40
node.js-buffer,node.js-buffer,,0,1,0,1,1,1,1,1
struts,struts,,21,31,89,52,85,141,3,47.619048
rweka,rweka,,1,2,6,3,20,9,0,100
excel-dna,excel-dna,,17,16,5,33,43,38,8,1
specman,specman,,2,2,11,4,37,15,9,1
e,e,,3,2,12,5,29,17,9,1
calibration,calibration,,13,10,11,23,33,34,0,1
scss-lint,scss-lint,,8,2,11,10,27,21,1,1
javascript-intellisense,javascript-intellisense,,2,2,6,4,22,10,9,1
android-audiorecord,android-audiorecord,,3,10,9,13,27,22,3,233.333333
subreport,subreport,,17,17,28,34,34,62,3,1
cloudconvert,cloudconvert,,2,1,2,3,3,5,13,1
olingo,olingo,,3,13,20,16,32,36,3,333.333333
google-nativeclient,google-nativeclient,,2,2,2,4,6,6,1,1
neo4jclient,neo4jclient,,5,3,10,8,48,18,2,1
gwt-tablayoutpanel,gwt-tablayoutpanel,,0,0,0,0,2,0,8,1
upstart,upstart,,5,1,14,6,24,20,9,1
hungarian-algorithm,hungarian-algorithm,,5,3,0,8,11,8,0,1
extract-text-plugin,extract-text-plugin,,4,0,4,4,40,8,1,1
cdialog,cdialog,,3,1,2,4,6,6,9,1
minifiedjs,minifiedjs,,0,1,1,1,1,2,1,1
sparklines,sparklines,,2,4,8,6,18,14,1,100
php-builtin-server,php-builtin-server,,0,1,3,1,9,4,4,1
non-linear-regression,non-linear-regression,,27,34,59,61,84,120,0,25.925926
google-aiy,google-aiy,,3,6,15,9,10,24,0,100
outgoing-mail,outgoing-mail,,0,0,4,0,3,4,4,1
optional-arguments,optional-arguments,,7,5,11,12,20,23,0,1
secondary-sort,secondary-sort,,0,0,0,0,3,0,2,1
windows-dev-center,windows-dev-center,,0,1,6,1,17,7,8,1
unique-id,unique-id,,2,2,12,4,14,16,1,1
2d-games,2d-games,,30,19,51,49,85,100,8,1
prism-6,prism-6,,1,0,14,1,41,15,8,1
isnullorempty,isnullorempty,,3,1,7,4,16,11,4,1
lov,lov,,1,0,0,1,7,1,4,1
data-quality,data-quality,,1,2,5,3,6,8,4,100
directadmin,directadmin,,5,4,16,9,22,25,4,1
grails-resources-plugin,grails-resources-plugin,,0,0,1,0,1,1,3,1
brainscript,brainscript,,0,0,1,0,4,1,0,1
catamorphism,catamorphism,,3,1,1,4,7,5,2,1
screensaver,screensaver,,5,6,14,11,16,25,13,20
node-sass,node-sass,,52,30,76,82,126,158,1,1
try-catch-finally,try-catch-finally,,4,4,8,8,22,16,3,1
laravel-facade,laravel-facade,,3,5,11,8,14,19,4,66.666667
stan,stan,,12,11,33,23,65,56,0,1
viewflipper,viewflipper,,4,2,6,6,8,12,3,1
callstack,callstack,,19,17,29,36,49,65,9,1
formview,formview,,3,1,11,4,24,15,8,1
wql,wql,,4,5,9,9,24,18,8,25
artifactory-query-lang,artifactory-query-lang,,4,5,8,9,19,17,6,25
qpython,qpython,,5,7,12,12,24,24,0,40
querying,querying,,19,19,29,38,46,67,13,1
python-gstreamer,python-gstreamer,,3,7,7,10,18,17,13,133.333333
stringwithformat,stringwithformat,,4,0,1,4,2,5,13,1
cereal,cereal,,4,7,5,11,25,16,9,75
.net-standard-1.5,.net-standard-1.5,,0,0,0,0,1,0,8,1
build-automation,build-automation,,10,5,27,15,44,42,3,1
.net-attributes,.net-attributes,,1,1,2,2,4,4,8,1
internet-explorer-8,internet-explorer-8,,9,5,15,14,36,29,1,1
babel-polyfill,babel-polyfill,,19,24,49,43,44,92,1,26.315789
multi-release-jar,multi-release-jar,,1,0,4,1,9,5,3,1
angularjs-ng-if,angularjs-ng-if,,3,3,2,6,16,8,1,1
netlify,netlify,,109,118,136,227,101,363,1,8.256881
python-fu,python-fu,,1,2,2,3,6,5,0,100
polymer-starter-kit,polymer-starter-kit,,1,2,7,3,28,10,1,100
yui-compressor,yui-compressor,,2,1,2,3,7,5,1,1
default-namespace,default-namespace,,0,0,0,0,1,0,3,1
bacula,bacula,,1,0,2,1,4,3,9,1
ip-blocking,ip-blocking,,0,1,1,1,5,2,4,1
chip-8,chip-8,,0,0,1,0,3,1,9,1
systemexit,systemexit,,1,0,1,1,2,2,3,1
android-contact-mimetype,android-contact-mimetype,,0,1,0,1,1,1,3,1
workflow-foundation-4,workflow-foundation-4,,10,3,11,13,19,24,8,1
workflow-foundation,workflow-foundation,,12,7,23,19,27,42,8,1
ext.net,ext.net,,2,3,20,5,34,25,8,50
dbvisualizer,dbvisualizer,,4,6,6,10,21,16,4,50
pdi,pdi,,9,11,27,20,67,47,4,22.222222
vanity,vanity,,0,1,1,1,2,2,12,1
phonegap-pushplugin,phonegap-pushplugin,,4,2,11,6,27,17,1,1
setup.py,setup.py,,57,45,96,102,143,198,0,1
atomicinteger,atomicinteger,,9,1,7,10,15,17,3,1
jhbuild,jhbuild,,0,0,0,0,4,0,9,1
pixman,pixman,,1,1,1,2,1,3,9,1
grunt-browser-sync,grunt-browser-sync,,0,1,3,1,3,4,1,1
command-line-tool,command-line-tool,,8,3,12,11,21,23,13,1
design-guidelines,design-guidelines,,2,2,8,4,11,12,13,1
gam,gam,,21,25,39,46,55,85,0,19.047619
assetbundle,assetbundle,,9,5,23,14,43,37,8,1
qwizard,qwizard,,4,4,5,8,12,13,0,1
sslengine,sslengine,,3,1,6,4,7,10,3,1
viewdiddisappear,viewdiddisappear,,0,1,1,1,4,2,13,1
ltpa,ltpa,,0,1,1,1,9,2,3,1
nvl,nvl,,2,5,6,7,10,13,4,150
disconnect,disconnect,,10,8,7,18,27,25,3,1
adblock,adblock,,11,7,27,18,39,45,1,1
entity-framework-5,entity-framework-5,,2,7,6,9,34,15,8,250
facebook-audience-network,facebook-audience-network,,20,13,26,33,50,59,3,1
java-6,java-6,,13,11,32,24,67,56,3,1
android-proguard,android-proguard,,50,0,106,50,248,156,3,1
python-appium,python-appium,,16,14,19,30,34,49,3,1
ajaxform,ajaxform,,10,7,30,17,49,47,1,1
temporal,temporal,,12,6,18,18,23,36,0,1
temporal-database,temporal-database,,3,2,7,5,9,12,4,1
autoregressive-models,autoregressive-models,,8,15,12,23,18,35,0,87.5
dynamic-picklist-vtiger,dynamic-picklist-vtiger,,0,1,1,1,2,2,4,1
opcache,opcache,,8,8,18,16,29,34,4,1
default-browser,default-browser,,1,1,3,2,3,5,9,1
ida,ida,,13,15,27,28,48,55,9,15.384615
filehandle,filehandle,,7,7,8,14,19,22,9,1
fclose,fclose,,4,1,9,5,23,14,9,1
angular2-opaquetoken,angular2-opaquetoken,,1,0,0,1,3,1,1,1
google-experiments,google-experiments,,0,0,0,0,10,0,5,1
flextable,flextable,,12,17,31,29,40,60,0,41.666667
pychef,pychef,,0,0,0,0,2,0,12,1
changelog,changelog,,10,6,14,16,17,30,3,1
initial-context,initial-context,,1,0,4,1,5,5,3,1
fastjson,fastjson,,2,1,3,3,3,6,3,1
scala.js,scala.js,,21,14,49,35,92,84,2,1
initializer,initializer,,13,13,27,26,60,53,9,1
spring-oauth2,spring-oauth2,,30,39,47,69,89,116,3,30
windows-console,windows-console,,16,8,46,24,79,70,9,1
server-core,server-core,,3,3,2,6,5,8,6,1
yoast,yoast,,27,19,29,46,45,75,4,1
snackbar,snackbar,,17,12,33,29,39,62,3,1
error-reporting,error-reporting,,3,4,5,7,13,12,4,33.333333
backup-strategies,backup-strategies,,4,7,2,11,13,13,4,75
path-variables,path-variables,,4,7,13,11,22,24,3,75
document-ready,document-ready,,3,7,7,10,25,17,1,133.333333
manifest.mf,manifest.mf,,9,6,7,15,29,22,3,1
google-assist-api,google-assist-api,,20,20,30,40,65,70,13,1
urlrequest,urlrequest,,7,3,13,10,30,23,13,1
urlsession,urlsession,,30,33,57,63,115,120,13,10
pdfptable,pdfptable,,4,4,3,8,5,11,8,1
xilinx,xilinx,,28,31,62,59,132,121,9,10.714286
jes,jes,,6,0,6,6,16,12,0,1
alter-table,alter-table,,16,14,33,30,75,63,4,1
yodlee,yodlee,,1,0,1,1,3,2,4,1
bash-on-windows,bash-on-windows,,1,0,1,1,16,2,9,1
ocilib,ocilib,,0,2,0,2,3,2,9,100
netstream,netstream,,1,0,0,1,2,1,8,1
findstr,findstr,,11,13,33,24,51,57,9,18.181818
fouc,fouc,,1,1,4,2,6,6,1,1
hibernate-5.x,hibernate-5.x,,18,15,17,33,59,50,3,1
graphing,graphing,,15,10,21,25,41,46,0,1
helix,helix,,2,2,8,4,10,12,8,1
dynamics-nav,dynamics-nav,,5,8,16,13,35,29,8,60
ajp,ajp,,1,4,6,5,12,11,3,300
regions,regions,,0,0,0,0,10,0,6,1
python-iris,python-iris,,5,2,5,7,10,12,0,1
ng-map,ng-map,,0,2,4,2,26,6,1,100
multiplying,multiplying,,12,13,25,25,47,50,0,8.333333
audiocontext,audiocontext,,15,13,26,28,19,54,1,1
web-ide,web-ide,,3,1,7,4,6,11,1,1
schema-compare,schema-compare,,2,0,5,2,15,7,4,1
finagle,finagle,,4,3,7,7,17,14,2,1
aadhaar,aadhaar,,0,2,2,2,7,4,3,100
wix3.11,wix3.11,,10,11,24,21,34,45,8,10
webcrypto-api,webcrypto-api,,10,6,16,16,40,32,6,1
collectstatic,collectstatic,,4,3,4,7,16,11,0,1
jquery-chosen,jquery-chosen,,17,16,50,33,78,83,1,1
playlist,playlist,,17,6,24,23,38,47,5,1
keypoint,keypoint,,6,7,11,13,19,24,0,16.666667
rsa-sha256,rsa-sha256,,1,1,3,2,11,5,6,1
clang-format,clang-format,,18,13,43,31,59,74,9,1
jbilling,jbilling,,0,0,0,0,1,0,3,1
trackball,trackball,,0,1,1,1,1,2,9,1
opengl-extensions,opengl-extensions,,1,0,3,1,3,4,9,1
re-frame,re-frame,,1,4,7,5,23,12,2,300
custom-lists,custom-lists,,5,5,10,10,15,20,3,1
zbuffer,zbuffer,,2,1,0,3,7,3,9,1
ion-checkbox,ion-checkbox,,1,0,1,1,8,2,1,1
hammerspoon,hammerspoon,,0,5,6,5,8,11,13,400
google-authenticator,google-authenticator,,7,9,16,16,38,32,3,28.571429
captiveportal,captiveportal,,5,4,15,9,26,24,3,1
centroid,centroid,,14,9,20,23,28,43,0,1
shiny-reactivity,shiny-reactivity,,73,52,100,125,55,225,0,1
akka-persistence,akka-persistence,,7,4,22,11,46,33,2,1
html-datalist,html-datalist,,19,19,27,38,44,65,1,1
application-data,application-data,,0,2,0,2,3,2,8,100
parallel-coordinates,parallel-coordinates,,2,1,13,3,12,16,1,1
codemirror,codemirror,,27,31,49,58,95,107,1,14.814815
react-codemirror,react-codemirror,,6,1,5,7,6,12,1,1
maven-war-plugin,maven-war-plugin,,3,0,8,3,13,11,3,1
maven-ear-plugin,maven-ear-plugin,,1,1,5,2,5,7,3,1
swi-prolog,swi-prolog,,34,28,48,62,82,110,0,1
epf,epf,,0,0,1,0,1,1,3,1
angular-moment,angular-moment,,4,5,24,9,23,33,1,25
aggregates,aggregates,,5,3,3,8,17,11,4,1
django-mysql,django-mysql,,6,7,5,13,15,18,0,16.666667
word-web-addins,word-web-addins,,1,8,7,9,10,16,5,700
typeloadexception,typeloadexception,,0,3,4,3,5,7,8,200
ember-addon,ember-addon,,4,1,4,5,13,9,1,1
html5-input-date,html5-input-date,,3,3,7,6,10,13,1,1
python-dateutil,python-dateutil,,17,10,20,27,45,47,0,1
cncontact,cncontact,,1,4,26,5,25,31,13,300
caret,caret,,34,24,24,58,49,82,1,1
mandelbrot,mandelbrot,,11,5,20,16,22,36,0,1
typesafe,typesafe,,2,5,12,7,25,19,2,150
oidc,oidc,,77,62,132,139,135,271,8,1
imagej,imagej,,14,32,28,46,57,74,0,128.571429
spatstat,spatstat,,9,8,21,17,26,38,0,1
layer,layer,,43,51,76,94,148,170,0,18.604651
comma-operator,comma-operator,,0,5,3,5,15,8,9,400
sld,sld,,2,2,4,4,8,8,1,1
xla,xla,,1,1,0,2,8,2,5,1
sgx,sgx,,11,3,17,14,30,31,9,1
flink-cep,flink-cep,,8,7,22,15,72,37,2,1
knppaginator,knppaginator,,3,3,7,6,12,13,4,1
knppaginatorbundle,knppaginatorbundle,,1,1,2,2,4,4,4,1
ex-unit,ex-unit,,6,4,11,10,24,21,2,1
event-propagation,event-propagation,,2,4,13,6,15,19,1,100
scrollto,scrollto,,3,6,12,9,25,21,1,100
angular-xeditable,angular-xeditable,,0,0,2,0,10,2,1,1
microsoft-test-manager,microsoft-test-manager,,3,4,9,7,40,16,8,33.333333
gabor-filter,gabor-filter,,5,3,0,8,16,8,0,1
commit-message,commit-message,,3,1,6,4,13,10,6,1
grovepi+,grovepi+,,1,1,4,2,5,6,0,1
unordered-set,unordered-set,,10,6,15,16,37,31,9,1
affinity,affinity,,3,5,20,8,22,28,9,66.666667
yii2-rbac,yii2-rbac,,1,0,2,1,9,3,4,1
yii2-user-roles,yii2-user-roles,,0,0,0,0,5,0,4,1
mpnowplayinginfocenter,mpnowplayinginfocenter,,5,3,10,8,8,18,13,1
consumption,consumption,,1,1,6,2,8,8,8,1
std-future,std-future,,5,3,2,8,12,10,9,1
uitouch,uitouch,,7,4,6,11,24,17,13,1
n-tier-architecture,n-tier-architecture,,9,11,6,20,33,26,8,22.222222
sql-types,sql-types,,0,2,0,2,5,2,4,100
tabbed-view,tabbed-view,,0,2,0,2,3,2,13,100
core-plot,core-plot,,5,4,8,9,39,17,13,1
smoke,smoke,,0,0,0,0,3,0,9,1
checkmarx,checkmarx,,8,3,16,11,22,27,3,1
mdf,mdf,,8,6,11,14,28,25,8,1
bitrise,bitrise,,8,9,27,17,21,44,13,12.5
audio-recording,audio-recording,,49,36,89,85,146,174,13,1
visual-studio-2005,visual-studio-2005,,4,1,13,5,23,18,8,1
vb6-migration,vb6-migration,,5,3,34,8,25,42,8,1
smartmenus,smartmenus,,1,0,1,1,2,2,1,1
qtserialport,qtserialport,,2,4,6,6,5,12,9,100
azure-iot-sdk,azure-iot-sdk,,24,21,43,45,55,88,8,1
url-mapping,url-mapping,,0,2,13,2,14,15,3,100
expression-evaluation,expression-evaluation,,2,4,7,6,13,13,9,100
zend-route,zend-route,,0,1,3,1,5,4,4,1
zend-router,zend-router,,4,0,2,4,2,6,4,1
pyroot,pyroot,,3,1,4,4,6,8,0,1
crc16,crc16,,7,8,11,15,32,26,9,14.285714
apache-atlas,apache-atlas,,2,10,12,12,7,24,2,400
mobile-broadband-api,mobile-broadband-api,,0,0,1,0,2,1,9,1
actor,actor,,27,20,49,47,129,96,2,1
gantt-chart,gantt-chart,,30,21,42,51,53,93,1,1
madbee,madbee,,0,0,0,0,1,0,3,1
redistributable,redistributable,,4,3,7,7,10,14,9,1
vcredist,vcredist,,1,0,8,1,9,9,9,1
visual-c++-2015,visual-c++-2015,,2,3,4,5,8,9,9,50
visual-c++-2017,visual-c++-2017,,3,3,7,6,16,13,9,1
parasoft,parasoft,,5,2,1,7,11,8,3,1
group-policy,group-policy,,22,11,20,33,37,53,8,1
flannel,flannel,,11,6,39,17,51,56,6,1
aws-batch,aws-batch,,11,23,33,34,50,67,6,109.090909
literals,literals,,24,24,54,48,88,102,0,1
javaapns,javaapns,,0,0,2,0,4,2,13,1
upi,upi,,5,3,3,8,11,11,3,1
search-box,search-box,,5,3,11,8,22,19,1,1
theming,theming,,7,11,18,18,40,36,1,57.142857
vnext,vnext,,2,3,23,5,25,28,8,50
quickcheck,quickcheck,,4,6,25,10,27,35,2,50
titlebar,titlebar,,8,4,25,12,42,37,8,1
gcov,gcov,,16,13,25,29,41,54,9,1
kcov,kcov,,0,1,0,1,4,1,9,1
azure-devtest-labs,azure-devtest-labs,,1,2,8,3,21,11,8,100
fragment-oncreateview,fragment-oncreateview,,0,0,5,0,9,5,3,1
singularitygs,singularitygs,,0,0,0,0,1,0,1,1
valuetuple,valuetuple,,6,6,20,12,31,32,8,1
uitextchecker,uitextchecker,,1,0,0,1,3,1,13,1
jvm-crash,jvm-crash,,1,5,7,6,18,13,3,400
woff,woff,,2,3,5,5,13,10,1,50
rpn,rpn,,6,3,4,9,15,13,9,1
katalon-studio,katalon-studio,,78,67,148,145,147,293,3,1
lasagne,lasagne,,3,2,8,5,13,13,0,1
generic-type-argument,generic-type-argument,,8,4,12,12,28,24,3,1
optionmenu,optionmenu,,5,8,22,13,47,35,0,60
bootstrap-table,bootstrap-table,,21,27,51,48,92,99,1,28.571429
moxios,moxios,,5,6,9,11,14,20,1,20
os.system,os.system,,21,9,32,30,54,62,0,1
posixlt,posixlt,,1,3,6,4,16,10,0,200
imports-loader,imports-loader,,0,0,0,0,6,0,1,1
exports-loader,exports-loader,,3,0,0,3,2,3,1,1
mkfifo,mkfifo,,4,8,13,12,22,25,9,100
density-independent-pixel,density-independent-pixel,,0,0,1,0,3,1,3,1
nsoutlineview,nsoutlineview,,8,7,15,15,32,30,13,1
hittest,hittest,,4,3,15,7,28,22,13,1
pychart,pychart,,1,0,0,1,1,1,0,1
skypedeveloper,skypedeveloper,,23,6,38,29,51,67,8,1
unified-service-desk,unified-service-desk,,6,5,8,11,5,19,8,1
pixelformat,pixelformat,,2,0,5,2,12,7,3,1
data-acquisition,data-acquisition,,1,5,6,6,5,12,0,400
synchronized,synchronized,,37,29,77,66,114,143,3,1
codelyzer,codelyzer,,0,2,0,2,6,2,1,100
ftdi,ftdi,,13,9,26,22,42,48,9,1
anonymous,anonymous,,4,5,13,9,31,22,8,25
ckan,ckan,,15,11,44,26,72,70,0,1
ropensci,ropensci,,2,2,4,4,8,8,0,1
custom-action,custom-action,,15,16,33,31,64,64,8,6.666667
slowcheetah,slowcheetah,,5,4,6,9,10,15,8,1
buffer-objects,buffer-objects,,0,0,2,0,4,2,9,1
whm,whm,,18,29,53,47,55,100,4,61.111111
timeuuid,timeuuid,,1,1,2,2,6,4,2,1
liquidsoap,liquidsoap,,2,1,3,3,16,6,13,1
android-browser,android-browser,,2,2,5,4,16,9,3,1
jplist,jplist,,1,1,4,2,5,6,1,1
azure-sqldw,azure-sqldw,,12,19,36,31,60,67,8,58.333333
moxy,moxy,,11,6,22,17,40,39,3,1
jenkins-scriptler,jenkins-scriptler,,0,1,3,1,2,4,6,1
jenkins-email-ext,jenkins-email-ext,,4,6,12,10,19,22,6,50
laravel-request,laravel-request,,7,7,17,14,42,31,4,1
vsphere,vsphere,,27,19,58,46,71,104,6,1
highrise,highrise,,1,0,1,1,1,2,8,1
richtextblock,richtextblock,,2,1,3,3,6,6,8,1
arc-ecto,arc-ecto,,0,1,1,1,2,2,2,1
datamart,datamart,,4,2,5,6,10,11,4,1
google-sheets-query,google-sheets-query,,109,248,90,357,127,447,5,127.522936
named-ranges,named-ranges,,15,19,32,34,66,66,5,26.666667
forum,forum,,5,9,14,14,29,28,4,80
bbpress,bbpress,,0,4,6,4,20,10,4,300
peg,peg,,4,5,8,9,15,17,0,25
react-native-fetch-blob,react-native-fetch-blob,,8,14,22,22,36,44,1,75
react-native-fs,react-native-fs,,15,13,16,28,21,44,1,1
mpi4py,mpi4py,,12,21,29,33,60,62,0,75
rhandsontable,rhandsontable,,5,20,38,25,42,63,0,300
grafana-templating,grafana-templating,,11,14,18,25,27,43,6,27.272727
poltergeist,poltergeist,,4,1,9,5,27,14,12,1
eventtrigger,eventtrigger,,15,10,20,25,57,45,1,1
fixeddocument,fixeddocument,,5,0,0,5,2,5,8,1
jtextarea,jtextarea,,19,14,36,33,97,69,3,1
arcgis-android-api,arcgis-android-api,,1,2,13,3,5,16,3,100
google-python-api,google-python-api,,4,0,21,4,45,25,5,1
qvariant,qvariant,,4,5,5,9,18,14,9,25
xcb,xcb,,8,7,15,15,13,30,9,1
candlestick-chart,candlestick-chart,,6,8,28,14,61,42,0,33.333333
quotation-marks,quotation-marks,,4,4,16,8,24,24,0,1
jexl,jexl,,2,2,4,4,14,8,3,1
conditional-breakpoint,conditional-breakpoint,,1,1,4,2,8,6,9,1
powerbi-datasource,powerbi-datasource,,22,17,42,39,88,81,5,1
data-import,data-import,,4,7,18,11,32,29,0,75
wavesurfer.js,wavesurfer.js,,11,10,20,21,27,41,1,1
soundwaves,soundwaves,,1,2,0,3,2,3,13,100
lftp,lftp,,10,2,14,12,22,26,9,1
uikit-dynamics,uikit-dynamics,,4,0,2,4,9,6,13,1
uidynamicanimator,uidynamicanimator,,1,0,4,1,2,5,13,1
uidynamicbehavior,uidynamicbehavior,,0,0,3,0,1,3,13,1
ironfunctions,ironfunctions,,0,0,0,0,1,0,3,1
ms-release-management,ms-release-management,,0,3,5,3,27,8,8,200
sqlpackage,sqlpackage,,10,10,9,20,20,29,4,1
msg,msg,,6,11,12,17,23,29,5,83.333333
matterjs,matterjs,,3,10,7,13,8,20,1,233.333333
lottie-android,lottie-android,,8,11,14,19,30,33,3,37.5
seafile-server,seafile-server,,0,1,4,1,3,5,6,1
cordova-sqlite-storage,cordova-sqlite-storage,,1,1,7,2,9,9,1,1
mathdotnet-symbolics,mathdotnet-symbolics,,0,0,0,0,3,0,8,1
pact,pact,,23,21,50,44,106,94,3,1
pact-jvm,pact-jvm,,4,5,9,9,36,18,3,25
doubly-linked-list,doubly-linked-list,,52,25,89,77,159,166,9,1
fullcalendar-3,fullcalendar-3,,26,35,26,61,62,87,1,34.615385
coalesce,coalesce,,18,12,38,30,63,68,4,1
jmonkeyengine,jmonkeyengine,,1,2,2,3,7,5,3,100
libusb,libusb,,18,13,47,31,50,78,3,1
libusb-1.0,libusb-1.0,,4,9,17,13,16,30,3,125
web-client,web-client,,0,0,0,0,10,0,3,1
jolt,jolt,,35,20,55,55,67,110,1,1
.net-trace,.net-trace,,0,0,0,0,1,0,8,1
go-guru,go-guru,,1,0,0,1,1,1,6,1
catboost,catboost,,11,11,30,22,33,52,0,1
retain,retain,,0,6,13,6,12,19,0,500
fileversioninfo,fileversioninfo,,0,1,4,1,5,5,8,1
xaudio2,xaudio2,,1,5,2,6,9,8,9,400
awk-formatting,awk-formatting,,0,0,3,0,10,3,9,1
jasmine-jquery,jasmine-jquery,,4,1,6,5,11,11,1,1
redux-devtools,redux-devtools,,4,4,12,8,16,20,1,1
examine,examine,,4,0,1,4,10,5,8,1
query-analyzer,query-analyzer,,4,1,2,5,4,7,4,1
cd,cd,,16,21,33,37,47,70,9,31.25
sparkcore,sparkcore,,1,0,5,1,9,6,2,1
flask-jwt,flask-jwt,,6,1,1,7,11,8,0,1
signalr-2,signalr-2,,9,5,19,14,22,33,8,1
empty-list,empty-list,,2,5,8,7,21,15,0,150
windows-media-player,windows-media-player,,7,3,8,10,19,18,8,1
mortar,mortar,,0,0,0,0,1,0,3,1
file-exists,file-exists,,9,7,15,16,45,31,4,1
os.path,os.path,,17,6,35,23,56,58,0,1
jackson-dataformat-csv,jackson-dataformat-csv,,6,1,2,7,7,9,3,1
file-ownership,file-ownership,,3,1,1,4,8,5,9,1
superuser,superuser,,4,5,13,9,21,22,9,25
oracle-apps,oracle-apps,,3,9,14,12,10,26,4,200
oracle-bi,oracle-bi,,5,3,9,8,15,17,4,1
oracle-xml-publisher,oracle-xml-publisher,,5,0,3,5,6,8,4,1
dayofweek,dayofweek,,11,15,26,26,59,52,0,36.363636
derived-column,derived-column,,10,14,6,24,26,30,4,40
inflection,inflection,,3,0,1,3,5,4,0,1
hanami,hanami,,2,0,7,2,16,9,12,1
parameterized-unit-test,parameterized-unit-test,,2,3,6,5,12,11,3,50
merge-conflict-resolution,merge-conflict-resolution,,16,18,48,34,66,82,6,12.5
git-merge-conflict,git-merge-conflict,,24,19,24,43,48,67,6,1
mondrian,mondrian,,10,6,9,16,21,25,4,1
data-driven,data-driven,,4,4,15,8,11,23,3,1
federation,federation,,5,5,8,10,19,18,8,1
nodejs-stream,nodejs-stream,,23,28,24,51,38,75,1,21.73913
hdmi,hdmi,,6,6,18,12,28,30,3,1
xrandr,xrandr,,4,1,9,5,10,14,9,1
items,items,,10,16,24,26,45,50,8,60
load-factor,load-factor,,0,1,2,1,5,3,3,1
system-tray,system-tray,,6,4,14,10,36,24,8,1
bbcode,bbcode,,8,7,8,15,27,23,4,1
nhibernate-envers,nhibernate-envers,,0,1,1,1,6,2,8,1
yii2-authclient,yii2-authclient,,1,0,1,1,8,2,4,1
strong-parameters,strong-parameters,,5,2,20,7,48,27,12,1
actioncontroller,actioncontroller,,6,7,7,13,19,20,12,16.666667
gss,gss,,0,0,1,0,1,1,0,1
direct3d,direct3d,,19,11,27,30,71,57,9,1
optparse-applicative,optparse-applicative,,1,1,5,2,7,7,2,1
atlasboard,atlasboard,,0,0,0,0,1,0,6,1
sysdate,sysdate,,3,1,12,4,16,16,4,1
ecdsa,ecdsa,,34,22,38,56,82,94,6,1
pkcs#10,pkcs#10,,0,0,1,0,5,1,6,1
rar,rar,,7,7,14,14,32,28,0,1
domino-designer-eclipse,domino-designer-eclipse,,15,4,10,19,28,29,5,1
unpivot,unpivot,,23,27,54,50,110,104,4,17.391304
unity-networking,unity-networking,,2,1,5,3,21,8,8,1
junit-theory,junit-theory,,0,0,0,0,2,0,3,1
matchmedia,matchmedia,,4,4,3,8,8,11,1,1
ifttt,ifttt,,12,9,43,21,52,64,4,1
glm-math,glm-math,,49,39,89,88,110,177,9,1
where-in,where-in,,12,6,21,18,47,39,4,1
audiorecord,audiorecord,,6,5,10,11,20,21,3,1
spreadsheetml,spreadsheetml,,1,2,3,3,6,6,8,100
wndproc,wndproc,,1,3,10,4,20,14,8,200
wmp,wmp,,2,1,5,3,2,8,8,1
axwindowsmediaplayer,axwindowsmediaplayer,,3,2,6,5,4,11,8,1
sabre,sabre,,10,13,24,23,67,47,3,30
apply-templates,apply-templates,,1,1,1,2,4,3,3,1
clonenode,clonenode,,0,1,10,1,9,11,1,1
lcs,lcs,,9,5,11,14,17,25,0,1
freetext,freetext,,3,3,2,6,8,8,4,1
git-review,git-review,,1,0,2,1,6,3,6,1
mojibake,mojibake,,3,3,4,6,17,10,0,1
probability-density,probability-density,,19,20,21,39,62,60,0,5.263158
kernel-density,kernel-density,,20,23,34,43,57,77,0,15
density-plot,density-plot,,16,16,34,32,70,66,0,1
graylog2,graylog2,,10,7,30,17,31,47,6,1
p2,p2,,7,4,16,11,27,27,3,1
protractor-net,protractor-net,,4,4,3,8,8,11,3,1
wayland,wayland,,5,9,8,14,45,22,9,80
uv-mapping,uv-mapping,,11,7,16,18,27,34,9,1
kriging,kriging,,10,2,7,12,17,19,0,1
gstat,gstat,,2,3,5,5,14,10,0,50
lti,lti,,6,2,14,8,15,22,12,1
identity-insert,identity-insert,,2,2,4,4,8,8,4,1
calculated-field,calculated-field,,19,18,29,37,77,66,5,1
cgdb,cgdb,,0,1,1,1,2,2,9,1
tfs-code-review,tfs-code-review,,1,3,6,4,10,10,8,200
pygit2,pygit2,,2,4,4,6,3,10,0,100
contacts-framework,contacts-framework,,0,1,4,1,8,5,13,1
non-printing-characters,non-printing-characters,,1,2,2,3,14,5,0,100
ef-core-2.0,ef-core-2.0,,51,40,113,91,428,204,8,1
borland-c++,borland-c++,,4,4,1,8,11,9,9,1
eps,eps,,1,4,12,5,26,17,8,300
preferences,preferences,,8,10,25,18,41,43,3,25
namenode,namenode,,7,11,19,18,45,37,2,57.142857
jitterbit,jitterbit,,0,0,2,0,8,2,4,1
data-pipeline,data-pipeline,,3,3,7,6,15,13,6,1
pimcore,pimcore,,8,2,12,10,32,22,4,1
pimcore-v5,pimcore-v5,,7,3,12,10,18,22,4,1
iproute,iproute,,3,4,5,7,7,12,9,33.333333
react-bootstrap-typeahead,react-bootstrap-typeahead,,5,9,6,14,14,20,1,80
uipresentationcontroller,uipresentationcontroller,,1,5,4,6,8,10,13,400
iphone-x,iphone-x,,24,4,75,28,530,103,13,1
rdb,rdb,,1,3,0,4,2,4,3,200
temperature,temperature,,9,8,28,17,54,45,0,1
chef-custom-resource,chef-custom-resource,,0,0,1,0,4,1,12,1
squish,squish,,3,6,15,9,22,24,0,100
tabpanel,tabpanel,,3,7,5,10,23,15,0,133.333333
powershell-module,powershell-module,,8,4,7,12,20,19,8,1
tukey,tukey,,3,11,9,14,11,23,0,266.666667
extras,extras,,0,0,0,0,7,0,3,1
jscs,jscs,,0,0,1,0,3,1,1,1
linter,linter,,8,8,25,16,40,41,0,1
pyopencl,pyopencl,,5,5,17,10,32,27,0,1
trading,trading,,19,24,22,43,86,65,0,26.315789
py4j,py4j,,12,9,24,21,30,45,2,1
truncate,truncate,,17,32,54,49,115,103,4,88.235294
face-id,face-id,,10,3,17,13,61,30,13,1
sharelatex,sharelatex,,1,0,2,1,7,3,0,1
schemacrawler,schemacrawler,,0,0,4,0,8,4,3,1
gluu,gluu,,2,2,3,4,5,7,8,1
jquerydatetimepicker,jquerydatetimepicker,,2,4,8,6,16,14,1,100
xml-libxml,xml-libxml,,2,5,11,7,12,18,3,150
grouplayout,grouplayout,,0,1,2,1,7,3,3,1
zalgo,zalgo,,1,0,1,1,1,2,0,1
fsockopen,fsockopen,,8,8,10,16,15,26,4,1
peerjs,peerjs,,6,8,16,14,31,30,1,33.333333
wikipedia-api,wikipedia-api,,21,10,42,31,86,73,0,1
visualizer,visualizer,,8,5,14,13,14,27,3,1
houghlines,houghlines,,8,2,5,10,8,15,0,1
ktor,ktor,,32,39,56,71,34,127,3,21.875
reform,reform,,1,0,2,1,3,3,12,1
multiple-processes,multiple-processes,,6,3,6,9,10,15,9,1
code-climate,code-climate,,1,0,6,1,8,7,6,1
oozie-coordinator,oozie-coordinator,,6,3,18,9,30,27,2,1
addtextchangedlistener,addtextchangedlistener,,4,1,8,5,10,13,3,1
qlistwidget,qlistwidget,,17,12,28,29,64,57,0,1
qlistwidgetitem,qlistwidgetitem,,2,6,6,8,19,14,0,200
gobject,gobject,,4,6,13,10,22,23,9,50
vertex,vertex,,5,9,21,14,52,35,0,80
terraform-template-file,terraform-template-file,,4,4,13,8,22,21,6,1
marklogic-8,marklogic-8,,10,7,51,17,103,68,3,1
network-traffic,network-traffic,,5,9,22,14,29,36,9,80
datastage,datastage,,17,11,21,28,35,49,4,1
message-hub,message-hub,,0,0,2,0,16,2,2,1
avro-tools,avro-tools,,5,6,10,11,18,21,2,20
webmail,webmail,,5,6,9,11,18,20,4,20
skyfield,skyfield,,2,2,8,4,6,12,0,1
gdbserver,gdbserver,,8,5,21,13,34,34,9,1
userinfo,userinfo,,3,3,5,6,18,11,4,1
wagtail-streamfield,wagtail-streamfield,,7,4,9,11,31,20,0,1
fastq,fastq,,6,4,11,10,17,21,0,1
sql-cte,sql-cte,,0,1,5,1,4,6,4,1
g-code,g-code,,5,7,6,12,12,18,0,40
transactional-email,transactional-email,,1,1,6,2,7,8,4,1
knockout-validation,knockout-validation,,1,2,8,3,14,11,1,100
fuzzywuzzy,fuzzywuzzy,,23,24,57,47,48,104,0,4.347826
fragment-caching,fragment-caching,,0,1,1,1,4,2,12,1
term-vectors,term-vectors,,0,1,1,1,5,2,6,1
flatmap,flatmap,,10,17,50,27,75,77,2,70
webm,webm,,13,16,27,29,54,56,13,23.076923
slim-lang,slim-lang,,4,4,37,8,50,45,12,1
animatedvectordrawable,animatedvectordrawable,,2,2,10,4,10,14,3,1
activerecord-relation,activerecord-relation,,0,0,3,0,5,3,12,1
displayobject,displayobject,,1,0,2,1,2,3,13,1
otp,otp,,9,8,29,17,57,46,2,1
plm,plm,,18,14,23,32,48,55,0,1
ampersand,ampersand,,5,8,18,13,17,31,4,60
mongodb-asyc-driver,mongodb-asyc-driver,,0,0,0,0,2,0,3,1
dotnetbrowser,dotnetbrowser,,0,3,10,3,27,13,8,200
vue-loader,vue-loader,,18,16,32,34,65,66,1,1
custom-function,custom-function,,13,28,32,41,72,73,5,115.384615
google-sheets-formula,google-sheets-formula,,451,636,243,1087,58,1330,5,41.019956
dictvectorizer,dictvectorizer,,0,2,0,2,7,2,0,100
recursive-backtracking,recursive-backtracking,,7,12,16,19,35,35,0,71.428571
cortex-m3,cortex-m3,,9,4,8,13,27,21,9,1
autograd,autograd,,19,18,22,37,22,59,0,1
domxpath,domxpath,,7,15,18,22,31,40,4,114.285714
cunit,cunit,,0,1,5,1,5,6,9,1
custom-attributes,custom-attributes,,8,8,37,16,53,53,8,1
webintents,webintents,,1,1,4,2,3,6,3,1
text-decorations,text-decorations,,2,5,4,7,11,11,1,150
smt,smt,,22,26,46,48,78,94,0,18.181818
decidable,decidable,,5,0,2,5,8,7,0,1
system.io.packaging,system.io.packaging,,1,1,3,2,3,5,8,1
heif,heif,,3,2,4,5,23,9,13,1
openmesh,openmesh,,2,1,5,3,8,8,0,1
spatial-query,spatial-query,,11,9,20,20,36,40,4,1
mysql-spatial,mysql-spatial,,3,0,6,3,6,9,4,1
getc,getc,,1,1,1,2,6,3,9,1
gtk-textbuffer,gtk-textbuffer,,0,0,1,0,1,1,9,1
react-relay,react-relay,,2,0,2,2,14,4,1,1
adminer,adminer,,6,5,14,11,15,25,4,1
infowindow,infowindow,,17,11,24,28,76,52,1,1
disabled-control,disabled-control,,2,4,8,6,21,14,1,100
paypal-webhooks,paypal-webhooks,,2,5,5,7,6,12,4,150
lending-club-api,lending-club-api,,0,1,0,1,3,1,0,1
dtmf,dtmf,,4,5,8,9,19,17,13,25
agi,agi,,14,11,10,25,31,35,13,1
vici,vici,,0,0,1,0,2,1,13,1
openscenegraph,openscenegraph,,10,1,12,11,20,23,9,1
inference,inference,,25,16,33,41,49,74,0,1
gpu-constant-memory,gpu-constant-memory,,2,1,0,3,4,3,0,1
mandrill,mandrill,,9,8,30,17,32,47,4,1
pypdf2,pypdf2,,51,56,79,107,107,186,0,9.803922
iphone-developer-program,iphone-developer-program,,3,2,10,5,22,15,13,1
unbounce,unbounce,,3,2,2,5,5,7,1,1
boost-propertytree,boost-propertytree,,1,2,8,3,27,11,9,100
as.yearqtr,as.yearqtr,,1,1,0,2,2,2,0,1
checkpointing,checkpointing,,6,3,8,9,16,17,0,1
typescript-2.5,typescript-2.5,,0,0,0,0,21,0,1,1
pickadate,pickadate,,7,2,0,9,16,9,1,1
tornadofx,tornadofx,,15,23,42,38,98,80,3,53.333333
ms-extensions-logging,ms-extensions-logging,,0,0,1,0,1,1,8,1
memory-segmentation,memory-segmentation,,8,3,4,11,8,15,9,1
micro-architecture,micro-architecture,,5,2,15,7,7,22,9,1
testunit,testunit,,0,0,5,0,6,5,12,1
sitecore7,sitecore7,,0,0,5,0,6,5,8,1
xterm,xterm,,9,4,18,13,39,31,9,1
uilongpressgesturerecogni,uilongpressgesturerecogni,,5,4,11,9,20,20,13,1
scalaz,scalaz,,9,14,25,23,78,48,2,55.555556
web2py,web2py,,15,24,50,39,69,89,0,60
lsmeans,lsmeans,,2,1,11,3,18,14,0,1
mediaextractor,mediaextractor,,3,2,5,5,7,10,3,1
vpc,vpc,,40,34,74,74,73,148,6,1
stencyl,stencyl,,0,2,0,2,1,2,9,100
fuse.js,fuse.js,,1,10,3,11,11,14,1,900
osi,osi,,2,0,6,2,8,8,9,1
ti-basic,ti-basic,,3,1,7,4,15,11,0,1
ti-nspire,ti-nspire,,2,0,4,2,13,6,9,1
minio,minio,,30,34,28,64,42,92,6,13.333333
dynamic-properties,dynamic-properties,,1,0,2,1,2,3,2,1
gperftools,gperftools,,3,1,6,4,7,10,9,1
responsive-filemanager,responsive-filemanager,,2,1,8,3,10,11,4,1
uberjar,uberjar,,2,3,11,5,21,16,3,50
accumulate,accumulate,,8,8,14,16,26,30,0,1
weighting,weighting,,3,4,4,7,7,11,0,33.333333
twitter-search,twitter-search,,1,1,2,2,7,4,0,1
django-modeltranslation,django-modeltranslation,,2,3,6,5,12,11,0,50
gltf,gltf,,36,36,59,72,78,131,1,1
windows-kernel,windows-kernel,,10,5,8,15,35,23,9,1
stripe-connect,stripe-connect,,0,0,0,0,95,0,4,1
java-home,java-home,,9,8,19,17,42,36,3,1
virtual-column,virtual-column,,0,1,3,1,8,4,4,1
rouge,rouge,,4,4,11,8,6,19,0,1
linefeed,linefeed,,4,2,10,6,30,16,9,1
apache-commons-httpclient,apache-commons-httpclient,,8,4,23,12,31,35,3,1
socketchannel,socketchannel,,4,3,15,7,12,22,3,1
managed-cuda,managed-cuda,,1,1,0,2,7,2,0,1
fog-aws,fog-aws,,0,0,2,0,3,2,12,1
glympse,glympse,,0,0,0,0,6,0,3,1
fbsdk,fbsdk,,5,9,33,14,75,47,13,80
uml-designer,uml-designer,,1,1,0,2,5,2,3,1
directed-acyclic-graphs,directed-acyclic-graphs,,28,35,77,63,79,140,0,25
partial-ordering,partial-ordering,,0,0,1,0,11,1,9,1
serve,serve,,15,18,18,33,44,51,4,20
sanity-testing,sanity-testing,,1,0,1,1,2,2,3,1
iboutletcollection,iboutletcollection,,3,2,4,5,8,9,13,1
ubuntu-server,ubuntu-server,,19,17,33,36,118,69,4,1
excel-automation,excel-automation,,2,2,5,4,14,9,5,1
bluegiga,bluegiga,,0,1,2,1,5,3,3,1
angular-cookies,angular-cookies,,1,1,3,2,20,5,1,1
missing-cookies,missing-cookies,,0,1,0,1,1,1,4,1
indexed-view,indexed-view,,3,2,6,5,6,11,4,1
angular-ui-select,angular-ui-select,,6,3,4,9,16,13,1,1
visual-studio-test-runner,visual-studio-test-runner,,4,2,7,6,7,13,8,1
migradoc,migradoc,,10,8,19,18,46,37,8,1
bcnf,bcnf,,2,4,9,6,12,15,4,100
pulseaudio,pulseaudio,,12,11,21,23,28,44,13,1
gdt,gdt,,2,2,9,4,6,13,9,1
android-checkbox,android-checkbox,,16,13,38,29,74,67,3,1
memsql,memsql,,6,9,20,15,30,35,4,50
circliful,circliful,,0,0,1,0,2,1,1,1
address-space,address-space,,0,2,4,2,7,6,9,100
chromebook,chromebook,,17,17,28,34,46,62,3,1
argumentnullexception,argumentnullexception,,3,6,7,9,11,16,8,100
currency-formatting,currency-formatting,,7,5,22,12,39,34,4,1
fltk,fltk,,9,3,12,12,28,24,9,1
aws-sdk-nodejs,aws-sdk-nodejs,,16,19,36,35,58,71,6,18.75
ocl,ocl,,2,2,7,4,14,11,3,1
piping,piping,,0,0,0,0,51,0,9,1
fromhtml,fromhtml,,2,1,5,3,9,8,3,1
sharpmap,sharpmap,,0,0,1,0,7,1,8,1
mapsui,mapsui,,3,4,5,7,1,12,8,33.333333
shared-element-transition,shared-element-transition,,18,12,35,30,68,65,3,1
blat,blat,,0,1,0,1,7,1,9,1
lint,lint,,39,50,106,89,183,195,3,28.205128
nedb,nedb,,10,7,22,17,22,39,1,1
geography,geography,,8,7,16,15,35,31,4,1
watch-os-2,watch-os-2,,3,1,6,4,15,10,13,1
wkinterfacelabel,wkinterfacelabel,,0,0,1,0,1,1,13,1
load-data-infile,load-data-infile,,13,8,31,21,24,52,4,1
freeswitch,freeswitch,,13,17,32,30,45,62,13,30.769231
fusionpbx,fusionpbx,,1,1,6,2,7,8,13,1
chroot,chroot,,8,8,9,16,26,25,9,1
collatz,collatz,,3,2,12,5,24,17,0,1
robotium,robotium,,2,2,5,4,7,9,3,1
bidirectional,bidirectional,,20,12,19,32,39,51,0,1
multi-layer,multi-layer,,4,0,12,4,18,16,0,1
openproject,openproject,,8,4,2,12,5,14,4,1
qt5.7,qt5.7,,0,1,1,1,8,2,9,1
pixels,pixels,,0,0,0,0,77,0,0,1
c9.io,c9.io,,2,0,10,2,25,12,12,1
pgbouncer,pgbouncer,,13,7,12,20,19,32,4,1
image-upload,image-upload,,18,22,23,40,67,63,4,22.222222
angular-schema-form,angular-schema-form,,3,0,5,3,14,8,1,1
smarthomeskill,smarthomeskill,,2,3,16,5,12,21,6,50
4g,4g,,5,0,11,5,11,16,3,1
device-management,device-management,,2,1,1,3,7,4,13,1
intentservice,intentservice,,11,9,33,20,85,53,3,1
sql-server-ce,sql-server-ce,,13,4,24,17,60,41,8,1
windows-ce,windows-ce,,17,17,33,34,74,67,8,1
sbteclipse,sbteclipse,,1,0,0,1,6,1,2,1
rsacryptoserviceprovider,rsacryptoserviceprovider,,6,3,7,9,8,16,6,1
streaming-radio,streaming-radio,,0,0,0,0,1,0,3,1
progressdialog,progressdialog,,20,12,38,32,76,70,3,1
android-launcher,android-launcher,,8,7,29,15,69,44,3,1
windows-server-2008,windows-server-2008,,12,15,29,27,65,56,8,25
angular-openlayers,angular-openlayers,,3,11,7,14,16,21,1,266.666667
octobercms-plugins,octobercms-plugins,,20,20,51,40,82,91,4,1
october-form-controller,october-form-controller,,3,4,7,7,19,14,4,33.333333
rijndaelmanaged,rijndaelmanaged,,4,3,11,7,12,18,6,1
exc-bad-access,exc-bad-access,,13,4,32,17,74,49,13,1
kern-invalid-address,kern-invalid-address,,0,0,1,0,2,1,13,1
ionic-v1,ionic-v1,,14,7,31,21,90,52,1,1
onitemclick,onitemclick,,3,3,4,6,16,10,3,1
getview,getview,,2,2,5,4,14,9,3,1
arduino-due,arduino-due,,4,2,6,6,10,12,9,1
waterline,waterline,,14,6,28,20,65,48,1,1
vector-icons,vector-icons,,1,1,3,2,11,5,1,1
biztalk-2013r2,biztalk-2013r2,,2,2,1,4,17,5,8,1
receive-location,receive-location,,0,0,0,0,2,0,8,1
uiinclude,uiinclude,,1,0,1,1,3,2,3,1
git-init,git-init,,1,0,3,1,6,4,6,1
reactive-cocoa,reactive-cocoa,,3,7,14,10,37,24,13,133.333333
reactive-swift,reactive-swift,,5,7,17,12,35,29,13,40
daemons,daemons,,3,2,3,5,5,8,12,1
flask-script,flask-script,,1,0,3,1,9,4,0,1
mongo-java-driver,mongo-java-driver,,9,12,30,21,50,51,1,33.333333
staggeredgridlayoutmanager,staggeredgridlayoutmanager,,1,4,5,5,20,10,3,300
build-helper-maven-plugin,build-helper-maven-plugin,,1,2,4,3,7,7,3,100
network-share,network-share,,9,4,9,13,8,22,8,1
snap.svg,snap.svg,,6,13,20,19,47,39,1,116.666667
finalbuilder,finalbuilder,,2,1,1,3,5,4,9,1
bpl,bpl,,0,0,1,0,3,1,9,1
side-menu,side-menu,,12,11,25,23,59,48,13,1
textangular,textangular,,1,1,3,2,6,5,1,1
listctrl,listctrl,,1,1,0,2,4,2,0,1
page-caching,page-caching,,2,0,4,2,9,6,9,1
http-accept-header,http-accept-header,,4,4,7,8,10,15,4,1
watch-os-3,watch-os-3,,2,0,0,2,20,2,13,1
ostream,ostream,,12,6,24,18,70,42,9,1
stereoscopy,stereoscopy,,3,3,2,6,20,8,0,1
not-operator,not-operator,,0,3,2,3,6,5,0,200
bulk-operations,bulk-operations,,5,4,5,9,11,14,4,1
facebook-ios-sdk,facebook-ios-sdk,,12,5,13,17,48,30,13,1
multiple-instances,multiple-instances,,20,12,42,32,46,74,3,1
os-userspace,os-userspace,,0,0,0,0,4,0,9,1
mkdocs,mkdocs,,2,12,12,14,20,26,0,500
ctags,ctags,,8,5,16,13,41,29,9,1
loose-coupling,loose-coupling,,0,3,7,3,14,10,3,200
usb-mass-storage,usb-mass-storage,,0,0,3,0,5,3,3,1
code-conversion,code-conversion,,2,6,4,8,18,12,8,200
spring-scheduled,spring-scheduled,,14,16,40,30,58,70,3,14.285714
android-mediascanner,android-mediascanner,,2,3,5,5,9,10,3,50
play-json,play-json,,12,16,19,28,43,47,2,33.333333
cryptoswift,cryptoswift,,2,6,6,8,16,14,13,200
arc4random,arc4random,,2,0,5,2,15,7,13,1
windows-runtime,windows-runtime,,21,31,32,52,84,84,8,47.619048
c++-winrt,c++-winrt,,28,32,65,60,47,125,8,14.285714
c++-coroutine,c++-coroutine,,6,4,5,10,8,15,9,1
tombstone,tombstone,,2,4,3,6,10,9,2,100
mongoose-web-server,mongoose-web-server,,3,0,6,3,5,9,1,1
epicor,epicor,,2,0,3,2,7,5,4,1
android-studio-2.0,android-studio-2.0,,2,0,0,2,5,2,3,1
ipreviewhandler,ipreviewhandler,,1,0,0,1,1,1,8,1
objection.js,objection.js,,21,13,22,34,29,56,1,1
remotewebdriver,remotewebdriver,,6,14,16,20,41,36,3,133.333333
kohana,kohana,,2,2,6,4,14,10,4,1
titanium-mobile,titanium-mobile,,6,3,21,9,25,30,13,1
http-delete,http-delete,,18,8,19,26,55,45,4,1
mechanize,mechanize,,16,21,33,37,94,70,0,31.25
cloud-haskell,cloud-haskell,,0,0,0,0,9,0,2,1
dpapi,dpapi,,4,3,6,7,9,13,8,1
unpack,unpack,,14,16,28,30,20,58,0,14.285714
android-ndk-r5,android-ndk-r5,,0,1,1,1,1,2,3,1
android-ndk-r7,android-ndk-r7,,0,0,1,0,2,1,3,1
android-ndk-r4,android-ndk-r4,,0,0,0,0,1,0,3,1
geode,geode,,9,11,14,20,59,34,3,22.222222
presenter,presenter,,4,3,7,7,14,14,3,1
aws-sdk-ios,aws-sdk-ios,,2,2,12,4,14,16,6,1
nlog-configuration,nlog-configuration,,1,0,1,1,4,2,8,1
encog,encog,,4,2,11,6,11,17,0,1
tintcolor,tintcolor,,2,4,6,6,13,12,13,100
cadvisor,cadvisor,,11,2,14,13,22,27,6,1
setx,setx,,0,0,2,0,3,2,3,1
datetimeoffset,datetimeoffset,,15,11,21,26,55,47,8,1
qhash,qhash,,1,1,2,2,3,4,9,1
gibbon,gibbon,,1,2,1,3,9,4,12,100
flake8,flake8,,17,14,29,31,44,60,0,1
code-splitting,code-splitting,,24,17,61,41,75,102,1,1
facebook-fql,facebook-fql,,2,1,4,3,11,7,13,1
ui-sref,ui-sref,,2,0,0,2,12,2,1,1
libssh2,libssh2,,6,9,8,15,19,23,9,50
fuzzy-search,fuzzy-search,,30,17,45,47,72,92,0,1
quad,quad,,5,2,9,7,19,16,0,1
dynamic-method,dynamic-method,,0,0,0,0,2,0,0,1
hasattr,hasattr,,1,1,2,2,3,4,0,1
physfs,physfs,,1,0,0,1,2,1,9,1
same-origin-policy,same-origin-policy,,9,14,38,23,53,61,1,55.555556
allow-same-origin,allow-same-origin,,1,2,11,3,16,14,1,100
image-zoom,image-zoom,,5,11,12,16,26,28,1,120
urldecode,urldecode,,6,7,15,13,28,28,4,16.666667
uiview-hierarchy,uiview-hierarchy,,2,2,3,4,14,7,13,1
avasset,avasset,,9,12,20,21,57,41,13,33.333333
wix3.10,wix3.10,,1,2,7,3,18,10,8,100
decouple,decouple,,0,0,1,0,3,1,8,1
source-code-protection,source-code-protection,,4,3,5,7,14,12,8,1
http-status-code-303,http-status-code-303,,0,2,3,2,4,5,4,100
comctl32,comctl32,,0,2,1,2,4,3,9,100
winscp-net,winscp-net,,5,8,16,13,40,29,9,60
javax.sound.midi,javax.sound.midi,,3,1,1,4,6,5,3,1
jenkins-build-flow,jenkins-build-flow,,0,2,3,2,3,5,6,100
polar-coordinates,polar-coordinates,,18,11,46,29,63,75,0,1
django-postgresql,django-postgresql,,7,4,8,11,23,19,0,1
azure-analysis-services,azure-analysis-services,,25,23,40,48,57,88,8,1
pyinotify,pyinotify,,0,1,2,1,7,3,0,1
paypal-ipn,paypal-ipn,,19,32,66,51,122,117,4,68.421053
waveform,waveform,,9,9,15,18,41,33,13,1
adc,adc,,20,19,35,39,44,74,9,1
vaadin-charts,vaadin-charts,,2,1,3,3,11,6,3,1
socketexception,socketexception,,6,9,13,15,30,28,8,50
risk-management,risk-management,,3,0,9,3,8,12,0,1
postgres.app,postgres.app,,0,0,1,0,2,1,4,1
landscape-portrait,landscape-portrait,,5,9,16,14,44,30,3,80
dblink,dblink,,12,10,36,22,45,58,4,1
rails-upgrade,rails-upgrade,,3,2,6,5,7,11,12,1
identity-delegation,identity-delegation,,0,0,0,0,2,0,8,1
quickfixn,quickfixn,,2,2,8,4,14,12,14,1
jsignature,jsignature,,2,1,2,3,9,5,1,1
x-cart,x-cart,,1,0,4,1,15,5,4,1
perfect,perfect,,3,1,5,4,28,9,13,1
llvm-4.0,llvm-4.0,,0,0,0,0,3,0,9,1
export-to-pdf,export-to-pdf,,11,29,40,40,72,80,5,163.636364
userlocation,userlocation,,2,1,5,3,9,8,13,1
vnet,vnet,,11,15,24,26,32,50,8,36.363636
othello,othello,,0,1,1,1,5,2,0,1
scripting-language,scripting-language,,6,1,15,7,16,22,9,1
monomorphism-restriction,monomorphism-restriction,,1,0,3,1,1,4,2,1
server-side-validation,server-side-validation,,1,3,3,4,10,7,1,200
contentful-management,contentful-management,,1,1,4,2,8,6,1,1
hibernate-ogm,hibernate-ogm,,3,2,13,5,49,18,3,1
node-http-proxy,node-http-proxy,,9,6,8,15,18,23,1,1
web-notifications,web-notifications,,6,6,11,12,25,23,13,1
armv8,armv8,,10,10,18,20,27,38,9,1
nix-shell,nix-shell,,1,0,1,1,2,2,2,1
certutil,certutil,,4,1,12,5,9,17,6,1
pdf417,pdf417,,3,4,7,7,14,14,3,33.333333
licenses.licx,licenses.licx,,1,1,1,2,4,3,8,1
control-center,control-center,,3,1,4,4,10,8,13,1
human-computer-interface,human-computer-interface,,2,0,2,2,2,4,13,1
gnome-shell,gnome-shell,,1,3,11,4,23,15,9,200
lpsolve,lpsolve,,15,12,15,27,25,42,0,1
smartassembly,smartassembly,,0,0,1,0,3,1,8,1
cgihttpserver,cgihttpserver,,0,0,0,0,2,0,4,1
re-natal,re-natal,,1,1,3,2,4,5,2,1
fiware-wilma,fiware-wilma,,1,1,1,2,10,3,6,1
junit5-extension-model,junit5-extension-model,,3,4,12,7,8,19,3,33.333333
priority-queue,priority-queue,,50,44,102,94,207,196,3,1
producer,producer,,9,6,6,15,23,21,3,1
accessibilityservice,accessibilityservice,,21,20,40,41,69,81,3,1
videojs-transcript,videojs-transcript,,1,0,2,1,5,3,13,1
winbugs,winbugs,,5,11,9,16,19,25,0,120
r2winbugs,r2winbugs,,5,3,4,8,10,12,0,1
asp.net-mvc-views,asp.net-mvc-views,,4,1,3,5,13,8,8,1
hexo,hexo,,6,8,20,14,37,34,1,33.333333
yaml-front-matter,yaml-front-matter,,5,1,10,6,17,16,1,1
crashlytics-beta,crashlytics-beta,,0,3,9,3,35,12,3,200
nxp-microcontroller,nxp-microcontroller,,10,11,18,21,25,39,9,10
aurelia-framework,aurelia-framework,,6,2,16,8,61,24,1,1
jaas,jaas,,9,18,27,27,46,54,3,100
android-design-library,android-design-library,,12,9,17,21,40,38,3,1
sonata-media-bundle,sonata-media-bundle,,1,1,10,2,31,12,4,1
python-behave,python-behave,,15,12,34,27,65,61,3,1
passport-twitter,passport-twitter,,2,4,3,6,8,9,1,100
ckquery,ckquery,,4,1,1,5,10,6,13,1
application-error,application-error,,0,1,2,1,8,3,8,1
cognos,cognos,,21,21,45,42,68,87,4,1
invantive-control,invantive-control,,1,0,0,1,7,1,4,1
addressing,addressing,,2,2,4,4,12,8,9,1
indexed,indexed,,4,1,2,5,9,7,0,1
kahadb,kahadb,,3,0,1,3,6,4,3,1
android-mediarecorder,android-mediarecorder,,12,15,32,27,52,59,3,25
android-mediacodec,android-mediacodec,,5,16,12,21,16,33,3,220
extjs6-classic,extjs6-classic,,9,7,32,16,63,48,1,1
sqlconnection,sqlconnection,,18,13,41,31,73,72,8,1
autosuggest,autosuggest,,17,17,34,34,58,68,1,1
r-mice,r-mice,,13,17,40,30,46,70,0,30.769231
list.js,list.js,,1,0,3,1,16,4,1,1
select-object,select-object,,1,3,12,4,14,16,8,200
google-shopping,google-shopping,,4,4,1,8,6,9,5,1
django-widget,django-widget,,16,4,18,20,27,38,0,1
backendless,backendless,,4,2,5,6,16,11,3,1
cloc,cloc,,1,0,3,1,3,4,6,1
feature-detection,feature-detection,,17,12,27,29,54,56,0,1
opencv-solvepnp,opencv-solvepnp,,2,7,11,9,23,20,0,250
import-csv,import-csv,,17,9,31,26,69,57,8,1
coordinate-systems,coordinate-systems,,24,18,29,42,54,71,0,1
windows-template-studio,windows-template-studio,,8,3,7,11,7,18,8,1
letter-spacing,letter-spacing,,2,3,5,5,8,10,1,50
color-picker,color-picker,,22,12,34,34,60,68,1,1
werkzeug,werkzeug,,11,15,23,26,54,49,0,36.363636
beyondcompare,beyondcompare,,1,1,6,2,18,8,6,1
text-comparison,text-comparison,,1,2,1,3,1,4,0,100
choropleth,choropleth,,29,19,49,48,69,97,0,1
gearman,gearman,,5,4,12,9,16,21,4,1
safetynet,safetynet,,5,2,5,7,15,12,3,1
2.5d,2.5d,,3,0,2,3,1,5,8,1
ogre,ogre,,5,0,5,5,7,10,9,1
jpa-criteria,jpa-criteria,,5,2,17,7,43,24,3,1
parchment,parchment,,1,2,3,3,1,6,13,100
extjs4,extjs4,,15,7,28,22,74,50,1,1
android-debug,android-debug,,7,8,15,15,44,30,3,14.285714
rc4-cipher,rc4-cipher,,9,3,7,12,4,19,6,1
cppcheck,cppcheck,,5,11,15,16,34,31,9,120
conversion-specifier,conversion-specifier,,0,0,3,0,3,3,9,1
ltac,ltac,,1,1,14,2,24,16,2,1
gora,gora,,0,1,1,1,5,2,2,1
pbs,pbs,,7,6,16,13,30,29,0,1
page-zoom,page-zoom,,0,0,0,0,4,0,1,1
javac,javac,,42,27,92,69,180,161,3,1
ecj,ecj,,2,1,3,3,8,6,3,1
atlaskit,atlaskit,,11,4,5,15,5,20,1,1
websphere-7,websphere-7,,1,1,7,2,17,9,3,1
prestashop-1.4,prestashop-1.4,,1,0,0,1,2,1,4,1
referrals,referrals,,5,4,6,9,23,15,4,1
childviewcontroller,childviewcontroller,,11,4,10,15,24,25,13,1
parentviewcontroller,parentviewcontroller,,1,1,1,2,10,3,13,1
codenarc,codenarc,,1,2,1,3,13,4,3,100
ssis-2008,ssis-2008,,13,8,21,21,79,42,4,1
lithium,lithium,,0,0,2,0,4,2,4,1
pdfclown,pdfclown,,2,0,3,2,16,5,3,1
node-mongodb-native,node-mongodb-native,,10,10,13,20,38,33,1,1
decibel,decibel,,3,2,3,5,14,8,13,1
retrypolicy,retrypolicy,,4,1,10,5,12,15,8,1
resource-leak,resource-leak,,3,0,4,3,13,7,3,1
feathers-authentication,feathers-authentication,,9,6,6,15,16,21,1,1
tcplistener,tcplistener,,28,14,37,42,85,79,8,1
callable,callable,,13,19,33,32,67,65,3,46.153846
synonym,synonym,,8,8,16,16,40,32,0,1
forge,forge,,16,15,32,31,56,63,14,1
dynamically-generated,dynamically-generated,,20,17,28,37,84,65,1,1
preloading,preloading,,6,5,9,11,12,20,1,1
reindex,reindex,,12,5,25,17,43,42,0,1
order-of-execution,order-of-execution,,3,8,9,11,12,20,9,166.666667
clickhouse,clickhouse,,30,39,43,69,62,112,4,30
ballerina,ballerina,,4,10,24,14,29,38,14,150
koa-passport,koa-passport,,2,2,2,4,4,6,1,1
mds,mds,,7,1,12,8,27,20,0,1
domain-events,domain-events,,1,0,8,1,10,9,8,1
ps1,ps1,,8,9,10,17,26,27,9,12.5
flask-jwt-extended,flask-jwt-extended,,11,7,12,18,15,30,0,1
datastore,datastore,,22,16,35,38,80,73,6,1
exist-db,exist-db,,7,16,49,23,35,72,3,128.571429
openvx,openvx,,2,1,1,3,3,4,0,1
hash-function,hash-function,,8,4,8,12,18,20,12,1
screenshotexception,screenshotexception,,0,0,0,0,1,0,3,1
selenium-extent-report,selenium-extent-report,,25,11,32,36,61,68,3,1
google-photos,google-photos,,25,14,45,39,45,84,5,1
mouselistener,mouselistener,,25,19,31,44,68,75,3,1
django-comments,django-comments,,3,0,0,3,9,3,0,1
magmi,magmi,,0,3,2,3,12,5,4,200
self-destruction,self-destruction,,0,2,2,2,2,4,6,100
cloud-storage,cloud-storage,,14,7,15,21,32,36,6,1
ln,ln,,4,4,5,8,11,13,9,1
network-interface,network-interface,,6,6,15,12,20,27,9,1
couchbase-sync-gateway,couchbase-sync-gateway,,2,6,9,8,35,17,3,200
couchdb-nano,couchdb-nano,,10,6,8,16,17,24,1,1
n-dimensional,n-dimensional,,2,3,4,5,13,9,0,50
firepath,firepath,,1,0,0,1,8,1,3,1
array-key-exists,array-key-exists,,0,1,0,1,8,1,4,1
amazonsellercentral,amazonsellercentral,,2,5,6,7,11,13,6,150
typeinfo,typeinfo,,0,2,3,2,14,5,9,100
automapper-3,automapper-3,,0,0,2,0,4,2,8,1
volatile,volatile,,31,30,86,61,154,147,3,1
sha1,sha1,,33,21,67,54,111,121,6,1
apksigner,apksigner,,3,2,8,5,15,13,3,1
barman,barman,,0,2,4,2,10,6,4,100
livewires,livewires,,0,0,3,0,3,3,0,1
qgroupbox,qgroupbox,,2,1,5,3,12,8,0,1
jpopupmenu,jpopupmenu,,1,0,4,1,9,5,3,1
objcopy,objcopy,,3,4,5,7,11,12,9,33.333333
scala-breeze,scala-breeze,,0,1,12,1,16,13,2,1
sat,sat,,9,3,11,12,28,23,0,1
yosys,yosys,,1,6,3,7,14,10,9,500
cnf,cnf,,3,0,10,3,4,13,0,1
repo,repo,,14,8,23,22,47,45,6,1
gerrit-trigger,gerrit-trigger,,2,6,9,8,23,17,6,200
dataoutputstream,dataoutputstream,,10,1,10,11,17,21,3,1
ublas,ublas,,0,0,0,0,4,0,9,1
curl-multi,curl-multi,,3,0,11,3,14,14,4,1
react-sortable-hoc,react-sortable-hoc,,5,2,7,7,10,14,1,1
omnipay,omnipay,,4,9,9,13,13,22,4,125
tempo,tempo,,1,1,3,2,2,5,6,1
mongolite,mongolite,,4,5,22,9,18,31,0,25
in-house-distribution,in-house-distribution,,5,2,6,7,15,13,13,1
subtype,subtype,,3,6,6,9,22,15,9,100
pykalman,pykalman,,3,3,5,6,11,11,0,1
sharepoint-2007,sharepoint-2007,,3,1,7,4,11,11,8,1
nanoc,nanoc,,0,0,2,0,3,2,12,1
google-cardboard,google-cardboard,,10,5,16,15,48,31,8,1
orange-pi,orange-pi,,5,2,9,7,20,16,9,1
event-driven,event-driven,,17,17,14,34,27,48,3,1
event-driven-design,event-driven-design,,10,5,10,15,19,25,3,1
computer-forensics,computer-forensics,,3,3,11,6,11,17,9,1
qudpsocket,qudpsocket,,4,1,7,5,7,12,9,1
xattr,xattr,,3,1,5,4,6,9,13,1
xamarin.ios-binding,xamarin.ios-binding,,3,5,2,8,16,10,8,66.666667
docutils,docutils,,2,6,8,8,12,16,0,200
browsefragment,browsefragment,,1,1,3,2,4,5,3,1
citus,citus,,4,5,2,9,6,11,4,25
cultureinfo,cultureinfo,,18,19,24,37,62,61,8,5.555556
timer-trigger,timer-trigger,,1,3,4,4,9,8,8,200
polaris,polaris,,3,0,16,3,8,19,1,1
wordpress-thesis-theme,wordpress-thesis-theme,,0,0,10,0,16,10,4,1
dvr,dvr,,4,3,3,7,4,10,13,1
django-staticfiles,django-staticfiles,,19,25,47,44,93,91,0,31.578947
httpconfiguration,httpconfiguration,,0,0,1,0,4,1,8,1
android-adapterview,android-adapterview,,2,4,7,6,12,13,3,100
salt-cloud,salt-cloud,,0,1,3,1,4,4,0,1
spn,spn,,3,2,1,5,7,6,2,1
keytab,keytab,,4,8,9,12,9,21,2,100
upn,upn,,1,0,3,1,4,4,8,1
ktpass,ktpass,,0,0,0,0,3,0,2,1
sipp,sipp,,2,4,3,6,6,9,13,100
impersonation,impersonation,,16,27,49,43,77,92,8,68.75
bcg,bcg,,1,0,3,1,3,4,9,1
watson-nlu,watson-nlu,,3,3,10,6,22,16,6,1
numerical-computing,numerical-computing,,3,2,5,5,17,10,0,1
vivado-hls,vivado-hls,,5,3,4,8,20,12,9,1
slime,slime,,4,2,8,6,16,14,0,1
atom-feed,atom-feed,,5,13,6,18,17,24,4,160
opensearch,opensearch,,4,2,4,6,9,10,1,1
pycel,pycel,,0,0,0,0,1,0,5,1
co,co,,2,2,1,4,5,5,4,1
custom-protocol,custom-protocol,,3,3,0,6,4,6,1,1
setup-deployment,setup-deployment,,10,8,19,18,26,37,8,1
advertised-shortcut,advertised-shortcut,,0,0,0,0,1,0,9,1
andyroid,andyroid,,0,2,0,2,2,2,3,100
boost-iterators,boost-iterators,,1,0,1,1,6,2,9,1
viewengine,viewengine,,1,5,10,6,7,16,8,400
shdocvw,shdocvw,,3,2,3,5,4,8,8,1
cognos-10,cognos-10,,6,4,20,10,33,30,4,1
delphi-10.1-berlin,delphi-10.1-berlin,,12,8,28,20,116,48,9,1
direct3d11,direct3d11,,7,6,17,13,15,30,9,1
dandelion,dandelion,,2,2,0,4,1,4,3,1
spark-repl,spark-repl,,0,0,2,0,1,2,2,1
exotel-api,exotel-api,,0,0,1,0,2,1,4,1
virtual,virtual,,45,39,88,84,173,172,9,1
ruby-thread,ruby-thread,,0,0,1,0,5,1,12,1
spf13vim,spf13vim,,1,0,0,1,5,1,9,1
solrnet,solrnet,,7,2,12,9,31,21,2,1
create-react-native-app,create-react-native-app,,4,5,23,9,101,32,1,25
vigenere,vigenere,,9,10,19,19,31,38,9,11.111111
occi,occi,,2,5,3,7,14,10,4,150
fusion,fusion,,7,6,10,13,22,23,0,1
inventory-management,inventory-management,,11,4,18,15,16,33,4,1
itsm,itsm,,1,0,1,1,6,2,4,1
mod,mod,,20,9,28,29,53,57,0,1
inboxsdk,inboxsdk,,1,3,9,4,9,13,1,200
presto,presto,,122,129,176,251,225,427,4,5.737705
urbanairship.com,urbanairship.com,,8,4,11,12,29,23,13,1
sql-in,sql-in,,5,3,7,8,22,15,4,1
fedora-21,fedora-21,,0,0,0,0,2,0,6,1
blueprintjs,blueprintjs,,6,0,12,6,26,18,1,1
unhandled,unhandled,,3,2,2,5,14,7,3,1
dep,dep,,3,3,11,6,14,17,6,1
polybase,polybase,,6,8,19,14,12,33,8,33.333333
onbackpressed,onbackpressed,,6,16,40,22,77,62,3,166.666667
layered-navigation,layered-navigation,,1,3,4,4,10,8,4,200
diamond-problem,diamond-problem,,7,5,8,12,23,20,9,1
uniq,uniq,,7,8,19,15,35,34,9,14.285714
eclipse-che,eclipse-che,,7,4,30,11,16,41,3,1
atmel,atmel,,11,12,39,23,54,62,9,9.090909
readlines,readlines,,14,11,35,25,44,60,0,1
embeddinator,embeddinator,,2,0,1,2,5,3,8,1
api-management,api-management,,7,7,15,14,19,29,8,1
java-ee-6,java-ee-6,,6,5,11,11,39,22,3,1
msdeploy,msdeploy,,10,10,28,20,44,48,8,1
linegraph,linegraph,,11,7,27,18,43,45,0,1
spring-batch-admin,spring-batch-admin,,5,4,8,9,22,17,3,1
resizable,resizable,,10,1,23,11,19,34,1,1
col,col,,11,12,17,23,34,40,0,9.090909
words,words,,0,0,0,0,89,0,0,1
laragon,laragon,,9,12,14,21,23,35,4,33.333333
jira-rest-java-api,jira-rest-java-api,,7,8,16,15,30,31,6,14.285714
opennms,opennms,,1,0,10,1,17,11,9,1
copy-item,copy-item,,3,12,11,15,37,26,8,300
autosize,autosize,,12,9,20,21,33,41,13,1
storing-data,storing-data,,8,6,9,14,20,23,0,1
class-members,class-members,,1,7,5,8,15,13,9,600
enterprise-distribution,enterprise-distribution,,3,1,6,4,9,10,13,1
sccm,sccm,,13,22,49,35,77,84,8,69.230769
firefox-marionette,firefox-marionette,,1,1,3,2,9,5,3,1
roda,roda,,1,0,1,1,7,2,12,1
dynamic-list,dynamic-list,,2,0,4,2,7,6,5,1
lockscreen,lockscreen,,13,16,46,29,59,75,3,23.076923
http-status-code-503,http-status-code-503,,16,9,23,25,55,48,4,1
django-middleware,django-middleware,,19,4,25,23,41,48,0,1
intermediate-language,intermediate-language,,2,0,6,2,12,8,8,1
lifting,lifting,,3,0,5,3,6,8,2,1
grob,grob,,4,2,8,6,20,14,0,1
linkedin-jsapi,linkedin-jsapi,,4,2,18,6,22,24,4,1
htmllayout,htmllayout,,0,1,0,1,4,1,1,1
public-method,public-method,,0,4,5,4,10,9,9,300
siblings,siblings,,7,13,19,20,36,39,1,85.714286
android-hardware,android-hardware,,3,2,9,5,6,14,3,1
drools-kie-server,drools-kie-server,,6,2,23,8,47,31,3,1
c++-standard-library,c++-standard-library,,25,30,37,55,69,92,9,20
rabbitmqadmin,rabbitmqadmin,,1,0,1,1,1,2,3,1
paper-trail-gem,paper-trail-gem,,8,6,7,14,23,21,12,1
connection-reset,connection-reset,,2,4,6,6,11,12,3,100
dnn-module,dnn-module,,2,11,17,13,36,30,8,450
ngmodel,ngmodel,,21,18,54,39,72,93,1,1
bug-tracking,bug-tracking,,1,2,3,3,9,6,4,100
sendfile,sendfile,,5,6,6,11,22,17,1,20
broker,broker,,7,10,17,17,41,34,6,42.857143
noaa,noaa,,5,4,14,9,15,23,0,1
rnoaa,rnoaa,,2,1,3,3,5,6,0,1
suave,suave,,2,1,6,3,16,9,8,1
flask-migrate,flask-migrate,,8,17,23,25,30,48,0,112.5
implicit-flow,implicit-flow,,3,3,3,6,14,9,8,1
backstop.js,backstop.js,,2,2,5,4,5,9,1,1
data-dictionary,data-dictionary,,8,7,5,15,14,20,4,1
cgimage,cgimage,,10,7,17,17,32,34,13,1
filetime,filetime,,1,3,5,4,8,9,0,200
sublime-anaconda,sublime-anaconda,,2,4,4,6,10,10,0,100
file-not-found,file-not-found,,10,25,27,35,47,62,0,150
numa,numa,,5,9,19,14,19,33,9,80
test-kitchen,test-kitchen,,3,8,17,11,46,28,12,166.666667
artifacts,artifacts,,5,12,24,17,48,41,3,140
coremltools,coremltools,,11,7,26,18,41,44,13,1
mload,mload,,2,0,0,2,2,2,4,1
popen3,popen3,,1,1,8,2,5,10,12,1
create-view,create-view,,2,8,7,10,21,17,4,300
spring-messaging,spring-messaging,,9,6,13,15,34,28,3,1
command-line-parsing,command-line-parsing,,5,8,8,13,12,21,9,60
windows-messages,windows-messages,,5,7,5,12,19,17,9,40
wmd,wmd,,2,1,3,3,4,6,0,1
pdfjs,pdfjs,,27,19,46,46,49,92,1,1
opengl-4,opengl-4,,9,11,15,20,32,35,9,22.222222
iolanguage,iolanguage,,0,0,0,0,1,0,0,1
reportbuilder,reportbuilder,,14,10,24,24,48,48,4,1
stripslashes,stripslashes,,0,0,0,0,2,0,4,1
broken-pipe,broken-pipe,,4,8,9,12,20,21,0,100
spl,spl,,1,4,5,5,18,10,4,300
linear-interpolation,linear-interpolation,,9,6,32,15,31,47,0,1
visual-sourcesafe-2005,visual-sourcesafe-2005,,0,0,1,0,4,1,8,1
screen-size,screen-size,,6,10,27,16,49,43,3,66.666667
samsung-s8,samsung-s8,,0,1,1,1,6,2,3,1
sharepoint-workflow,sharepoint-workflow,,8,3,24,11,23,35,8,1
event-receiver,event-receiver,,4,4,4,8,6,12,8,1
poi-hssf,poi-hssf,,3,1,2,4,11,6,3,1
phylogeny,phylogeny,,8,10,26,18,31,44,0,25
gridlines,gridlines,,3,4,14,7,16,21,0,33.333333
dashdb,dashdb,,4,4,4,8,22,12,4,1
dataconnect,dataconnect,,0,0,0,0,4,0,4,1
disjoint-sets,disjoint-sets,,8,0,9,8,16,17,0,1
telephony,telephony,,11,10,24,21,52,45,3,1
zombie.js,zombie.js,,1,0,0,1,7,1,1,1
nonetype,nonetype,,40,32,57,72,126,129,0,1
frp,frp,,3,5,3,8,16,11,2,66.666667
reflex,reflex,,2,4,3,6,14,9,2,100
partial-application,partial-application,,5,4,13,9,23,22,2,1
type-synonyms,type-synonyms,,1,1,4,2,4,6,2,1
webhdfs,webhdfs,,8,10,29,18,24,47,2,25
compile-time-constant,compile-time-constant,,4,13,9,17,21,26,9,225
blobs,blobs,,0,0,0,0,6,0,0,1
variable-length,variable-length,,4,3,18,7,23,25,0,1
monk,monk,,1,2,8,3,9,11,1,100
link-to,link-to,,4,4,12,8,35,20,12,1
cmusphinx,cmusphinx,,10,9,19,19,51,38,6,1
pocketsphinx,pocketsphinx,,23,25,28,48,69,76,6,8.695652
pocketsphinx-android,pocketsphinx-android,,2,2,1,4,18,5,6,1
java-2d,java-2d,,11,8,21,19,33,40,3,1
affinetransform,affinetransform,,9,11,13,20,41,33,0,22.222222
django-multilingual,django-multilingual,,0,1,2,1,1,3,0,1
mailcore2,mailcore2,,5,4,6,9,12,15,13,1
mailcore,mailcore,,1,0,0,1,4,1,13,1
gflags,gflags,,3,1,3,4,12,7,9,1
musicxml,musicxml,,1,3,0,4,4,4,0,200
google-amp,google-amp,,0,0,4,0,80,4,1,1
signed-integer,signed-integer,,1,0,5,1,7,6,9,1
interval-tree,interval-tree,,0,0,3,0,6,3,0,1
godeps,godeps,,4,4,8,8,19,16,6,1
exuberant-ctags,exuberant-ctags,,1,3,4,4,12,8,9,200
jsdata,jsdata,,0,0,2,0,9,2,1,1
nio2,nio2,,5,3,3,8,11,11,3,1
hole-punching,hole-punching,,1,4,5,5,7,10,9,300
grant,grant,,13,15,21,28,58,49,4,15.384615
rdl,rdl,,12,5,26,17,29,43,4,1
navigationitem,navigationitem,,1,1,2,2,7,4,13,1
xamarin-test-cloud,xamarin-test-cloud,,1,1,1,2,10,3,8,1
pbrun,pbrun,,0,0,1,0,3,1,9,1
setwindowpos,setwindowpos,,2,0,4,2,3,6,8,1
exitstatus,exitstatus,,4,0,2,4,6,6,9,1
mouseclick-event,mouseclick-event,,7,6,17,13,53,30,1,1
stream-graph,stream-graph,,2,1,1,3,3,4,0,1
boost-spirit,boost-spirit,,19,17,37,36,100,73,9,1
boost-phoenix,boost-phoenix,,0,0,3,0,4,3,9,1
labelled-break,labelled-break,,0,0,0,0,1,0,0,1
simplewebrtc,simplewebrtc,,6,8,14,14,18,28,1,33.333333
openwebrtc,openwebrtc,,3,3,11,6,15,17,1,1
openwebrtcdemo,openwebrtcdemo,,0,0,3,0,3,3,1,1
react-data-grid,react-data-grid,,22,17,17,39,28,56,1,1
icefaces,icefaces,,7,7,7,14,14,21,3,1
scichart,scichart,,6,6,18,12,35,30,8,1
workload-scheduler,workload-scheduler,,0,0,3,0,11,3,3,1
backreference,backreference,,7,6,10,13,31,23,0,1
regexp-substr,regexp-substr,,14,10,23,24,44,47,4,1
console-output,console-output,,0,1,2,1,14,3,3,1
wave,wave,,18,18,25,36,43,61,0,1
bit-depth,bit-depth,,2,6,7,8,7,15,13,200
nonsequential,nonsequential,,0,1,0,1,4,1,0,1
red,red,,2,1,6,3,104,9,0,1
max-pooling,max-pooling,,9,6,12,15,33,27,0,1
cordova-nativestorage,cordova-nativestorage,,1,2,2,3,10,5,1,100
location-provider,location-provider,,0,1,4,1,4,5,3,1
edge.js,edge.js,,3,1,1,4,8,5,1,1
cartesian,cartesian,,4,2,8,6,15,14,0,1
no-database,no-database,,2,1,3,3,5,6,4,1
f#-data,f#-data,,6,9,26,15,34,41,8,50
retrieve-and-rank,retrieve-and-rank,,0,0,0,0,1,0,6,1
magenta,magenta,,1,1,6,2,8,8,0,1
ggtern,ggtern,,4,6,5,10,11,15,0,50
mesa,mesa,,4,5,12,9,11,21,9,25
bookmarks,bookmarks,,21,19,41,40,70,81,1,1
libreoffice-basic,libreoffice-basic,,4,4,13,8,21,21,5,1
linqpad,linqpad,,12,19,20,31,56,51,8,58.333333
html-generation,html-generation,,1,0,0,1,2,1,0,1
roi,roi,,11,14,20,25,40,45,0,27.272727
fiji,fiji,,5,12,9,17,19,26,0,140
hmvc,hmvc,,7,3,15,10,34,25,4,1
identitymanager,identitymanager,,1,4,1,5,5,6,4,300
skybox,skybox,,6,5,7,11,11,18,9,1
amazon-acm,amazon-acm,,1,2,2,3,5,5,6,100
git-workflow,git-workflow,,0,6,8,6,13,14,6,500
howler.js,howler.js,,5,5,16,10,24,26,1,1
angular-compiler,angular-compiler,,3,8,7,11,32,18,1,166.666667
easygui,easygui,,1,1,9,2,21,11,0,1
sortedmap,sortedmap,,1,1,5,2,10,7,3,1
google-web-designer,google-web-designer,,3,3,6,6,14,12,1,1
landsat,landsat,,5,5,10,10,15,20,0,1
mdt,mdt,,2,1,4,3,14,7,8,1
solidworks,solidworks,,9,5,24,14,27,38,8,1
sessionid,sessionid,,5,4,8,9,23,17,4,1
connect-by,connect-by,,8,3,13,11,22,24,4,1
locate,locate,,3,3,9,6,19,15,0,1
reactivemongo,reactivemongo,,4,5,15,9,33,24,2,25
web-testing,web-testing,,77,53,37,130,57,167,3,1
java-api,java-api,,6,12,24,18,48,42,3,100
parseui,parseui,,0,0,0,0,2,0,13,1
file-format,file-format,,17,16,32,33,44,65,0,1
nonblank,nonblank,,4,1,2,5,4,7,5,1
project-template,project-template,,3,2,9,5,30,14,8,1
cocos2d-iphone-2.x,cocos2d-iphone-2.x,,0,0,0,0,1,0,13,1
google-sitelink-searchbox,google-sitelink-searchbox,,0,2,3,2,1,5,4,100
rubaxa-sortable,rubaxa-sortable,,0,2,3,2,12,5,1,100
abstracttablemodel,abstracttablemodel,,2,0,5,2,9,7,3,1
isa,isa,,2,6,11,8,15,19,9,200
amazon-ecr,amazon-ecr,,19,6,11,25,17,36,6,1
pwd,pwd,,1,5,10,6,4,16,9,400
python-importlib,python-importlib,,8,15,15,23,27,38,0,87.5
domcrawler,domcrawler,,6,7,13,13,21,26,4,16.666667
pytesser,pytesser,,2,0,5,2,22,7,0,1
typeahead.js,typeahead.js,,19,18,45,37,80,82,1,1
pixel-manipulation,pixel-manipulation,,0,0,0,0,2,0,1,1
conemu,conemu,,6,5,18,11,26,29,9,1
apacheds,apacheds,,5,3,5,8,5,13,8,1
rational-team-concert,rational-team-concert,,8,5,17,13,16,30,3,1
jfoenix,jfoenix,,16,13,26,29,78,55,3,1
jgraph,jgraph,,8,11,11,19,14,30,1,37.5
trac,trac,,1,3,2,4,18,6,6,200
mgcv,mgcv,,11,16,24,27,39,51,0,45.454545
sphinxql,sphinxql,,3,2,5,5,13,10,4,1
autolisp,autolisp,,5,12,4,17,31,21,5,140
go-playground,go-playground,,1,0,0,1,1,1,6,1
upcasting,upcasting,,2,3,8,5,20,13,9,50
fsevents,fsevents,,4,4,7,8,15,15,1,1
passport-facebook,passport-facebook,,8,9,13,17,40,30,1,12.5
modx-chunks,modx-chunks,,0,0,1,0,2,1,4,1
test-explorer,test-explorer,,2,6,16,8,8,24,8,200
differentialequations.jl,differentialequations.jl,,1,4,7,5,14,12,0,300
low-memory,low-memory,,2,3,1,5,3,6,3,50
associated-types,associated-types,,21,12,23,33,46,56,13,1
sharepoint-designer,sharepoint-designer,,20,21,51,41,66,92,8,5
angular2-md-tabs,angular2-md-tabs,,1,0,2,1,4,3,1,1
fusion360,fusion360,,1,0,6,1,3,7,0,1
natural-join,natural-join,,3,2,2,5,21,7,4,1
maven-dependency,maven-dependency,,6,8,15,14,30,29,3,33.333333
card-flip,card-flip,,0,1,0,1,3,1,1,1
django-quiz,django-quiz,,1,0,0,1,1,1,0,1
structural-typing,structural-typing,,4,6,4,10,12,14,2,50
string.h,string.h,,4,3,10,7,16,17,9,1
key-value-coding,key-value-coding,,1,0,4,1,10,5,13,1
getproperty,getproperty,,2,2,3,4,9,7,3,1
laravel-excel,laravel-excel,,29,29,52,58,43,110,4,1
genius-api,genius-api,,0,2,0,2,2,2,9,100
best-fit,best-fit,,8,2,5,10,8,15,0,1
android-flexboxlayout,android-flexboxlayout,,2,3,7,5,18,12,3,50
vendor,vendor,,13,8,27,21,50,48,4,1
veracode,veracode,,15,21,20,36,34,56,3,40
azure-cli,azure-cli,,65,70,115,135,169,250,8,7.692308
gossip,gossip,,2,2,7,4,12,11,2,1
ember-cli-mirage,ember-cli-mirage,,5,3,4,8,25,12,1,1
acra,acra,,0,1,4,1,11,5,3,1
google-admin-sdk,google-admin-sdk,,24,20,66,44,114,110,5,1
google-shared-contacts,google-shared-contacts,,0,0,1,0,1,1,5,1
ready-api,ready-api,,10,7,27,17,55,44,3,1
facebook-share,facebook-share,,9,12,29,21,46,50,13,33.333333
clappr,clappr,,3,2,4,5,3,9,1,1
rparallel,rparallel,,4,3,4,7,12,11,0,1
jet,jet,,6,6,21,12,27,33,5,1
plasticscm,plasticscm,,2,3,5,5,11,10,6,50
fileappender,fileappender,,1,2,1,3,9,4,3,100
suitecloud,suitecloud,,4,2,4,6,5,10,14,1
dronedeploy,dronedeploy,,0,0,0,0,3,0,1,1
random-seed,random-seed,,44,28,59,72,49,131,0,1
graphic,graphic,,0,0,0,0,41,0,0,1
windows-wpp,windows-wpp,,2,0,1,2,1,3,9,1
tomcat6,tomcat6,,7,2,9,9,18,18,3,1
cyclic-reference,cyclic-reference,,1,6,5,7,5,12,3,500
unity3d-editor,unity3d-editor,,9,4,11,13,21,24,8,1
cookiecutter-django,cookiecutter-django,,11,8,11,19,54,30,0,1
cache-invalidation,cache-invalidation,,1,3,2,4,10,6,3,200
edi,edi,,10,8,15,18,48,33,8,1
app.yaml,app.yaml,,14,6,23,20,37,43,6,1
webaddress,webaddress,,0,0,3,0,2,3,8,1
iperf,iperf,,9,6,11,15,20,26,9,1
jcheckbox,jcheckbox,,3,5,18,8,25,26,3,66.666667
cryptographicexception,cryptographicexception,,0,0,3,0,4,3,8,1
fog,fog,,4,1,9,5,23,14,12,1
tmap,tmap,,16,28,28,44,65,72,0,75
cex,cex,,2,1,0,3,3,3,0,1
internal-server-error,internal-server-error,,21,15,36,36,83,72,4,1
service-provider,service-provider,,6,16,17,22,35,39,4,166.666667
user-management,user-management,,11,10,13,21,33,34,4,1
ios-keyboard-extension,ios-keyboard-extension,,3,5,12,8,24,20,13,66.666667
textflow,textflow,,0,2,1,2,5,3,3,100
fancyimpute,fancyimpute,,3,0,6,3,12,9,0,1
spatial-index,spatial-index,,3,2,13,5,14,18,4,1
bjam,bjam,,3,1,2,4,5,6,9,1
ninja-forms,ninja-forms,,9,12,27,21,33,48,4,33.333333
listagg,listagg,,5,8,25,13,40,38,4,60
bootstrap-carousel,bootstrap-carousel,,9,5,13,14,45,27,1,1
box-api,box-api,,7,4,11,11,15,22,4,1
boxapiv2,boxapiv2,,4,1,5,5,5,10,4,1
pyfits,pyfits,,2,2,2,4,9,6,0,1
multimap,multimap,,13,9,21,22,49,43,9,1
overlapping,overlapping,,11,9,32,20,59,52,1,1
aurelia-dialog,aurelia-dialog,,1,1,1,2,4,3,1,1
imagej-macro,imagej-macro,,2,5,4,7,8,11,0,150
qualtrics,qualtrics,,14,16,35,30,114,65,1,14.285714
tesseract.js,tesseract.js,,3,7,5,10,12,15,1,133.333333
nsb-servicecontrol,nsb-servicecontrol,,0,1,0,1,2,1,8,1
force-layout,force-layout,,15,10,30,25,46,55,1,1
findinfiles,findinfiles,,1,1,2,2,5,4,8,1
user-registration,user-registration,,10,12,23,22,36,45,4,20
radix,radix,,8,2,8,10,9,18,0,1
jce,jce,,8,8,14,16,31,30,3,1
codenvy,codenvy,,1,3,7,4,12,11,3,200
exact-match,exact-match,,7,6,10,13,26,23,4,1
processbuilder,processbuilder,,28,26,72,54,124,126,3,1
express-graphql,express-graphql,,33,24,48,57,86,105,1,1
access-denied,access-denied,,25,11,47,36,74,83,8,1
custom-adapter,custom-adapter,,9,9,32,18,78,50,3,1
topojson,topojson,,15,13,23,28,57,51,1,1
system-design,system-design,,10,26,25,36,28,61,3,160
inotifywait,inotifywait,,4,2,7,6,15,13,9,1
configurationmanager,configurationmanager,,3,9,22,12,39,34,8,200
facebook-java-api,facebook-java-api,,3,2,1,5,8,6,13,1
little-o,little-o,,0,0,0,0,2,0,0,1
par,par,,2,6,7,8,17,15,0,200
labeling,labeling,,10,1,13,11,24,24,0,1
xnu,xnu,,1,3,7,4,39,11,13,200
cloudera-navigator,cloudera-navigator,,0,0,2,0,4,2,2,1
python-social-auth,python-social-auth,,15,10,20,25,52,45,0,1
stun,stun,,9,9,35,18,28,53,1,1
attributerouting,attributerouting,,7,3,8,10,35,18,8,1
annyang,annyang,,0,0,5,0,3,5,1,1
tfrecord,tfrecord,,39,22,61,61,109,122,0,1
nextsibling,nextsibling,,1,1,2,2,3,4,0,1
ibm-rad,ibm-rad,,3,5,9,8,17,17,3,66.666667
archetypes,archetypes,,6,3,10,9,13,19,3,1
case-folding,case-folding,,0,0,1,0,2,1,0,1
negation,negation,,2,5,13,7,20,20,0,150
glide-golang,glide-golang,,7,3,18,10,31,28,6,1
android-layoutparams,android-layoutparams,,4,1,13,5,19,18,3,1
qtreewidgetitem,qtreewidgetitem,,5,5,7,10,21,17,0,1
continuous,continuous,,13,10,26,23,34,49,0,1
ijulia-notebook,ijulia-notebook,,5,7,8,12,21,20,0,40
pascalscript,pascalscript,,27,19,44,46,54,90,8,1
tedious,tedious,,13,11,22,24,31,46,1,1
dateformatter,dateformatter,,11,16,28,27,60,55,13,45.454545
oracle-enterprise-manager,oracle-enterprise-manager,,4,3,1,7,8,8,4,1
ie-developer-tools,ie-developer-tools,,3,1,3,4,3,7,1,1
isbn,isbn,,2,0,4,2,8,6,0,1
nscolor,nscolor,,3,4,7,7,8,14,13,33.333333
processing.js,processing.js,,4,1,11,5,22,16,1,1
event-delegation,event-delegation,,5,4,11,9,23,20,1,1
bootstrap-confirmation,bootstrap-confirmation,,2,1,2,3,12,5,1,1
uistepper,uistepper,,5,8,6,13,17,19,13,60
socrata,socrata,,10,8,16,18,29,34,0,1
soda,soda,,7,7,10,14,16,24,0,1
color-mapping,color-mapping,,2,1,5,3,9,8,0,1
xamarin.forms.listview,xamarin.forms.listview,,13,7,24,20,20,44,8,1
ng-init,ng-init,,0,2,4,2,8,6,1,100
fluent-ffmpeg,fluent-ffmpeg,,22,15,19,37,39,56,13,1
django-pagination,django-pagination,,9,7,10,16,20,26,0,1
satellite-image,satellite-image,,3,7,8,10,15,18,0,133.333333
cfgrid,cfgrid,,1,1,3,2,2,5,4,1
tform,tform,,0,0,0,0,2,0,9,1
mpiexec,mpiexec,,1,2,0,3,4,3,0,100
dot-product,dot-product,,9,10,14,19,41,33,0,11.111111
collaborative-filtering,collaborative-filtering,,12,5,18,17,24,35,0,1
strcpy,strcpy,,14,12,39,26,86,65,9,1
opam,opam,,6,5,13,11,24,24,0,1
ocaml-core,ocaml-core,,1,2,1,3,12,4,0,100
ocaml-dune,ocaml-dune,,1,3,7,4,4,11,0,200
numpy-random,numpy-random,,3,1,3,4,8,7,0,1
es2017,es2017,,8,1,12,9,25,21,1,1
atmosphere.js,atmosphere.js,,2,0,3,2,8,5,1,1
mousemotionlistener,mousemotionlistener,,4,2,6,6,7,12,3,1
userdefaults,userdefaults,,22,25,39,47,97,86,13,13.636364
thread-synchronization,thread-synchronization,,16,16,47,32,59,79,3,1
boost-spirit-x3,boost-spirit-x3,,7,14,17,21,39,38,9,100
lorawan,lorawan,,10,12,22,22,31,44,9,20
dronekit-python,dronekit-python,,2,5,12,7,17,19,0,150
dronekit,dronekit,,1,5,9,6,18,15,0,400
mavlink,mavlink,,2,1,5,3,17,8,0,1
jasmin,jasmin,,0,1,4,1,1,5,3,1
jvm-bytecode,jvm-bytecode,,2,6,17,8,29,25,3,200
intro.js,intro.js,,4,7,9,11,20,20,1,75
chrome-web-store,chrome-web-store,,12,5,23,17,47,40,1,1
motorola,motorola,,3,1,12,4,20,16,3,1
68000,68000,,3,1,8,4,21,12,9,1
zfs,zfs,,5,4,19,9,30,28,9,1
nanodbc,nanodbc,,2,0,1,2,3,3,9,1
easy-engine,easy-engine,,3,1,3,4,8,7,4,1
fbconnect,fbconnect,,0,2,3,2,1,5,13,100
fbloginview,fbloginview,,0,0,1,0,1,1,13,1
objective-sharpie,objective-sharpie,,2,2,5,4,22,9,8,1
pointer-events,pointer-events,,4,5,12,9,29,21,1,25
confluent-kafka,confluent-kafka,,22,52,47,74,95,121,2,136.363636
amazon-elasticache,amazon-elasticache,,24,16,43,40,77,83,6,1
symfony2-easyadmin,symfony2-easyadmin,,4,4,15,8,19,23,4,1
python-sip,python-sip,,2,3,6,5,17,11,0,50
android-4.2-jelly-bean,android-4.2-jelly-bean,,2,0,5,2,10,7,3,1
font-awesome-5,font-awesome-5,,18,38,73,56,143,129,1,111.111111
c99,c99,,27,20,59,47,115,106,9,1
system.out,system.out,,2,8,16,10,35,26,3,300
hydra-core,hydra-core,,0,0,2,0,4,2,3,1
strsep,strsep,,2,1,1,3,10,4,9,1
inout,inout,,6,3,5,9,24,14,13,1
neon,neon,,10,10,19,20,67,39,9,1
uicollectionreusableview,uicollectionreusableview,,5,5,5,10,22,15,13,1
androiddesignsupport,androiddesignsupport,,3,6,13,9,29,22,3,100
get-childitem,get-childitem,,5,13,25,18,54,43,8,160
mongo-java,mongo-java,,4,3,10,7,29,17,1,1
intuit,intuit,,4,9,4,13,25,17,4,125
expired-sessions,expired-sessions,,1,3,4,4,3,8,4,200
originlab,originlab,,0,2,0,2,1,2,0,100
paypal-nvp,paypal-nvp,,3,0,2,3,5,5,4,1
gil,gil,,14,12,13,26,33,39,0,1
late-binding,late-binding,,2,8,9,10,29,19,5,300
trace32,trace32,,9,1,18,10,15,28,9,1
lauterbach,lauterbach,,8,1,11,9,16,20,9,1
forever,forever,,8,9,31,17,53,48,1,12.5
calibre,calibre,,4,1,2,5,5,7,0,1
flexlm,flexlm,,0,0,1,0,3,1,8,1
sqldependency,sqldependency,,10,10,22,20,35,42,8,1
query-notifications,query-notifications,,0,0,0,0,3,0,4,1
jcombobox,jcombobox,,20,25,64,45,103,109,3,25
owncloud,owncloud,,7,5,14,12,39,26,4,1
bxslider,bxslider,,21,5,17,26,28,43,1,1
pager,pager,,11,3,5,14,15,19,1,1
qdatastream,qdatastream,,4,4,8,8,17,16,9,1
app-router,app-router,,0,2,1,2,1,3,3,100
time-t,time-t,,4,1,2,5,15,7,9,1
vmware-server,vmware-server,,0,0,1,0,2,1,6,1
match-against,match-against,,2,1,6,3,8,9,4,1
partial-classes,partial-classes,,1,5,6,6,13,12,8,400
go-to-definition,go-to-definition,,1,3,2,4,4,6,8,200
xml-drawable,xml-drawable,,10,2,11,12,24,23,3,1
object-construction,object-construction,,1,2,3,3,7,6,9,100
django-select-related,django-select-related,,1,2,9,3,12,12,0,100
saxparser,saxparser,,8,6,11,14,30,25,3,1
ulimit,ulimit,,9,11,11,20,31,31,9,22.222222
ejb-2.x,ejb-2.x,,1,3,12,4,6,16,3,200
formula-editor,formula-editor,,0,0,1,0,4,1,5,1
file-manager,file-manager,,9,15,26,24,40,50,13,66.666667
recursive-cte,recursive-cte,,3,2,7,5,12,12,4,1
jbuilder,jbuilder,,4,3,10,7,29,17,12,1
run-time-polymorphism,run-time-polymorphism,,2,2,8,4,3,12,9,1
asp.net-mvc-partialview,asp.net-mvc-partialview,,8,11,30,19,55,49,8,37.5
node-cron,node-cron,,8,4,10,12,16,22,1,1
qdapregex,qdapregex,,0,1,0,1,2,1,0,1
c++builder-xe,c++builder-xe,,0,0,0,0,2,0,9,1
charles-proxy,charles-proxy,,9,15,44,24,53,68,6,66.666667
coverflow,coverflow,,2,1,0,3,5,3,3,1
landscape,landscape,,13,10,30,23,55,53,3,1
xamarin.windows,xamarin.windows,,0,0,2,0,1,2,8,1
history.js,history.js,,8,0,10,8,15,18,1,1
netbeans-platform,netbeans-platform,,7,0,16,7,19,23,3,1
ekcalendar,ekcalendar,,4,0,4,4,6,8,13,1
fontconfig,fontconfig,,3,0,3,3,15,6,9,1
unirest,unirest,,17,10,43,27,43,70,3,1
jquery-pagination,jquery-pagination,,2,3,3,5,6,8,1,50
mpeg-dash,mpeg-dash,,28,22,65,50,94,115,13,1
eme,eme,,1,0,2,1,6,3,3,1
ioredis,ioredis,,10,2,18,12,14,30,3,1
gitblit,gitblit,,2,0,1,2,13,3,6,1
package-name,package-name,,3,0,11,3,19,14,3,1
smart-tags,smart-tags,,0,2,0,2,1,2,8,100
conflicting-libraries,conflicting-libraries,,3,3,9,6,13,15,8,1
twitter-digits,twitter-digits,,0,0,0,0,5,0,13,1
elfinder,elfinder,,5,2,10,7,17,17,4,1
livechat,livechat,,3,3,5,6,25,11,1,1
multi-device-hybrid-apps,multi-device-hybrid-apps,,2,1,3,3,11,6,1,1
sqlbulkcopy,sqlbulkcopy,,34,15,41,49,62,90,4,1
imageurl,imageurl,,6,10,11,16,22,27,3,66.666667
camelcasing,camelcasing,,5,7,14,12,24,26,8,40
fuseesb,fuseesb,,7,6,11,13,20,24,3,1
scheduledexecutorservice,scheduledexecutorservice,,16,9,22,25,47,47,3,1
work-stealing,work-stealing,,0,4,1,4,3,5,3,300
cgpath,cgpath,,0,6,8,6,20,14,13,500
mlr,mlr,,25,23,45,48,50,93,0,1
android-tablelayout,android-tablelayout,,11,11,36,22,65,58,3,1
jubula,jubula,,9,3,2,12,4,14,3,1
sendgrid-api-v3,sendgrid-api-v3,,21,17,41,38,56,79,4,1
umbraco-ucommerce,umbraco-ucommerce,,0,0,1,0,5,1,8,1
shallow-copy,shallow-copy,,8,6,24,14,29,38,0,1
browser-support,browser-support,,7,3,3,10,9,13,1,1
pyopengl,pyopengl,,22,37,64,59,71,123,0,68.181818
nodegit,nodegit,,2,1,9,3,17,12,6,1
rich-notifications,rich-notifications,,0,1,4,1,12,5,13,1
sqlcl,sqlcl,,2,4,5,6,9,11,4,100
function-call,function-call,,24,17,45,41,50,86,9,1
sql-timestamp,sql-timestamp,,7,8,16,15,37,31,4,14.285714
webjob,webjob,,10,5,10,15,22,25,8,1
iiop,iiop,,2,3,3,5,5,8,3,50
jxbrowser,jxbrowser,,11,5,22,16,51,38,3,1
unicorn,unicorn,,11,10,13,21,41,34,12,1
laravel-mail,laravel-mail,,11,9,35,20,29,55,4,1
idiomatic,idiomatic,,10,4,23,14,38,37,9,1
ggbiplot,ggbiplot,,6,0,2,6,8,8,0,1
substitution,substitution,,25,39,68,64,153,132,0,56
localdate,localdate,,33,33,69,66,108,135,3,1
deconvolution,deconvolution,,4,6,20,10,52,30,0,50
prosody-im,prosody-im,,1,0,5,1,5,6,3,1
drbd,drbd,,2,0,2,2,7,4,9,1
svn-trunk,svn-trunk,,0,0,0,0,3,0,6,1
user32,user32,,13,13,29,26,40,55,8,1
forwarding-reference,forwarding-reference,,4,7,8,11,28,19,9,75
unionfs,unionfs,,0,0,0,0,2,0,6,1
pygments,pygments,,6,5,7,11,15,18,0,1
grails-2.5,grails-2.5,,1,3,7,4,9,11,3,200
spring-ioc,spring-ioc,,3,5,9,8,37,17,3,66.666667
amazon-redshift-spectrum,amazon-redshift-spectrum,,14,18,19,32,50,51,6,28.571429
expandable-table,expandable-table,,2,0,2,2,5,4,13,1
isam,isam,,0,0,0,0,3,0,3,1
function-signature,function-signature,,0,0,2,0,9,2,9,1
mox,mox,,0,2,2,2,4,4,0,100
android-activity-alias,android-activity-alias,,0,0,1,0,1,1,3,1
spring-boot-maven-plugin,spring-boot-maven-plugin,,23,12,40,35,68,75,3,1
observablelist,observablelist,,9,5,14,14,29,28,3,1
denormalization,denormalization,,5,10,13,15,32,28,4,100
sendgrid-api-v2,sendgrid-api-v2,,1,1,3,2,4,5,4,1
web.config-transform,web.config-transform,,9,4,12,13,24,25,8,1
getvalue,getvalue,,8,1,12,9,29,21,5,1
dbmigrate,dbmigrate,,4,3,13,7,18,20,12,1
string.xml,string.xml,,3,1,7,4,9,11,3,1
megamenu,megamenu,,3,7,13,10,30,23,1,133.333333
hbm2ddl,hbm2ddl,,0,0,3,0,8,3,3,1
hbm,hbm,,3,1,3,4,6,7,3,1
flv,flv,,1,5,6,6,18,12,13,400
openerp-8,openerp-8,,0,0,0,0,8,0,0,1
spring-orm,spring-orm,,6,2,12,8,22,20,3,1
testrail,testrail,,7,11,13,18,21,31,3,57.142857
robotframework-ide,robotframework-ide,,1,9,3,10,30,13,3,800
nested-if,nested-if,,6,8,9,14,44,23,5,33.333333
monaco-editor,monaco-editor,,24,32,47,56,76,103,1,33.333333
amazon-cloudsearch,amazon-cloudsearch,,6,3,9,9,35,18,6,1
joomla3.5,joomla3.5,,1,1,0,2,8,2,4,1
jshell,jshell,,11,3,24,14,63,38,3,1
navparams,navparams,,0,1,3,1,6,4,1,1
rxandroidble,rxandroidble,,13,5,26,18,66,44,3,1
business-process-management,business-process-management,,14,8,46,22,55,68,3,1
bizagi,bizagi,,1,0,0,1,2,1,3,1
php-ews,php-ews,,0,2,4,2,15,6,8,100
react-native-scrollview,react-native-scrollview,,6,11,14,17,26,31,1,83.333333
android-tablet-layout,android-tablet-layout,,0,0,2,0,1,2,3,1
highlighting,highlighting,,0,0,0,0,35,0,1,1
angular2-highcharts,angular2-highcharts,,15,4,30,19,60,49,1,1
networkextension,networkextension,,7,15,21,22,29,43,13,114.285714
genealogy,genealogy,,0,0,3,0,6,3,0,1
gedcom,gedcom,,0,0,3,0,3,3,0,1
tei,tei,,2,1,17,3,29,20,3,1
cmder,cmder,,15,8,27,23,32,50,9,1
eclipse-mars,eclipse-mars,,0,3,9,3,22,12,3,200
jsog,jsog,,0,0,1,0,2,1,8,1
browser-link,browser-link,,0,1,2,1,5,3,8,1
const-correctness,const-correctness,,2,3,9,5,10,14,9,50
google-pagespeed,google-pagespeed,,18,21,52,39,33,91,4,16.666667
dnsmasq,dnsmasq,,11,6,25,17,44,42,4,1
boolean-operations,boolean-operations,,5,8,15,13,45,28,0,60
dom4j,dom4j,,5,4,3,9,20,12,3,1
html-reports-jenkins,html-reports-jenkins,,2,1,0,3,6,3,3,1
sony-smartwatch,sony-smartwatch,,5,0,1,5,5,6,3,1
meteor-collection2,meteor-collection2,,1,2,1,3,4,4,1,100
hash-code-uniqueness,hash-code-uniqueness,,0,0,2,0,3,2,3,1
has-and-belongs-to-many,has-and-belongs-to-many,,11,3,26,14,63,40,12,1
cakephp-3.4,cakephp-3.4,,0,2,4,2,49,6,4,100
rails-geocoder,rails-geocoder,,7,0,14,7,20,21,12,1
swift-package-manager,swift-package-manager,,8,40,26,48,61,74,13,400
quantitative-finance,quantitative-finance,,23,20,49,43,88,92,0,1
starvation,starvation,,1,2,6,3,7,9,3,100
getelementsbyclassname,getelementsbyclassname,,9,13,23,22,65,45,1,44.444444
cargo-maven2-plugin,cargo-maven2-plugin,,0,1,4,1,5,5,3,1
corflags,corflags,,0,0,1,0,1,1,8,1
coupon,coupon,,22,10,29,32,60,61,4,1
divider,divider,,8,4,5,12,19,17,3,1
novacode-docx,novacode-docx,,1,0,2,1,14,3,8,1
installshield-2012,installshield-2012,,2,0,2,2,4,4,8,1
installanywhere,installanywhere,,4,1,1,5,4,6,8,1
facebook-access-token,facebook-access-token,,10,6,17,16,42,33,13,1
tfs-reports,tfs-reports,,0,0,2,0,8,2,8,1
pscp,pscp,,4,2,2,6,16,8,9,1
libsodium,libsodium,,13,14,33,27,47,60,6,7.692308
shotgun,shotgun,,0,1,0,1,2,1,12,1
cassandra-driver,cassandra-driver,,6,10,10,16,22,26,2,66.666667
idataerrorinfo,idataerrorinfo,,2,3,8,5,11,13,8,50
ctabitem,ctabitem,,0,0,0,0,1,0,3,1
autotools,autotools,,17,14,35,31,110,66,9,1
autoconf,autoconf,,11,10,29,21,86,50,9,1
zposition,zposition,,0,0,4,0,6,4,13,1
nsurlsessiondatatask,nsurlsessiondatatask,,9,8,17,17,32,34,13,1
umbraco6,umbraco6,,1,3,6,4,7,10,8,200
ios-provisioning,ios-provisioning,,10,7,15,17,31,32,13,1
geotagging,geotagging,,0,5,5,5,12,10,3,400
zebra,zebra,,11,17,18,28,32,46,3,54.545455
opencv-python,opencv-python,,25,13,46,38,52,84,0,1
vmware-workstation,vmware-workstation,,23,9,42,32,38,74,6,1
dexguard,dexguard,,2,4,14,6,22,20,3,100
protection,protection,,10,7,18,17,21,35,4,1
tput,tput,,1,3,3,4,7,7,9,200
testng-dataprovider,testng-dataprovider,,25,11,34,36,71,70,3,1
babel-plugin-react-intl,babel-plugin-react-intl,,1,3,1,4,4,5,1,200
razor-2,razor-2,,0,2,6,2,19,8,8,100
asp.net-mvc-5.2,asp.net-mvc-5.2,,14,9,23,23,48,46,8,1
numericupdown,numericupdown,,3,3,5,6,14,11,8,1
gtkmm,gtkmm,,9,17,27,26,73,53,9,88.888889
gtkmm3,gtkmm3,,6,4,21,10,32,31,9,1
not-exists,not-exists,,4,4,12,8,32,20,4,1
surveymonkey,surveymonkey,,8,3,24,11,19,35,4,1
limesurvey,limesurvey,,2,5,7,7,15,14,4,150
feathers-sequelize,feathers-sequelize,,6,8,9,14,26,23,1,33.333333
jxl,jxl,,4,7,19,11,22,30,3,75
savestate,savestate,,6,5,10,11,18,21,3,1
portal,portal,,12,12,16,24,39,40,8,1
apigee,apigee,,11,7,18,18,23,36,4,1
orientjs,orientjs,,0,1,2,1,14,3,2,1
java-server,java-server,,2,3,4,5,11,9,3,50
textblock,textblock,,13,15,30,28,43,58,8,15.384615
ciimage,ciimage,,7,5,18,12,45,30,13,1
cgo,cgo,,17,28,41,45,102,86,6,64.705882
tagged-templates,tagged-templates,,1,2,4,3,3,7,1,100
viewwilltransitiontosize,viewwilltransitiontosize,,1,0,1,1,8,2,13,1
android-geofence,android-geofence,,18,22,36,40,78,76,3,22.222222
onsen-ui2,onsen-ui2,,1,3,14,4,22,18,1,200
sharepoint-api,sharepoint-api,,2,7,10,9,33,19,8,250
angular-dom-sanitizer,angular-dom-sanitizer,,5,7,15,12,24,27,1,40
redraw,redraw,,5,5,5,10,13,15,3,1
parseint,parseint,,15,10,17,25,46,42,1,1
party,party,,4,2,10,6,28,16,0,1
skype-bots,skype-bots,,6,4,15,10,32,25,8,1
gradle-eclipse,gradle-eclipse,,2,0,12,2,17,14,3,1
buildship,buildship,,1,3,7,4,19,11,3,200
gd2,gd2,,0,1,0,1,5,1,4,1
snmpv2c,snmpv2c,,0,0,2,0,1,2,9,1
typecast-operator,typecast-operator,,3,1,3,4,9,7,9,1
xsl-stylesheet,xsl-stylesheet,,2,1,0,3,2,3,3,1
xmlrpcclient,xmlrpcclient,,5,1,2,6,7,8,0,1
or-condition,or-condition,,1,0,1,1,3,2,0,1
elementor,elementor,,53,72,70,125,46,195,4,35.849057
git-config,git-config,,9,12,30,21,60,51,6,33.333333
build-tools,build-tools,,17,8,14,25,67,39,3,1
g1gc,g1gc,,9,9,21,18,38,39,3,1
keyboard-navigation,keyboard-navigation,,3,1,2,4,8,6,13,1
object-detection-api,object-detection-api,,136,87,164,223,193,387,0,1
ionic-storage,ionic-storage,,6,5,11,11,31,22,1,1
feathers-hook,feathers-hook,,1,2,10,3,20,13,1,100
feathers-service,feathers-service,,3,2,6,5,9,11,1,1
cyrillic,cyrillic,,12,14,20,26,53,46,0,16.666667
sprite-sheet,sprite-sheet,,9,5,16,14,29,30,1,1
facebook-like,facebook-like,,8,8,18,16,44,34,13,1
mod-fastcgi,mod-fastcgi,,1,1,2,2,3,4,4,1
readonly,readonly,,20,12,43,32,90,75,8,1
react-native-0.46,react-native-0.46,,0,0,0,0,1,0,1,1
google-app-maker,google-app-maker,,55,48,82,103,139,185,5,1
flow-typed,flow-typed,,6,5,13,11,36,24,1,1
browscap,browscap,,2,0,0,2,2,2,4,1
strace,strace,,12,5,20,17,39,37,9,1
google-geolocation,google-geolocation,,10,8,22,18,34,40,1,1
swtbot,swtbot,,2,0,4,2,6,6,3,1
awss3transfermanager,awss3transfermanager,,3,3,7,6,8,13,6,1
qt-installer,qt-installer,,3,5,4,8,25,12,9,66.666667
qt5.9,qt5.9,,5,4,4,9,38,13,9,1
mergetool,mergetool,,8,0,5,8,13,13,6,1
difftool,difftool,,3,0,5,3,4,8,6,1
webdriver-manager,webdriver-manager,,13,9,5,22,15,27,3,1
bitcode,bitcode,,6,7,28,13,30,41,13,16.666667
xcode8.1,xcode8.1,,0,0,0,0,2,0,13,1
jcache,jcache,,3,19,11,22,24,33,3,533.333333
datastax-enterprise-graph,datastax-enterprise-graph,,7,0,14,7,48,21,2,1
capability,capability,,4,3,10,7,10,17,4,1
unique-array,unique-array,,0,0,0,0,2,0,5,1
wow64,wow64,,1,1,6,2,6,8,9,1
parse-cloud,parse-cloud,,8,2,7,10,13,17,13,1
shippo,shippo,,2,0,1,2,7,3,4,1
microsoft-ajax-minifier,microsoft-ajax-minifier,,1,0,2,1,2,3,1,1
expected-exception,expected-exception,,3,1,1,4,7,5,3,1
android-espresso-recorder,android-espresso-recorder,,3,7,5,10,10,15,3,133.333333
datetimeindex,datetimeindex,,15,9,17,24,35,41,0,1
formbuilder,formbuilder,,26,20,52,46,75,98,4,1
itemsource,itemsource,,1,5,4,6,9,10,8,400
navmesh,navmesh,,5,5,15,10,26,25,8,1
laravel-4,laravel-4,,16,23,108,39,216,147,4,43.75
qslider,qslider,,7,5,8,12,18,20,0,1
rowsum,rowsum,,2,11,16,13,19,29,0,450
node-pg-pool,node-pg-pool,,3,1,4,4,4,8,1,1
vue-data-tables,vue-data-tables,,3,4,1,7,4,8,1,33.333333
nssm,nssm,,9,11,6,20,14,26,9,22.222222
most-vexing-parse,most-vexing-parse,,1,2,5,3,18,8,9,100
drools-planner,drools-planner,,2,0,10,2,18,12,3,1
rounded-corners,rounded-corners,,12,9,31,21,48,52,13,1
roundedcorners-dropshadow,roundedcorners-dropshadow,,0,0,1,0,1,1,13,1
dfa,dfa,,16,9,33,25,33,58,0,1
nfa,nfa,,7,2,15,9,21,24,0,1
ms-media-foundation,ms-media-foundation,,20,9,30,29,56,59,9,1
multimedia,multimedia,,2,3,12,5,13,17,13,50
cart-rules,cart-rules,,0,0,1,0,3,1,4,1
mobile-development,mobile-development,,20,16,41,36,86,77,3,1
xidel,xidel,,4,0,2,4,7,6,9,1
datareader,datareader,,10,10,21,20,56,41,8,1
mosaic,mosaic,,2,2,4,4,8,8,0,1
window-resize,window-resize,,13,8,23,21,52,44,1,1
hortonworks-dataflow,hortonworks-dataflow,,4,13,14,17,26,31,2,225
plink,plink,,7,12,26,19,45,45,9,71.428571
allegrograph,allegrograph,,1,0,4,1,7,5,2,1
stringstream,stringstream,,13,20,33,33,72,66,9,53.846154
ack,ack,,7,5,3,12,11,15,9,1
suse,suse,,12,10,23,22,43,45,9,1
libssh,libssh,,4,2,20,6,17,26,9,1
autoformatting,autoformatting,,2,4,8,6,14,14,9,100
pivot-grid,pivot-grid,,2,2,2,4,6,6,8,1
selenium-hub,selenium-hub,,0,1,3,1,5,4,3,1
qquickview,qquickview,,1,0,2,1,6,3,9,1
love2d,love2d,,10,11,19,21,43,40,9,10
code39,code39,,0,0,3,0,5,3,3,1
logstash-file,logstash-file,,12,8,18,20,22,38,6,1
grails3.2.0,grails3.2.0,,0,1,1,1,4,2,3,1
android-jodatime,android-jodatime,,3,3,7,6,13,13,3,1
sccm-2007,sccm-2007,,0,0,1,0,2,1,8,1
phonegap-build,phonegap-build,,16,23,59,39,135,98,1,43.75
read.fwf,read.fwf,,2,0,0,2,6,2,0,1
using,using,,42,38,56,80,113,136,9,1
quickgraph,quickgraph,,1,0,2,1,2,3,8,1
audiokit,audiokit,,38,39,122,77,275,199,13,2.631579
octopus,octopus,,5,4,16,9,15,25,8,1
multiple-value,multiple-value,,2,1,7,3,16,10,4,1
metal-performance-shaders,metal-performance-shaders,,6,7,14,13,15,27,13,16.666667
single-precision,single-precision,,0,2,2,2,4,4,0,100
google-cloud-console,google-cloud-console,,7,4,9,11,27,20,6,1
pure-layout,pure-layout,,0,0,2,0,6,2,13,1
systemfit,systemfit,,1,0,7,1,1,8,0,1
sugarorm,sugarorm,,2,1,14,3,41,17,3,1
maven-compiler-plugin,maven-compiler-plugin,,8,6,16,14,22,30,3,1
android-ble,android-ble,,5,10,18,15,40,33,3,100
real-time-data,real-time-data,,15,9,15,24,22,39,13,1
fbsdksharekit,fbsdksharekit,,1,1,5,2,5,7,13,1
css-gradients,css-gradients,,3,4,6,7,6,13,1,33.333333
binding-context,binding-context,,1,0,6,1,7,7,8,1
atexit,atexit,,4,3,5,7,14,12,0,1
bootstrap-sass,bootstrap-sass,,0,5,7,5,14,12,1,400
google-awareness,google-awareness,,1,1,8,2,15,10,3,1
django-users,django-users,,17,15,37,32,72,69,0,1
master-detail,master-detail,,18,21,49,39,90,88,8,16.666667
datarowview,datarowview,,1,1,2,2,6,4,8,1
gdx-pay,gdx-pay,,0,1,2,1,4,3,3,1
dgrid,dgrid,,0,1,6,1,14,7,1,1
orchard-modules,orchard-modules,,3,1,3,4,15,7,8,1
orchardcms-1.9,orchardcms-1.9,,0,0,5,0,7,5,8,1
rawstring,rawstring,,1,6,3,7,12,10,0,500
google-streetview-publish,google-streetview-publish,,1,2,3,3,12,6,1,100
masked-array,masked-array,,3,3,4,6,20,10,0,1
octal,octal,,4,2,21,6,32,27,0,1
iccube,iccube,,2,8,10,10,35,20,4,300
cflags,cflags,,2,1,6,3,7,9,9,1
ldflags,ldflags,,0,5,1,5,10,6,9,400
datacontract,datacontract,,3,7,15,10,30,25,8,133.333333
datacontractjsonserializer,datacontractjsonserializer,,2,4,8,6,17,14,8,100
java-stored-procedures,java-stored-procedures,,2,6,15,8,19,23,4,200
simplex,simplex,,4,2,10,6,7,16,0,1
simplex-algorithm,simplex-algorithm,,1,1,1,2,6,3,0,1
ds-5,ds-5,,0,1,5,1,4,6,9,1
sqlbase,sqlbase,,1,1,0,2,12,2,4,1
nscoding,nscoding,,6,1,16,7,35,23,13,1
pre,pre,,3,8,18,11,21,29,1,166.666667
ticker,ticker,,6,7,15,13,33,28,0,16.666667
etag,etag,,12,17,25,29,32,54,4,41.666667
radgrid,radgrid,,12,9,21,21,28,42,8,1
serializationbinder,serializationbinder,,0,0,0,0,1,0,8,1
dreamweaver,dreamweaver,,8,9,31,17,67,48,1,12.5
python-markdown,python-markdown,,4,2,2,6,4,8,0,1
css-frameworks,css-frameworks,,1,1,3,2,11,5,1,1
nqp,nqp,,4,0,5,4,1,9,9,1
paypal-marketplaces,paypal-marketplaces,,0,0,0,0,3,0,4,1
provisioning,provisioning,,21,12,40,33,58,73,6,1
ssh-agent,ssh-agent,,4,7,19,11,34,30,9,75
boost-numeric,boost-numeric,,0,0,0,0,2,0,9,1
soft-delete,soft-delete,,10,7,15,17,38,32,4,1
txtextcontrol,txtextcontrol,,3,1,3,4,4,7,8,1
sanitization,sanitization,,25,15,26,40,54,66,4,1
pointer-to-member,pointer-to-member,,4,3,8,7,16,15,9,1
qtscript,qtscript,,1,0,2,1,5,3,9,1
nsmutabledictionary,nsmutabledictionary,,6,5,6,11,26,17,13,1
google-cloud-python,google-cloud-python,,9,5,17,14,44,31,6,1
core-nfc,core-nfc,,2,10,4,12,10,16,13,400
jquery-cookie,jquery-cookie,,3,1,7,4,20,11,1,1
window-managers,window-managers,,6,4,16,10,24,26,9,1
cs-cart,cs-cart,,8,3,7,11,22,18,4,1
nco,nco,,7,9,12,16,30,28,0,28.571429
google-apps-for-education,google-apps-for-education,,2,1,1,3,2,4,5,1
getgauge,getgauge,,4,8,17,12,16,29,3,100
amazon-cloudtrail,amazon-cloudtrail,,6,16,13,22,28,35,6,166.666667
endeca-workbench,endeca-workbench,,0,1,0,1,7,1,3,1
apdu,apdu,,8,18,20,26,72,46,3,125
contactless-smartcard,contactless-smartcard,,3,3,15,6,31,21,3,1
pvlib,pvlib,,6,8,11,14,9,25,0,33.333333
ideavim,ideavim,,6,6,14,12,18,26,3,1
hamlet,hamlet,,0,0,0,0,6,0,2,1
user-config,user-config,,0,0,0,0,3,0,8,1
tab-delimited,tab-delimited,,4,2,3,6,19,9,0,1
enumerable,enumerable,,8,9,8,17,34,25,8,12.5
enumerator,enumerator,,1,4,12,5,17,17,8,300
nodeapi,nodeapi,,4,3,6,7,7,13,1,1
preg-split,preg-split,,8,3,21,11,43,32,4,1
reducing,reducing,,3,0,2,3,1,5,3,1
mixer,mixer,,4,5,11,9,16,20,13,25
istio,istio,,122,123,202,245,137,447,6,1
node-pdfkit,node-pdfkit,,7,7,8,14,12,22,1,1
jsonix,jsonix,,2,1,0,3,6,3,1,1
aws-amplify,aws-amplify,,183,198,238,381,127,619,6,8.196721
ssm,ssm,,16,22,18,38,25,56,6,37.5
wso2greg,wso2greg,,0,0,3,0,8,3,14,1
governance-registry,governance-registry,,0,1,1,1,4,2,14,1
raw-sockets,raw-sockets,,17,10,28,27,44,55,9,1
precision-recall,precision-recall,,20,16,25,36,50,61,0,1
mysql-5.5,mysql-5.5,,9,5,7,14,15,21,4,1
tableadapter,tableadapter,,10,3,11,13,23,24,8,1
mobirise,mobirise,,2,2,2,4,2,6,1,1
easyrtc,easyrtc,,3,1,3,4,12,7,1,1
coturn,coturn,,10,4,11,14,17,25,1,1
c1-cms,c1-cms,,0,1,0,1,2,1,8,1
orckestra-cms,orckestra-cms,,0,0,0,0,4,0,8,1
coq-extraction,coq-extraction,,1,0,0,1,9,1,2,1
upsetr,upsetr,,3,1,3,4,4,7,0,1
structuremap,structuremap,,13,7,23,20,71,43,8,1
libcrypto,libcrypto,,2,1,13,3,13,16,6,1
android-facebook,android-facebook,,4,2,3,6,34,9,3,1
raft,raft,,8,15,15,23,30,38,6,87.5
leader,leader,,1,2,1,3,10,4,6,100
powermail,powermail,,5,6,18,11,32,29,4,20
orc,orc,,16,32,40,48,85,88,2,100
apache-tez,apache-tez,,11,10,33,21,8,54,2,1
gwt-history,gwt-history,,0,0,0,0,1,0,3,1
opc-ua,opc-ua,,27,28,49,55,111,104,8,3.703704
node-opcua,node-opcua,,2,4,10,6,15,16,8,100
asa,asa,,1,2,2,3,3,5,6,100
matlab-table,matlab-table,,2,4,8,6,26,14,0,100
chrome-native-messaging,chrome-native-messaging,,7,5,17,12,27,29,1,1
records,records,,0,0,0,0,60,0,4,1
mobicents-sip-servlets,mobicents-sip-servlets,,0,0,0,0,5,0,3,1
ringcentral,ringcentral,,11,12,16,23,60,39,3,9.090909
jwe,jwe,,7,10,11,17,15,28,6,42.857143
ecdh,ecdh,,5,14,13,19,22,32,6,180
tf-cli,tf-cli,,0,0,7,0,16,7,8,1
payment-request-api,payment-request-api,,6,1,3,7,11,10,4,1
deap,deap,,8,13,12,21,22,33,0,62.5
microsoft.build,microsoft.build,,0,1,1,1,5,2,8,1
server-side-attacks,server-side-attacks,,2,4,8,6,11,14,4,100
hangfire-autofac,hangfire-autofac,,2,2,2,4,3,6,8,1
customising,customising,,1,0,0,1,3,1,0,1
chrome-custom-tabs,chrome-custom-tabs,,8,12,30,20,51,50,3,50
nexus-5,nexus-5,,1,0,4,1,3,5,3,1
gzipstream,gzipstream,,1,6,4,7,15,11,8,500
translucency,translucency,,1,0,1,1,9,2,13,1
azure-resource-group,azure-resource-group,,9,13,31,22,45,53,8,44.444444
symfony-3.1,symfony-3.1,,0,1,3,1,9,4,4,1
biztalk-mapper,biztalk-mapper,,2,1,8,3,21,11,8,1
esoteric-languages,esoteric-languages,,0,1,1,1,3,2,9,1
apfs,apfs,,2,3,3,5,18,8,13,50
android-syncadapter,android-syncadapter,,9,10,17,19,50,36,3,11.111111
rx-kotlin,rx-kotlin,,16,11,35,27,60,62,3,1
related-content,related-content,,3,1,1,4,8,5,4,1
exponential,exponential,,19,18,31,37,81,68,0,1
exponential-backoff,exponential-backoff,,3,3,5,6,10,11,3,1
matplotlib-venn,matplotlib-venn,,3,3,6,6,9,12,0,1
rippledrawable,rippledrawable,,1,4,13,5,16,18,3,300
wildfly-8,wildfly-8,,8,3,14,11,26,25,3,1
busboy,busboy,,14,11,17,25,27,42,1,1
dcast,dcast,,14,13,23,27,38,50,0,1
papyrus,papyrus,,2,2,4,4,7,8,3,1
spring-statemachine,spring-statemachine,,14,4,19,18,29,37,3,1
java.time.instant,java.time.instant,,4,5,10,9,32,19,3,25
magick.net,magick.net,,4,7,5,11,12,16,8,75
imagemagick.net,imagemagick.net,,3,4,4,7,12,11,8,33.333333
javascript-debugger,javascript-debugger,,7,6,13,13,37,26,1,1
karatsuba,karatsuba,,2,5,5,7,13,12,0,150
mysql-error-1364,mysql-error-1364,,0,0,1,0,1,1,4,1
mmo,mmo,,0,0,3,0,3,3,8,1
designated-initializer,designated-initializer,,2,1,3,3,12,6,9,1
collectd,collectd,,7,8,19,15,30,34,6,14.285714
strcat,strcat,,7,5,13,12,33,25,9,1
shared-objects,shared-objects,,7,2,11,9,14,20,9,1
auc,auc,,17,22,34,39,61,73,0,29.411765
pypiserver,pypiserver,,2,2,2,4,7,6,0,1
ems,ems,,2,4,4,6,6,10,3,100
extracttextwebpackplugin,extracttextwebpackplugin,,2,0,5,2,40,7,1,1
adhoc,adhoc,,3,4,11,7,21,18,13,33.333333
maple,maple,,2,5,18,7,28,25,0,150
gamma-function,gamma-function,,4,2,5,6,10,11,0,1
python-collections,python-collections,,3,6,6,9,20,15,0,100
win2d,win2d,,7,4,13,11,16,24,8,1
rfc6902,rfc6902,,0,0,0,0,2,0,3,1
ttx-fonttools,ttx-fonttools,,2,0,4,2,3,6,1,1
elastic-ip,elastic-ip,,8,4,11,12,27,23,6,1
eclipse-indigo,eclipse-indigo,,1,0,0,1,2,1,3,1
wsdl2java,wsdl2java,,24,13,27,37,32,64,3,1
rapidweaver,rapidweaver,,0,0,0,0,1,0,5,1
cups,cups,,9,12,22,21,38,43,9,33.333333
email-templates,email-templates,,13,12,25,25,51,50,1,1
rsyslog,rsyslog,,31,18,58,49,56,107,9,1
stat,stat,,19,11,31,30,61,61,9,1
dr-memory,dr-memory,,1,3,5,4,3,9,9,200
postgresql-8.2,postgresql-8.2,,1,0,1,1,4,2,4,1
change-tracking,change-tracking,,10,6,16,16,26,32,8,1
javascriptserializer,javascriptserializer,,4,9,5,13,30,18,8,125
clarity,clarity,,8,7,23,15,17,38,1,1
jcenter,jcenter,,8,4,33,12,60,45,3,1
flash-cs6,flash-cs6,,2,2,7,4,21,11,13,1
rwunderground,rwunderground,,0,0,0,0,2,0,0,1
ext3,ext3,,1,2,2,3,3,5,9,100
rasterio,rasterio,,16,29,36,45,23,81,0,81.25
ssh-keys,ssh-keys,,36,38,65,74,166,139,9,5.555556
azure-cli2,azure-cli2,,7,5,15,12,34,27,8,1
refluxjs,refluxjs,,1,2,4,3,10,7,1,100
deviceiocontrol,deviceiocontrol,,1,1,7,2,7,9,9,1
apktool,apktool,,8,8,23,16,32,39,3,1
skia,skia,,9,3,14,12,25,26,8,1
vavr,vavr,,11,11,12,22,31,34,3,1
formsets,formsets,,0,0,1,0,17,1,0,1
tolist,tolist,,3,2,5,5,12,10,8,1
pyexcelerate,pyexcelerate,,0,0,0,0,2,0,5,1
linestyle,linestyle,,1,3,1,4,10,5,0,200
fable-f#,fable-f#,,9,8,16,17,15,33,8,1
servicepoint,servicepoint,,3,0,2,3,4,5,8,1
query-cache,query-cache,,1,3,6,4,16,10,3,200
iso8583,iso8583,,8,5,12,13,22,25,3,1
ebcdic,ebcdic,,3,4,4,7,16,11,0,33.333333
declare,declare,,13,10,29,23,58,52,4,1
stanford-snap,stanford-snap,,0,0,0,0,2,0,0,1
deleted-functions,deleted-functions,,4,2,4,6,11,10,9,1
lib-nfc,lib-nfc,,2,3,7,5,11,12,3,50
integrated,integrated,,1,1,1,2,5,3,0,1
bin,bin,,17,12,31,29,74,60,0,1
appwidgetprovider,appwidgetprovider,,3,1,5,4,16,9,3,1
org.json,org.json,,13,4,20,17,26,37,3,1
tsd,tsd,,0,1,1,1,1,2,1,1
chron,chron,,0,2,9,2,14,11,0,100
defaults,defaults,,0,0,0,0,10,0,13,1
bleve,bleve,,1,0,2,1,6,3,6,1
msdasql,msdasql,,0,1,0,1,3,1,4,1
rownum,rownum,,2,3,10,5,24,15,4,50
spring-async,spring-async,,5,5,11,10,18,21,3,1
formatexception,formatexception,,1,0,9,1,14,10,8,1
exceldatareader,exceldatareader,,2,5,10,7,29,17,8,150
setfocus,setfocus,,3,2,7,5,34,12,1,1
projects,projects,,0,0,0,0,15,0,3,1
google-refine,google-refine,,0,0,1,0,4,1,0,1
grel,grel,,1,3,2,4,10,6,0,200
subtyping,subtyping,,9,4,5,13,21,18,9,1
drools-kie-workbench,drools-kie-workbench,,4,1,7,5,11,12,3,1
tsconfig,tsconfig,,39,41,63,80,111,143,1,5.128205
bnlearn,bnlearn,,8,6,7,14,15,21,0,1
chameleon,chameleon,,1,3,1,4,3,5,0,200
injective-function,injective-function,,0,0,1,0,4,1,2,1
mailx,mailx,,7,5,12,12,22,24,9,1
automic,automic,,0,1,1,1,3,2,9,1
django-aggregation,django-aggregation,,4,6,12,10,14,22,0,50
unity5.3,unity5.3,,0,0,0,0,3,0,8,1
gear-vr,gear-vr,,4,6,10,10,22,20,8,50
virtual-tour,virtual-tour,,0,1,1,1,3,2,8,1
github-graphql,github-graphql,,7,8,20,15,53,35,6,14.285714
mybatis-generator,mybatis-generator,,2,2,6,4,17,10,3,1
openseamap,openseamap,,0,0,2,0,6,2,1,1
node-mysql2,node-mysql2,,4,3,6,7,9,13,1,1
uniplate,uniplate,,0,0,0,0,1,0,2,1
odac,odac,,4,1,14,5,20,19,4,1
ffimageloading,ffimageloading,,6,4,12,10,32,22,8,1
angular-fullstack,angular-fullstack,,3,5,7,8,22,15,1,66.666667
dynamics-sl,dynamics-sl,,1,0,2,1,2,3,8,1
lmfit,lmfit,,10,17,14,27,54,41,0,70
sinon-chai,sinon-chai,,9,13,41,22,41,63,1,44.444444
microsoft-web-deploy,microsoft-web-deploy,,3,2,3,5,12,8,8,1
jupyter-lab,jupyter-lab,,85,123,132,208,123,340,0,44.705882
firebase-performance,firebase-performance,,11,6,33,17,38,50,3,1
http-status-code-405,http-status-code-405,,8,10,24,18,48,42,3,25
ng-style,ng-style,,7,12,9,19,31,28,1,71.428571
httpwebresponse,httpwebresponse,,12,13,40,25,72,65,8,8.333333
azure-java-sdk,azure-java-sdk,,6,9,15,15,21,30,8,50
connect-mongo,connect-mongo,,5,4,4,9,10,13,1,1
emscripten,emscripten,,35,36,73,71,101,144,1,2.857143
v4l2,v4l2,,11,6,14,17,30,31,13,1
wallaby.js,wallaby.js,,0,1,3,1,7,4,1,1
xml-namespaces,xml-namespaces,,33,30,64,63,135,127,3,1
jquery-migrate,jquery-migrate,,4,5,5,9,8,14,1,25
unet,unet,,0,0,0,0,56,0,8,1
unmarked-package,unmarked-package,,1,3,2,4,2,6,0,200
routeattribute,routeattribute,,0,0,0,0,2,0,8,1
enroute,enroute,,2,0,1,2,4,3,3,1
rescale,rescale,,5,4,6,9,16,15,0,1
ubsan,ubsan,,3,4,2,7,4,9,9,33.333333
address-sanitizer,address-sanitizer,,18,11,35,29,65,64,9,1
rails-activejob,rails-activejob,,7,17,33,24,62,57,12,142.857143
babel-cli,babel-cli,,4,3,9,7,8,16,1,1
matconvnet,matconvnet,,1,0,2,1,13,3,0,1
coordinate,coordinate,,0,0,0,0,37,0,0,1
virus-scanning,virus-scanning,,1,1,6,2,7,8,4,1
itunes-app,itunes-app,,1,2,4,3,5,7,13,100
sql-server-migration-assi,sql-server-migration-assi,,3,2,4,5,7,9,4,1
immediate-window,immediate-window,,1,3,6,4,9,10,8,200
qeventloop,qeventloop,,1,2,3,3,10,6,9,100
queued-connection,queued-connection,,1,0,0,1,2,1,9,1
qprogressdialog,qprogressdialog,,0,0,1,0,7,1,9,1
icarousel,icarousel,,0,2,4,2,11,6,13,100
dashing,dashing,,0,3,2,3,15,5,12,200
apple-search-ads,apple-search-ads,,2,0,1,2,3,3,13,1
phpbb,phpbb,,2,3,7,5,16,12,4,50
avqueueplayer,avqueueplayer,,1,5,7,6,12,13,13,400
devkit,devkit,,1,2,1,3,5,4,8,100
eclipse-marketplace,eclipse-marketplace,,2,2,8,4,12,12,3,1
aide-ide,aide-ide,,4,0,10,4,8,14,3,1
mrjob,mrjob,,10,1,20,11,24,31,2,1
column-types,column-types,,2,2,0,4,3,4,0,1
hclust,hclust,,5,3,11,8,20,19,0,1
iokit,iokit,,7,11,16,18,39,34,13,57.142857
formtastic,formtastic,,1,3,8,4,9,12,12,200
ftell,ftell,,2,0,0,2,8,2,9,1
qtextdocument,qtextdocument,,3,3,2,6,10,8,9,1
arithmetic-expressions,arithmetic-expressions,,13,8,41,21,49,62,0,1
ubuntu-16.10,ubuntu-16.10,,1,0,1,1,7,2,9,1
srand,srand,,8,3,12,11,23,23,9,1
viewer,viewer,,11,10,24,21,33,45,1,1
snakebite,snakebite,,2,0,1,2,2,3,0,1
mnemonics,mnemonics,,3,2,6,5,7,11,6,1
dateinterval,dateinterval,,3,4,6,7,22,13,4,33.333333
datetimeformatinfo,datetimeformatinfo,,3,1,0,4,3,4,0,1
server-variables,server-variables,,1,1,1,2,3,3,4,1
vim-fugitive,vim-fugitive,,1,1,3,2,8,5,9,1
drupal-webform,drupal-webform,,5,0,20,5,13,25,4,1
nested-select,nested-select,,1,1,6,2,11,8,4,1
fieldset,fieldset,,5,9,13,14,27,27,1,80
asana,asana,,6,3,9,9,21,18,4,1
asana-api,asana-api,,2,2,8,4,18,12,4,1
asana-connect,asana-connect,,1,0,0,1,3,1,4,1
azure-deployment,azure-deployment,,10,13,45,23,62,68,8,30
data-protection,data-protection,,15,5,18,20,29,38,8,1
twentytwenty,twentytwenty,,0,2,1,2,2,3,1,100
openiddict,openiddict,,11,5,12,16,48,28,8,1
sqlbrite,sqlbrite,,0,0,3,0,3,3,3,1
dexie,dexie,,8,9,15,17,40,32,1,12.5
graphicimage,graphicimage,,2,1,3,3,4,6,3,1
ajax-update,ajax-update,,0,0,1,0,6,1,3,1
missing-features,missing-features,,3,1,5,4,8,9,0,1
comm,comm,,2,1,7,3,21,10,9,1
rights-management,rights-management,,1,1,1,2,3,3,8,1
sharp,sharp,,13,24,23,37,40,60,1,84.615385
trailing-return-type,trailing-return-type,,2,0,3,2,11,5,9,1
custom-cell,custom-cell,,4,6,8,10,45,18,13,50
resourcebundle,resourcebundle,,10,4,10,14,32,24,3,1
systrace,systrace,,3,1,5,4,15,9,3,1
sleekxmpp,sleekxmpp,,1,5,1,6,2,7,0,400
user-data,user-data,,18,10,32,28,44,60,6,1
cloud-init,cloud-init,,6,8,35,14,41,49,6,33.333333
oracle-ucm,oracle-ucm,,2,0,1,2,9,3,3,1
dom-repeat,dom-repeat,,1,4,2,5,29,7,1,300
hibernate-jpa,hibernate-jpa,,6,5,9,11,13,20,3,1
jsonserializer,jsonserializer,,9,5,21,14,25,35,8,1
json-serialization,json-serialization,,16,13,25,29,35,54,8,1
read-committed,read-committed,,0,2,3,2,3,5,4,100
twisted.internet,twisted.internet,,5,1,6,6,20,12,0,1
platformio,platformio,,14,10,23,24,21,47,9,1
cobalt,cobalt,,1,4,3,5,30,8,3,300
dynamic-loading,dynamic-loading,,8,7,12,15,34,27,9,1
smbus,smbus,,6,4,8,10,11,18,9,1
gnu-coreutils,gnu-coreutils,,9,1,8,10,10,18,9,1
phyloseq,phyloseq,,6,3,8,9,9,17,0,1
spring-java-config,spring-java-config,,8,5,19,13,59,32,3,1
sktextureatlas,sktextureatlas,,0,1,3,1,2,4,13,1
browser-detection,browser-detection,,6,6,5,12,13,17,1,1
azure-managed-identity,azure-managed-identity,,3,14,23,17,42,40,8,366.666667
nanoboxio,nanoboxio,,1,0,2,1,7,3,12,1
winscard,winscard,,2,3,4,5,8,9,3,50
sip-servlet,sip-servlet,,1,0,0,1,5,1,3,1
type-parameter,type-parameter,,8,14,17,22,40,39,3,75
pyspider,pyspider,,0,2,2,2,5,4,0,100
postgrest,postgrest,,0,2,5,2,13,7,4,100
web-application-design,web-application-design,,4,0,1,4,3,5,3,1
dts,dts,,6,7,12,13,16,25,4,16.666667
audio-video-sync,audio-video-sync,,3,0,3,3,2,6,13,1
worklight-adapters,worklight-adapters,,0,1,3,1,8,4,13,1
mfp,mfp,,5,4,6,9,21,15,13,1
android-inputtype,android-inputtype,,4,1,5,5,18,10,3,1
advanced-rest-client,advanced-rest-client,,3,6,9,9,12,18,4,100
ollydbg,ollydbg,,3,5,10,8,18,18,9,66.666667
reversing,reversing,,1,2,8,3,8,11,9,100
jsvalue,jsvalue,,0,1,0,1,3,1,2,1
android-debugging,android-debugging,,0,3,3,3,6,6,3,200
fitsharp,fitsharp,,1,0,0,1,4,1,3,1
tablecellrenderer,tablecellrenderer,,2,2,6,4,20,10,3,1
file-access,file-access,,8,11,16,19,27,35,8,37.5
ddp,ddp,,1,1,2,2,13,4,1,1
endpoints,endpoints,,0,0,0,0,30,0,3,1
flash-cs5,flash-cs5,,1,1,1,2,17,3,13,1
windows2012,windows2012,,4,4,8,8,22,16,8,1
jquery-jtable,jquery-jtable,,3,0,2,3,18,5,1,1
cost-management,cost-management,,5,7,5,12,9,17,6,40
xpathquery,xpathquery,,0,2,0,2,3,2,3,100
css-variables,css-variables,,33,25,57,58,73,115,1,1
windows-process,windows-process,,2,0,6,2,4,8,8,1
opc,opc,,16,11,29,27,50,56,8,1
mod-proxy,mod-proxy,,24,13,35,37,48,72,4,1
razorengine,razorengine,,11,11,27,22,71,49,8,1
magicline,magicline,,0,0,0,0,4,0,1,1
jquery-file-upload,jquery-file-upload,,19,14,41,33,97,74,1,1
hsts,hsts,,13,7,23,20,54,43,4,1
unset,unset,,11,6,19,17,39,36,4,1
android-storage,android-storage,,6,8,21,14,51,35,3,33.333333
tabbar,tabbar,,23,35,52,58,97,110,13,52.173913
addobserver,addobserver,,0,1,1,1,4,2,13,1
phpcs,phpcs,,5,5,20,10,25,30,4,1
wake-on-lan,wake-on-lan,,0,3,5,3,5,8,9,200
android-graphics,android-graphics,,6,6,13,12,14,25,3,1
hevc,hevc,,8,7,17,15,47,32,13,1
h.265,h.265,,2,2,8,4,15,12,13,1
android-print-framework,android-print-framework,,3,5,5,8,10,13,3,66.666667
jsr310,jsr310,,2,1,6,3,13,9,3,1
infix-notation,infix-notation,,11,5,19,16,37,35,9,1
azure-hub,azure-hub,,0,0,1,0,1,1,3,1
fputcsv,fputcsv,,5,6,13,11,30,24,4,20
otrs,otrs,,4,3,7,7,20,14,9,1
tree-traversal,tree-traversal,,16,9,25,25,56,50,0,1
exchange-server-2010,exchange-server-2010,,5,1,17,6,37,23,8,1
autodoc,autodoc,,13,9,21,22,35,43,0,1
libm,libm,,0,2,4,2,4,6,9,100
jgraphx,jgraphx,,10,2,14,12,8,26,3,1
dotnetnuke-8,dotnetnuke-8,,0,0,0,0,6,0,8,1
macos-carbon,macos-carbon,,5,2,11,7,7,18,13,1
matlab-deployment,matlab-deployment,,1,5,8,6,27,14,0,400
limits,limits,,0,0,0,0,36,0,0,1
asp.net-mvc-apiexplorer,asp.net-mvc-apiexplorer,,1,1,0,2,4,2,8,1
page-size,page-size,,3,1,3,4,7,7,8,1
capl,capl,,11,17,21,28,48,49,9,54.545455
nstabviewcontroller,nstabviewcontroller,,0,1,1,1,9,2,13,1
adb-shell,adb-shell,,5,9,3,14,18,17,3,80
android-junit,android-junit,,5,1,6,6,11,12,3,1
sqlproj,sqlproj,,1,1,5,2,7,7,8,1
atmega16,atmega16,,6,4,3,10,8,13,9,1
bin-packing,bin-packing,,4,8,11,12,27,23,0,100
database-relations,database-relations,,6,6,10,12,18,22,4,1
delaunay,delaunay,,8,8,18,16,30,34,0,1
git-mv,git-mv,,1,1,4,2,5,6,6,1
php-password-hash,php-password-hash,,1,3,7,4,25,11,4,200
dependency-resolution,dependency-resolution,,1,0,1,1,7,2,3,1
data-race,data-race,,5,4,7,9,7,16,9,1
cocos2d-iphone,cocos2d-iphone,,6,6,12,12,21,24,13,1
memory-barriers,memory-barriers,,21,18,17,39,69,56,9,1
cocoa-bindings,cocoa-bindings,,6,6,10,12,13,22,13,1
nsarraycontroller,nsarraycontroller,,2,0,6,2,11,8,13,1
gnuradio,gnuradio,,18,27,42,45,64,87,0,50
gnuradio-companion,gnuradio-companion,,13,15,23,28,41,51,0,15.384615
gtk2,gtk2,,6,12,35,18,37,53,9,100
beanstalkd,beanstalkd,,4,4,11,8,22,19,4,1
postdata,postdata,,4,2,7,6,18,13,4,1
dangling-pointer,dangling-pointer,,4,3,4,7,16,11,9,1
web-widget,web-widget,,0,0,0,0,2,0,1,1
dev-to-production,dev-to-production,,5,7,14,12,18,26,1,40
noise-reduction,noise-reduction,,8,5,18,13,18,31,0,1
error-log,error-log,,8,3,9,11,25,20,4,1
layoutparams,layoutparams,,5,5,7,10,19,17,3,1
halcon,halcon,,5,4,3,9,6,12,0,1
phpword,phpword,,21,32,59,53,85,112,4,52.380952
android-bootstrap-widgets,android-bootstrap-widgets,,0,0,0,0,1,0,3,1
gulp-nunjucks-render,gulp-nunjucks-render,,2,1,6,3,7,9,1,1
hindi,hindi,,3,9,13,12,32,25,0,200
datacontractsurrogate,datacontractsurrogate,,0,0,0,0,1,0,8,1
internal-storage,internal-storage,,6,3,10,9,26,19,3,1
pades,pades,,1,3,4,4,4,8,8,200
kentor-authservices,kentor-authservices,,2,0,7,2,13,9,8,1
apache-directory,apache-directory,,3,1,2,4,5,6,8,1
godaddy-api,godaddy-api,,15,14,18,29,19,47,4,1
registrar,registrar,,0,1,3,1,3,4,4,1
email-parsing,email-parsing,,5,2,7,7,11,14,4,1
xmlpullparser,xmlpullparser,,10,3,13,13,16,26,3,1
spring-data-gemfire,spring-data-gemfire,,8,7,20,15,42,35,3,1
change-data-capture,change-data-capture,,4,5,7,9,21,16,4,25
hadoop2.7.3,hadoop2.7.3,,0,0,1,0,3,1,2,1
try-with-resources,try-with-resources,,10,11,15,21,44,36,3,10
autocloseable,autocloseable,,4,1,8,5,16,13,3,1
argv,argv,,20,18,30,38,78,68,9,1
project-organization,project-organization,,3,3,2,6,7,8,9,1
request-cancelling,request-cancelling,,0,0,1,0,2,1,1,1
css-import,css-import,,1,0,4,1,6,5,1,1
datomic,datomic,,3,1,16,4,22,20,2,1
multiple-tables,multiple-tables,,5,11,11,16,36,27,4,120
timeoutexception,timeoutexception,,10,13,24,23,31,47,3,30
ssms-2014,ssms-2014,,9,5,15,14,26,29,4,1
barrier,barrier,,4,2,11,6,29,17,3,1
javacompiler,javacompiler,,6,2,12,8,14,20,3,1
django-settings,django-settings,,19,13,26,32,79,58,0,1
clipperlib,clipperlib,,1,0,2,1,4,3,8,1
angular-ui-typeahead,angular-ui-typeahead,,0,1,4,1,12,5,1,1
continuewith,continuewith,,5,1,5,6,8,11,8,1
tycho-surefire-plugin,tycho-surefire-plugin,,0,0,2,0,5,2,3,1
locked,locked,,10,0,5,10,16,15,5,1
dbal,dbal,,8,3,8,11,18,19,4,1
rowstate,rowstate,,0,0,0,0,2,0,8,1
logalyze,logalyze,,0,0,1,0,2,1,3,1
wiringpi,wiringpi,,7,6,17,13,17,30,9,1
user-defined-data-types,user-defined-data-types,,3,3,2,6,7,8,4,1
cmb2,cmb2,,10,3,5,13,10,18,4,1
spreadsheetgear,spreadsheetgear,,3,3,3,6,16,9,8,1
opl,opl,,39,20,26,59,53,85,0,1
reactor,reactor,,22,49,69,71,27,140,3,122.727273
reactor-netty,reactor-netty,,32,27,42,59,30,101,3,1
mysql-slow-query-log,mysql-slow-query-log,,6,2,5,8,16,13,4,1
text-search,text-search,,5,2,3,7,17,10,1,1
sencha-cmd,sencha-cmd,,5,6,16,11,40,27,1,20
web-platform-installer,web-platform-installer,,1,0,3,1,6,4,8,1
ibmhttpserver,ibmhttpserver,,3,2,5,5,19,10,4,1
xilinx-ise,xilinx-ise,,3,3,13,6,26,19,9,1
python-venv,python-venv,,37,47,69,84,59,153,0,27.027027
python-interactive,python-interactive,,6,2,6,8,13,14,0,1
mailmerge,mailmerge,,16,12,27,28,44,55,5,1
spire.doc,spire.doc,,0,0,1,0,11,1,8,1
react-scripts,react-scripts,,26,23,39,49,31,88,1,1
oracle-nosql,oracle-nosql,,4,1,2,5,2,7,4,1
django-suit,django-suit,,0,2,0,2,5,2,0,100
term-document-matrix,term-document-matrix,,2,3,6,5,25,11,0,50
8051,8051,,15,3,26,18,45,44,9,1
consistent-hashing,consistent-hashing,,0,4,1,4,8,5,3,300
tablecell,tablecell,,2,4,14,6,27,20,13,100
custom-draw,custom-draw,,0,1,0,1,2,1,9,1
cmenu,cmenu,,0,0,0,0,3,0,9,1
elixir-framework,elixir-framework,,7,3,8,10,27,18,2,1
jsr352,jsr352,,5,4,12,9,33,21,3,1
valueconverter,valueconverter,,0,0,4,0,17,4,8,1
google-maps-ios-utils,google-maps-ios-utils,,2,2,3,4,2,7,13,1
static-data,static-data,,1,0,1,1,7,2,3,1
modelattribute,modelattribute,,5,5,16,10,32,26,3,1
ngx-http-access-module,ngx-http-access-module,,0,0,0,0,2,0,6,1
facebook-insights,facebook-insights,,5,5,18,10,30,28,13,1
twincat,twincat,,11,7,7,18,23,25,9,1
structured-text,structured-text,,4,1,4,5,12,9,9,1
simple-xml-converter,simple-xml-converter,,0,1,8,1,8,9,3,1
image-stitching,image-stitching,,9,10,16,19,31,35,0,11.111111
sweave,sweave,,4,8,11,12,30,23,0,100
intershop,intershop,,1,2,15,3,25,18,4,100
checklist-model,checklist-model,,0,0,3,0,3,3,1,1
informatica-powerexchange,informatica-powerexchange,,2,1,4,3,7,7,4,1
oracle-cdc,oracle-cdc,,3,3,2,6,6,8,4,1
qtvirtualkeyboard,qtvirtualkeyboard,,7,1,3,8,6,11,9,1
ngen,ngen,,2,2,3,4,6,7,8,1
redux-framework,redux-framework,,4,2,9,6,9,15,4,1
boomi,boomi,,6,2,6,8,10,14,14,1
non-exhaustive-patterns,non-exhaustive-patterns,,5,2,7,7,4,14,2,1
gdbinit,gdbinit,,2,0,0,2,4,2,9,1
circleimage,circleimage,,0,0,4,0,6,4,3,1
relativepanel,relativepanel,,0,0,1,0,3,1,8,1
treenode,treenode,,4,7,18,11,22,29,8,75
ctype,ctype,,3,1,3,4,8,7,0,1
chained-select,chained-select,,0,0,2,0,4,2,1,1
function-declaration,function-declaration,,8,9,16,17,20,33,9,12.5
ipopt,ipopt,,9,7,19,16,26,35,0,1
distinct-on,distinct-on,,3,2,5,5,8,10,4,1
autorest,autorest,,6,4,8,10,24,18,8,1
preg-replace-callback,preg-replace-callback,,8,8,20,16,27,36,4,1
taskaffinity,taskaffinity,,1,0,4,1,3,5,3,1
tcpchannel,tcpchannel,,0,0,0,0,2,0,8,1
fixer.io,fixer.io,,3,0,1,3,17,4,1,1
table-variable,table-variable,,3,1,5,4,16,9,4,1
xsockets.net,xsockets.net,,0,0,0,0,2,0,8,1
earlgrey,earlgrey,,1,1,6,2,10,8,13,1
bundling-and-minification,bundling-and-minification,,19,22,44,41,90,85,1,15.789474
avplayerlayer,avplayerlayer,,6,6,10,12,18,22,13,1
static-cast,static-cast,,5,11,19,16,52,35,9,120
infobubble,infobubble,,1,1,2,2,2,4,3,1
gravity,gravity,,8,14,28,22,45,50,3,75
arabic-support,arabic-support,,15,10,20,25,33,45,0,1
flask-oauthlib,flask-oauthlib,,1,2,9,3,11,12,0,100
wnet,wnet,,0,0,0,0,2,0,9,1
tablemodel,tablemodel,,2,2,4,4,12,8,3,1
onsubmit,onsubmit,,17,12,27,29,45,56,1,1
slcomposeviewcontroller,slcomposeviewcontroller,,1,3,1,4,9,5,13,200
social-framework,social-framework,,0,0,1,0,2,1,13,1
jcl,jcl,,9,2,17,11,37,28,4,1
splitview,splitview,,1,2,3,3,12,6,13,100
couchbase-view,couchbase-view,,4,1,5,5,20,10,3,1
gcc7,gcc7,,3,0,10,3,27,13,9,1
elementref,elementref,,5,2,14,7,25,21,1,1
satis,satis,,1,2,6,3,5,9,4,100
pdfviewer,pdfviewer,,0,0,1,0,12,1,8,1
tinymce-3,tinymce-3,,3,3,3,6,5,9,1,1
xlconnect,xlconnect,,7,5,13,12,42,25,0,1
launch,launch,,20,20,27,40,88,67,3,1
shutdown-hook,shutdown-hook,,7,5,8,12,15,20,3,1
tablesort,tablesort,,4,0,3,4,3,7,1,1
telerik-mvc,telerik-mvc,,12,9,30,21,25,51,8,1
function-object,function-object,,3,0,4,3,12,7,9,1
circlize,circlize,,5,1,7,6,10,13,0,1
localnotification,localnotification,,27,16,26,43,63,69,13,1
touchesbegan,touchesbegan,,1,1,10,2,21,12,13,1
graphicsmagick,graphicsmagick,,10,20,26,30,55,56,12,100
image-conversion,image-conversion,,11,3,14,14,29,28,0,1
gmagick,gmagick,,1,0,2,1,3,3,4,1
scala-implicits,scala-implicits,,0,0,0,0,14,0,2,1
drupal-entities,drupal-entities,,0,1,2,1,3,3,4,1
nsvaluetransformer,nsvaluetransformer,,0,0,2,0,2,2,13,1
rxjs-dom,rxjs-dom,,0,0,0,0,8,0,1,1
spawning,spawning,,3,5,2,8,9,10,8,66.666667
milliseconds,milliseconds,,21,11,25,32,62,57,0,1
cdi-2.0,cdi-2.0,,1,1,3,2,5,5,3,1
kotlin-interop,kotlin-interop,,2,2,9,4,54,13,3,1
iar,iar,,15,11,26,26,43,52,9,1
stm8,stm8,,2,5,5,7,7,12,9,150
sna,sna,,10,3,21,13,27,34,0,1
non-greedy,non-greedy,,1,5,4,6,9,10,0,400
sqlparameter,sqlparameter,,0,2,2,2,7,4,4,100
jsonresult,jsonresult,,8,5,11,13,20,24,8,1
android-handler,android-handler,,19,13,41,32,65,73,3,1
selenium-server,selenium-server,,2,2,5,4,21,9,3,1
tsqlt,tsqlt,,3,3,10,6,22,16,4,1
raiserror,raiserror,,1,1,6,2,9,8,4,1
xmldiff,xmldiff,,0,2,4,2,3,6,3,100
xmlunit-2,xmlunit-2,,1,0,5,1,12,6,3,1
xssf,xssf,,14,15,19,29,39,48,3,7.142857
restkit,restkit,,1,2,2,3,13,5,13,100
rkobjectmapping,rkobjectmapping,,0,0,0,0,2,0,13,1
gridlayoutmanager,gridlayoutmanager,,17,24,29,41,63,70,3,41.176471
swiftcharts,swiftcharts,,3,2,8,5,20,13,13,1
.so,.so,,12,20,17,32,43,49,3,66.666667
sift,sift,,14,8,30,22,67,52,0,1
medium-editor,medium-editor,,4,0,7,4,9,11,1,1
metasploit,metasploit,,9,10,12,19,26,31,9,11.111111
telerik-grid,telerik-grid,,18,18,48,36,64,84,8,1
apache-beam-io,apache-beam-io,,38,25,50,63,53,113,6,1
bnf,bnf,,11,7,10,18,30,28,0,1
android-uiautomator,android-uiautomator,,35,34,47,69,73,116,3,1
xamarin.winphone,xamarin.winphone,,0,0,0,0,1,0,8,1
cross-device,cross-device,,0,0,1,0,2,1,8,1
interaction,interaction,,27,28,33,55,77,88,0,3.703704
datatableadapters,datatableadapters,,1,0,0,1,5,1,8,1
normals,normals,,9,13,21,22,30,43,0,44.444444
quasar,quasar,,13,28,20,41,32,61,1,115.384615
byref,byref,,4,3,5,7,8,12,5,1
getelementsbytagname,getelementsbytagname,,8,8,16,16,42,32,1,1
getelementsbyname,getelementsbyname,,4,0,3,4,14,7,1,1
qlpreviewcontroller,qlpreviewcontroller,,7,1,10,8,23,18,13,1
bartintcolor,bartintcolor,,0,1,2,1,4,3,13,1
magma,magma,,4,0,2,4,5,6,9,1
rollapply,rollapply,,1,6,18,7,42,25,0,500
oracle-export-dump,oracle-export-dump,,0,0,0,0,4,0,4,1
cllocationdistance,cllocationdistance,,1,0,1,1,3,2,13,1
jdo,jdo,,3,3,11,6,24,17,3,1
datanucleus,datanucleus,,4,3,15,7,36,22,3,1
groovy-console,groovy-console,,2,4,7,6,16,13,3,100
libyuv,libyuv,,0,0,2,0,4,2,13,1
rhino-mocks,rhino-mocks,,7,5,10,12,13,22,8,1
reporters,reporters,,2,4,11,6,16,17,0,100
compositing,compositing,,0,4,1,4,7,5,13,300
chalice,chalice,,9,7,12,16,29,28,6,1
qchart,qchart,,9,5,13,14,33,27,9,1
android-paint,android-paint,,6,1,8,7,13,15,3,1
sizer,sizer,,1,1,0,2,6,2,0,1
gridbagsizer,gridbagsizer,,0,1,1,1,2,2,0,1
long-long,long-long,,1,0,5,1,13,6,9,1
fiona,fiona,,6,10,14,16,20,30,0,66.666667
bus,bus,,9,7,20,16,19,36,9,1
amazon-connect,amazon-connect,,13,11,21,24,24,45,6,1
boost-iostreams,boost-iostreams,,2,3,5,5,11,10,9,50
iphone-8,iphone-8,,1,1,2,2,9,4,13,1
maven-surefire-plugin,maven-surefire-plugin,,42,41,101,83,131,184,3,1
maven-failsafe-plugin,maven-failsafe-plugin,,12,12,19,24,44,43,3,1
sales-tax,sales-tax,,0,0,0,0,2,0,4,1
auxil-excel-add-in,auxil-excel-add-in,,0,0,1,0,1,1,4,1
download-speed,download-speed,,2,3,2,5,4,7,4,50
kendo-datasource,kendo-datasource,,8,4,4,12,24,16,1,1
laravel-scheduler,laravel-scheduler,,3,4,8,7,10,15,4,33.333333
javafx-3d,javafx-3d,,7,5,6,12,36,18,3,1
elasticsearch-watcher,elasticsearch-watcher,,0,1,3,1,6,4,6,1
flying-saucer,flying-saucer,,15,5,16,20,30,36,3,1
kibana-4,kibana-4,,0,6,14,6,16,20,6,500
cray,cray,,0,2,1,2,5,3,9,100
spring-boot-admin,spring-boot-admin,,20,18,53,38,42,91,3,1
dtd,dtd,,24,16,29,40,75,69,3,1
taskfactory,taskfactory,,0,2,4,2,6,6,8,100
braintree-sandbox,braintree-sandbox,,8,11,28,19,43,47,4,37.5
mercurial-subrepos,mercurial-subrepos,,2,1,2,3,8,5,6,1
imagesource,imagesource,,5,1,13,6,32,19,8,1
nntool,nntool,,0,1,1,1,1,2,0,1
devexpress-mvc,devexpress-mvc,,7,6,13,13,19,26,8,1
django-cache,django-cache,,3,5,13,8,9,21,0,66.666667
django-caching,django-caching,,1,0,1,1,1,2,0,1
wxmathplot,wxmathplot,,0,2,0,2,1,2,9,100
clj-http,clj-http,,0,1,2,1,6,3,2,1
liferay-aui,liferay-aui,,3,2,6,5,19,11,3,1
alloy-ui,alloy-ui,,3,2,4,5,9,9,1,1
android-intent-chooser,android-intent-chooser,,4,3,14,7,11,21,3,1
android-photos,android-photos,,0,0,0,0,5,0,3,1
intel-xdk,intel-xdk,,0,0,0,0,7,0,1,1
multiple-monitors,multiple-monitors,,15,13,30,28,41,58,8,1
security-trimming,security-trimming,,0,0,0,0,3,0,8,1
jca,jca,,4,3,8,7,11,15,3,1
composite-primary-key,composite-primary-key,,24,14,39,38,87,77,4,1
pt-online-schema-change,pt-online-schema-change,,3,0,1,3,5,4,4,1
grunt-contrib-cssmin,grunt-contrib-cssmin,,1,0,0,1,4,1,1,1
hornetq,hornetq,,4,4,13,8,23,21,3,1
ffserver,ffserver,,6,0,7,6,10,13,13,1
apex-code,apex-code,,8,15,25,23,44,48,14,87.5
hybrid,hybrid,,14,16,43,30,77,73,1,14.285714
absolute-value,absolute-value,,0,6,5,6,16,11,0,500
wreq,wreq,,1,1,1,2,8,3,2,1
radar-chart,radar-chart,,13,9,20,22,37,42,0,1
meshlab,meshlab,,10,10,21,20,58,41,0,1
grib,grib,,3,4,11,7,12,18,0,33.333333
name-lookup,name-lookup,,6,10,10,16,38,26,9,66.666667
restier,restier,,1,2,1,3,2,4,8,100
restful.js,restful.js,,0,0,0,0,1,0,1,1
lib,lib,,37,32,68,69,125,137,9,1
git-bare,git-bare,,3,3,12,6,20,18,6,1
impdp,impdp,,6,3,13,9,31,22,4,1
datagridtemplatecolumn,datagridtemplatecolumn,,5,5,7,10,19,17,8,1
data-management,data-management,,2,8,18,10,29,28,0,300
marching-cubes,marching-cubes,,6,4,6,10,12,16,0,1
image-morphology,image-morphology,,10,5,7,15,21,22,0,1
jasmine-spec-reporter,jasmine-spec-reporter,,0,0,0,0,4,0,3,1
azure-vm-scale-set,azure-vm-scale-set,,16,14,34,30,59,64,8,1
direct-runner,direct-runner,,0,0,0,0,2,0,6,1
orocrm,orocrm,,2,1,7,3,13,10,4,1
orocommerce,orocommerce,,2,1,5,3,11,8,4,1
android-radiobutton,android-radiobutton,,6,3,24,9,50,33,3,1
amazon-pay,amazon-pay,,4,2,9,6,10,15,6,1
jaunt-api,jaunt-api,,0,0,3,0,6,3,3,1
springrunner,springrunner,,3,4,8,7,10,15,3,33.333333
foolproof-validation,foolproof-validation,,2,0,0,2,2,2,8,1
sqlite-net-extensions,sqlite-net-extensions,,1,1,14,2,8,16,8,1
sqlparameters,sqlparameters,,3,3,7,6,7,13,4,1
geoalchemy2,geoalchemy2,,5,5,1,10,9,11,0,1
subapplication,subapplication,,1,2,1,3,3,4,1,100
photosframework,photosframework,,10,6,15,16,28,31,13,1
xml-signature,xml-signature,,6,7,19,13,34,32,6,16.666667
routed-events,routed-events,,1,4,7,5,11,12,8,300
wif,wif,,5,1,12,6,23,18,8,1
ws-trust,ws-trust,,3,1,6,4,8,10,3,1
goslate,goslate,,0,0,2,0,2,2,0,1
wrds-compusat,wrds-compusat,,2,1,0,3,2,3,0,1
wso2apicloud,wso2apicloud,,0,1,3,1,2,4,14,1
icollectionview,icollectionview,,1,4,5,5,9,10,8,300
self-type,self-type,,0,3,2,3,8,5,2,200
saxon-js,saxon-js,,0,1,2,1,5,3,3,1
core-media,core-media,,0,5,4,5,12,9,13,400
snowflake-datawarehouse,snowflake-datawarehouse,,32,24,58,56,57,114,4,1
comexception,comexception,,2,7,5,9,12,14,8,250
c++builder-xe7,c++builder-xe7,,0,3,1,3,1,4,9,200
qtquickcontrols,qtquickcontrols,,6,3,13,9,14,22,9,1
tin-can-api,tin-can-api,,1,2,3,3,12,6,8,100
exceptionmapper,exceptionmapper,,2,2,7,4,5,11,3,1
slots,slots,,9,8,16,17,24,33,0,1
anonymous-methods,anonymous-methods,,3,0,9,3,7,12,8,1
nuget-update,nuget-update,,0,2,3,2,3,5,8,100
netscaler,netscaler,,5,4,3,9,14,12,4,1
ora-01017,ora-01017,,0,0,1,0,1,1,4,1
delphi-10-seattle,delphi-10-seattle,,17,6,23,23,56,46,9,1
reader,reader,,24,12,32,36,59,68,0,1
tph,tph,,2,1,6,3,12,9,8,1
statistical-sampling,statistical-sampling,,0,0,4,0,16,4,0,1
parameterbinding,parameterbinding,,1,4,5,5,7,10,8,300
native-module,native-module,,8,3,9,11,22,20,1,1
action-button,action-button,,6,8,8,14,16,22,0,33.333333
addremoveprograms,addremoveprograms,,0,0,0,0,3,0,8,1
turbolinks,turbolinks,,16,10,36,26,80,62,12,1
blue-green-deployment,blue-green-deployment,,5,4,9,9,14,18,6,1
htmlbars,htmlbars,,0,0,0,0,3,0,1,1
buildfire,buildfire,,0,4,5,4,13,9,1,300
raml,raml,,8,9,22,17,41,39,14,12.5
mathquill,mathquill,,1,0,6,1,5,7,1,1
stringindexoutofbounds,stringindexoutofbounds,,3,1,5,4,18,9,3,1
google-news,google-news,,3,1,3,4,13,7,0,1
caddy,caddy,,16,7,18,23,33,41,6,1
javascriptcore,javascriptcore,,9,12,15,21,30,36,13,33.333333
rubymine,rubymine,,13,13,31,26,67,57,12,1
epson,epson,,5,11,24,16,42,40,3,120
epos,epos,,1,2,5,3,6,8,3,100
mup,mup,,2,4,11,6,27,17,1,100
table-valued-parameters,table-valued-parameters,,11,8,14,19,29,33,4,1
unsupportedoperation,unsupportedoperation,,1,2,4,3,8,7,3,100
nowdoc,nowdoc,,0,0,1,0,2,1,4,1
bigtable,bigtable,,14,12,29,26,42,55,6,1
webarchive,webarchive,,0,1,3,1,3,4,13,1
clearcase-ucm,clearcase-ucm,,1,0,7,1,18,8,6,1
python-object,python-object,,0,3,11,3,14,14,0,200
cfml,cfml,,19,32,35,51,62,86,4,68.421053
grgit,grgit,,1,3,3,4,2,7,3,200
cucumber-junit,cucumber-junit,,23,23,41,46,73,87,3,1
sql-limit,sql-limit,,3,2,8,5,15,13,4,1
opensql,opensql,,2,6,18,8,15,26,5,200
django-apps,django-apps,,5,7,18,12,31,30,0,40
zpl,zpl,,11,17,23,28,54,51,3,54.545455
datagridviewcolumn,datagridviewcolumn,,11,6,23,17,32,40,8,1
spin,spin,,4,0,14,4,24,18,0,1
promela,promela,,4,1,13,5,24,18,0,1
strong-soap,strong-soap,,4,0,6,4,6,10,3,1
amazon-waf,amazon-waf,,6,9,11,15,20,26,6,50
walmart-electrode,walmart-electrode,,0,1,2,1,6,3,1,1
smtpappender,smtpappender,,1,3,3,4,7,7,3,200
solution,solution,,11,11,39,22,61,61,8,1
output-window,output-window,,0,0,0,0,2,0,8,1
vertices,vertices,,12,6,20,18,35,38,0,1
midje,midje,,1,0,1,1,2,2,2,1
spark-thriftserver,spark-thriftserver,,4,7,14,11,29,25,2,75
celerybeat,celerybeat,,22,16,52,38,55,90,0,1
psse,psse,,2,5,1,7,2,8,0,150
setup-project,setup-project,,22,21,47,43,85,90,8,1
glassfish-4.1,glassfish-4.1,,8,4,16,12,29,28,3,1
candidate-key,candidate-key,,2,2,8,4,8,12,4,1
django-annotate,django-annotate,,7,9,23,16,28,39,0,28.571429
copytree,copytree,,1,0,3,1,6,4,0,1
user-tracking,user-tracking,,2,0,3,2,8,5,5,1
dataview,dataview,,6,8,12,14,34,26,8,33.333333
node-acl,node-acl,,0,0,0,0,1,0,1,1
explicit-constructor,explicit-constructor,,1,0,2,1,5,3,9,1
max-msp-jitter,max-msp-jitter,,1,1,1,2,3,3,0,1
spring-cloud-aws,spring-cloud-aws,,19,6,17,25,28,42,3,1
cartalyst-sentinel,cartalyst-sentinel,,1,2,5,3,18,8,4,100
media-source,media-source,,6,13,21,19,37,40,1,116.666667
spring-data-hadoop,spring-data-hadoop,,0,0,3,0,2,3,2,1
contentsize,contentsize,,0,1,5,1,9,6,13,1
xdebug-profiler,xdebug-profiler,,0,1,2,1,6,3,4,1
filenet-p8,filenet-p8,,11,8,12,19,29,31,15,1
filenet,filenet,,3,4,3,7,13,10,15,33.333333
filenet-content-engine,filenet-content-engine,,7,7,11,14,19,25,15,1
socialauth,socialauth,,0,0,1,0,6,1,4,1
header-only,header-only,,0,1,2,1,9,3,9,1
android-gravity,android-gravity,,2,1,2,3,9,5,3,1
angular-momentum,angular-momentum,,0,0,2,0,1,2,1,1
tasm,tasm,,22,9,22,31,71,53,9,1
render-to-string,render-to-string,,1,1,3,2,6,5,1,1
rocks,rocks,,0,0,1,0,3,1,9,1
opengl-3,opengl-3,,10,15,30,25,53,55,9,50
rails-console,rails-console,,8,3,9,11,15,20,12,1
firebase-app-indexing,firebase-app-indexing,,1,4,8,5,10,13,3,300
grails-3.0,grails-3.0,,1,2,13,3,12,16,3,100
mobility,mobility,,2,1,4,3,15,7,12,1
autoprefixer,autoprefixer,,14,16,18,30,40,48,1,14.285714
bootstrap-treeview,bootstrap-treeview,,1,1,1,2,11,3,1,1
unify,unify,,0,1,2,1,2,3,8,1
ldf,ldf,,0,2,1,2,4,3,4,100
demo,demo,,1,4,11,5,16,16,3,300
react-helmet,react-helmet,,9,11,29,20,18,49,1,22.222222
f#-4.1,f#-4.1,,0,1,0,1,2,1,8,1
data-oriented-design,data-oriented-design,,3,1,2,4,5,6,9,1
visual-studio-community,visual-studio-community,,0,0,0,0,34,0,8,1
jspm,jspm,,2,3,2,5,22,7,1,50
distributed-transactions,distributed-transactions,,10,10,20,20,36,40,3,1
xa,xa,,5,5,13,10,31,23,3,1
2phase-commit,2phase-commit,,4,2,2,6,4,8,3,1
object-pooling,object-pooling,,4,6,3,10,13,13,8,50
sqltransaction,sqltransaction,,6,3,11,9,14,20,4,1
rack-middleware,rack-middleware,,0,0,1,0,1,1,12,1
featured,featured,,0,0,0,0,7,0,4,1
eiffel,eiffel,,1,1,46,2,15,48,9,1
post-conditions,post-conditions,,0,1,4,1,5,5,9,1
deepequals,deepequals,,0,0,1,0,8,1,1,1
geomesa,geomesa,,12,6,11,18,22,29,2,1
bsxfun,bsxfun,,0,0,2,0,12,2,0,1
pyjnius,pyjnius,,4,9,10,13,18,23,0,125
graphstream,graphstream,,9,1,5,10,8,15,3,1
javascript-injection,javascript-injection,,5,3,9,8,16,17,1,1
4d-database,4d-database,,1,2,3,3,8,6,4,100
fault,fault,,5,7,18,12,39,30,9,40
pugixml,pugixml,,4,3,3,7,12,10,9,1
android-securityexception,android-securityexception,,5,1,11,6,18,17,3,1
template-templates,template-templates,,8,6,7,14,34,21,9,1
litedb,litedb,,12,8,20,20,23,40,8,1
chm,chm,,4,4,8,8,32,16,8,1
mplayer,mplayer,,0,6,9,6,16,15,9,500
live555,live555,,1,4,10,5,11,15,13,300
claudia.js,claudia.js,,0,0,2,0,5,2,6,1
zeroconf,zeroconf,,3,3,9,6,13,15,9,1
webharvy,webharvy,,0,0,0,0,1,0,0,1
itunes-store,itunes-store,,3,4,18,7,35,25,13,33.333333
lsf,lsf,,1,5,8,6,21,14,9,400
django-cors-headers,django-cors-headers,,11,7,20,18,17,38,0,1
docker-network,docker-network,,14,10,33,24,40,57,6,1
admin-ajax,admin-ajax,,2,1,6,3,9,9,4,1
readprocessmemory,readprocessmemory,,3,3,6,6,25,12,9,1
cllocationcoordinate2d,cllocationcoordinate2d,,3,1,5,4,11,9,13,1
bufferedinputstream,bufferedinputstream,,3,4,9,7,19,16,3,33.333333
ibm-cloud-infrastructure,ibm-cloud-infrastructure,,10,15,34,25,115,59,6,50
process-pool,process-pool,,2,6,4,8,13,12,0,200
mutual-authentication,mutual-authentication,,12,11,30,23,27,53,6,1
bit-representation,bit-representation,,1,1,1,2,6,3,0,1
vxworks,vxworks,,9,5,16,14,28,30,9,1
sencha-touch-2,sencha-touch-2,,0,1,5,1,13,6,1,1
extjs6-modern,extjs6-modern,,12,4,25,16,38,41,1,1
make-shared,make-shared,,1,2,4,3,11,7,9,100
google-chrome-storage,google-chrome-storage,,4,6,8,10,23,18,1,50
graphcool,graphcool,,3,0,13,3,62,16,1,1
leap-year,leap-year,,3,2,7,5,15,12,0,1
flashlight,flashlight,,6,6,12,12,28,24,3,1
timer-jobs,timer-jobs,,0,0,0,0,3,0,8,1
layer-list,layer-list,,4,9,8,13,25,21,3,125
android-shape,android-shape,,7,8,12,15,14,27,3,14.285714
video-codecs,video-codecs,,3,4,13,7,14,20,13,33.333333
avassetexportsession,avassetexportsession,,4,10,20,14,21,34,13,150
class-properties,class-properties,,2,3,2,5,8,7,1,50
strpos,strpos,,8,14,28,22,45,50,4,75
text-analytics-api,text-analytics-api,,2,1,6,3,14,9,8,1
matlab-gui,matlab-gui,,1,2,12,3,21,15,0,100
storage-duration,storage-duration,,0,3,2,3,5,5,9,200
data-munging,data-munging,,8,3,18,11,36,29,0,1
cortana-intelligence,cortana-intelligence,,2,0,5,2,5,7,8,1
qkeyevent,qkeyevent,,2,2,2,4,14,6,9,1
pthread-join,pthread-join,,9,5,11,14,21,25,9,1
qtsql,qtsql,,0,6,9,6,22,15,9,500
qsqldatabase,qsqldatabase,,1,7,7,8,22,15,9,600
pglogical,pglogical,,2,0,4,2,6,6,4,1
django-rq,django-rq,,1,2,3,3,7,6,0,100
zypper,zypper,,0,1,2,1,5,3,9,1
jaspersoft-studio,jaspersoft-studio,,9,20,18,29,27,47,3,122.222222
unistd.h,unistd.h,,4,3,14,7,12,21,9,1
script-fu,script-fu,,2,1,11,3,13,14,0,1
js-scrollintoview,js-scrollintoview,,8,5,14,13,16,27,1,1
postgresql-8.4,postgresql-8.4,,3,0,4,3,11,7,4,1
mongokitten,mongokitten,,0,0,1,0,11,1,13,1
crafter-cms,crafter-cms,,2,1,0,3,16,3,4,1
twine,twine,,6,2,5,8,25,13,0,1
http-status-code-504,http-status-code-504,,10,10,18,20,29,38,4,1
rdflib,rdflib,,7,8,16,15,27,31,2,14.285714
file-pointer,file-pointer,,3,1,11,4,14,15,9,1
fragment-identifier,fragment-identifier,,2,1,3,3,13,6,1,1
drupal-field-collection,drupal-field-collection,,0,0,1,0,3,1,4,1
speech,speech,,19,15,42,34,79,76,6,1
explain,explain,,12,7,15,19,53,34,4,1
function-attributes,function-attributes,,0,2,3,2,3,5,9,100
puzzle,puzzle,,11,6,16,17,44,33,0,1
system-shutdown,system-shutdown,,5,1,0,6,4,6,9,1
rename-item-cmdlet,rename-item-cmdlet,,3,4,4,7,7,11,8,33.333333
session-timeout,session-timeout,,9,8,28,17,31,45,3,1
feather,feather,,2,7,11,9,19,20,0,250
author,author,,8,5,25,13,36,38,4,1
nszombies,nszombies,,0,0,0,0,2,0,13,1
cover,cover,,2,4,4,6,19,10,1,100
mapply,mapply,,21,20,22,41,60,63,0,1
visual-studio-sdk,visual-studio-sdk,,5,6,11,11,10,22,8,20
batterylevel,batterylevel,,2,4,10,6,28,16,3,100
true-type-fonts,true-type-fonts,,14,17,39,31,43,70,1,21.428571
metatype,metatype,,1,1,5,2,6,7,13,1
dynamic-languages,dynamic-languages,,2,0,4,2,3,6,9,1
control-flow-graph,control-flow-graph,,5,1,4,6,19,10,9,1
navigator,navigator,,30,25,65,55,61,120,1,1
fiber,fiber,,0,0,0,0,21,0,9,1
boost-coroutine,boost-coroutine,,2,1,3,3,8,6,9,1
orientdb2.2,orientdb2.2,,2,0,8,2,62,10,2,1
setlocale,setlocale,,6,3,8,9,20,17,4,1
nstextfieldcell,nstextfieldcell,,0,0,1,0,3,1,13,1
orgchart,orgchart,,11,5,15,16,20,31,1,1
powerapps,powerapps,,51,49,112,100,95,212,8,1
toolstrip,toolstrip,,1,2,6,3,16,9,8,100
toolstripdropdown,toolstripdropdown,,1,0,4,1,4,5,8,1
no-www,no-www,,2,4,20,6,22,26,4,100
angularjs-factory,angularjs-factory,,1,0,8,1,18,9,1,1
8085,8085,,5,1,2,6,8,8,9,1
machine-instruction,machine-instruction,,1,0,3,1,8,4,9,1
kotlinc,kotlinc,,2,2,2,4,7,6,3,1
ssr,ssr,,103,143,204,246,124,450,1,38.834951
google-maps-urls,google-maps-urls,,1,3,2,4,18,6,1,200
hyperparameters,hyperparameters,,43,35,54,78,82,132,0,1
hoogle,hoogle,,1,1,1,2,4,3,2,1
sortedset,sortedset,,6,3,7,9,22,16,3,1
amazon-polly,amazon-polly,,8,13,12,21,23,33,6,62.5
cosmicmind,cosmicmind,,1,1,4,2,19,6,13,1
postfix-notation,postfix-notation,,17,6,26,23,36,49,9,1
rowcount,rowcount,,5,7,12,12,23,24,4,40
rich-snippets,rich-snippets,,0,2,2,2,6,4,4,100
vrtk,vrtk,,5,3,10,8,12,18,8,1
image-viewer,image-viewer,,0,1,0,1,4,1,3,1
nstableviewcell,nstableviewcell,,1,1,2,2,5,4,13,1
browserify-rails,browserify-rails,,0,0,0,0,1,0,1,1
information-schema,information-schema,,10,12,17,22,43,39,4,20
ecmascript-next,ecmascript-next,,8,11,10,19,85,29,1,37.5
react-cookie,react-cookie,,5,3,6,8,11,14,1,1
servlet-3.1,servlet-3.1,,3,2,4,5,13,9,3,1
server-push,server-push,,6,1,4,7,21,11,3,1
mapper,mapper,,17,10,22,27,51,49,3,1
ibm-integration-bus,ibm-integration-bus,,17,11,28,28,39,56,3,1
google-groups,google-groups,,4,4,7,8,16,15,5,1
stock-data,stock-data,,0,0,4,0,13,4,4,1
embedded-tomcat-8,embedded-tomcat-8,,5,6,18,11,47,29,3,20
dirpagination,dirpagination,,0,1,6,1,4,7,1,1
poller,poller,,3,1,2,4,7,6,3,1
office-app,office-app,,2,2,1,4,9,5,5,1
portal-server,portal-server,,0,0,0,0,1,0,3,1
flash-memory,flash-memory,,7,15,19,22,28,41,9,114.285714
eeprom,eeprom,,5,11,14,16,30,30,9,120
background-subtraction,background-subtraction,,3,6,8,9,23,17,0,100
angularjs-ng-template,angularjs-ng-template,,0,0,1,0,1,1,1,1
git-fork,git-fork,,12,16,29,28,47,57,6,33.333333
cakephp-3.1,cakephp-3.1,,0,0,0,0,4,0,4,1
cakephp-3.3,cakephp-3.3,,0,0,0,0,6,0,4,1
window-handles,window-handles,,1,4,8,5,19,13,3,300
dbms-output,dbms-output,,5,4,6,9,19,15,4,1
isinstance,isinstance,,6,8,15,14,23,29,0,33.333333
angulardraganddroplists,angulardraganddroplists,,2,2,5,4,3,9,1,1
assetic,assetic,,2,1,3,3,15,6,4,1
sip-server,sip-server,,4,6,12,10,17,22,13,50
fontforge,fontforge,,2,1,12,3,7,15,1,1
android-developer-api,android-developer-api,,6,15,24,21,45,45,3,150
red5,red5,,6,1,3,7,10,10,13,1
jrubyonrails,jrubyonrails,,2,0,6,2,8,8,12,1
red5pro,red5pro,,3,0,3,3,10,6,13,1
webmin-module-development,webmin-module-development,,0,0,0,0,1,0,9,1
throughput,throughput,,9,15,16,24,36,40,6,66.666667
miui,miui,,10,11,15,21,23,36,3,10
xiaomi,xiaomi,,14,13,49,27,39,76,3,1
switchyard,switchyard,,1,0,3,1,3,4,3,1
cosu,cosu,,3,1,3,4,22,7,3,1
println,println,,8,4,22,12,37,34,3,1
realloc,realloc,,35,15,71,50,115,121,9,1
calloc,calloc,,12,6,19,18,28,37,9,1
jemalloc,jemalloc,,5,3,10,8,12,18,9,1
stdinitializerlist,stdinitializerlist,,4,1,1,5,7,6,9,1
google-analytics-sdk,google-analytics-sdk,,2,7,19,9,14,28,5,250
grommet,grommet,,8,4,1,12,7,13,1,1
powershell-dsc,powershell-dsc,,4,0,4,4,12,8,8,1
libuv,libuv,,7,7,19,14,44,33,1,1
forward-list,forward-list,,1,0,1,1,6,2,9,1
ssh.net,ssh.net,,15,11,27,26,29,53,8,1
accountmanager,accountmanager,,8,6,10,14,20,24,3,1
ex-doc,ex-doc,,0,0,0,0,2,0,2,1
receiver,receiver,,12,14,25,26,48,51,3,16.666667
office-2010,office-2010,,0,1,2,1,7,3,5,1
angular-loopback,angular-loopback,,1,1,6,2,20,8,1,1
line-api,line-api,,1,3,3,4,8,7,3,200
wp-api,wp-api,,5,6,8,11,38,19,4,20
reactive-forms,reactive-forms,,31,26,48,57,66,105,1,1
spray,spray,,1,1,10,2,27,12,2,1
sbt-revolver,sbt-revolver,,0,0,0,0,1,0,2,1
mockup-tool,mockup-tool,,0,1,0,1,2,1,7,1
anchor-scroll,anchor-scroll,,4,2,12,6,8,18,1,1
isenabled,isenabled,,3,3,10,6,13,16,8,1
dafny,dafny,,5,8,11,13,38,24,2,60
ceil,ceil,,7,0,16,7,23,23,0,1
opencv3.3,opencv3.3,,1,4,8,5,41,13,0,300
primeng-calendar,primeng-calendar,,10,4,15,14,17,29,1,1
function-composition,function-composition,,8,8,17,16,41,33,2,1
asp.net-mvc-helpers,asp.net-mvc-helpers,,0,0,1,0,3,1,8,1
noindex,noindex,,4,0,7,4,12,11,4,1
widgetkit,widgetkit,,2,0,0,2,1,2,1,1
runtime-compilation,runtime-compilation,,1,2,3,3,16,6,8,100
yii2-extension,yii2-extension,,1,1,4,2,12,6,4,1
mute,mute,,0,1,9,1,15,10,1,1
captions,captions,,0,0,1,0,14,1,1,1
android-device-monitor,android-device-monitor,,2,0,5,2,25,7,3,1
codecov,codecov,,6,6,9,12,10,21,6,1
second-level-cache,second-level-cache,,4,3,7,7,19,14,3,1
sitecore-habitat,sitecore-habitat,,1,2,0,3,2,3,8,100
slick2d,slick2d,,2,3,5,5,23,10,3,50
declarative-services,declarative-services,,4,2,11,6,11,17,3,1
dispatcher,dispatcher,,20,10,34,30,66,64,8,1
angular-decorator,angular-decorator,,4,7,17,11,18,28,1,75
vgg-net,vgg-net,,45,25,66,70,27,136,0,1
staticlayout,staticlayout,,3,0,3,3,5,6,3,1
formwizard,formwizard,,2,1,8,3,4,11,0,1
findwindow,findwindow,,2,4,1,6,5,7,9,100
tamil,tamil,,2,2,3,4,10,7,0,1
tinifile,tinifile,,0,0,1,0,2,1,9,1
apache-tika,apache-tika,,29,32,58,61,106,119,3,10.344828
rajawali,rajawali,,0,1,2,1,8,3,3,1
python.net,python.net,,14,13,32,27,57,59,8,1
android-wake-lock,android-wake-lock,,6,9,17,15,24,32,3,50
rmysql,rmysql,,11,5,23,16,54,39,0,1
pythonw,pythonw,,3,2,3,5,11,8,0,1
jcr-sql2,jcr-sql2,,2,1,3,3,7,6,3,1
aframe-react,aframe-react,,0,1,3,1,4,4,1,1
notification-channel,notification-channel,,5,6,15,11,33,26,3,20
aws-vpc,aws-vpc,,22,2,51,24,66,75,6,1
privacy-policy,privacy-policy,,9,3,14,12,23,26,3,1
updatecommand,updatecommand,,0,1,1,1,3,2,8,1
visualsvn,visualsvn,,2,3,3,5,24,8,6,50
trichedit,trichedit,,1,0,0,1,2,1,9,1
lora,lora,,18,14,27,32,51,59,9,1
uv4l,uv4l,,0,2,7,2,11,9,0,100
meteor-ios,meteor-ios,,0,0,0,0,2,0,13,1
wikitude,wikitude,,4,1,11,5,26,16,3,1
sungridengine,sungridengine,,3,5,16,8,18,24,0,66.666667
mumin,mumin,,2,4,10,6,8,16,0,100
movieclip,movieclip,,2,1,4,3,19,7,13,1
metalkit,metalkit,,14,14,86,28,92,114,13,1
locationmanager,locationmanager,,14,13,24,27,61,51,3,1
integration-patterns,integration-patterns,,2,1,0,3,6,3,3,1
http-mock,http-mock,,0,2,1,2,3,3,1,100
movie,movie,,6,2,11,8,25,19,0,1
yourls,yourls,,2,2,0,4,1,4,4,1
clpr,clpr,,0,1,1,1,5,2,0,1
data-members,data-members,,0,0,1,0,6,1,9,1
valuemember,valuemember,,1,0,0,1,2,1,8,1
stop-words,stop-words,,26,20,22,46,57,68,0,1
devops-services,devops-services,,6,6,14,12,29,26,6,1
svn2git,svn2git,,7,3,1,10,20,11,6,1
sharp-repository,sharp-repository,,0,0,1,0,1,1,8,1
feature-file,feature-file,,7,5,9,12,18,21,3,1
ratchet,ratchet,,28,16,49,44,68,93,4,1
fall-through,fall-through,,2,1,2,3,8,5,9,1
dynamic-cast,dynamic-cast,,7,2,22,9,46,31,9,1
phpbb3,phpbb3,,4,4,8,8,20,16,4,1
pmml,pmml,,13,16,19,29,27,48,0,23.076923
opencart-3,opencart-3,,47,30,68,77,147,145,4,1
apache-commons-logging,apache-commons-logging,,3,4,6,7,11,13,3,33.333333
mousetrap,mousetrap,,3,1,3,4,7,7,1,1
byte-buddy,byte-buddy,,24,26,31,50,90,81,3,8.333333
eigenvector,eigenvector,,14,16,35,30,50,65,0,14.285714
orthogonal,orthogonal,,4,1,6,5,16,11,0,1
hibernate-5,hibernate-5,,1,2,1,3,6,4,3,100
commandargument,commandargument,,2,2,2,4,3,6,8,1
rust-diesel,rust-diesel,,12,11,8,23,17,31,9,1
dyld,dyld,,21,9,12,30,31,42,13,1
bootstrapvalidator-1000hz,bootstrapvalidator-1000hz,,0,0,1,0,6,1,1,1
srcset,srcset,,9,20,35,29,50,64,1,122.222222
getseq,getseq,,0,0,0,0,1,0,8,1
magic-mirror,magic-mirror,,0,0,5,0,4,5,0,1
boxlayout,boxlayout,,7,2,7,9,19,16,3,1
moloquent,moloquent,,1,2,2,3,7,5,4,100
tdm-gcc,tdm-gcc,,1,2,3,3,10,6,9,100
geoserver,geoserver,,40,40,51,80,117,131,1,1
c2hs,c2hs,,0,0,3,0,4,3,2,1
icloud-drive,icloud-drive,,6,7,9,13,29,22,13,16.666667
icloud-documents,icloud-documents,,2,3,5,5,8,10,13,50
git-status,git-status,,5,3,8,8,10,16,6,1
play-reactivemongo,play-reactivemongo,,3,1,5,4,17,9,2,1
remove-if,remove-if,,3,4,5,7,18,12,0,33.333333
jniwrapper,jniwrapper,,2,4,6,6,2,12,3,100
blacklist,blacklist,,6,11,7,17,19,24,4,83.333333
omniauth-twitter,omniauth-twitter,,0,0,1,0,6,1,12,1
nerdtree,nerdtree,,6,5,10,11,23,21,9,1
cache-expiration,cache-expiration,,1,2,3,3,5,6,3,100
nsfetchrequest,nsfetchrequest,,9,11,18,20,49,38,13,22.222222
apache-toree,apache-toree,,1,3,5,4,16,9,2,200
weebly,weebly,,7,6,12,13,19,25,1,1
nullptr,nullptr,,5,8,17,13,40,30,9,60
dropshadow,dropshadow,,6,3,16,9,23,25,1,1
qmainwindow,qmainwindow,,6,13,25,19,64,44,0,116.666667
qdialog,qdialog,,5,10,18,15,37,33,0,100
spim,spim,,3,0,8,3,17,11,9,1
custom-taxonomy,custom-taxonomy,,64,28,150,92,210,242,4,1
activeqt,activeqt,,0,0,0,0,2,0,5,1
psr-7,psr-7,,4,2,4,6,15,10,4,1
system-variable,system-variable,,2,1,6,3,12,9,3,1
addressing-mode,addressing-mode,,6,8,9,14,13,23,9,33.333333
android-ibeacon,android-ibeacon,,4,4,13,8,24,21,3,1
sql-server-performance,sql-server-performance,,1,0,2,1,2,3,4,1
cmake-gui,cmake-gui,,6,9,21,15,43,36,9,50
npm-start,npm-start,,28,22,48,50,59,98,1,1
map-files,map-files,,0,1,3,1,8,4,9,1
augmented-assignment,augmented-assignment,,1,0,4,1,3,5,0,1
convertview,convertview,,0,0,0,0,4,0,3,1
component-scan,component-scan,,7,1,4,8,10,12,3,1
ios-extensions,ios-extensions,,6,5,25,11,40,36,13,1
html-input,html-input,,11,13,24,24,50,48,1,18.181818
dds-format,dds-format,,1,1,4,2,8,6,9,1
google-smartlockpasswords,google-smartlockpasswords,,6,5,6,11,26,17,3,1
canoe,canoe,,14,18,17,32,39,49,9,28.571429
sql-optimization,sql-optimization,,6,7,13,13,30,26,4,16.666667
wikidata-api,wikidata-api,,19,7,13,26,30,39,2,1
findandmodify,findandmodify,,2,1,3,3,10,6,1,1
zend-framework-routing,zend-framework-routing,,0,0,0,0,2,0,4,1
trojan,trojan,,1,2,6,3,10,9,4,100
borrow-checker,borrow-checker,,46,27,57,73,103,130,9,1
folderbrowserdialog,folderbrowserdialog,,3,5,9,8,18,17,8,66.666667
details,details,,7,6,9,13,9,22,1,1
violin-plot,violin-plot,,14,23,17,37,33,54,0,64.285714
decltype,decltype,,15,6,35,21,64,56,9,1
react-dnd,react-dnd,,30,15,27,45,48,72,1,1
django-oscar,django-oscar,,19,33,31,52,49,83,0,73.684211
zipline,zipline,,4,4,15,8,20,23,0,1
subtraction,subtraction,,26,24,61,50,127,111,0,1
btle,btle,,0,0,5,0,4,5,3,1
elmah,elmah,,4,9,19,13,21,32,8,125
jsnlog,jsnlog,,1,0,1,1,7,2,8,1
parity,parity,,8,8,13,16,22,29,6,1
webpack-plugin,webpack-plugin,,4,8,21,12,30,33,1,100
canactivate,canactivate,,2,3,12,5,38,17,1,50
microstrategy,microstrategy,,5,4,10,9,24,19,4,1
vsinstaller,vsinstaller,,3,3,3,6,3,9,8,1
node-set,node-set,,0,0,1,0,2,1,3,1
pugxmultiuserbundle,pugxmultiuserbundle,,0,0,0,0,5,0,4,1
index-buffer,index-buffer,,1,1,1,2,5,3,9,1
circular-list,circular-list,,10,4,13,14,22,27,9,1
vtk.js,vtk.js,,1,1,4,2,6,6,1,1
gwt-test-utils,gwt-test-utils,,0,0,0,0,1,0,3,1
listadapter,listadapter,,11,13,23,24,33,47,3,18.181818
xml.etree,xml.etree,,13,4,13,17,20,30,0,1
std-bitset,std-bitset,,3,2,1,5,17,6,9,1
sequencefile,sequencefile,,2,3,8,5,17,13,2,50
java-pair-rdd,java-pair-rdd,,3,0,6,3,14,9,2,1
thread-sleep,thread-sleep,,13,5,32,18,53,50,3,1
hopac,hopac,,1,0,0,1,1,1,8,1
flickr,flickr,,5,9,22,14,39,36,1,80
static-constructor,static-constructor,,5,0,7,5,3,12,9,1
enumerate,enumerate,,28,12,40,40,97,80,0,1
single-table-inheritance,single-table-inheritance,,6,8,9,14,20,23,12,33.333333
groupwise-maximum,groupwise-maximum,,8,5,12,13,20,25,4,1
direction,direction,,15,8,27,23,57,50,1,1
sknode,sknode,,11,4,4,15,28,19,13,1
flycapture,flycapture,,0,2,0,2,6,2,8,100
gige-sdk,gige-sdk,,0,5,2,5,2,7,0,400
ctime,ctime,,4,5,8,9,13,17,9,25
greendao,greendao,,6,2,20,8,35,28,3,1
nsrange,nsrange,,4,3,8,7,18,15,13,1
seekbar,seekbar,,17,21,34,38,86,72,3,23.529412
roslyn-code-analysis,roslyn-code-analysis,,25,15,45,40,90,85,8,1
hsv,hsv,,9,3,16,12,35,28,0,1
setattribute,setattribute,,9,6,12,15,30,27,1,1
padrino,padrino,,1,0,3,1,20,4,12,1
face,face,,15,13,30,28,52,58,0,1
menustrip,menustrip,,5,0,7,5,13,12,8,1
default-arguments,default-arguments,,3,4,13,7,27,20,9,33.333333
blockly,blockly,,12,13,14,25,27,39,1,8.333333
oculus,oculus,,28,35,48,63,63,111,8,25
rssi,rssi,,11,12,17,23,22,40,3,9.090909
line-profiler,line-profiler,,2,4,7,6,8,13,0,100
visitor,visitor,,14,7,14,21,37,35,3,1
fastmember,fastmember,,0,2,1,2,6,3,8,100
int64,int64,,7,5,8,12,15,20,0,1
disability,disability,,0,0,2,0,5,2,13,1
amsmath,amsmath,,0,0,0,0,2,0,0,1
vuefire,vuefire,,6,12,10,18,39,28,13,100
skrill,skrill,,0,0,2,0,3,2,4,1
crt,crt,,2,9,15,11,22,26,9,350
loopj,loopj,,5,1,10,6,13,16,3,1
workitem,workitem,,6,3,12,9,24,21,8,1
ggiraph,ggiraph,,2,3,4,5,7,9,0,50
rakefile,rakefile,,3,3,8,6,10,14,12,1
plist,plist,,23,31,65,54,136,119,13,34.782609
connman,connman,,1,1,2,2,9,4,9,1
jquery-backstretch,jquery-backstretch,,1,3,2,4,2,6,1,200
chinese-remainder-theorem,chinese-remainder-theorem,,0,0,0,0,2,0,2,1
payola,payola,,0,0,4,0,3,4,12,1
mysql-error-1093,mysql-error-1093,,0,1,3,1,3,4,4,1
mysql-error-1242,mysql-error-1242,,1,0,1,1,3,2,4,1
bibtex,bibtex,,13,11,26,24,25,50,0,1
objectdisposedexception,objectdisposedexception,,0,0,10,0,13,10,8,1
in-subquery,in-subquery,,1,4,6,5,13,11,4,300
jxcore,jxcore,,0,0,0,0,1,0,1,1
automata-theory,automata-theory,,6,0,6,6,17,12,0,1
bpf,bpf,,16,30,19,46,46,65,9,87.5
pow,pow,,11,7,33,18,65,51,0,1
binary-operators,binary-operators,,4,5,7,9,15,16,0,25
macbookpro-touch-bar,macbookpro-touch-bar,,1,4,14,5,16,19,13,300
null-terminated,null-terminated,,1,2,8,3,20,11,9,100
ribbon-control,ribbon-control,,4,1,7,5,11,12,5,1
secure-random,secure-random,,3,0,8,3,16,11,3,1
portsip,portsip,,0,0,1,0,5,1,13,1
isomorphic-javascript,isomorphic-javascript,,5,6,9,11,24,20,1,20
cleartimeout,cleartimeout,,4,5,6,9,22,15,1,25
bluej,bluej,,27,4,29,31,104,60,3,1
shrine,shrine,,4,4,10,8,32,18,12,1
android-powermanager,android-powermanager,,3,5,3,8,6,11,3,66.666667
spyon,spyon,,3,3,10,6,13,16,1,1
charat,charat,,7,1,16,8,40,24,3,1
string-function,string-function,,2,1,6,3,12,9,4,1
android-crop,android-crop,,0,0,3,0,7,3,3,1
audio-processing,audio-processing,,13,15,37,28,41,65,0,15.384615
commerce,commerce,,5,2,11,7,10,18,4,1
commerce-kickstart,commerce-kickstart,,0,0,0,0,2,0,4,1
pgi,pgi,,9,3,9,12,28,21,0,1
sorteddictionary,sorteddictionary,,2,2,9,4,5,13,8,1
formfield,formfield,,0,0,0,0,6,0,1,1
shake,shake,,2,1,7,3,10,10,13,1
po-file,po-file,,0,0,0,0,1,0,0,1
triangulation,triangulation,,16,12,32,28,54,60,0,1
capitalize,capitalize,,5,4,11,9,14,20,0,1
mongorepository,mongorepository,,14,7,15,21,13,36,3,1
lsof,lsof,,5,3,11,8,18,19,9,1
vcenter,vcenter,,12,9,25,21,21,46,6,1
onestepcheckout,onestepcheckout,,1,0,0,1,2,1,4,1
openkinect,openkinect,,4,1,3,5,8,8,8,1
libfreenect2,libfreenect2,,4,1,5,5,10,10,8,1
cmake-server,cmake-server,,0,0,1,0,2,1,8,1
live-wallpaper,live-wallpaper,,0,11,16,11,12,27,3,1000
aws-lambda-edge,aws-lambda-edge,,17,8,24,25,25,49,6,1
data-driven-tests,data-driven-tests,,8,7,25,15,36,40,3,1
appleevents,appleevents,,1,4,9,5,5,14,13,300
libwebsockets,libwebsockets,,3,4,16,7,18,23,9,33.333333
janus-gateway,janus-gateway,,4,4,6,8,7,14,1,1
geosphere,geosphere,,7,6,20,13,25,33,0,1
ipython-parallel,ipython-parallel,,0,1,3,1,16,4,0,1
keras-2,keras-2,,10,19,35,29,112,64,0,90
linear-discriminant,linear-discriminant,,8,4,10,12,13,22,0,1
spring-webflow-2,spring-webflow-2,,3,2,7,5,15,12,3,1
sim-toolkit,sim-toolkit,,0,0,1,0,6,1,9,1
bluenrg,bluenrg,,1,0,1,1,2,2,9,1
bluesnap,bluesnap,,4,0,4,4,27,8,4,1
webgl2,webgl2,,22,22,40,44,54,84,1,1
6502,6502,,4,5,6,9,22,15,9,25
symfony2-voter,symfony2-voter,,0,0,0,0,1,0,4,1
pythran,pythran,,1,1,1,2,3,3,0,1
firemonkey-style,firemonkey-style,,0,0,1,0,2,1,9,1
mina,mina,,0,0,0,0,12,0,3,1
sdkman,sdkman,,4,10,1,14,9,15,3,150
codecvt,codecvt,,0,1,0,1,4,1,9,1
nette,nette,,5,7,3,12,17,15,4,40
nosql-aggregation,nosql-aggregation,,7,7,14,14,36,28,1,1
high-voltage,high-voltage,,0,2,0,2,3,2,12,100
itcss,itcss,,1,1,2,2,2,4,1,1
dialyzer,dialyzer,,2,4,7,6,20,13,2,100
collada,collada,,6,5,19,11,51,30,13,1
grunt-cli,grunt-cli,,0,1,0,1,4,1,1,1
lowercase,lowercase,,18,11,42,29,82,71,0,1
reversegeocodelocation,reversegeocodelocation,,0,0,2,0,1,2,3,1
multichoiceitems,multichoiceitems,,0,2,7,2,11,9,3,100
typescript-declarations,typescript-declarations,,2,3,7,5,8,12,1,50
leap-motion,leap-motion,,18,6,13,24,17,37,8,1
output-formatting,output-formatting,,1,0,4,1,8,5,0,1
unnamed-module,unnamed-module,,0,1,0,1,2,1,3,1
sphinx-apidoc,sphinx-apidoc,,1,1,5,2,10,7,0,1
netlink,netlink,,12,7,6,19,24,25,9,1
wlanapi,wlanapi,,0,0,0,0,6,0,9,1
linearlayoutmanager,linearlayoutmanager,,10,7,11,17,21,28,3,1
asp.net-4.5,asp.net-4.5,,7,3,21,10,20,31,8,1
noise-generator,noise-generator,,2,3,6,5,7,11,0,50
gatt,gatt,,20,16,30,36,66,66,3,1
splinter,splinter,,9,10,14,19,52,33,3,11.111111
qimage,qimage,,9,10,13,19,48,32,9,11.111111
compound-assignment,compound-assignment,,0,3,1,3,5,4,9,200
fluent-ribbon,fluent-ribbon,,1,1,2,2,3,4,8,1
distriqt,distriqt,,0,0,1,0,3,1,3,1
jython-2.5,jython-2.5,,3,0,3,3,5,6,0,1
ateasy,ateasy,,0,0,1,0,3,1,9,1
file-management,file-management,,7,14,20,21,32,41,13,100
osx-server,osx-server,,0,1,2,1,3,3,13,1
unicode-escapes,unicode-escapes,,12,7,25,19,22,44,0,1
mc-dc,mc-dc,,0,0,1,0,2,1,3,1
swingx,swingx,,2,3,8,5,16,13,3,50
netbeans-plugins,netbeans-plugins,,7,1,7,8,12,15,3,1
web-component-tester,web-component-tester,,1,5,14,6,12,20,1,400
sjs,sjs,,0,0,1,0,7,1,3,1
virtual-environment,virtual-environment,,16,19,28,35,41,63,0,18.75
android-shortcut,android-shortcut,,3,2,6,5,12,11,3,1
type-constraints,type-constraints,,5,5,17,10,16,27,2,1
input-field,input-field,,12,10,24,22,33,46,1,1
mbeans,mbeans,,5,2,10,7,22,17,3,1
cgbitmapcontext,cgbitmapcontext,,0,1,0,1,2,1,13,1
android-jack-and-jill,android-jack-and-jill,,0,0,0,0,5,0,3,1
contingency,contingency,,9,6,21,15,20,36,0,1
ovh,ovh,,9,11,23,20,40,43,4,22.222222
default-parameters,default-parameters,,5,10,14,15,28,29,9,100
getmethod,getmethod,,5,6,4,11,11,15,3,20
annotation-processing,annotation-processing,,22,17,39,39,57,78,3,1
java-5,java-5,,1,3,4,4,6,8,3,200
strncpy,strncpy,,3,2,9,5,19,14,9,1
garbage,garbage,,4,3,12,7,26,19,3,1
wavelet,wavelet,,12,12,20,24,24,44,0,1
windows-10-desktop,windows-10-desktop,,18,15,30,33,51,63,8,1
mv,mv,,11,11,26,22,53,48,9,1
galaxy,galaxy,,6,3,12,9,16,21,3,1
quartile,quartile,,8,1,10,9,12,19,0,1
autocad-plugin,autocad-plugin,,8,8,17,16,39,33,5,1
objectarx,objectarx,,0,0,1,0,9,1,5,1
django-fixtures,django-fixtures,,3,2,5,5,11,10,0,1
access-point,access-point,,2,4,7,6,16,13,3,100
pdf-viewer,pdf-viewer,,18,14,24,32,24,56,1,1
audit-trail,audit-trail,,12,7,17,19,26,36,4,1
audit-logging,audit-logging,,11,9,30,20,28,50,4,1
custom-activity,custom-activity,,1,0,3,1,10,4,8,1
parse-javascript-sdk,parse-javascript-sdk,,7,3,8,10,7,18,13,1
steambot,steambot,,3,1,4,4,6,8,8,1
cgpathref,cgpathref,,0,0,0,0,1,0,13,1
jnativehook,jnativehook,,3,2,8,5,11,13,3,1
atof,atof,,1,2,4,3,7,7,9,100
eventlet,eventlet,,9,7,6,16,31,22,0,1
asp.net-core-signalr,asp.net-core-signalr,,51,60,97,111,168,208,8,17.647059
proof-general,proof-general,,1,2,1,3,3,4,2,100
amazon-policy,amazon-policy,,2,3,6,5,14,11,6,50
integer-division,integer-division,,16,13,28,29,35,57,0,1
floor-division,floor-division,,2,1,3,3,8,6,0,1
newtons-method,newtons-method,,20,5,32,25,34,57,0,1
inherited,inherited,,4,1,1,5,7,6,9,1
appcompatactivity,appcompatactivity,,6,4,11,10,43,21,3,1
pycairo,pycairo,,4,9,13,13,14,26,0,125
embedded-database,embedded-database,,3,2,15,5,26,20,3,1
mat,mat,,18,17,47,35,67,82,0,1
google-plus-signin,google-plus-signin,,5,3,15,8,23,23,5,1
auto-renewable,auto-renewable,,7,5,9,12,26,21,13,1
template-toolkit,template-toolkit,,1,1,3,2,9,5,9,1
javafx-bindings,javafx-bindings,,0,0,1,0,4,1,3,1
smart-commits,smart-commits,,1,0,1,1,1,2,6,1
data-persistence,data-persistence,,1,5,10,6,13,16,13,400
neko,neko,,0,1,1,1,7,2,9,1
frama-c,frama-c,,4,5,10,9,36,19,9,25
tr24731,tr24731,,0,0,0,0,8,0,9,1
listselectionlistener,listselectionlistener,,1,0,2,1,7,3,3,1
tree-structure,tree-structure,,0,2,3,2,8,5,1,100
sample-rate,sample-rate,,3,5,9,8,10,17,13,66.666667
recordrtc,recordrtc,,8,5,10,13,33,23,1,1
multivariate-testing,multivariate-testing,,9,8,20,17,21,37,0,1
podio,podio,,21,9,22,30,68,52,4,1
usort,usort,,6,4,12,10,32,22,4,1
angular-date-format,angular-date-format,,1,4,8,5,13,13,1,300
systemctl,systemctl,,23,28,49,51,65,100,9,21.73913
adldap,adldap,,3,4,2,7,8,9,4,33.333333
unsafe-pointers,unsafe-pointers,,6,7,14,13,29,27,13,16.666667
neon-animation,neon-animation,,0,0,0,0,1,0,1,1
syntastic,syntastic,,0,4,3,4,12,7,9,300
spacevim,spacevim,,2,1,3,3,3,6,9,1
playframework-2.4,playframework-2.4,,0,6,7,6,6,13,2,500
playframework-webservice,playframework-webservice,,0,0,0,0,1,0,2,1
update-statement,update-statement,,4,2,3,6,6,9,4,1
android-image-capture,android-image-capture,,3,1,2,4,12,6,3,1
mutt,mutt,,9,6,15,15,18,30,4,1
getaddrinfo,getaddrinfo,,3,3,9,6,25,15,9,1
magnification,magnification,,0,1,2,1,4,3,1,1
esp32,esp32,,105,109,96,214,91,310,9,3.809524
rtos,rtos,,11,10,31,21,52,52,9,1
finally,finally,,3,2,6,5,17,11,3,1
drift,drift,,2,5,4,7,4,11,0,150
hostmonster,hostmonster,,0,0,1,0,2,1,4,1
sybase-ase,sybase-ase,,22,22,38,44,87,82,4,1
ponyorm,ponyorm,,11,7,15,18,19,33,0,1
alloy,alloy,,8,2,6,10,9,16,3,1
netlib-java,netlib-java,,0,0,1,0,2,1,2,1
amadeus,amadeus,,5,5,18,10,23,28,4,1
spinlock,spinlock,,6,6,18,12,18,30,9,1
android-xmlpullparser,android-xmlpullparser,,2,1,3,3,7,6,3,1
responsys,responsys,,3,0,5,3,5,8,4,1
crystal-reports-2013,crystal-reports-2013,,1,0,6,1,10,7,8,1
lock-free,lock-free,,13,8,17,21,50,38,9,1
farseer,farseer,,1,0,1,1,4,2,8,1
laravel-jobs,laravel-jobs,,2,10,12,12,18,24,4,400
dna-sequence,dna-sequence,,14,7,16,21,46,37,0,1
react-animated,react-animated,,20,20,29,40,62,69,1,1
pickerview,pickerview,,2,5,6,7,16,13,13,150
sage,sage,,32,21,32,53,51,85,0,1
xcode-storyboard,xcode-storyboard,,21,16,23,37,55,60,13,1
ratelimit,ratelimit,,1,7,4,8,13,12,4,600
variadic-macros,variadic-macros,,8,4,13,12,25,25,9,1
data-hiding,data-hiding,,0,2,0,2,5,2,9,100
ucanaccess,ucanaccess,,11,12,26,23,43,49,3,9.090909
opera,opera,,13,18,23,31,51,54,1,38.461538
role,role,,0,0,0,0,36,0,4,1
datarow,datarow,,14,11,18,25,34,43,8,1
sugar.js,sugar.js,,0,1,1,1,1,2,1,1
code-rally,code-rally,,5,1,4,6,17,10,3,1
google-webfonts,google-webfonts,,6,1,9,7,24,16,1,1
scikits,scikits,,2,4,7,6,13,13,0,100
contentobserver,contentobserver,,0,4,12,4,8,16,3,300
function-binding,function-binding,,3,3,5,6,4,11,9,1
spring-validator,spring-validator,,13,17,25,30,50,55,3,30.769231
dialplan,dialplan,,4,1,7,5,22,12,13,1
material-swift,material-swift,,0,0,3,0,3,3,13,1
url-pattern,url-pattern,,6,9,10,15,25,25,3,50
multiprocess,multiprocess,,14,6,33,20,53,53,0,1
waitpid,waitpid,,6,2,15,8,22,23,9,1
marten,marten,,1,3,2,4,7,6,8,200
superpowered,superpowered,,0,2,13,2,30,15,3,100
js-beautify,js-beautify,,8,4,6,12,12,18,9,1
atomicity,atomicity,,7,12,17,19,38,36,3,71.428571
bolt,bolt,,5,3,21,8,16,29,2,1
pervasive,pervasive,,7,5,17,12,25,29,4,1
google-api-js-client,google-api-js-client,,4,3,15,7,28,22,5,1
threetenbp,threetenbp,,3,13,14,16,9,30,3,333.333333
jasmine-node,jasmine-node,,3,2,13,5,36,18,1,1
frisby.js,frisby.js,,3,1,5,4,12,9,1,1
zurb-foundation-6,zurb-foundation-6,,12,13,38,25,73,63,1,8.333333
hibernate-native-query,hibernate-native-query,,2,6,13,8,17,21,3,200
onmousemove,onmousemove,,1,2,7,3,17,10,1,100
linked-data,linked-data,,7,10,12,17,34,29,2,42.857143
typed-racket,typed-racket,,2,0,2,2,10,4,0,1
mosaico,mosaico,,1,0,0,1,2,1,1,1
qspinbox,qspinbox,,3,2,5,5,12,10,9,1
webgl-extensions,webgl-extensions,,0,1,3,1,3,4,1,1
nls,nls,,30,9,40,39,37,79,0,1
jsdoc3,jsdoc3,,4,5,16,9,40,25,1,25
google-pixel,google-pixel,,4,3,8,7,19,15,3,1
controlsfx,controlsfx,,10,8,23,18,36,41,3,1
when-js,when-js,,1,0,1,1,1,2,1,1
gs-conditional-formatting,gs-conditional-formatting,,49,46,46,95,71,141,5,1
webpack-hot-middleware,webpack-hot-middleware,,3,5,10,8,15,18,1,66.666667
irvine16,irvine16,,2,0,0,2,1,2,9,1
dovecot,dovecot,,11,20,27,31,39,58,4,81.818182
appx,appx,,14,9,18,23,43,41,8,1
gchart,gchart,,0,1,1,1,5,2,12,1
kotlin-js-interop,kotlin-js-interop,,2,2,5,4,21,9,3,1
olap-cube,olap-cube,,23,10,34,33,70,67,4,1
pytables,pytables,,14,11,19,25,21,44,0,1
http-status-code-413,http-status-code-413,,4,3,4,7,12,11,4,1
alu,alu,,7,3,4,10,16,14,9,1
php-amqplib,php-amqplib,,7,2,7,9,10,16,4,1
vimeo-api,vimeo-api,,25,18,47,43,74,90,1,1
readystate,readystate,,1,3,2,4,9,6,1,200
uglifier,uglifier,,6,1,3,7,7,10,12,1
ogg,ogg,,6,11,12,17,22,29,13,83.333333
chrome-web-driver,chrome-web-driver,,8,5,15,13,41,28,3,1
apache-spark-encoders,apache-spark-encoders,,0,1,6,1,8,7,2,1
c#-to-vb.net,c#-to-vb.net,,3,5,2,8,9,10,8,66.666667
sightly,sightly,,3,9,23,12,37,35,3,200
htl,htl,,5,4,16,9,33,25,3,1
cartridge,cartridge,,0,1,0,1,2,1,0,1
jsdom,jsdom,,27,27,59,54,68,113,1,1
cfb-mode,cfb-mode,,0,0,0,0,2,0,6,1
computation,computation,,14,13,17,27,39,44,0,1
stream-cipher,stream-cipher,,1,0,0,1,4,1,6,1
image-capture,image-capture,,2,5,14,7,21,21,3,150
sparqlwrapper,sparqlwrapper,,4,6,8,10,21,18,2,50
partial-page-refresh,partial-page-refresh,,1,0,0,1,7,1,1,1
addhandler,addhandler,,1,0,2,1,6,3,8,1
processing-ide,processing-ide,,0,0,2,0,4,2,3,1
jupyter-console,jupyter-console,,0,3,9,3,11,12,0,200
prefetch,prefetch,,12,14,35,26,60,61,0,16.666667
gulp-babel,gulp-babel,,4,2,9,6,9,15,1,1
fody-costura,fody-costura,,8,4,18,12,15,30,8,1
mat-file,mat-file,,3,6,10,9,19,19,0,100
android-calendar,android-calendar,,19,20,38,39,78,77,3,5.263158
html-sanitizing,html-sanitizing,,9,3,6,12,20,18,4,1
urllib3,urllib3,,33,31,54,64,90,118,0,1
gateone,gateone,,0,0,0,0,1,0,9,1
revitpythonshell,revitpythonshell,,6,13,10,19,10,29,8,116.666667
touchableopacity,touchableopacity,,13,11,20,24,38,44,1,1
sql-standards,sql-standards,,0,0,0,0,7,0,4,1
link-local,link-local,,1,1,0,2,8,2,9,1
sitecore-azure,sitecore-azure,,1,0,0,1,2,1,8,1
gcc6,gcc6,,1,1,5,2,9,7,9,1
android-pageradapter,android-pageradapter,,11,5,20,16,53,36,3,1
kerberos-delegation,kerberos-delegation,,6,6,8,12,17,20,2,1
easeljs,easeljs,,10,10,17,20,49,37,1,1
ios7,ios7,,4,2,7,6,20,13,13,1
equation-solving,equation-solving,,27,15,35,42,72,77,0,1
deadbolt-2,deadbolt-2,,1,0,0,1,5,1,2,1
genymotion,genymotion,,29,20,48,49,84,97,3,1
instancestate,instancestate,,0,0,1,0,1,1,3,1
server-configuration,server-configuration,,4,5,9,9,10,18,4,25
repair,repair,,4,5,10,9,13,19,2,25
procedures,procedures,,0,0,0,0,20,0,4,1
handlebarshelper,handlebarshelper,,2,1,9,3,24,12,1,1
flask-whooshee,flask-whooshee,,0,0,0,0,2,0,0,1
applicationhost,applicationhost,,2,0,5,2,8,7,8,1
document-conversion,document-conversion,,0,2,2,2,3,4,8,100
composer.json,composer.json,,6,3,11,9,18,20,4,1
uitabcontroller,uitabcontroller,,0,1,2,1,4,3,13,1
create-directory,create-directory,,4,3,6,7,21,13,8,1
nativescript-angular,nativescript-angular,,108,122,199,230,85,429,1,12.962963
background-service,background-service,,31,26,62,57,86,119,3,1
microprocessors,microprocessors,,13,6,24,19,43,43,9,1
desktop-app-converter,desktop-app-converter,,0,2,3,2,22,5,8,100
google-search-console,google-search-console,,32,43,45,75,46,120,4,34.375
android-listfragment,android-listfragment,,3,1,7,4,27,11,3,1
before-save,before-save,,4,0,1,4,16,5,5,1
.a,.a,,3,1,3,4,8,7,9,1
samsung-galaxy-gear,samsung-galaxy-gear,,11,1,8,12,10,20,13,1
pinned-shortcut,pinned-shortcut,,0,1,1,1,5,2,3,1
thread-abort,thread-abort,,2,2,0,4,2,4,8,1
multiple-databases,multiple-databases,,13,7,18,20,36,38,4,1
django-database,django-database,,18,10,32,28,69,60,0,1
django-database-functions,django-database-functions,,2,1,0,3,4,3,0,1
django-mailer,django-mailer,,1,3,1,4,5,5,0,200
netsh,netsh,,10,4,25,14,33,39,8,1
cross-cutting-concerns,cross-cutting-concerns,,0,0,1,0,4,1,1,1
subject-observer,subject-observer,,7,3,6,10,29,16,1,1
miktex,miktex,,4,6,14,10,26,24,0,50
apic,apic,,3,5,11,8,8,19,9,66.666667
fat-free-framework,fat-free-framework,,5,4,8,9,43,17,4,1
drools-flow,drools-flow,,2,1,4,3,9,7,3,1
cocossharp,cocossharp,,3,2,5,5,11,10,8,1
sametime,sametime,,0,0,3,0,2,3,4,1
android-keypad,android-keypad,,6,7,15,13,18,28,3,16.666667
3d-secure,3d-secure,,7,22,9,29,10,38,4,214.285714
amslidemenu,amslidemenu,,0,0,0,0,3,0,13,1
hhvm,hhvm,,2,4,6,6,13,12,4,100
evdev,evdev,,8,3,15,11,22,26,9,1
uinput,uinput,,3,0,1,3,6,4,9,1
ccw,ccw,,0,0,0,0,1,0,9,1
column-chart,column-chart,,8,5,10,13,25,23,1,1
kubernetes-namespace,kubernetes-namespace,,2,0,2,2,2,4,6,1
pod-priority,pod-priority,,0,0,1,0,1,1,6,1
android-applicationinfo,android-applicationinfo,,5,1,2,6,12,8,3,1
page-factory,page-factory,,11,11,28,22,43,50,3,1
urlconnection,urlconnection,,6,7,12,13,34,25,3,16.666667
vbe,vbe,,7,2,9,9,29,18,5,1
early-binding,early-binding,,0,2,0,2,7,2,5,100
vbide,vbide,,0,0,0,0,4,0,5,1
charsequence,charsequence,,4,2,5,6,8,11,3,1
mainwindow,mainwindow,,3,2,7,5,8,12,8,1
undefined-symbol,undefined-symbol,,9,3,13,12,32,25,9,1
lua-patterns,lua-patterns,,1,4,12,5,13,17,9,300
inline-images,inline-images,,1,1,3,2,9,5,1,1
hawkular,hawkular,,1,2,2,3,5,5,6,100
admin-sdk,admin-sdk,,1,2,11,3,2,14,13,100
opencv-stitching,opencv-stitching,,1,4,4,5,13,9,0,300
seektotime,seektotime,,0,0,2,0,1,2,13,1
apache-httpasyncclient,apache-httpasyncclient,,5,2,6,7,17,13,3,1
primeng-dropdowns,primeng-dropdowns,,12,3,27,15,29,42,1,1
hl7-fhir,hl7-fhir,,26,19,20,45,40,65,14,1
eclemma,eclemma,,4,2,9,6,14,15,3,1
sslstream,sslstream,,6,6,8,12,12,20,8,1
rampart,rampart,,1,2,3,3,5,6,3,100
eclipse-virgo,eclipse-virgo,,1,0,1,1,2,2,3,1
invalid-argument,invalid-argument,,4,4,7,8,22,15,0,1
named-query,named-query,,7,11,13,18,36,31,3,57.142857
visual-studio-templates,visual-studio-templates,,8,0,7,8,18,15,8,1
bgp,bgp,,2,8,12,10,14,22,9,300
photogrammetry,photogrammetry,,2,1,9,3,15,12,0,1
issuu,issuu,,0,0,4,0,2,4,1,1
invocationtargetexception,invocationtargetexception,,5,3,9,8,17,17,3,1
sonarlint-intellij,sonarlint-intellij,,3,0,3,3,13,6,3,1
xrm,xrm,,4,3,10,7,28,17,8,1
crm-ribbon-workbench,crm-ribbon-workbench,,2,0,4,2,18,6,8,1
merlin,merlin,,0,0,0,0,2,0,0,1
psych,psych,,8,11,13,19,28,32,0,37.5
spark-packages,spark-packages,,1,0,0,1,3,1,2,1
nspersistentstore,nspersistentstore,,1,1,5,2,11,7,13,1
error-checking,error-checking,,4,3,7,7,11,14,3,1
xen,xen,,7,8,13,15,30,28,6,14.285714
du,du,,2,6,6,8,15,14,9,200
gpg-agent,gpg-agent,,5,0,7,5,11,12,6,1
react-vis,react-vis,,7,7,8,14,8,22,1,1
sframe,sframe,,3,1,2,4,6,6,0,1
pentaho-report-designer,pentaho-report-designer,,10,11,13,21,50,34,4,10
react-sketchapp,react-sketchapp,,0,0,2,0,2,2,1,1
pcm,pcm,,15,13,29,28,53,57,13,1
qmetatype,qmetatype,,0,1,1,1,5,2,9,1
java-batch,java-batch,,4,1,3,5,21,8,3,1
merge-statement,merge-statement,,1,2,2,3,5,5,4,100
azure-emulator,azure-emulator,,0,0,2,0,5,2,8,1
otree,otree,,3,6,13,9,19,22,0,100
bigrquery,bigrquery,,2,2,5,4,3,9,0,1
winmm,winmm,,0,1,7,1,8,8,9,1
django-geoposition,django-geoposition,,0,2,0,2,5,2,0,100
qore,qore,,0,0,0,0,3,0,3,1
mongo-cxx-driver,mongo-cxx-driver,,7,15,16,22,53,38,1,114.285714
googlesigninapi,googlesigninapi,,7,9,22,16,38,38,3,28.571429
codesniffer,codesniffer,,3,0,6,3,12,9,4,1
phpcodesniffer,phpcodesniffer,,4,1,4,5,16,9,4,1
storybook,storybook,,38,78,70,116,66,186,1,105.263158
jcabi,jcabi,,0,2,1,2,6,3,3,100
timeline.js,timeline.js,,3,0,3,3,6,6,1,1
stanza,stanza,,1,0,0,1,1,1,3,1
validationsummary,validationsummary,,1,1,4,2,7,6,8,1
console.writeline,console.writeline,,2,1,11,3,21,14,8,1
directory-listing,directory-listing,,5,8,9,13,9,22,4,60
rotativa,rotativa,,14,6,18,20,43,38,8,1
opensl,opensl,,4,2,7,6,10,13,3,1
google-closure-library,google-closure-library,,4,1,3,5,13,8,1,1
text-rendering,text-rendering,,6,5,10,11,13,21,8,1
pygame-surface,pygame-surface,,15,17,28,32,36,60,0,13.333333
spf,spf,,20,15,26,35,44,61,4,1
orientdb-etl,orientdb-etl,,0,0,3,0,7,3,2,1
django-login,django-login,,8,10,10,18,18,28,0,25
blackjack,blackjack,,9,6,24,15,47,39,0,1
jtree,jtree,,10,13,21,23,49,44,3,30
java.util.date,java.util.date,,6,3,16,9,30,25,3,1
adaptive-bitrate,adaptive-bitrate,,2,0,4,2,6,6,13,1
mediaelement,mediaelement,,9,8,20,17,30,37,8,1
reek,reek,,0,1,0,1,5,1,12,1
lmdb,lmdb,,8,6,18,14,36,32,0,1
heidisql,heidisql,,11,15,33,26,51,59,4,36.363636
envdte,envdte,,6,7,22,13,33,35,8,16.666667
wpa-supplicant,wpa-supplicant,,2,2,7,4,13,11,3,1
wep,wep,,0,1,2,1,5,3,9,1
ad-hoc-network,ad-hoc-network,,2,1,3,3,9,6,9,1
matrix-indexing,matrix-indexing,,8,11,13,19,33,32,0,37.5
sqlcipher-android,sqlcipher-android,,2,11,9,13,16,22,3,450
startactivityforresult,startactivityforresult,,9,11,17,20,44,37,3,22.222222
google-container-os,google-container-os,,4,3,3,7,14,10,6,1
zapier-cli,zapier-cli,,4,15,16,19,25,35,4,275
data-virtualization,data-virtualization,,2,2,5,4,6,9,3,1
denodo,denodo,,4,10,3,14,3,17,4,150
redhat-datavirt,redhat-datavirt,,1,0,7,1,14,8,3,1
django-countries,django-countries,,2,0,3,2,3,5,0,1
eventkit,eventkit,,10,6,21,16,36,37,13,1
abrecord,abrecord,,0,0,0,0,1,0,13,1
language-implementation,language-implementation,,1,0,0,1,18,1,9,1
language-specifications,language-specifications,,3,6,2,9,11,11,9,100
nservicebus5,nservicebus5,,0,0,0,0,10,0,8,1
dreamhost,dreamhost,,3,7,6,10,17,16,4,133.333333
moxiemanager,moxiemanager,,2,0,2,2,2,4,1,1
callout,callout,,0,0,0,0,7,0,13,1
bread-board,bread-board,,0,0,0,0,1,0,4,1
spring-mvc-test,spring-mvc-test,,12,8,13,20,27,33,3,1
spring-security-test,spring-security-test,,1,0,6,1,3,7,3,1
loop-unrolling,loop-unrolling,,7,2,7,9,13,16,9,1
continuum,continuum,,0,3,2,3,3,5,0,200
request-validation,request-validation,,1,2,4,3,9,7,4,100
sharepoint-apps,sharepoint-apps,,4,1,4,5,7,9,8,1
enhanced-rich-text,enhanced-rich-text,,0,0,0,0,1,0,8,1
application-loader,application-loader,,2,7,16,9,26,25,13,250
dosbox,dosbox,,14,14,16,28,46,44,9,1
imdb,imdb,,6,4,29,10,27,39,0,1
imdbpy,imdbpy,,3,0,14,3,10,17,0,1
subreports,subreports,,0,0,0,0,6,0,8,1
f#-interactive,f#-interactive,,6,3,24,9,27,33,8,1
salesforce-service-cloud,salesforce-service-cloud,,4,7,15,11,27,26,14,75
insight,insight,,3,1,1,4,3,5,8,1
node-crypto,node-crypto,,6,5,9,11,16,20,6,1
primereact,primereact,,8,8,7,16,8,23,1,1
ajax-polling,ajax-polling,,2,0,3,2,7,5,1,1
miniprofiler,miniprofiler,,2,4,5,6,10,11,8,100
processstartinfo,processstartinfo,,7,6,14,13,16,27,8,1
routeconfig,routeconfig,,3,3,1,6,13,7,8,1
kops,kops,,29,19,76,48,120,124,6,1
skview,skview,,3,1,5,4,11,9,13,1
pygal,pygal,,12,9,15,21,24,36,0,1
install4j,install4j,,15,15,28,30,77,58,3,1
neo4j-apoc,neo4j-apoc,,21,39,71,60,116,131,2,85.714286
touchablehighlight,touchablehighlight,,3,0,5,3,16,8,1,1
google-books,google-books,,8,2,17,10,31,27,5,1
submit-button,submit-button,,5,3,10,8,23,18,1,1
tasklist,tasklist,,3,0,5,3,15,8,9,1
nant,nant,,0,4,2,4,17,6,8,300
file-browser,file-browser,,3,2,6,5,7,11,3,1
spotify-scio,spotify-scio,,7,7,5,14,22,19,6,1
mpv,mpv,,0,6,5,6,10,11,13,500
over-clause,over-clause,,0,1,1,1,6,2,4,1
rt,rt,,1,3,2,4,2,6,9,200
universal-image-loader,universal-image-loader,,3,3,6,6,25,12,3,1
android-viewmodel,android-viewmodel,,88,83,148,171,165,319,3,1
winforms-to-web,winforms-to-web,,0,4,0,4,1,4,8,300
morphological-analysis,morphological-analysis,,1,1,4,2,4,6,0,1
freetts,freetts,,2,2,2,4,5,6,3,1
ms-project,ms-project,,23,22,35,45,93,80,5,1
classnotfound,classnotfound,,0,1,5,1,9,6,4,1
react-native-fbsdk,react-native-fbsdk,,14,18,46,32,79,78,1,28.571429
wix3.6,wix3.6,,1,2,8,3,10,11,8,100
handlers,handlers,,0,0,0,0,10,0,8,1
sevenzipsharp,sevenzipsharp,,1,1,3,2,9,5,8,1
grub,grub,,13,6,11,19,16,30,9,1
crosswalk-project,crosswalk-project,,0,0,0,0,4,0,3,1
android-optionsmenu,android-optionsmenu,,4,6,5,10,16,15,3,50
cryptostream,cryptostream,,0,0,2,0,7,2,8,1
epub3,epub3,,3,1,5,4,6,9,3,1
distortion,distortion,,1,4,10,5,17,15,0,300
camel-cxf,camel-cxf,,4,5,8,9,10,17,3,25
smooth-scrolling,smooth-scrolling,,17,18,43,35,92,78,1,5.882353
hipaa,hipaa,,3,3,6,6,10,12,8,1
keccak,keccak,,0,2,5,2,8,7,6,100
outer-classes,outer-classes,,0,0,0,0,4,0,3,1
blynk,blynk,,2,1,4,3,4,7,9,1
proactive,proactive,,2,6,7,8,4,15,8,200
model-based-testing,model-based-testing,,0,0,0,0,3,0,3,1
email-client,email-client,,5,4,10,9,12,19,4,1
blame,blame,,4,0,1,4,8,5,6,1
spring-data-keyvalue,spring-data-keyvalue,,0,0,0,0,2,0,3,1
floor,floor,,11,7,12,18,40,30,0,1
linearmodels,linearmodels,,2,4,9,6,19,15,0,100
descriptor,descriptor,,14,6,18,20,49,38,0,1
drupal-6,drupal-6,,1,2,5,3,12,8,4,100
apache-httpcomponents,apache-httpcomponents,,4,8,19,12,38,31,3,100
back-testing,back-testing,,5,7,9,12,18,21,0,40
template-classes,template-classes,,3,4,7,7,16,14,9,33.333333
openjpa,openjpa,,11,9,21,20,37,41,3,1
pdf-reactor,pdf-reactor,,1,1,0,2,3,2,6,1
savon,savon,,7,3,11,10,27,21,12,1
draggable,draggable,,40,50,122,90,168,212,1,25
containment,containment,,2,0,1,2,8,3,1,1
qcheckbox,qcheckbox,,7,5,7,12,18,19,0,1
drools-fusion,drools-fusion,,2,2,8,4,19,12,3,1
facebook-webhooks,facebook-webhooks,,13,16,25,29,51,54,13,23.076923
pysnmp,pysnmp,,18,21,33,39,57,72,9,16.666667
displaytag,displaytag,,4,2,2,6,8,8,3,1
windows-socket-api,windows-socket-api,,2,2,0,4,2,4,9,1
libtooling,libtooling,,7,15,4,22,9,26,9,114.285714
startapp,startapp,,2,0,3,2,10,5,3,1
google-ad-manager,google-ad-manager,,13,10,18,23,5,41,3,1
range-query,range-query,,5,0,5,5,11,10,0,1
kong,kong,,33,32,40,65,68,105,6,1
ng-bind-html,ng-bind-html,,3,0,1,3,23,4,1,1
nimbus,nimbus,,2,4,6,6,10,12,3,100
cassandra-python-driver,cassandra-python-driver,,1,1,3,2,14,5,2,1
multidplyr,multidplyr,,1,4,6,5,11,11,0,300
webpack-loader,webpack-loader,,11,7,21,18,32,39,1,1
helpshift,helpshift,,0,1,2,1,4,3,3,1
strftime,strftime,,13,14,30,27,58,57,0,7.692308
playlists,playlists,,0,0,0,0,2,0,3,1
dredd,dredd,,3,2,4,5,11,9,3,1
content-editor,content-editor,,0,1,1,1,7,2,1,1
describe,describe,,1,2,4,3,21,7,0,100
r-portfolioanalytics,r-portfolioanalytics,,3,2,4,5,11,9,0,1
simplify,simplify,,18,13,28,31,62,59,0,1
hssf,hssf,,5,1,3,6,7,9,3,1
record-linkage,record-linkage,,6,6,11,12,24,23,0,1
xbap,xbap,,2,3,6,5,7,11,8,50
monorepo,monorepo,,30,32,50,62,58,112,1,6.666667
curlftpfs,curlftpfs,,0,0,0,0,2,0,4,1
nsubstitute,nsubstitute,,16,17,27,33,63,60,8,6.25
shoes,shoes,,2,0,6,2,12,8,12,1
spring-cloud-feign,spring-cloud-feign,,51,43,51,94,88,145,3,1
greatest-common-divisor,greatest-common-divisor,,5,9,23,14,38,37,0,80
select-insert,select-insert,,0,0,1,0,2,1,4,1
kubernetes-fission,kubernetes-fission,,0,0,0,0,4,0,6,1
django-related-manager,django-related-manager,,5,5,10,10,17,20,0,1
ios-camera,ios-camera,,9,3,15,12,27,27,13,1
camera-overlay,camera-overlay,,1,0,7,1,3,8,13,1
objdump,objdump,,10,14,13,24,31,37,9,40
nm,nm,,4,5,22,9,17,31,9,25
python-internals,python-internals,,8,15,44,23,78,67,0,87.5
angularjs-ng-init,angularjs-ng-init,,1,1,3,2,7,5,1,1
interleave,interleave,,2,4,9,6,8,15,0,100
email-validation,email-validation,,12,19,47,31,64,78,4,58.333333
jssor,jssor,,3,0,15,3,23,18,1,1
printstream,printstream,,4,0,8,4,19,12,3,1
horizontal-line,horizontal-line,,2,1,4,3,16,7,1,1
highland.js,highland.js,,2,2,1,4,7,5,1,1
oracle-fusion-middleware,oracle-fusion-middleware,,32,5,16,37,24,53,4,1
rss-reader,rss-reader,,5,5,15,10,23,25,4,1
marketplace,marketplace,,9,3,9,12,19,21,4,1
input-language,input-language,,1,0,0,1,4,1,13,1
wasapi,wasapi,,3,4,14,7,19,21,8,33.333333
rolling-average,rolling-average,,4,4,17,8,24,25,0,1
rgl,rgl,,14,9,33,23,37,56,0,1
denied,denied,,2,7,19,9,32,28,3,250
jsdt,jsdt,,0,1,1,1,1,2,3,1
eclipse-jsdt,eclipse-jsdt,,0,0,0,0,4,0,3,1
property-placeholder,property-placeholder,,4,1,9,5,11,14,3,1
wpml,wpml,,23,26,34,49,35,83,4,13.043478
unauthorizedaccessexcepti,unauthorizedaccessexcepti,,4,1,8,5,10,13,8,1
qiodevice,qiodevice,,0,1,1,1,7,2,9,1
installscript,installscript,,5,2,13,7,15,20,8,1
controlpanel,controlpanel,,3,4,5,7,6,12,8,33.333333
control-panel,control-panel,,0,0,0,0,6,0,8,1
pc-lint,pc-lint,,0,3,2,3,9,5,9,200
ionic-tabs,ionic-tabs,,5,2,9,7,13,16,1,1
android-websettings,android-websettings,,4,0,5,4,9,9,3,1
standardjs,standardjs,,2,0,3,2,15,5,1,1
dlquery,dlquery,,0,0,2,0,3,2,2,1
content-encoding,content-encoding,,3,1,5,4,8,9,4,1
http-accept-encoding,http-accept-encoding,,1,1,0,2,3,2,4,1
webix,webix,,5,8,13,13,40,26,1,60
prometheus-operator,prometheus-operator,,20,13,24,33,17,57,6,1
ordinal,ordinal,,10,7,6,17,23,23,0,1
process.start,process.start,,12,7,16,19,34,35,8,1
django-rest-framework-filters,django-rest-framework-filters,,2,1,0,3,5,3,0,1
arduino-c++,arduino-c++,,47,32,18,79,5,97,9,1
boost-log,boost-log,,8,4,16,12,22,28,9,1
vcl-styles,vcl-styles,,3,3,2,6,9,8,9,1
gephi,gephi,,11,6,17,17,34,34,0,1
kdtree,kdtree,,6,9,20,15,39,35,0,50
lunrjs,lunrjs,,2,2,3,4,6,7,1,1
cordova-2.0.0,cordova-2.0.0,,0,1,3,1,7,4,1,1
pcsc,pcsc,,7,4,4,11,23,15,3,1
datadirect,datadirect,,2,0,0,2,4,2,4,1
tx-gridelements,tx-gridelements,,2,2,4,4,13,8,4,1
dspace,dspace,,7,4,17,11,34,28,3,1
entity-framework-plus,entity-framework-plus,,4,2,5,6,16,11,8,1
entity-framework-extensions,entity-framework-extensions,,2,2,1,4,8,5,8,1
intel-pin,intel-pin,,11,9,11,20,31,31,9,1
influxdb-python,influxdb-python,,7,11,14,18,41,32,6,57.142857
ascx,ascx,,9,8,10,17,23,27,8,1
failed-to-load-viewstate,failed-to-load-viewstate,,1,0,0,1,2,1,8,1
text-segmentation,text-segmentation,,3,6,8,9,12,17,0,100
handwriting-recognition,handwriting-recognition,,12,9,7,21,22,28,0,1
rowsorter,rowsorter,,0,1,2,1,2,3,3,1
pound,pound,,0,0,0,0,2,0,3,1
moviepy,moviepy,,26,21,24,47,59,71,0,1
javadb,javadb,,7,4,9,11,19,20,3,1
cachemanager,cachemanager,,3,2,4,5,10,9,3,1
inputaccessoryview,inputaccessoryview,,5,3,16,8,47,24,13,1
logback-classic,logback-classic,,6,3,16,9,25,25,3,1
server-error,server-error,,7,1,8,8,10,16,4,1
mov,mov,,3,2,8,5,18,13,9,1
facebook-instant-articles,facebook-instant-articles,,1,4,12,5,23,17,13,300
javasound,javasound,,13,17,29,30,44,59,3,30.769231
mongo-c-driver,mongo-c-driver,,1,2,9,3,9,12,1,100
securityexception,securityexception,,3,3,5,6,22,11,3,1
wasp,wasp,,0,0,0,0,1,0,1,1
data-uri,data-uri,,14,6,28,20,39,48,1,1
restfb,restfb,,7,2,13,9,25,22,13,1
aliasing,aliasing,,1,5,10,6,9,16,0,400
docxtemplater,docxtemplater,,0,2,2,2,3,4,1,100
flickable,flickable,,0,0,1,0,1,1,9,1
mousearea,mousearea,,0,1,3,1,5,4,9,1
iwork,iwork,,2,1,3,3,5,6,13,1
tbb,tbb,,5,9,9,14,54,23,9,80
rpath,rpath,,3,5,13,8,16,21,9,66.666667
aws-security-group,aws-security-group,,34,24,54,58,95,112,6,1
numerical-stability,numerical-stability,,2,2,4,4,14,8,0,1
cassandra-sharp,cassandra-sharp,,0,0,0,0,1,0,2,1
bzip2,bzip2,,2,2,10,4,25,14,0,1
preventdefault,preventdefault,,18,15,43,33,60,76,1,1
progress-reports,progress-reports,,0,0,0,0,2,0,8,1
atlassian-plugin-sdk,atlassian-plugin-sdk,,9,11,12,20,12,32,6,22.222222
webdav,webdav,,27,17,31,44,63,75,4,1
datanode,datanode,,4,11,23,15,13,38,2,175
tfs2008,tfs2008,,0,1,0,1,3,1,8,1
sqlitestudio,sqlitestudio,,5,2,3,7,14,10,3,1
backwards-compatibility,backwards-compatibility,,14,15,26,29,47,55,3,7.142857
static-assert,static-assert,,12,7,18,19,37,37,9,1
datagridviewcheckboxcell,datagridviewcheckboxcell,,1,1,3,2,9,5,8,1
system.io.file,system.io.file,,10,14,28,24,47,52,8,40
montage,montage,,1,0,0,1,6,1,12,1
variable-declaration,variable-declaration,,13,5,34,18,57,52,9,1
qlist,qlist,,7,6,14,13,24,27,9,1
spotbugs,spotbugs,,6,8,13,14,32,27,3,33.333333
rendertargetbitmap,rendertargetbitmap,,1,2,5,3,9,8,8,100
drawingvisual,drawingvisual,,1,1,1,2,2,3,8,1
jpegbitmapencoder,jpegbitmapencoder,,0,0,0,0,2,0,8,1
getdrivetype,getdrivetype,,0,0,0,0,1,0,5,1
human-interface,human-interface,,0,1,3,1,7,4,13,1
user-defined-types,user-defined-types,,23,17,37,40,93,77,4,1
truecrypt,truecrypt,,0,0,0,0,4,0,6,1
file-security,file-security,,1,2,3,3,3,6,8,100
apache2.2,apache2.2,,5,6,8,11,21,19,4,20
reference-type,reference-type,,3,2,11,5,20,16,8,1
sdl-ttf,sdl-ttf,,7,6,5,13,11,18,9,1
imblearn,imblearn,,10,15,15,25,12,40,0,50
fuzzy-comparison,fuzzy-comparison,,6,10,28,16,32,44,0,66.666667
p12,p12,,15,14,10,29,32,39,6,1
ammonite,ammonite,,2,4,6,6,6,12,2,100
tracelistener,tracelistener,,4,1,1,5,4,6,8,1
sql-tuning,sql-tuning,,12,4,28,16,41,44,4,1
spynner,spynner,,0,0,0,0,1,0,0,1
moses,moses,,1,0,0,1,4,1,0,1
giza++,giza++,,0,0,0,0,1,0,0,1
sybase-ase15,sybase-ase15,,1,4,8,5,16,13,4,300
socialshare,socialshare,,4,7,12,11,20,23,1,75
bfd,bfd,,0,1,2,1,4,3,9,1
dataadapter,dataadapter,,2,6,10,8,25,18,8,200
docusigncompositetmplts,docusigncompositetmplts,,10,12,19,22,19,41,8,20
cfsocket,cfsocket,,0,0,2,0,5,2,13,1
blueprint,blueprint,,18,8,30,26,46,56,3,1
examdiff,examdiff,,0,0,0,0,2,0,6,1
vmrun,vmrun,,0,0,1,0,3,1,6,1
janrain,janrain,,1,0,0,1,6,1,4,1
blas,blas,,16,7,36,23,65,59,9,1
spring4d,spring4d,,4,0,2,4,16,6,9,1
uisearchbardelegate,uisearchbardelegate,,2,3,6,5,13,11,13,50
uisearchresultscontroller,uisearchresultscontroller,,1,1,1,2,7,3,13,1
days,days,,11,10,23,21,38,44,0,1
rjdbc,rjdbc,,8,9,24,17,23,41,0,12.5
express-4,express-4,,1,0,4,1,13,5,1,1
strassen,strassen,,1,1,5,2,7,7,0,1
compiler-bug,compiler-bug,,7,1,19,8,23,27,9,1
kbuild,kbuild,,4,5,9,9,14,18,9,25
reporting-services-2012,reporting-services-2012,,2,0,2,2,12,4,4,1
nvm,nvm,,34,33,66,67,94,133,1,1
service-fabric-stateful,service-fabric-stateful,,9,9,26,18,63,44,8,1
service-fabric-actor,service-fabric-actor,,2,4,13,6,21,19,8,100
woocommerce-rest-api,woocommerce-rest-api,,56,54,118,110,150,228,4,1
vanity-url,vanity-url,,4,0,1,4,2,5,4,1
closest,closest,,7,12,21,19,35,40,1,71.428571
kofax,kofax,,2,1,10,3,4,13,8,1
tabnavigator,tabnavigator,,6,3,10,9,86,19,1,1
gtk#,gtk#,,8,7,20,15,37,35,8,1
seek,seek,,9,6,13,15,41,28,0,1
psobject,psobject,,4,4,7,8,26,15,8,1
aif,aif,,0,0,0,0,5,0,8,1
viper-architecture,viper-architecture,,2,4,3,6,12,9,13,100
proxy-authentication,proxy-authentication,,3,4,5,7,5,12,6,33.333333
tacit-programming,tacit-programming,,0,1,4,1,5,5,2,1
visual-glitch,visual-glitch,,7,6,7,13,19,20,1,1
riak,riak,,5,4,8,9,20,17,2,1
riak-cs,riak-cs,,1,0,0,1,4,1,2,1
riak-ts,riak-ts,,0,0,0,0,3,0,2,1
rcpp11,rcpp11,,1,4,1,5,12,6,0,300
unselect,unselect,,0,0,0,0,8,0,1,1
netstat,netstat,,12,11,29,23,41,52,9,1
static-memory-allocation,static-memory-allocation,,3,1,5,4,9,9,9,1
infopath,infopath,,5,5,28,10,32,38,8,1
struts2-convention-plugin,struts2-convention-plugin,,1,0,0,1,3,1,3,1
errorlevel,errorlevel,,6,5,5,11,15,16,9,1
amortization,amortization,,3,0,2,3,4,5,0,1
django-jsonfield,django-jsonfield,,7,9,16,16,15,32,0,28.571429
uipasteboard,uipasteboard,,4,4,9,8,19,17,13,1
xml-deserialization,xml-deserialization,,24,14,27,38,62,65,8,1
http-tunneling,http-tunneling,,3,1,7,4,11,11,6,1
asp.net-core-routing,asp.net-core-routing,,8,10,21,18,65,39,8,25
split-stacks,split-stacks,,0,1,0,1,3,1,9,1
mfmailcomposeviewcontroller,mfmailcomposeviewcontroller,,4,4,13,8,35,21,13,1
kvc,kvc,,3,1,5,4,10,9,13,1
browsermob,browsermob,,2,3,12,5,13,17,3,50
prototypejs,prototypejs,,4,4,8,8,37,16,1,1
dismiss,dismiss,,12,6,22,18,36,40,13,1
cycle2,cycle2,,0,1,7,1,4,8,1,1
structr,structr,,0,0,0,0,2,0,2,1
ticket-system,ticket-system,,3,5,5,8,10,13,4,66.666667
autocompleteextender,autocompleteextender,,2,0,4,2,2,6,8,1
uri-fragment,uri-fragment,,1,0,0,1,1,1,1,1
dynamo-local,dynamo-local,,5,6,11,11,20,22,6,20
guzzlehttp,guzzlehttp,,24,10,31,34,59,65,4,1
bitarray,bitarray,,3,2,8,5,10,13,0,1
corpus,corpus,,21,15,36,36,89,72,0,1
ganglia,ganglia,,0,0,1,0,10,1,6,1
mpeg2-ts,mpeg2-ts,,5,7,10,12,23,22,13,40
gopro,gopro,,2,2,3,4,14,7,13,1
digest-authentication,digest-authentication,,5,4,20,9,20,29,4,1
tab-delimited-text,tab-delimited-text,,1,1,5,2,14,7,0,1
virtual-hosts,virtual-hosts,,0,0,0,0,28,0,4,1
ng-hide,ng-hide,,1,2,5,3,12,8,1,100
omxplayer,omxplayer,,5,5,17,10,12,27,0,1
exception-safety,exception-safety,,0,1,2,1,5,3,9,1
phpspec,phpspec,,3,0,1,3,9,4,4,1
quotations,quotations,,1,2,6,3,11,9,0,100
archiva,archiva,,2,1,9,3,10,12,3,1
nuke,nuke,,10,7,10,17,18,27,0,1
mapbox-gl-draw,mapbox-gl-draw,,7,4,4,11,14,15,1,1
ng2-nvd3,ng2-nvd3,,1,0,5,1,10,6,1,1
vtl,vtl,,6,12,19,18,13,37,6,100
windows-locationapi,windows-locationapi,,0,0,0,0,2,0,3,1
mleap,mleap,,2,4,10,6,7,16,2,100
heroku-ci,heroku-ci,,4,9,6,13,14,19,1,125
esplorer,esplorer,,0,0,1,0,4,1,9,1
desire2learn,desire2learn,,0,1,1,1,5,2,4,1
valence,valence,,0,1,0,1,4,1,4,1
android-night-mode,android-night-mode,,9,8,4,17,5,21,3,1
gelf,gelf,,7,9,8,16,13,24,6,28.571429
ninja,ninja,,19,24,40,43,59,83,9,26.315789
wixcode,wixcode,,48,19,47,67,72,114,1,1
kapacitor,kapacitor,,14,6,15,20,30,35,6,1
gac,gac,,11,8,15,19,33,34,8,1
sti,sti,,3,3,5,6,18,11,12,1
ndef,ndef,,12,6,24,18,31,42,3,1
proxmox,proxmox,,11,5,14,16,19,30,6,1
sarama,sarama,,3,5,5,8,19,13,2,66.666667
resin,resin,,2,0,4,2,5,6,3,1
soil,soil,,4,2,3,6,11,9,9,1
babel-plugin,babel-plugin,,3,3,7,6,12,13,1,1
babel-babylon,babel-babylon,,1,0,1,1,5,2,1,1
dynamic-html,dynamic-html,,6,0,13,6,10,19,1,1
coproduct,coproduct,,0,1,1,1,2,2,2,1
myo,myo,,0,0,4,0,3,4,13,1
openbsd,openbsd,,3,6,15,9,17,24,9,100
google-direction,google-direction,,7,6,18,13,29,31,1,1
qvtkwidget,qvtkwidget,,3,2,10,5,15,15,9,1
manjaro,manjaro,,18,15,31,33,37,64,9,1
sql-subselect,sql-subselect,,1,1,4,2,12,6,4,1
contentoffset,contentoffset,,3,4,8,7,7,15,13,33.333333
pysqlite,pysqlite,,1,0,3,1,8,4,0,1
word-addins,word-addins,,22,35,38,57,51,95,5,59.090909
ora-12545,ora-12545,,0,0,0,0,1,0,6,1
hudson-plugins,hudson-plugins,,2,1,1,3,6,4,6,1
bunny,bunny,,0,1,9,1,9,10,12,1
windows-1252,windows-1252,,2,5,10,7,9,17,0,150
tidy,tidy,,7,6,22,13,16,35,0,1
formattable,formattable,,9,10,19,19,26,38,0,11.111111
bpel,bpel,,10,5,13,15,26,28,3,1
nano-server,nano-server,,5,6,4,11,15,15,6,20
swirl,swirl,,0,2,5,2,9,7,0,100
inline-svg,inline-svg,,2,2,7,4,10,11,1,1
android-popupwindow,android-popupwindow,,6,5,21,11,38,32,3,1
scite,scite,,0,0,4,0,3,4,9,1
mirror,mirror,,13,13,19,26,37,45,6,1
wp-nav-walker,wp-nav-walker,,7,7,11,14,20,25,4,1
jax-ws-customization,jax-ws-customization,,3,2,4,5,5,9,3,1
mvcsitemapprovider,mvcsitemapprovider,,4,1,2,5,4,7,8,1
winmerge,winmerge,,1,2,2,3,3,5,6,100
android-screen-support,android-screen-support,,3,6,17,9,22,26,3,100
munit,munit,,0,3,14,3,13,17,14,200
vision-api,vision-api,,11,6,10,17,32,27,3,1
local-network,local-network,,10,6,5,16,14,21,4,1
lcg,lcg,,0,4,2,4,3,6,0,300
primitive,primitive,,7,8,22,15,62,37,3,14.285714
codepoint,codepoint,,5,2,3,7,6,10,0,1
methodnotfound,methodnotfound,,3,2,1,5,7,6,4,1
ansi-c,ansi-c,,8,5,11,13,22,24,9,1
fusioncharts,fusioncharts,,14,18,45,32,40,77,1,28.571429
usb-debugging,usb-debugging,,3,7,11,10,17,21,3,133.333333
f2py,f2py,,7,10,23,17,46,40,9,42.857143
mod-dav-svn,mod-dav-svn,,0,0,2,0,2,2,6,1
printwriter,printwriter,,14,7,30,21,67,51,3,1
vraptor,vraptor,,0,0,1,0,1,1,3,1
pyside2,pyside2,,98,143,162,241,148,403,0,45.918367
django-file-upload,django-file-upload,,12,6,16,18,27,34,0,1
blend,blend,,12,6,19,18,29,37,8,1
adaboost,adaboost,,10,6,15,16,22,31,0,1
javafx-tableview,javafx-tableview,,4,0,6,4,12,10,3,1
circular-slider,circular-slider,,1,0,0,1,2,1,13,1
hgcircularslider,hgcircularslider,,0,0,0,0,1,0,13,1
xojo,xojo,,3,1,2,4,7,6,13,1
haskeline,haskeline,,1,0,0,1,1,1,2,1
mysql-connector-python,mysql-connector-python,,24,25,30,49,42,79,0,4.166667
php-pgsql,php-pgsql,,2,8,2,10,10,12,4,300
podfile,podfile,,0,10,25,10,42,35,13,900
codedom,codedom,,4,7,15,11,30,26,8,75
percentile,percentile,,26,17,40,43,72,83,0,1
onitemselectedlistener,onitemselectedlistener,,4,2,5,6,14,11,3,1
amp-analytics,amp-analytics,,3,5,7,8,13,15,1,66.666667
external-links,external-links,,4,2,4,6,5,10,4,1
google-cloud-error-reporting,google-cloud-error-reporting,,3,1,3,4,11,7,6,1
nexus-4,nexus-4,,0,0,1,0,2,1,3,1
nexus-s,nexus-s,,0,0,0,0,1,0,3,1
object-oriented-database,object-oriented-database,,2,1,2,3,15,5,9,1
openapi-generator,openapi-generator,,30,33,31,63,9,94,3,10
goutte,goutte,,7,10,9,17,31,26,4,42.857143
rattle,rattle,,1,5,6,6,9,12,0,400
google-schemas,google-schemas,,6,4,7,10,16,17,4,1
cross-entropy,cross-entropy,,14,14,25,28,60,53,0,1
sigmoid,sigmoid,,18,9,17,27,35,44,0,1
easing,easing,,3,4,9,7,15,16,1,33.333333
build-script,build-script,,4,1,8,5,15,13,13,1
onstart,onstart,,2,3,3,5,7,8,3,50
jmail,jmail,,0,0,0,0,2,0,5,1
ruby-2.2,ruby-2.2,,1,3,1,4,7,5,12,200
bz2,bz2,,6,7,13,13,21,26,0,16.666667
ivr,ivr,,3,6,17,9,27,26,13,100
onitemlongclicklistener,onitemlongclicklistener,,0,0,2,0,7,2,3,1
ref,ref,,49,38,85,87,111,172,1,1
reed-solomon,reed-solomon,,1,6,9,7,13,16,9,500
rating,rating,,18,15,33,33,53,66,4,1
blending,blending,,6,9,15,15,37,30,9,50
modelr,modelr,,1,1,4,2,8,6,0,1
sqlcipher,sqlcipher,,9,19,23,28,27,51,3,111.111111
luminus,luminus,,0,0,0,0,10,0,2,1
jcalendar,jcalendar,,1,0,6,1,9,7,3,1
imx7,imx7,,1,1,1,2,2,3,9,1
html-to-pdf,html-to-pdf,,27,19,41,46,62,87,8,1
avatar,avatar,,6,3,19,9,30,28,4,1
sumologic,sumologic,,4,3,6,7,10,13,6,1
beyondcompare4,beyondcompare4,,2,1,4,3,14,7,6,1
dynamic-proxy,dynamic-proxy,,11,2,6,13,19,19,3,1
cpanel-xmlapi,cpanel-xmlapi,,4,1,6,5,2,11,4,1
listpreference,listpreference,,2,5,6,7,8,13,3,150
cuba-platform,cuba-platform,,1,0,2,1,16,3,3,1
phasset,phasset,,20,18,37,38,55,75,13,1
worklight-studio,worklight-studio,,0,1,0,1,5,1,13,1
froogaloop,froogaloop,,0,1,3,1,4,4,1,1
global-scope,global-scope,,2,1,5,3,10,8,4,1
usleep,usleep,,2,2,4,4,8,8,9,1
target-action,target-action,,1,1,2,2,7,4,13,1
jsonapi-resources,jsonapi-resources,,2,5,8,7,16,15,12,150
jsonapi-serialize,jsonapi-serialize,,0,0,1,0,5,1,12,1
koala,koala,,1,2,2,3,12,5,12,100
faraday,faraday,,6,8,13,14,28,27,12,33.333333
industrial,industrial,,3,1,3,4,4,7,0,1
android-togglebutton,android-togglebutton,,8,4,10,12,15,22,3,1
sys-refcursor,sys-refcursor,,4,3,4,7,10,11,4,1
angularjs-track-by,angularjs-track-by,,0,0,2,0,8,2,1,1
mysql-real-escape-string,mysql-real-escape-string,,3,1,2,4,11,6,4,1
cordic,cordic,,2,0,0,2,4,2,0,1
cpack,cpack,,13,3,16,16,38,32,9,1
vxml,vxml,,6,2,4,8,6,12,13,1
android-guava,android-guava,,2,2,7,4,3,11,3,1
copybook,copybook,,1,0,2,1,4,3,4,1
jrecord,jrecord,,0,1,0,1,6,1,4,1
pyhive,pyhive,,6,4,20,10,19,30,2,1
template-engine,template-engine,,9,13,14,22,41,36,1,44.444444
feedparser,feedparser,,8,9,11,17,28,28,0,12.5
guest-executable,guest-executable,,0,0,3,0,7,3,8,1
listview-adapter,listview-adapter,,5,2,4,7,11,11,3,1
android-percent-library,android-percent-library,,0,0,0,0,1,0,3,1
jdatechooser,jdatechooser,,1,5,8,6,15,14,3,400
glassfish-5,glassfish-5,,6,2,17,8,25,25,3,1
android-mediaprojection,android-mediaprojection,,8,5,11,13,23,24,3,1
mediaprojectionmanager,mediaprojectionmanager,,2,0,1,2,5,3,3,1
pajek,pajek,,1,1,3,2,1,5,0,1
java.util.logging,java.util.logging,,10,13,21,23,52,44,3,30
simple-framework,simple-framework,,7,1,14,8,26,22,3,1
defineproperty,defineproperty,,4,3,5,7,19,12,1,1
stxxl,stxxl,,0,1,1,1,2,2,9,1
android-search,android-search,,15,5,12,20,34,32,3,1
angular-amd,angular-amd,,0,0,0,0,2,0,1,1
mpremotecommandcenter,mpremotecommandcenter,,3,1,14,4,15,18,13,1
auto-indent,auto-indent,,9,5,11,14,35,25,9,1
dac,dac,,8,3,13,11,27,24,4,1
hadoop-plugins,hadoop-plugins,,1,1,1,2,3,3,2,1
hortonworks-sandbox,hortonworks-sandbox,,12,6,28,18,49,46,2,1
execute-immediate,execute-immediate,,3,4,6,7,16,13,4,33.333333
navision,navision,,11,12,24,23,37,47,8,9.090909
importrange,importrange,,17,41,39,58,17,97,5,141.176471
jxtable,jxtable,,0,0,3,0,3,3,3,1
futuretask,futuretask,,5,3,8,8,20,16,3,1
tightly-coupled-code,tightly-coupled-code,,0,0,0,0,5,0,3,1
libvlc,libvlc,,40,31,58,71,73,129,13,1
surfaceholder,surfaceholder,,2,0,3,2,13,5,3,1
tcpreplay,tcpreplay,,3,2,5,5,4,10,9,1
argument-matcher,argument-matcher,,3,0,2,3,2,5,3,1
saripaar,saripaar,,0,1,1,1,2,2,3,1
adobe-brackets,adobe-brackets,,10,4,11,14,42,25,1,1
onfocus,onfocus,,10,7,9,17,26,26,1,1
rowversion,rowversion,,1,2,5,3,12,8,8,100
graylog,graylog,,15,18,26,33,28,59,6,20
rpa,rpa,,42,50,89,92,124,181,5,19.047619
workfusion,workfusion,,2,0,7,2,14,9,5,1
return-type-deduction,return-type-deduction,,1,0,1,1,6,2,9,1
easyphp,easyphp,,5,1,10,6,25,16,4,1
django-widget-tweaks,django-widget-tweaks,,4,0,6,4,13,10,0,1
ellucian-banner,ellucian-banner,,0,0,0,0,3,0,3,1
giphy,giphy,,5,3,8,8,12,16,1,1
mocha-webpack,mocha-webpack,,4,5,10,9,10,19,1,25
phpredis,phpredis,,5,5,6,10,21,16,4,1
stdmutex,stdmutex,,0,1,6,1,8,7,9,1
dynamicmvc,dynamicmvc,,1,0,0,1,1,1,8,1
quest,quest,,1,5,0,6,5,6,8,400
symmetricds,symmetricds,,4,5,10,9,30,19,4,25
pass-by-rvalue-reference,pass-by-rvalue-reference,,3,1,1,4,2,5,9,1
datawindow,datawindow,,4,0,5,4,12,9,8,1
asynccallback,asynccallback,,7,5,12,12,35,24,1,1
reportgenerator,reportgenerator,,1,2,3,3,8,6,8,100
powershell-v6.0,powershell-v6.0,,12,2,20,14,17,34,8,1
detach,detach,,2,4,10,6,22,16,4,100
jlayer,jlayer,,0,0,1,0,10,1,3,1
audioinputstream,audioinputstream,,1,6,0,7,14,7,3,500
tritonus,tritonus,,0,0,0,0,1,0,3,1
cobol,cobol,,15,21,55,36,96,91,4,40
inspect,inspect,,19,17,40,36,50,76,0,1
imagedownload,imagedownload,,7,7,9,14,15,23,3,1
url.action,url.action,,2,2,2,4,11,6,8,1
sitefinity-4,sitefinity-4,,0,0,0,0,1,0,8,1
hprof,hprof,,0,3,6,3,12,9,3,200
usb-drive,usb-drive,,7,14,20,21,34,41,3,100
microkernel,microkernel,,0,0,1,0,6,1,9,1
sel4,sel4,,0,0,1,0,1,1,9,1
smpp,smpp,,12,7,16,19,21,35,3,1
django-custom-tags,django-custom-tags,,0,2,1,2,2,3,0,100
ember-testing,ember-testing,,1,0,5,1,10,6,1,1
android-lint,android-lint,,4,9,20,13,30,33,3,125
cyk,cyk,,3,0,3,3,7,6,0,1
jmeter-maven-plugin,jmeter-maven-plugin,,2,6,17,8,30,25,3,200
strikethrough,strikethrough,,5,2,7,7,18,14,13,1
rights,rights,,1,1,6,2,14,8,4,1
plaid,plaid,,12,7,4,19,22,23,4,1
pox,pox,,4,3,18,7,28,25,9,1
hping,hping,,0,0,2,0,3,2,4,1
explicit-conversion,explicit-conversion,,0,1,4,1,13,5,9,1
spannable,spannable,,3,5,15,8,26,23,3,66.666667
cometd,cometd,,3,2,6,5,15,11,3,1
outlook.com,outlook.com,,1,3,4,4,5,8,4,200
output-parameter,output-parameter,,1,2,4,3,8,7,4,100
dbtype,dbtype,,0,0,0,0,2,0,8,1
gatling-plugin,gatling-plugin,,10,4,3,14,11,17,2,1
xctestcase,xctestcase,,7,4,29,11,39,40,13,1
byte-order-mark,byte-order-mark,,10,9,19,19,40,38,0,1
msbi,msbi,,10,6,11,16,37,27,4,1
derived-table,derived-table,,1,3,4,4,16,8,4,200
stdadvance,stdadvance,,0,0,0,0,1,0,9,1
lempel-ziv-76,lempel-ziv-76,,0,0,0,0,3,0,0,1
obout,obout,,0,1,1,1,1,2,8,1
scotty,scotty,,1,1,1,2,16,3,2,1
hippocms,hippocms,,0,1,6,1,10,7,3,1
meld,meld,,3,3,9,6,16,15,6,1
3-way-merge,3-way-merge,,0,1,1,1,2,2,6,1
mdi,mdi,,17,7,19,24,32,43,8,1
mdichild,mdichild,,5,7,2,12,12,14,8,40
mdiparent,mdiparent,,5,5,7,10,11,17,8,1
canopy,canopy,,2,2,11,4,31,15,0,1
tab-completion,tab-completion,,6,4,9,10,25,19,9,1
zsh-completion,zsh-completion,,4,4,7,8,16,15,9,1
flot,flot,,5,8,17,13,43,30,1,60
jboss-esb,jboss-esb,,0,0,0,0,3,0,3,1
maven-antrun-plugin,maven-antrun-plugin,,4,3,9,7,14,16,3,1
windows-hosting,windows-hosting,,3,0,2,3,7,5,4,1
joinfaces,joinfaces,,2,0,11,2,8,13,3,1
avaudiorecorder,avaudiorecorder,,15,8,21,23,24,44,13,1
pinchzoom,pinchzoom,,32,7,32,39,38,71,3,1
elasticsearch-query,elasticsearch-query,,8,9,17,17,35,34,6,12.5
gitbook,gitbook,,3,0,10,3,16,13,0,1
svg.js,svg.js,,19,11,35,30,65,65,1,1
boost-date-time,boost-date-time,,1,1,3,2,7,5,9,1
angularjs-ng-model,angularjs-ng-model,,8,4,17,12,55,29,1,1
ole-automation,ole-automation,,2,1,3,3,7,6,4,1
ios10.3.2,ios10.3.2,,0,1,0,1,5,1,13,1
libsass,libsass,,1,0,6,1,14,7,1,1
rgui,rgui,,3,2,0,5,6,5,0,1
goaop,goaop,,0,0,1,0,3,1,4,1
sdp,sdp,,15,10,17,25,38,42,13,1
qfiledialog,qfiledialog,,7,3,18,10,29,28,0,1
firefox-android,firefox-android,,3,1,3,4,8,7,1,1
fontawesome-4.4.0,fontawesome-4.4.0,,0,0,2,0,7,2,1,1
static-ip-address,static-ip-address,,10,7,11,17,24,28,9,1
lab,lab,,6,2,15,8,8,23,1,1
deterministic,deterministic,,8,7,13,15,32,28,0,1
non-deterministic,non-deterministic,,4,5,13,9,25,22,0,25
inversion,inversion,,1,4,9,5,19,14,0,300
aws-organizations,aws-organizations,,8,5,8,13,9,21,6,1
windows-api-code-pack,windows-api-code-pack,,5,4,2,9,8,11,8,1
luarocks,luarocks,,4,7,11,11,29,22,9,75
freetype2,freetype2,,4,7,8,11,21,19,9,75
mscorlib,mscorlib,,3,5,8,8,17,16,8,66.666667
illegal-characters,illegal-characters,,2,2,4,4,12,8,5,1
objective-c-2.0,objective-c-2.0,,1,2,0,3,7,3,13,100
citrus-pay,citrus-pay,,0,0,0,0,3,0,4,1
alv,alv,,8,6,12,14,25,26,5,1
foxpro,foxpro,,6,1,24,7,46,31,4,1
maatwebsite-excel,maatwebsite-excel,,33,43,56,76,68,132,4,30.30303
lts,lts,,1,0,7,1,6,8,2,1
broken-links,broken-links,,1,1,7,2,12,9,4,1
lnk2005,lnk2005,,0,1,2,1,10,3,9,1
visual-c++-runtime,visual-c++-runtime,,2,0,2,2,4,4,8,1
symfony-routing,symfony-routing,,9,6,17,15,20,32,4,1
android-sms,android-sms,,13,7,11,20,15,31,3,1
outlook-redemption,outlook-redemption,,11,19,21,30,30,51,8,72.727273
notificationmanager,notificationmanager,,6,4,14,10,22,24,3,1
for-xml,for-xml,,0,0,4,0,11,4,4,1
smooch,smooch,,8,1,8,9,20,17,3,1
actionbarsherlock,actionbarsherlock,,1,0,5,1,2,6,3,1
sound-recognition,sound-recognition,,2,0,1,2,4,3,0,1
magicalrecord,magicalrecord,,9,1,6,10,10,16,13,1
quote,quote,,9,7,15,16,44,31,0,1
open-zeppelin,open-zeppelin,,2,4,10,6,6,16,6,100
pythonmagick,pythonmagick,,1,0,2,1,5,3,12,1
flexboxgrid,flexboxgrid,,3,0,8,3,12,11,1,1
guvnor,guvnor,,0,0,1,0,3,1,3,1
inode,inode,,6,4,10,10,21,20,9,1
fuser,fuser,,1,0,2,1,3,3,9,1
gql,gql,,6,5,8,11,14,19,6,1
url-validation,url-validation,,2,1,6,3,6,9,4,1
hierarchicaldatatemplate,hierarchicaldatatemplate,,6,1,8,7,14,15,8,1
parents,parents,,0,0,0,0,4,0,1,1
redactor.js,redactor.js,,1,1,0,2,7,2,4,1
reactcsstransitiongroup,reactcsstransitiongroup,,8,6,18,14,30,32,1,1
kodo,kodo,,0,1,0,1,1,1,3,1
teamcity-10,teamcity-10,,0,0,0,0,5,0,8,1
enterprise-architect,enterprise-architect,,8,10,33,18,88,51,3,25
xmldom,xmldom,,8,4,8,12,20,20,3,1
vs-extensibility,vs-extensibility,,7,9,10,16,33,26,8,28.571429
existential-type,existential-type,,8,5,11,13,30,24,2,1
strictness,strictness,,1,0,3,1,3,4,2,1
sentence-similarity,sentence-similarity,,6,10,16,16,28,32,0,66.666667
longest-path,longest-path,,3,2,7,5,10,12,0,1
touchdevelop,touchdevelop,,0,0,0,0,1,0,1,1
sqlfilestream,sqlfilestream,,5,4,5,9,10,14,4,1
javax.persistence,javax.persistence,,8,4,3,12,11,15,3,1
filehandler,filehandler,,2,2,3,4,11,7,3,1
rapidxml,rapidxml,,2,0,7,2,10,9,9,1
app-engine-ndb,app-engine-ndb,,9,6,23,15,72,38,6,1
qabstracttablemodel,qabstracttablemodel,,4,6,10,10,16,20,9,50
generate-series,generate-series,,6,5,15,11,22,26,4,1
grails-3.1,grails-3.1,,0,0,6,0,8,6,3,1
multi-upload,multi-upload,,1,2,0,3,3,3,4,100
ggforce,ggforce,,6,3,6,9,21,15,0,1
iaca,iaca,,1,0,0,1,2,1,9,1
sap-erp,sap-erp,,0,0,1,0,4,1,5,1
excel-reader,excel-reader,,1,4,5,5,10,10,8,300
gml,gml,,8,4,18,12,19,30,2,1
inline-functions,inline-functions,,3,5,5,8,10,13,9,66.666667
spring-config,spring-config,,25,16,68,41,94,109,3,1
bzip,bzip,,0,1,1,1,4,2,0,1
auto-close,auto-close,,4,2,1,6,3,7,9,1
apache-twill,apache-twill,,1,0,2,1,1,3,2,1
android-install-apk,android-install-apk,,11,21,43,32,59,75,3,90.909091
openwrt,openwrt,,20,21,39,41,90,80,9,5
git-reset,git-reset,,12,17,22,29,46,51,6,41.666667
opencart-module,opencart-module,,5,10,13,15,34,28,4,100
filebeat,filebeat,,79,59,109,138,168,247,6,1
unity3d-2dtools,unity3d-2dtools,,2,5,8,7,68,15,8,150
djinni,djinni,,1,2,2,3,13,5,13,100
siebel,siebel,,1,3,13,4,15,17,3,200
scala-dispatch,scala-dispatch,,0,1,0,1,1,1,2,1
uservoice,uservoice,,0,0,0,0,2,0,1,1
confluent-schema-registry,confluent-schema-registry,,47,60,75,107,100,182,2,27.659574
taskmanager,taskmanager,,8,7,22,15,41,37,8,1
selectlist,selectlist,,3,10,8,13,24,21,8,233.333333
skshapenode,skshapenode,,2,5,11,7,27,18,13,150
git-worktree,git-worktree,,8,2,15,10,13,25,6,1
greenrobot-eventbus,greenrobot-eventbus,,9,4,8,13,30,21,3,1
dispatch-queue,dispatch-queue,,9,17,32,26,44,58,13,88.888889
jdom,jdom,,3,7,13,10,15,23,3,133.333333
listitem,listitem,,14,6,30,20,62,50,1,1
nunittestadapter,nunittestadapter,,1,2,1,3,13,4,8,100
ihtmldocument,ihtmldocument,,0,0,2,0,3,2,8,1
jpype,jpype,,7,5,8,12,13,20,0,1
boilerpipe,boilerpipe,,2,0,0,2,4,2,0,1
bjoern,bjoern,,0,0,1,0,2,1,6,1
postgresql-performance,postgresql-performance,,16,5,18,21,39,39,4,1
gplots,gplots,,6,2,9,8,19,17,0,1
raygun,raygun,,1,0,1,1,8,2,1,1
pep,pep,,16,7,13,23,26,36,0,1
flatzinc,flatzinc,,0,0,4,0,3,4,0,1
mhtml,mhtml,,0,1,10,1,6,11,1,1
binary.js,binary.js,,0,0,0,0,1,0,1,1
languagetool,languagetool,,0,1,6,1,5,7,3,1
matrix-synapse,matrix-synapse,,1,1,0,2,3,2,0,1
cakephp-3.2,cakephp-3.2,,1,0,1,1,5,2,4,1
nsprogress,nsprogress,,0,0,1,0,3,1,13,1
doxygen-wizard,doxygen-wizard,,2,0,3,2,4,5,9,1
restriction,restriction,,12,19,39,31,34,70,4,58.333333
radeditor,radeditor,,3,0,5,3,10,8,8,1
microsoft-dynamics-webapi,microsoft-dynamics-webapi,,0,0,0,0,17,0,8,1
rosie-pattern-language,rosie-pattern-language,,0,0,0,0,1,0,0,1
language-packs,language-packs,,1,1,1,2,2,3,8,1
htc-vive,htc-vive,,9,9,25,18,35,43,8,1
sencha-architect,sencha-architect,,3,9,8,12,25,20,1,200
proc-sql,proc-sql,,18,15,31,33,78,64,0,1
glimpse,glimpse,,2,0,5,2,5,7,8,1
sodium,sodium,,3,1,3,4,5,7,6,1
qprinter,qprinter,,5,6,7,11,13,18,9,20
dependency-resolver,dependency-resolver,,2,4,5,6,12,11,8,100
cdi-unit,cdi-unit,,0,1,2,1,4,3,3,1
ezaudio,ezaudio,,1,0,1,1,5,2,13,1
multiple-assignment,multiple-assignment,,1,2,4,3,3,7,0,100
flann,flann,,7,5,9,12,21,21,0,1
rmiregistry,rmiregistry,,0,1,0,1,4,1,3,1
mrpt,mrpt,,1,1,1,2,5,3,9,1
firefox2,firefox2,,0,0,0,0,1,0,1,1
tableviewer,tableviewer,,1,0,2,1,13,3,3,1
uidocumentinteraction,uidocumentinteraction,,3,1,3,4,16,7,13,1
active-form,active-form,,4,4,6,8,28,14,4,1
setup-wizard,setup-wizard,,0,0,1,0,5,1,3,1
apache-config,apache-config,,5,2,7,7,11,14,4,1
gooddata,gooddata,,0,1,6,1,5,7,2,1
invisible-recaptcha,invisible-recaptcha,,12,18,38,30,73,68,1,50
iptc,iptc,,0,1,8,1,11,9,4,1
testcomplete,testcomplete,,7,5,5,12,37,17,3,1
clang-complete,clang-complete,,0,0,0,0,4,0,9,1
periodic-task,periodic-task,,3,9,15,12,24,27,0,200
encodeuricomponent,encodeuricomponent,,2,3,7,5,12,12,1,50
zipfoundation,zipfoundation,,1,0,2,1,3,3,13,1
ldif,ldif,,3,4,8,7,14,15,8,33.333333
samsung-gear-fit,samsung-gear-fit,,0,0,0,0,4,0,13,1
apple-numbers,apple-numbers,,3,2,2,5,3,7,5,1
joomla1.5,joomla1.5,,1,1,3,2,6,5,4,1
skproduct,skproduct,,1,2,5,3,6,8,13,100
frombodyattribute,frombodyattribute,,1,0,5,1,7,6,8,1
delta,delta,,9,11,10,20,11,30,0,22.222222
viewwithtag,viewwithtag,,0,0,1,0,4,1,13,1
mutual-recursion,mutual-recursion,,4,1,3,5,6,8,0,1
wonderware,wonderware,,1,3,3,4,10,7,4,200
historian,historian,,2,2,7,4,10,11,4,1
cyclicbarrier,cyclicbarrier,,1,1,1,2,7,3,3,1
react-icons,react-icons,,0,2,3,2,3,5,1,100
qapplication,qapplication,,4,4,4,8,19,12,9,1
xxe,xxe,,5,1,11,6,12,17,3,1
stack-level,stack-level,,0,0,0,0,2,0,12,1
mktime,mktime,,4,2,4,6,15,10,9,1
ios-animations,ios-animations,,0,4,9,4,24,13,13,300
sphinx-napoleon,sphinx-napoleon,,0,1,2,1,4,3,0,1
bindy,bindy,,1,0,6,1,10,7,3,1
amazon-product-api,amazon-product-api,,17,6,23,23,32,46,6,1
esri-leaflet,esri-leaflet,,3,2,4,5,10,9,1,1
typo3-8.x,typo3-8.x,,73,67,179,140,277,319,4,1
freopen,freopen,,2,2,1,4,12,5,9,1
cstdio,cstdio,,1,2,2,3,3,5,9,100
sspi,sspi,,3,8,8,11,18,19,2,166.666667
scalar,scalar,,12,9,18,21,40,39,0,1
ieee,ieee,,5,6,14,11,15,25,0,20
decrement,decrement,,12,6,10,18,29,28,0,1
multi-user,multi-user,,3,5,8,8,17,16,4,66.666667
continuation-passing,continuation-passing,,5,10,8,15,13,23,2,100
refinements,refinements,,0,1,2,1,7,3,12,1
refinement-type,refinement-type,,3,1,4,4,4,8,2,1
fbo,fbo,,4,3,11,7,20,18,9,1
stencil-buffer,stencil-buffer,,7,7,3,14,11,17,9,1
function-expression,function-expression,,4,6,4,10,10,14,1,50
gdcm,gdcm,,1,3,5,4,9,9,9,200
datapicker,datapicker,,3,0,7,3,7,10,1,1
biztalk-orchestrations,biztalk-orchestrations,,1,0,1,1,12,2,8,1
typescript-compiler-api,typescript-compiler-api,,10,10,15,20,18,35,1,1
fasm,fasm,,4,6,12,10,26,22,9,50
gpo,gpo,,16,7,26,23,33,49,8,1
mailinator,mailinator,,1,0,0,1,3,1,4,1
c#-to-f#,c#-to-f#,,3,5,18,8,21,26,8,66.666667
urlloader,urlloader,,4,3,8,7,18,15,1,1
air-native-extension,air-native-extension,,0,0,0,0,4,0,13,1
base91,base91,,0,0,0,0,4,0,0,1
android-remoteview,android-remoteview,,1,1,1,2,20,3,3,1
android-appwidget-list,android-appwidget-list,,0,1,4,1,3,5,3,1
cellid,cellid,,2,3,1,5,5,6,3,50
fabric-beta,fabric-beta,,2,4,8,6,10,14,3,100
livereload,livereload,,6,6,16,12,40,28,1,1
ical-dotnet,ical-dotnet,,0,0,1,0,9,1,8,1
xbee,xbee,,16,8,16,24,26,40,0,1
swiftdate,swiftdate,,0,0,6,0,5,6,13,1
cross-product,cross-product,,7,3,5,10,12,15,0,1
quickfixgo,quickfixgo,,0,0,0,0,1,0,14,1
fselector,fselector,,0,0,0,0,5,0,0,1
isabelle,isabelle,,13,6,24,19,33,43,2,1
isar,isar,,4,2,2,6,8,8,2,1
munge,munge,,0,1,1,1,2,2,0,1
gnat,gnat,,15,9,26,24,48,50,9,1
divio,divio,,5,0,12,5,10,17,0,1
mac-app-store,mac-app-store,,4,4,19,8,20,27,13,1
jmstemplate,jmstemplate,,10,7,9,17,24,26,3,1
message-listener,message-listener,,2,0,1,2,3,3,3,1
treegrid,treegrid,,9,1,5,10,16,15,1,1
cpu-cores,cpu-cores,,1,4,7,5,20,12,0,300
crash-dumps,crash-dumps,,9,7,13,16,32,29,9,1
aac,aac,,8,19,28,27,30,55,13,137.5
epel,epel,,0,3,2,3,3,5,9,200
macos-app-extension,macos-app-extension,,1,0,3,1,6,4,13,1
datagridtextcolumn,datagridtextcolumn,,2,1,5,3,13,8,8,1
oracle-coherence,oracle-coherence,,4,3,5,7,11,12,3,1
intel-mic,intel-mic,,0,0,1,0,2,1,9,1
nameof,nameof,,3,3,2,6,17,8,8,1
visual-studio-setup-proje,visual-studio-setup-proje,,1,7,13,8,72,21,8,600
jsonreader,jsonreader,,3,2,3,5,9,8,3,1
asp.net-mvc-viewmodel,asp.net-mvc-viewmodel,,4,6,13,10,35,23,8,50
multiple-versions,multiple-versions,,3,0,4,3,7,7,9,1
httpmodule,httpmodule,,11,7,13,18,27,31,8,1
custom-authentication,custom-authentication,,8,4,9,12,13,21,8,1
system.io.compression,system.io.compression,,2,0,7,2,15,9,8,1
jmespath,jmespath,,13,11,20,24,34,44,6,1
core.autocrlf,core.autocrlf,,7,3,4,10,16,14,6,1
on-clause,on-clause,,1,0,1,1,3,2,4,1
r-lavaan,r-lavaan,,6,16,18,22,20,40,0,166.666667
google-knowledge-graph,google-knowledge-graph,,5,4,4,9,16,13,2,1
nginfinitescroll,nginfinitescroll,,0,0,1,0,9,1,1,1
jsessionid,jsessionid,,6,8,28,14,30,42,3,33.333333
amazon-fire-tv,amazon-fire-tv,,12,10,20,22,23,42,3,1
angularjs-validation,angularjs-validation,,3,2,4,5,7,9,1,1
static-initialization,static-initialization,,5,6,14,11,25,25,9,20
togglz,togglz,,1,4,2,5,9,7,3,300
resource-cleanup,resource-cleanup,,0,7,2,7,15,9,3,600
array-reduce,array-reduce,,2,2,3,4,2,7,1,1
uikeyboard,uikeyboard,,12,5,34,17,60,51,13,1
apcu,apcu,,1,3,5,4,12,9,4,200
web-deployment-project,web-deployment-project,,3,1,6,4,9,10,1,1
http4s,http4s,,6,4,9,10,19,19,2,1
http4s-circe,http4s-circe,,2,1,3,3,3,6,2,1
wiredep,wiredep,,0,0,2,0,4,2,1,1
main-bower-files,main-bower-files,,0,0,0,0,4,0,1,1
jbox2d,jbox2d,,2,5,4,7,3,11,3,150
test-plan,test-plan,,0,3,5,3,7,8,8,200
tcxgrid,tcxgrid,,3,3,3,6,4,9,9,1
mysqli-multi-query,mysqli-multi-query,,1,2,7,3,24,10,4,100
appcelerator-android,appcelerator-android,,0,0,0,0,2,0,13,1
foreman,foreman,,7,6,13,13,17,26,12,1
specrun,specrun,,3,1,3,4,7,7,8,1
angularjs-slider,angularjs-slider,,1,1,1,2,3,3,1,1
qualifiers,qualifiers,,4,3,7,7,17,14,9,1
minifilter,minifilter,,2,1,3,3,19,6,9,1
towers-of-hanoi,towers-of-hanoi,,6,2,23,8,24,31,0,1
ipsec,ipsec,,17,9,8,26,15,34,6,1
system.drawing.color,system.drawing.color,,0,0,0,0,2,0,8,1
mysema,mysema,,1,0,0,1,4,1,3,1
qz-tray,qz-tray,,3,2,2,5,8,7,1,1
mysql-5.6,mysql-5.6,,14,13,34,27,31,61,4,1
python-django-storages,python-django-storages,,1,7,3,8,5,11,0,600
developer-console,developer-console,,8,6,13,14,23,27,3,1
character-trimming,character-trimming,,3,0,2,3,12,5,4,1
solarium,solarium,,3,5,4,8,13,12,2,66.666667
nelmiosolariumbundle,nelmiosolariumbundle,,0,0,0,0,1,0,2,1
pyq,pyq,,2,0,6,2,10,8,0,1
collate,collate,,2,0,4,2,6,6,4,1
scncamera,scncamera,,2,1,4,3,8,7,13,1
foxx,foxx,,0,3,16,3,24,19,2,200
shields.io,shields.io,,0,0,2,0,4,2,6,1
jackson-databind,jackson-databind,,72,64,115,136,142,251,3,1
hive-partitions,hive-partitions,,10,6,10,16,20,26,2,1
html-frames,html-frames,,0,0,1,0,2,1,1,1
pre-build-event,pre-build-event,,3,5,9,8,17,17,8,66.666667
clustered-index,clustered-index,,6,6,17,12,48,29,4,1
projectile,projectile,,7,0,14,7,21,21,0,1
activity-diagram,activity-diagram,,4,3,13,7,24,20,3,1
portable-applications,portable-applications,,0,2,2,2,11,4,0,100
spring-data-neo4j,spring-data-neo4j,,17,19,62,36,148,98,2,11.764706
raw-input,raw-input,,3,10,18,13,43,31,0,233.333333
couchdb-mango,couchdb-mango,,5,4,10,9,24,19,1,1
qtmultimedia,qtmultimedia,,8,1,9,9,22,18,9,1
qt-events,qt-events,,1,1,0,2,5,2,9,1
tempus-dominus-datetimepicker,tempus-dominus-datetimepicker,,7,11,10,18,15,28,1,57.142857
gpx,gpx,,4,5,15,9,30,24,3,25
pearson-correlation,pearson-correlation,,15,10,17,25,40,42,0,1
window-scroll,window-scroll,,0,2,3,2,4,5,1,100
datafeed,datafeed,,1,0,6,1,8,7,5,1
uint8t,uint8t,,13,6,8,19,26,27,9,1
3dtouch,3dtouch,,7,5,18,12,36,30,13,1
exrin,exrin,,0,0,0,0,2,0,8,1
git-interactive-rebase,git-interactive-rebase,,1,1,4,2,7,6,6,1
buck,buck,,6,1,7,7,12,14,3,1
html2pdf,html2pdf,,22,28,41,50,45,91,1,27.272727
camera-api,camera-api,,2,5,11,7,11,18,3,150
ng-filter,ng-filter,,2,0,2,2,7,4,1,1
mobile-chrome,mobile-chrome,,7,8,6,15,13,21,1,14.285714
joomla2.5,joomla2.5,,5,3,8,8,11,16,4,1
source-control-explorer,source-control-explorer,,1,3,5,4,13,9,8,200
quorum,quorum,,17,18,24,35,26,59,6,5.882353
for-else,for-else,,0,0,2,0,4,2,0,1
xsi,xsi,,1,1,0,2,6,2,8,1
windows-2000,windows-2000,,0,1,0,1,3,1,8,1
xforms,xforms,,3,4,17,7,21,24,1,33.333333
xsltforms,xsltforms,,0,0,3,0,2,3,1,1
cloud-code,cloud-code,,6,5,8,11,37,19,13,1
forceclose,forceclose,,3,0,0,3,11,3,3,1
django-sites,django-sites,,0,1,4,1,15,5,0,1
chumak,chumak,,0,0,0,0,6,0,2,1
jasmine2.0,jasmine2.0,,13,7,15,20,47,35,1,1
azure-management-portal,azure-management-portal,,0,0,1,0,2,1,8,1
chimp.js,chimp.js,,0,0,3,0,9,3,3,1
code-standards,code-standards,,4,2,8,6,12,14,3,1
textselection,textselection,,11,10,5,21,24,26,1,1
to-char,to-char,,8,3,9,11,15,20,4,1
ion-toggle,ion-toggle,,1,1,1,2,4,3,1,1
ember-table,ember-table,,0,0,0,0,3,0,1,1
viewbag,viewbag,,12,12,17,24,40,41,8,1
indexpath,indexpath,,6,7,16,13,33,29,13,16.666667
execv,execv,,6,4,8,10,12,18,9,1
vendor-prefix,vendor-prefix,,1,2,3,3,10,6,1,100
awesome-wm,awesome-wm,,6,4,9,10,25,19,9,1
rational-number,rational-number,,2,2,1,4,13,5,0,1
hubspot,hubspot,,19,19,32,38,43,70,1,1
hubspot-crm,hubspot-crm,,1,3,5,4,10,9,1,200
tango,tango,,0,0,2,0,12,2,3,1
aiml,aiml,,14,5,16,19,26,35,0,1
karaf-maven-plugin,karaf-maven-plugin,,1,1,5,2,4,7,3,1
prism-4,prism-4,,0,0,1,0,2,1,8,1
deck.gl,deck.gl,,11,14,21,25,7,46,1,27.272727
boolean-expression,boolean-expression,,13,15,49,28,89,77,0,15.384615
fixed-width,fixed-width,,11,5,29,16,23,45,0,1
socketcan,socketcan,,11,5,15,16,17,31,9,1
web-performance,web-performance,,12,5,15,17,33,32,1,1
write.table,write.table,,5,0,7,5,24,12,0,1
couchdb-python,couchdb-python,,0,0,2,0,7,2,1,1
vast,vast,,8,2,8,10,21,18,3,1
guitar,guitar,,1,0,1,1,6,2,0,1
perspective,perspective,,5,9,27,14,50,41,0,80
plane,plane,,12,7,22,19,24,41,0,1
cfexecute,cfexecute,,0,2,1,2,2,3,4,100
vmware-fusion,vmware-fusion,,5,2,11,7,11,18,6,1
wtl,wtl,,0,1,2,1,3,3,9,1
sha2,sha2,,3,2,8,5,9,13,6,1
clipboard.js,clipboard.js,,3,8,10,11,10,21,1,166.666667
assertion,assertion,,37,32,104,69,100,173,3,1
expect.js,expect.js,,0,0,0,0,1,0,1,1
strava,strava,,9,6,19,15,14,34,4,1
defaulttablemodel,defaulttablemodel,,3,3,7,6,21,13,3,1
tld,tld,,3,4,7,7,16,14,4,33.333333
tidytext,tidytext,,8,16,24,24,78,48,0,100
application-shutdown,application-shutdown,,1,4,7,5,15,12,3,300
django-auth-ldap,django-auth-ldap,,5,2,5,7,13,12,0,1
cumulative-frequency,cumulative-frequency,,2,1,4,3,7,7,0,1
android-studio-2.2,android-studio-2.2,,0,1,7,1,14,8,3,1
twos-complement,twos-complement,,10,4,37,14,49,51,0,1
gethostbyname,gethostbyname,,0,2,4,2,7,6,9,100
devcon,devcon,,0,2,4,2,4,6,9,100
amd-gcn,amd-gcn,,0,2,0,2,7,2,0,100
system-verilog-assertions,system-verilog-assertions,,3,12,9,15,24,24,9,300
glkit,glkit,,4,3,7,7,6,14,13,1
handle,handle,,23,14,44,37,68,81,9,1
photon,photon,,29,21,52,50,34,102,8,1
ibdesignable,ibdesignable,,10,5,20,15,51,35,13,1
mle,mle,,17,18,30,35,36,65,0,5.882353
non-recursive,non-recursive,,1,1,1,2,6,3,0,1
callable-statement,callable-statement,,6,5,6,11,15,17,3,1
terracotta,terracotta,,1,1,6,2,10,8,3,1
android-immersive,android-immersive,,7,1,4,8,27,12,3,1
nonlinear-functions,nonlinear-functions,,10,8,15,18,32,33,0,1
vertex-buffer,vertex-buffer,,1,3,9,4,14,13,9,200
.class-file,.class-file,,3,4,10,7,16,17,3,33.333333
digital-assets-links,digital-assets-links,,0,2,1,2,3,3,3,100
proxysql,proxysql,,5,6,7,11,6,18,4,20
geofire,geofire,,30,29,64,59,129,123,13,1
droneci,droneci,,1,0,0,1,2,1,6,1
pivot-chart,pivot-chart,,5,4,9,9,15,18,5,1
enterprise-manager,enterprise-manager,,1,0,0,1,1,1,4,1
initializing,initializing,,2,1,4,3,7,7,3,1
github-enterprise,github-enterprise,,7,11,9,18,26,27,6,57.142857
storagefile,storagefile,,4,6,7,10,19,17,8,50
libgcc,libgcc,,1,1,3,2,6,5,9,1
recurly,recurly,,3,4,0,7,8,7,4,33.333333
ansible-vault,ansible-vault,,14,5,16,19,26,35,6,1
sbv,sbv,,0,2,5,2,2,7,0,100
biased-locking,biased-locking,,0,1,1,1,2,2,3,1
continue,continue,,17,14,37,31,55,68,0,1
cer,cer,,1,1,2,2,7,4,6,1
public-key-exchange,public-key-exchange,,1,2,6,3,8,9,6,100
mscapi,mscapi,,0,0,2,0,9,2,6,1
iex,iex,,5,8,13,13,18,26,2,60
errno,errno,,7,7,13,14,40,27,9,1
feof,feof,,2,1,6,3,13,9,9,1
path-iterator,path-iterator,,0,0,0,0,2,0,3,1
osmar,osmar,,0,0,0,0,2,0,0,1
fgetc,fgetc,,3,3,8,6,19,14,9,1
biztalk-2016,biztalk-2016,,13,13,35,26,42,61,8,1
splint,splint,,2,0,2,2,3,4,9,1
elasticsearch-dsl-py,elasticsearch-dsl-py,,8,11,13,19,32,32,6,37.5
quartz.net,quartz.net,,18,21,35,39,90,74,8,16.666667
jpgraph,jpgraph,,7,1,3,8,10,11,4,1
ios8.1,ios8.1,,0,0,0,0,2,0,13,1
feeds,feeds,,0,0,0,0,17,0,4,1
upsource,upsource,,1,1,4,2,11,6,3,1
android-signing,android-signing,,3,4,7,7,16,14,3,33.333333
cidetector,cidetector,,1,1,5,2,6,7,13,1
jqlite,jqlite,,1,1,1,2,5,3,1,1
multiple-resultsets,multiple-resultsets,,2,0,1,2,12,3,3,1
uppercase,uppercase,,17,19,43,36,95,79,0,11.764706
iphone-8-plus,iphone-8-plus,,1,0,1,1,9,2,13,1
data-paging,data-paging,,1,2,3,3,6,6,3,100
textctrl,textctrl,,0,0,0,0,3,0,0,1
segmentedcontrol,segmentedcontrol,,2,4,3,6,7,9,13,100
androguard,androguard,,3,4,1,7,3,8,3,33.333333
pixel-ratio,pixel-ratio,,1,2,1,3,1,4,1,100
hidpi,hidpi,,2,5,10,7,11,17,9,150
jdk1.6,jdk1.6,,6,1,13,7,31,20,3,1
vk,vk,,5,8,16,13,17,29,4,60
robospock,robospock,,0,0,0,0,1,0,3,1
ngsanitize,ngsanitize,,1,1,0,2,9,2,1,1
apple-mail,apple-mail,,4,2,7,6,20,13,13,1
ptrace,ptrace,,9,2,17,11,36,28,9,1
library-interposition,library-interposition,,0,0,0,0,2,0,9,1
afterglow,afterglow,,0,0,1,0,1,1,1,1
sqlreportingservice,sqlreportingservice,,3,2,1,5,11,6,4,1
sample,sample,,45,48,70,93,142,163,0,6.666667
gpg-signature,gpg-signature,,5,2,4,7,19,11,6,1
spring-integration-amqp,spring-integration-amqp,,4,4,11,8,25,19,3,1
cloudsim,cloudsim,,3,2,13,5,16,18,6,1
subobject,subobject,,0,1,4,1,1,5,9,1
ui-thread,ui-thread,,12,1,24,13,36,37,3,1
layerdrawable,layerdrawable,,0,0,0,0,5,0,3,1
sonarjs,sonarjs,,2,1,4,3,15,7,3,1
directx-10,directx-10,,0,1,3,1,8,4,9,1
managed-directx,managed-directx,,0,1,0,1,3,1,9,1
hibernate-entitymanager,hibernate-entitymanager,,9,8,12,17,26,29,3,1
8-bit,8-bit,,7,5,5,12,19,17,9,1
angular-i18n,angular-i18n,,21,16,39,37,56,76,1,1
sharepoint-clientobject,sharepoint-clientobject,,0,2,2,2,9,4,8,100
content-query-web-part,content-query-web-part,,1,2,0,3,3,3,8,100
donejs,donejs,,0,0,1,0,4,1,1,1
stack-memory,stack-memory,,6,9,7,15,17,22,9,50
angular-lifecycle-hooks,angular-lifecycle-hooks,,13,10,14,23,8,37,1,1
neo4j-spatial,neo4j-spatial,,1,0,2,1,14,3,2,1
random-effects,random-effects,,9,4,14,13,25,27,0,1
ember-model,ember-model,,1,0,2,1,11,3,1,1
system.drawing.graphics,system.drawing.graphics,,3,0,1,3,4,4,8,1
locked-files,locked-files,,0,2,2,2,5,4,8,100
cbperipheral,cbperipheral,,4,4,15,8,25,23,13,1
conditional-operator,conditional-operator,,17,22,32,39,66,71,9,29.411765
akka-dispatcher,akka-dispatcher,,1,1,1,2,5,3,2,1
pdf-parsing,pdf-parsing,,5,4,7,9,11,16,8,1
file-processing,file-processing,,5,3,15,8,23,23,0,1
skew,skew,,14,16,13,30,35,43,1,14.285714
tanuki,tanuki,,0,0,1,0,6,1,3,1
python-cryptography,python-cryptography,,7,7,25,14,29,39,0,1
scorm,scorm,,8,1,12,9,28,21,1,1
managed-property,managed-property,,0,0,0,0,3,0,3,1
site-column,site-column,,0,1,1,1,4,2,8,1
front-end-optimization,front-end-optimization,,0,0,1,0,2,1,1,1
junitparams,junitparams,,3,1,2,4,1,6,3,1
video-editing,video-editing,,12,8,31,20,20,51,13,1
gnome-3,gnome-3,,4,4,2,8,29,10,9,1
nautilus,nautilus,,5,2,5,7,9,12,9,1
particle-filter,particle-filter,,3,1,0,4,1,4,0,1
dock,dock,,5,6,9,11,13,20,13,20
wakelock,wakelock,,3,8,18,11,24,29,3,166.666667
iscsi,iscsi,,3,1,9,4,14,13,9,1
svn-reintegrate,svn-reintegrate,,0,0,0,0,3,0,6,1
jquery-tokeninput,jquery-tokeninput,,2,0,3,2,8,5,1,1
adfs2.0,adfs2.0,,2,4,13,6,25,19,8,100
bicubic,bicubic,,0,2,3,2,16,5,0,100
traffic,traffic,,9,6,37,15,58,52,9,1
gtable,gtable,,4,2,9,6,20,15,0,1
heads-up-notifications,heads-up-notifications,,4,3,2,7,8,9,3,1
irr,irr,,2,4,10,6,7,16,0,100
xirr,xirr,,3,2,5,5,5,10,5,1
http-status-code-422,http-status-code-422,,4,4,5,8,13,13,4,1
frustum,frustum,,4,2,12,6,9,18,9,1
split-screen,split-screen,,4,6,9,10,11,19,3,50
guptateamdeveloper,guptateamdeveloper,,1,0,1,1,7,2,4,1
centura,centura,,1,0,1,1,3,2,4,1
sqldf,sqldf,,25,15,26,40,91,66,0,1
flatfilesource,flatfilesource,,1,2,6,3,7,9,4,100
druid,druid,,16,27,31,43,63,74,2,68.75
apache-calcite,apache-calcite,,12,11,22,23,24,45,3,1
teamviewer,teamviewer,,0,9,11,9,22,20,3,800
rtvs,rtvs,,1,0,1,1,11,2,0,1
htmlbutton,htmlbutton,,4,2,8,6,8,14,1,1
spring-integration-sftp,spring-integration-sftp,,15,14,46,29,44,75,3,1
poison-queue,poison-queue,,0,0,1,0,3,1,8,1
pgagent,pgagent,,3,4,5,7,15,12,4,33.333333
productivity-power-tools,productivity-power-tools,,2,1,2,3,6,5,8,1
drawimage,drawimage,,11,11,20,22,38,42,1,1
subgraph,subgraph,,9,2,9,11,21,20,0,1
ancestor,ancestor,,0,7,7,7,8,14,3,600
nominet,nominet,,1,0,0,1,1,1,4,1
rsqlite,rsqlite,,5,5,11,10,38,21,0,1
editing,editing,,22,11,27,33,51,60,13,1
activator,activator,,3,5,6,8,20,14,8,66.666667
elementary,elementary,,1,2,10,3,6,13,9,100
elementary-functions,elementary-functions,,0,0,0,0,4,0,0,1
woodstox,woodstox,,1,1,3,2,6,5,3,1
django-viewflow,django-viewflow,,7,0,9,7,21,16,0,1
tigase,tigase,,1,1,0,2,1,2,3,1
riot.js,riot.js,,1,2,6,3,22,9,1,100
pg-jdbc,pg-jdbc,,4,1,3,5,7,8,4,1
cost-based-optimizer,cost-based-optimizer,,1,1,1,2,16,3,0,1
dropdownbox,dropdownbox,,8,4,16,12,21,28,1,1
webdynpro,webdynpro,,1,0,2,1,6,3,5,1
subversive,subversive,,0,1,8,1,13,9,3,1
pyd,pyd,,4,0,2,4,7,6,0,1
udid,udid,,3,1,11,4,8,15,13,1
reinstall,reinstall,,2,2,7,4,14,11,13,1
extended-ascii,extended-ascii,,4,2,6,6,14,12,0,1
dataitem,dataitem,,0,0,1,0,6,1,1,1
system.data.datatable,system.data.datatable,,0,0,2,0,1,2,8,1
facebook-oauth,facebook-oauth,,5,5,17,10,35,27,13,1
nltk-trainer,nltk-trainer,,2,0,7,2,10,9,0,1
in-operator,in-operator,,2,5,5,7,14,12,4,150
tivoli,tivoli,,5,1,5,6,11,11,3,1
wmplib,wmplib,,2,0,5,2,5,7,8,1
webpage-screenshot,webpage-screenshot,,8,4,13,12,18,25,3,1
low-latency,low-latency,,7,11,18,18,22,36,3,57.142857
fiware-cygnus,fiware-cygnus,,9,1,19,10,33,29,6,1
emv,emv,,9,9,20,18,31,38,3,1
ractivejs,ractivejs,,2,0,1,2,15,3,1,1
alertify,alertify,,3,1,1,4,6,5,1,1
form-control,form-control,,22,17,34,39,63,73,1,1
pugjs,pugjs,,0,0,0,0,31,0,1,1
miglayout,miglayout,,1,2,8,3,17,11,3,100
uimanager,uimanager,,3,3,4,6,7,10,3,1
keynote,keynote,,6,1,7,7,6,14,13,1
database-sequence,database-sequence,,8,6,14,14,9,28,4,1
systemmodeler,systemmodeler,,1,3,6,4,4,10,0,200
shrink,shrink,,5,5,13,10,16,23,4,1
jboss-tools,jboss-tools,,9,3,12,12,25,24,3,1
system-requirements,system-requirements,,0,1,2,1,2,3,6,1
snmpd,snmpd,,3,4,13,7,10,20,9,33.333333
flash-builder,flash-builder,,4,2,8,6,21,14,13,1
shapes,shapes,,101,60,167,161,97,328,0,1
gembox-document,gembox-document,,0,1,3,1,5,4,8,1
facebook-pixel,facebook-pixel,,18,31,32,49,56,81,13,72.222222
rpres,rpres,,0,2,2,2,7,4,0,100
jsondb,jsondb,,0,0,0,0,2,0,1,1
dpi-aware,dpi-aware,,2,0,5,2,13,7,8,1
ef-code-first-mapping,ef-code-first-mapping,,9,9,7,18,19,25,8,1
keyevent,keyevent,,26,20,52,46,74,98,3,1
arrows,arrows,,7,9,18,16,22,34,2,28.571429
xml-twig,xml-twig,,2,0,3,2,15,5,9,1
viewdata,viewdata,,4,4,1,8,12,9,8,1
dynamic-rdlc-generation,dynamic-rdlc-generation,,5,4,6,9,14,15,8,1
opensips,opensips,,3,3,13,6,15,19,13,1
riverplot,riverplot,,0,0,0,0,4,0,0,1
virtuemart,virtuemart,,6,3,8,9,17,17,4,1
digit,digit,,0,0,2,0,43,2,0,1
predix,predix,,2,1,6,3,15,9,1,1
opos,opos,,1,0,11,1,10,12,8,1
pos-for-.net,pos-for-.net,,0,2,3,2,4,5,8,100
grok,grok,,2,21,14,23,15,37,6,950
mnesia,mnesia,,1,4,15,5,18,20,2,300
lookaround,lookaround,,0,0,3,0,2,3,0,1
phplib,phplib,,0,0,1,0,3,1,4,1
jformattedtextfield,jformattedtextfield,,3,4,7,7,6,14,3,33.333333
self-updating,self-updating,,1,0,1,1,6,2,0,1
domparser,domparser,,12,18,41,30,49,71,1,50
premake,premake,,6,7,6,13,10,19,9,16.666667
activesupport,activesupport,,2,9,13,11,24,24,12,350
tempdb,tempdb,,7,3,4,10,13,14,4,1
active-objects,active-objects,,2,1,0,3,3,3,6,1
xml-import,xml-import,,1,0,5,1,5,6,3,1
python-memcached,python-memcached,,2,0,2,2,2,4,0,1
nsthread,nsthread,,1,3,2,4,7,6,13,200
castle-dynamicproxy,castle-dynamicproxy,,5,1,5,6,20,11,8,1
soaphandler,soaphandler,,2,1,2,3,3,5,3,1
hexagonal-tiles,hexagonal-tiles,,5,6,8,11,19,19,0,20
paypal-subscriptions,paypal-subscriptions,,8,30,45,38,50,83,4,275
nvml,nvml,,1,0,3,1,5,4,0,1
knpmenubundle,knpmenubundle,,0,0,2,0,13,2,4,1
savechanges,savechanges,,3,5,12,8,24,20,8,66.666667
idoc,idoc,,8,2,8,10,7,18,5,1
system.componentmodel,system.componentmodel,,0,0,2,0,6,2,8,1
libpcap,libpcap,,19,7,22,26,38,48,9,1
ios-permissions,ios-permissions,,5,4,8,9,12,17,13,1
location-services,location-services,,9,1,13,10,24,23,3,1
relational-division,relational-division,,9,8,20,17,25,37,4,1
amazon-kms,amazon-kms,,0,0,0,0,22,0,6,1
vsx,vsx,,0,5,2,5,10,7,8,400
aps,aps,,0,0,3,0,3,3,3,1
httrack,httrack,,0,3,4,3,4,7,0,200
serial-number,serial-number,,6,2,8,8,17,16,3,1
gretty,gretty,,0,8,7,8,13,15,3,700
scroller,scroller,,5,2,2,7,13,9,1,1
iview-ui,iview-ui,,1,0,1,1,6,2,1,1
elementhost,elementhost,,2,2,2,4,9,6,8,1
locust,locust,,9,22,27,31,50,58,0,144.444444
ocmod,ocmod,,1,1,2,2,4,4,4,1
scopes,scopes,,7,9,14,16,26,30,4,28.571429
adobe-premiere,adobe-premiere,,7,7,4,14,4,18,1,1
tyk,tyk,,5,0,8,5,8,13,6,1
directwrite,directwrite,,4,2,4,6,9,10,9,1
openejb,openejb,,3,1,6,4,9,10,3,1
eofexception,eofexception,,3,4,5,7,16,12,3,33.333333
perfect-scrollbar,perfect-scrollbar,,4,9,8,13,14,21,1,125
android-twitter,android-twitter,,0,0,1,0,2,1,3,1
pandas.excelwriter,pandas.excelwriter,,5,9,12,14,21,26,0,80
nsfilewrapper,nsfilewrapper,,0,0,3,0,3,3,13,1
pageloadstrategy,pageloadstrategy,,0,1,2,1,3,3,3,1
linkify,linkify,,2,7,3,9,8,12,3,250
internal-load-balancer,internal-load-balancer,,2,6,19,8,20,27,8,200
cssnano,cssnano,,1,1,5,2,7,7,1,1
less-loader,less-loader,,4,1,5,5,16,10,1,1
vee-validate,vee-validate,,41,29,53,70,104,123,1,1
polymer-cli,polymer-cli,,1,2,9,3,16,12,1,100
unhandled-exception,unhandled-exception,,9,13,27,22,47,49,8,44.444444
apache-cordova,apache-cordova,,10,1,13,11,30,24,1,1
strict-transport-security,strict-transport-security,,1,3,0,4,5,4,4,200
xml-encoding,xml-encoding,,1,1,1,2,2,3,3,1
daypilot-scheduler,daypilot-scheduler,,0,0,0,0,2,0,1,1
keymaps,keymaps,,2,1,2,3,1,5,3,1
helium,helium,,0,0,2,0,4,2,2,1
rest-assured-jsonpath,rest-assured-jsonpath,,15,27,28,42,50,70,3,80
empirical-distribution,empirical-distribution,,0,1,1,1,3,2,0,1
mockups,mockups,,6,2,0,8,8,8,1,1
memcheck,memcheck,,4,3,6,7,9,13,9,1
windows-defender,windows-defender,,5,5,12,10,18,22,8,1
aws-pinpoint,aws-pinpoint,,22,12,25,34,36,59,6,1
valarray,valarray,,2,0,2,2,8,4,9,1
timestamp-with-timezone,timestamp-with-timezone,,17,12,36,29,44,65,4,1
radio-group,radio-group,,19,15,60,34,86,94,1,1
chai-http,chai-http,,5,15,8,20,27,28,1,200
parallel.for,parallel.for,,1,3,7,4,12,11,8,200
ls-colors,ls-colors,,0,0,0,0,1,0,9,1
elasticsearch2,elasticsearch2,,0,0,0,0,1,0,6,1
sqldelight,sqldelight,,0,5,1,5,1,6,3,400
lift,lift,,2,2,5,4,11,9,2,1
embedded-v8,embedded-v8,,9,8,17,17,23,34,1,1
wireless-connection,wireless-connection,,2,6,5,8,12,13,9,200
operands,operands,,6,7,22,13,20,35,0,16.666667
texreg,texreg,,1,6,3,7,10,10,0,500
lirc,lirc,,1,4,1,5,11,6,0,300
osx-yosemite,osx-yosemite,,0,2,3,2,27,5,13,100
eclipse-emf,eclipse-emf,,2,3,13,5,20,18,3,50
eclipse-emf-ecore,eclipse-emf-ecore,,0,0,2,0,6,2,3,1
x509trustmanager,x509trustmanager,,2,2,3,4,8,7,3,1
azure-app-api,azure-app-api,,2,2,1,4,3,5,8,1
relaunch,relaunch,,0,0,1,0,5,1,3,1
3g,3g,,2,2,5,4,12,9,3,1
pinning,pinning,,4,7,8,11,13,19,6,75
certificate-pinning,certificate-pinning,,8,7,10,15,10,25,6,1
android-network-security-config,android-network-security-config,,3,2,3,5,6,8,3,1
harmon.ie,harmon.ie,,0,0,6,0,10,6,8,1
mongodump,mongodump,,14,6,16,20,22,36,1,1
mongorestore,mongorestore,,11,8,11,19,22,30,1,1
jdi,jdi,,0,0,7,0,14,7,3,1
jpda,jpda,,0,0,1,0,9,1,3,1
swiftlint,swiftlint,,9,5,13,14,23,27,13,1
minitab,minitab,,5,0,1,5,7,6,0,1
angular-compiler-cli,angular-compiler-cli,,1,3,2,4,10,6,1,200
doctrine-extensions,doctrine-extensions,,5,5,6,10,10,16,4,1
stofdoctrineextensions,stofdoctrineextensions,,3,0,5,3,4,8,4,1
zend-db,zend-db,,4,3,9,7,19,16,4,1
flir,flir,,2,5,3,7,4,10,0,150
row-level-security,row-level-security,,11,5,17,16,34,33,4,1
node.js-client,node.js-client,,0,0,0,0,1,0,1,1
report-viewer2012,report-viewer2012,,0,0,1,0,2,1,8,1
arangojs,arangojs,,1,0,9,1,20,10,2,1
static-resource,static-resource,,0,0,1,0,11,1,3,1
san,san,,4,6,9,10,17,19,9,50
coverage.py,coverage.py,,13,14,20,27,37,47,0,7.692308
ion-auth,ion-auth,,6,0,8,6,18,14,4,1
worldwind,worldwind,,0,2,5,2,15,7,3,100
query-parser,query-parser,,0,0,3,0,11,3,2,1
nsobject,nsobject,,13,5,21,18,36,39,13,1
vorbis,vorbis,,2,1,3,3,7,6,13,1
cognos-tm1,cognos-tm1,,1,0,3,1,9,4,4,1
httpcookie,httpcookie,,7,10,13,17,24,30,4,42.857143
imultivalueconverter,imultivalueconverter,,0,0,8,0,15,8,8,1
variable-length-array,variable-length-array,,5,5,14,10,34,24,9,1
loess,loess,,4,4,13,8,24,21,0,1
xpdf,xpdf,,1,0,3,1,11,4,8,1
naturallyspeaking,naturallyspeaking,,1,1,1,2,2,3,1,1
ektron,ektron,,1,0,1,1,3,2,8,1
u2,u2,,0,3,5,3,7,8,9,200
unidata,unidata,,3,3,8,6,8,14,9,1
chaiscript,chaiscript,,0,0,1,0,7,1,9,1
elasticsearch-aggregation,elasticsearch-aggregation,,60,51,116,111,91,227,6,1
anchorpoint,anchorpoint,,3,2,2,5,11,7,13,1
itextg,itextg,,3,0,2,3,10,5,3,1
var-dump,var-dump,,1,5,13,6,26,19,4,400
openoffice-base,openoffice-base,,0,2,0,2,2,2,5,100
ember-paper,ember-paper,,1,0,0,1,1,1,1,1
git-webhooks,git-webhooks,,6,3,17,9,8,26,6,1
tcomb-form-native,tcomb-form-native,,6,1,8,7,13,15,1,1
sites,sites,,2,1,4,3,7,7,8,1
radians,radians,,2,3,5,5,8,10,0,50
armv7,armv7,,13,6,26,19,31,45,9,1
email-headers,email-headers,,6,5,16,11,22,27,4,1
dmarc,dmarc,,8,4,8,12,14,20,4,1
powerpoint2016,powerpoint2016,,2,1,3,3,7,6,5,1
sendinput,sendinput,,3,4,10,7,14,17,9,33.333333
qframe,qframe,,1,3,2,4,12,6,0,200
mashery,mashery,,1,1,1,2,1,3,3,1
dcgan,dcgan,,11,8,10,19,6,29,0,1
text-size,text-size,,3,3,13,6,25,19,3,1
bacon.js,bacon.js,,0,0,1,0,5,1,1,1
keyboard-wedge,keyboard-wedge,,0,2,1,2,1,3,3,100
loadlibrary,loadlibrary,,5,10,15,15,41,30,9,100
load-csv,load-csv,,7,13,1,20,10,21,2,85.714286
zombie-process,zombie-process,,5,8,10,13,22,23,9,60
compound-index,compound-index,,4,2,6,6,11,12,1,1
boost-units,boost-units,,1,0,3,1,8,4,9,1
filemtime,filemtime,,3,2,2,5,15,7,4,1
dublin-core,dublin-core,,2,1,0,3,5,3,2,1
motion-planning,motion-planning,,2,3,5,5,8,10,0,50
ims,ims,,4,3,5,7,13,12,13,1
hoisting,hoisting,,11,13,19,24,50,43,1,18.181818
openoffice.org,openoffice.org,,11,5,9,16,17,25,5,1
spring-test-dbunit,spring-test-dbunit,,4,0,5,4,14,9,3,1
autofac-module,autofac-module,,1,3,10,4,13,14,8,200
autofac-configuration,autofac-configuration,,5,4,8,9,22,17,8,1
auth-token,auth-token,,1,5,5,6,7,11,4,400
jtogglebutton,jtogglebutton,,1,1,2,2,4,4,3,1
spring-data-couchbase,spring-data-couchbase,,21,19,33,40,30,73,3,1
spring-boot-starter,spring-boot-starter,,15,19,21,34,50,55,3,26.666667
django-sessions,django-sessions,,10,11,14,21,27,35,0,10
facebook-messages,facebook-messages,,2,1,1,3,7,4,13,1
ionic2-providers,ionic2-providers,,0,0,0,0,4,0,1,1
border-image,border-image,,2,3,8,5,10,13,1,50
wsfederationhttpbinding,wsfederationhttpbinding,,0,0,1,0,1,1,8,1
cfstring,cfstring,,1,0,0,1,4,1,13,1
uiimagepickercontrollermediatype,uiimagepickercontrollermediatype,,0,0,3,0,4,3,13,1
bunyan,bunyan,,4,2,14,6,14,20,1,1
annotation-processor,annotation-processor,,4,5,13,9,29,22,3,25
objectlistview,objectlistview,,9,6,10,15,18,25,8,1
google-data,google-data,,1,1,7,2,5,9,4,1
sidekiq-monitor,sidekiq-monitor,,0,1,5,1,7,6,12,1
autosar,autosar,,3,5,9,8,15,17,9,66.666667
columnsorting,columnsorting,,23,12,34,35,52,69,0,1
csvhelper,csvhelper,,38,33,38,71,67,109,8,1
csv-write-stream,csv-write-stream,,2,1,4,3,6,7,0,1
junction,junction,,1,1,6,2,8,8,9,1
objectify,objectify,,7,7,20,14,62,34,6,1
incoming-call,incoming-call,,2,3,7,5,17,12,3,50
bridge.net,bridge.net,,0,1,3,1,6,4,8,1
rolling-sum,rolling-sum,,1,1,12,2,17,14,0,1
wpa,wpa,,1,1,3,2,10,5,9,1
jquery-effects,jquery-effects,,0,0,0,0,6,0,1,1
touchmove,touchmove,,4,3,7,7,15,14,1,1
dimension,dimension,,17,18,31,35,51,66,0,5.882353
fabrication-gem,fabrication-gem,,1,0,0,1,1,1,12,1
ios-ui-automation,ios-ui-automation,,5,4,17,9,26,26,13,1
bitcoin-testnet,bitcoin-testnet,,10,3,6,13,12,19,6,1
null-coalescing-operator,null-coalescing-operator,,6,5,9,11,15,20,8,1
angular2-jwt,angular2-jwt,,4,4,17,8,32,25,1,1
samsung-smart-tv,samsung-smart-tv,,9,7,19,16,39,35,13,1
named-graphs,named-graphs,,0,1,1,1,6,2,2,1
awss3transferutility,awss3transferutility,,3,2,4,5,10,9,6,1
database-caching,database-caching,,1,0,2,1,2,3,4,1
datamember,datamember,,2,6,3,8,8,11,8,200
delphi-xe,delphi-xe,,7,11,16,18,29,34,9,57.142857
viber,viber,,11,4,18,15,17,33,3,1
typescript-definitions,typescript-definitions,,6,2,7,8,16,15,1,1
pddl,pddl,,3,4,5,7,2,12,0,33.333333
qtablewidgetitem,qtablewidgetitem,,12,3,5,15,19,20,0,1
google-cloud-endpoints-v2,google-cloud-endpoints-v2,,9,5,20,14,81,34,6,1
unsafemutablepointer,unsafemutablepointer,,5,2,12,7,21,19,13,1
dependency-walker,dependency-walker,,0,1,1,1,6,2,8,1
c++builder-xe5,c++builder-xe5,,1,0,0,1,4,1,9,1
openmax,openmax,,3,1,1,4,4,5,13,1
raspbian-wheezy,raspbian-wheezy,,0,0,0,0,2,0,9,1
cloudkit-web-services,cloudkit-web-services,,2,2,3,4,6,7,13,1
build-process,build-process,,3,1,8,4,16,12,9,1
parameterized-types,parameterized-types,,1,0,1,1,10,2,3,1
assembly-loading,assembly-loading,,2,3,6,5,10,11,8,50
concurrentskiplistmap,concurrentskiplistmap,,1,1,1,2,3,3,3,1
linklabel,linklabel,,1,0,4,1,6,5,8,1
aws-step-functions,aws-step-functions,,51,39,72,90,96,162,6,1
nservicebus6,nservicebus6,,0,0,2,0,13,2,8,1
nservicebus-rabbitmq,nservicebus-rabbitmq,,0,0,0,0,1,0,8,1
c++-actor-framework,c++-actor-framework,,0,0,1,0,5,1,2,1
ssmtp,ssmtp,,0,3,6,3,7,9,4,200
camera-view,camera-view,,4,1,8,5,5,13,3,1
html5-appcache,html5-appcache,,1,2,9,3,19,12,1,100
geonetwork,geonetwork,,3,0,4,3,4,7,3,1
background-fetch,background-fetch,,6,7,12,13,34,25,13,16.666667
silentpush,silentpush,,1,0,3,1,14,4,13,1
unity-components,unity-components,,2,1,2,3,2,5,8,1
unity-editor,unity-editor,,5,24,24,29,47,53,8,380
opscenter,opscenter,,1,1,4,2,17,6,2,1
mod-cluster,mod-cluster,,2,4,6,6,7,12,3,100
pechkin,pechkin,,1,0,1,1,2,2,8,1
tuespechkin,tuespechkin,,2,2,1,4,1,5,8,1
skin,skin,,5,3,7,8,9,15,8,1
consul-kv,consul-kv,,6,7,9,13,8,22,3,16.666667
selenium3,selenium3,,2,1,10,3,16,13,3,1
mixed-integer-programming,mixed-integer-programming,,17,19,37,36,56,73,0,11.764706
bourbon,bourbon,,2,2,2,4,19,6,1,1
modalpopupextender,modalpopupextender,,6,2,6,8,13,14,8,1
mostjs,mostjs,,0,0,0,0,1,0,1,1
motorcycle,motorcycle,,0,0,0,0,1,0,1,1
pexpect,pexpect,,23,16,45,39,64,84,0,1
cprofile,cprofile,,5,4,14,9,23,23,0,1
advanced-installer,advanced-installer,,7,5,12,12,23,24,8,1
hunit,hunit,,0,0,1,0,2,1,2,1
boost-range,boost-range,,4,1,1,5,12,6,9,1
qscript,qscript,,0,0,0,0,2,0,9,1
right-join,right-join,,6,6,13,12,19,25,4,1
xpdo,xpdo,,1,0,1,1,2,2,4,1
typeconverter,typeconverter,,7,5,18,12,23,30,8,1
winpcap,winpcap,,3,7,10,10,19,20,9,133.333333
prvalue,prvalue,,2,0,2,2,6,4,9,1
urlconf,urlconf,,1,1,2,2,5,4,0,1
method-resolution-order,method-resolution-order,,5,5,6,10,24,16,0,1
objectdatasource,objectdatasource,,2,1,0,3,9,3,8,1
jsobject,jsobject,,0,3,5,3,10,8,1,200
dos,dos,,40,30,38,70,100,108,9,1
gamma-distribution,gamma-distribution,,12,9,14,21,16,35,0,1
organizer,organizer,,0,2,2,2,4,4,0,100
particle.io,particle.io,,2,0,1,2,8,3,6,1
particle-photon,particle-photon,,2,3,4,5,6,9,9,50
aws-ios,aws-ios,,1,0,4,1,4,5,6,1
preload,preload,,25,16,45,41,79,86,1,1
r-corrplot,r-corrplot,,2,8,21,10,34,31,0,300
html5-draggable,html5-draggable,,1,3,4,4,14,8,1,200
hybridauth,hybridauth,,3,6,4,9,17,13,4,100
tabslideout,tabslideout,,0,0,0,0,1,0,1,1
rustdoc,rustdoc,,4,1,0,5,6,5,9,1
jlink,jlink,,9,17,29,26,35,55,3,88.888889
jdeps,jdeps,,3,1,8,4,11,12,3,1
openid-provider,openid-provider,,0,0,6,0,10,6,8,1
fact,fact,,4,6,7,10,6,17,4,50
jquery-select2-4,jquery-select2-4,,16,10,24,26,40,50,1,1
foreground,foreground,,11,9,38,20,41,58,3,1
npm-private-modules,npm-private-modules,,0,0,0,0,3,0,1,1
cookbook,cookbook,,8,2,12,10,63,22,12,1
linked-tables,linked-tables,,0,5,9,5,19,14,5,400
symfony1,symfony1,,2,0,6,2,30,8,4,1
microsoft-runtime-library,microsoft-runtime-library,,0,1,0,1,2,1,9,1
anglesharp,anglesharp,,5,10,13,15,23,28,8,100
bitset,bitset,,8,5,36,13,33,49,9,1
cfhttp,cfhttp,,4,1,8,5,7,13,4,1
cfhttpparam,cfhttpparam,,0,0,2,0,2,2,4,1
bit64,bit64,,1,1,0,2,2,2,0,1
redisson,redisson,,8,15,30,23,44,53,3,87.5
windows-98,windows-98,,0,2,2,2,3,4,9,100
traversable,traversable,,5,3,2,8,13,10,2,1
becomefirstresponder,becomefirstresponder,,1,3,3,4,15,7,13,200
ztree,ztree,,1,1,1,2,3,3,1,1
stdafx.h,stdafx.h,,1,1,3,2,6,5,9,1
material-design-in-xaml,material-design-in-xaml,,16,12,21,28,32,49,8,1
select2-rails,select2-rails,,5,5,3,10,9,13,1,1
ejb-jar.xml,ejb-jar.xml,,1,0,0,1,3,1,3,1
alphabetized,alphabetized,,1,1,0,2,1,2,0,1
homebrew-cask,homebrew-cask,,5,8,11,13,12,24,13,60
gpu-warp,gpu-warp,,0,1,3,1,7,4,0,1
uva,uva,,3,2,1,5,7,6,9,1
unified-memory,unified-memory,,2,0,3,2,6,5,0,1
mapped-memory,mapped-memory,,0,1,1,1,2,2,9,1
sequences,sequences,,0,0,0,0,71,0,0,1
touchstart,touchstart,,3,3,10,6,13,16,1,1
ocamlbuild,ocamlbuild,,4,3,5,7,5,12,0,1
removeall,removeall,,2,3,13,5,24,18,3,50
ggraph,ggraph,,16,4,10,20,28,30,0,1
fest,fest,,1,0,2,1,2,3,3,1
virtualtreeview,virtualtreeview,,5,0,8,5,12,13,9,1
tvirtualstringtree,tvirtualstringtree,,4,0,3,4,9,7,9,1
uidocumentmenuvc,uidocumentmenuvc,,0,0,0,0,2,0,13,1
uidocumentbrowservc,uidocumentbrowservc,,4,5,13,9,14,22,13,25
video-intelligence-api,video-intelligence-api,,3,7,2,10,13,12,6,133.333333
testability,testability,,0,2,1,2,6,3,3,100
openstack-heat,openstack-heat,,1,4,8,5,15,13,6,300
dotnethighcharts,dotnethighcharts,,4,2,1,6,10,7,1,1
files-app,files-app,,2,1,2,3,10,5,13,1
irvine32,irvine32,,12,2,32,14,34,46,9,1
osclass,osclass,,1,3,5,4,6,9,4,200
jelastic,jelastic,,12,6,15,18,22,33,3,1
xmgrace,xmgrace,,1,1,3,2,7,5,0,1
spring-jmx,spring-jmx,,2,2,7,4,16,11,3,1
wordpress-login,wordpress-login,,3,2,15,5,11,20,4,1
preprocessor-directive,preprocessor-directive,,13,10,21,23,25,44,9,1
groovydsl,groovydsl,,0,1,3,1,1,4,3,1
brighter,brighter,,2,1,0,3,1,3,8,1
scnlight,scnlight,,1,0,4,1,5,5,13,1
mapped-types,mapped-types,,6,9,16,15,31,31,1,50
okta-api,okta-api,,13,13,27,26,50,53,8,1
hcatalog,hcatalog,,0,1,1,1,12,2,2,1
causality,causality,,1,2,6,3,6,9,0,100
generic-handler,generic-handler,,3,0,4,3,9,7,8,1
twitter-bootstrap-2,twitter-bootstrap-2,,1,0,3,1,5,4,1,1
photoshop-script,photoshop-script,,13,11,32,24,46,56,1,1
wic,wic,,3,3,3,6,8,9,9,1
asciimath,asciimath,,5,0,1,5,2,6,3,1
bsd,bsd,,5,4,21,9,39,30,9,1
rails-4-upgrade,rails-4-upgrade,,2,1,1,3,3,4,12,1
proc-open,proc-open,,1,2,5,3,8,8,4,100
webkit-perspective,webkit-perspective,,0,0,0,0,4,0,1,1
adfs3.0,adfs3.0,,11,12,20,23,41,43,8,9.090909
jose,jose,,7,4,10,11,10,21,6,1
timestampdiff,timestampdiff,,0,1,6,1,8,7,4,1
runjettyrun,runjettyrun,,0,0,0,0,1,0,3,1
textjoin,textjoin,,6,23,4,29,9,33,5,283.333333
static-pages,static-pages,,6,2,10,8,7,18,4,1
flask-restless,flask-restless,,1,0,3,1,15,4,0,1
spring-social-google,spring-social-google,,1,0,0,1,5,1,3,1
bytea,bytea,,4,2,9,6,19,15,4,1
asadmin,asadmin,,0,1,1,1,4,2,3,1
expandable,expandable,,6,7,9,13,18,22,3,16.666667
appsflyer,appsflyer,,4,2,15,6,17,21,3,1
parceler,parceler,,0,2,0,2,11,2,3,100
outline,outline,,11,7,20,18,28,38,1,1
unordered,unordered,,3,2,6,5,16,11,0,1
jquery-selectbox,jquery-selectbox,,3,3,2,6,13,8,1,1
vlsi,vlsi,,0,3,7,3,15,10,9,200
asic,asic,,3,2,10,5,9,15,9,1
nintex-workflow,nintex-workflow,,6,3,10,9,17,19,8,1
matlab-struct,matlab-struct,,4,0,2,4,10,6,0,1
unsigned-long-long-int,unsigned-long-long-int,,1,3,6,4,15,10,9,200
ghdl,ghdl,,7,5,5,12,15,17,9,1
hardware-design,hardware-design,,0,0,1,0,3,1,9,1
sigasi-studio,sigasi-studio,,0,0,1,0,2,1,9,1
uint32,uint32,,1,3,4,4,12,8,9,200
eclipse-kepler,eclipse-kepler,,0,1,0,1,10,1,3,1
sql-calc-found-rows,sql-calc-found-rows,,1,1,1,2,4,3,4,1
html-object,html-object,,1,1,3,2,11,5,1,1
twitter-bootstrap-form,twitter-bootstrap-form,,1,0,1,1,3,2,1,1
hakyll,hakyll,,0,1,9,1,9,10,2,1
hapijs-vision,hapijs-vision,,1,0,0,1,1,1,1,1
reconnect,reconnect,,3,1,10,4,14,14,1,1
ransac,ransac,,6,7,5,13,12,18,0,16.666667
rancher,rancher,,43,42,74,85,131,159,6,1
cattle,cattle,,0,0,0,0,4,0,6,1
sliding-window,sliding-window,,14,21,29,35,50,64,0,50
pessimistic-locking,pessimistic-locking,,2,2,13,4,8,17,3,1
bigbluebutton,bigbluebutton,,0,2,5,2,5,7,4,100
pelican,pelican,,5,1,11,6,22,17,0,1
spannablestringbuilder,spannablestringbuilder,,1,2,10,3,14,13,3,100
listcellrenderer,listcellrenderer,,1,0,3,1,6,4,3,1
cellrenderer,cellrenderer,,3,2,1,5,12,6,1,1
sqrt,sqrt,,9,6,21,15,23,36,0,1
clarifai,clarifai,,3,5,6,8,20,14,1,66.666667
openocd,openocd,,9,5,15,14,35,29,9,1
partitioner,partitioner,,2,2,3,4,4,7,2,1
efk,efk,,6,4,4,10,18,14,6,1
sfdc,sfdc,,5,4,12,9,14,21,14,1
software-packaging,software-packaging,,0,0,1,0,7,1,9,1
ups,ups,,5,7,16,12,23,28,4,40
dhl,dhl,,5,3,4,8,7,12,4,1
mlogit,mlogit,,10,9,25,19,22,44,0,1
gmsmapview,gmsmapview,,11,9,28,20,37,48,13,1
robovm,robovm,,7,1,5,8,11,13,3,1
game-center-leaderboard,game-center-leaderboard,,3,2,5,5,8,10,13,1
junit-runner,junit-runner,,3,4,11,7,16,18,3,33.333333
cakeyframeanimation,cakeyframeanimation,,2,5,8,7,10,15,13,150
android-monkey,android-monkey,,0,0,0,0,4,0,3,1
sender-id,sender-id,,0,1,0,1,5,1,6,1
servicestack-text,servicestack-text,,3,1,11,4,18,15,8,1
autodesk-model-derivative,autodesk-model-derivative,,16,13,31,29,66,60,14,1
pdftoppm,pdftoppm,,0,0,4,0,3,4,0,1
dynamic-class-loaders,dynamic-class-loaders,,8,2,7,10,14,17,3,1
polynomial-math,polynomial-math,,13,5,23,18,42,41,0,1
wcf-data-services,wcf-data-services,,6,8,3,14,17,17,8,33.333333
bolts-framework,bolts-framework,,2,0,1,2,7,3,13,1
migrating,migrating,,4,2,8,6,8,14,4,1
uiscreen,uiscreen,,4,1,5,5,10,10,13,1
commonsware-cwac,commonsware-cwac,,3,1,6,4,4,10,3,1
mutators,mutators,,3,4,13,7,32,20,4,33.333333
leading-zero,leading-zero,,7,3,11,10,27,21,0,1
submatrix,submatrix,,2,2,12,4,13,16,0,1
no-data,no-data,,0,2,8,2,7,10,0,100
data-vault,data-vault,,0,3,4,3,4,7,4,200
sgml,sgml,,1,0,4,1,3,5,3,1
appdomainsetup,appdomainsetup,,0,1,2,1,7,3,8,1
jdbcrealm,jdbcrealm,,1,2,8,3,9,11,3,100
file-import,file-import,,2,3,2,5,10,7,0,50
bmc,bmc,,5,4,8,9,10,17,3,1
dwolla,dwolla,,1,0,0,1,5,1,4,1
short,short,,4,4,18,8,38,26,9,1
singleton-methods,singleton-methods,,0,0,0,0,10,0,3,1
opengl-es-3.1,opengl-es-3.1,,1,1,2,2,5,4,3,1
msbuild-4.0,msbuild-4.0,,1,1,5,2,9,7,8,1
ethercard,ethercard,,2,0,0,2,1,2,9,1
windows-nt,windows-nt,,0,1,4,1,3,5,9,1
task-runner-explorer,task-runner-explorer,,1,2,1,3,16,4,8,100
cfbundledisplayname,cfbundledisplayname,,2,0,1,2,3,3,13,1
ts-loader,ts-loader,,8,7,24,15,26,39,1,1
sybase-iq,sybase-iq,,8,5,21,13,31,34,4,1
dht,dht,,4,5,18,9,15,27,9,25
for-xml-path,for-xml-path,,4,5,4,9,32,13,4,25
xmladapter,xmladapter,,0,2,0,2,5,2,3,100
haskell-chart,haskell-chart,,1,0,1,1,1,2,2,1
wijmo5,wijmo5,,0,2,0,2,7,2,1,100
google-roads-api,google-roads-api,,0,4,5,4,10,9,1,300
ezpublish,ezpublish,,1,1,4,2,9,6,4,1
rubymine-7,rubymine-7,,0,0,0,0,4,0,12,1
cakephp-2.3,cakephp-2.3,,1,2,7,3,19,10,4,100
variants,variants,,0,0,0,0,7,0,4,1
ode45,ode45,,10,1,15,11,17,26,0,1
ffdshow,ffdshow,,1,0,2,1,3,3,13,1
wal-e,wal-e,,0,0,2,0,3,2,4,1
hummus.js,hummus.js,,4,3,2,7,16,9,1,1
amazon-cloudwatch-metrics,amazon-cloudwatch-metrics,,17,25,30,42,33,72,6,47.058824
pop,pop,,14,3,11,17,22,28,0,1
content-length,content-length,,9,4,16,13,25,29,4,1
crystal-reports-8.5,crystal-reports-8.5,,1,4,7,5,15,12,8,300
keyboard-maestro,keyboard-maestro,,1,1,1,2,7,3,13,1
sumatra,sumatra,,0,0,0,0,2,0,4,1
createdibsection,createdibsection,,1,0,1,1,2,2,9,1
nrf51,nrf51,,2,0,4,2,14,6,9,1
rterm,rterm,,0,0,0,0,1,0,0,1
avoriaz,avoriaz,,0,0,0,0,6,0,1,1
video-tracking,video-tracking,,1,5,7,6,18,13,0,400
back-projection,back-projection,,1,1,0,2,4,2,0,1
snmp-trap,snmp-trap,,7,3,18,10,17,28,9,1
affdex-sdk,affdex-sdk,,1,2,1,3,19,4,3,100
kernel32,kernel32,,3,6,7,9,22,16,8,100
jersey-client,jersey-client,,18,18,42,36,84,78,3,1
libarchive,libarchive,,1,0,3,1,11,4,9,1
moped,moped,,0,0,0,0,3,0,12,1
single-dispatch,single-dispatch,,1,4,1,5,4,6,0,300
http-status-code-401,http-status-code-401,,32,21,55,53,76,108,4,1
sessionstorage,sessionstorage,,0,0,0,0,33,0,1,1
es6-proxy,es6-proxy,,5,5,8,10,38,18,1,1
g++4.8,g++4.8,,0,1,4,1,11,5,9,1
ankhsvn,ankhsvn,,4,1,2,5,10,7,8,1
update-attribute,update-attribute,,0,0,0,0,3,0,12,1
application-lifecycle,application-lifecycle,,3,3,8,6,15,14,3,1
azure-timeseries-insights,azure-timeseries-insights,,6,6,6,12,9,18,8,1
scalaz-stream,scalaz-stream,,0,0,0,0,5,0,2,1
self-executing-function,self-executing-function,,1,0,4,1,5,5,1,1
amazon-glacier,amazon-glacier,,8,14,18,22,38,40,6,75
max-age,max-age,,3,1,3,4,7,7,4,1
test-environments,test-environments,,1,3,10,4,12,14,1,200
weibull,weibull,,7,9,17,16,27,33,0,28.571429
measurement-studio,measurement-studio,,0,1,0,1,2,1,8,1
wolfssl,wolfssl,,3,3,2,6,5,8,9,1
huffman-code,huffman-code,,30,9,53,39,89,92,0,1
dotnetrdf,dotnetrdf,,2,0,10,2,11,12,2,1
rdf-xml,rdf-xml,,0,4,3,4,12,7,2,300
apn,apn,,6,5,13,11,29,24,13,1
qregularexpression,qregularexpression,,9,7,13,16,13,29,0,1
osb,osb,,15,9,30,24,45,54,3,1
ccxml,ccxml,,0,1,0,1,2,1,13,1
google-directory-api,google-directory-api,,8,9,29,17,35,46,5,12.5
google-groups-api,google-groups-api,,1,4,11,5,11,16,5,300
multiple-domains,multiple-domains,,5,2,7,7,11,14,4,1
stylevision,stylevision,,0,0,0,0,1,0,3,1
laravel-dusk2,laravel-dusk2,,3,2,2,5,12,7,4,1
balance,balance,,6,2,11,8,27,19,0,1
http-status-code-406,http-status-code-406,,4,7,8,11,13,19,4,75
page-break,page-break,,14,6,22,20,35,42,1,1
page-break-inside,page-break-inside,,1,1,2,2,6,4,1,1
gmail-pop,gmail-pop,,0,0,0,0,1,0,4,1
jaxb2-basics,jaxb2-basics,,1,0,2,1,5,3,3,1
random-beans,random-beans,,0,0,2,0,2,2,3,1
tsx,tsx,,7,19,31,26,34,57,1,171.428571
azure-web-roles,azure-web-roles,,1,3,6,4,15,10,8,200
checkin-policy,checkin-policy,,1,0,1,1,8,2,8,1
sequencing,sequencing,,2,1,4,3,8,7,9,1
shim,shim,,10,3,12,13,20,25,8,1
internal-representation,internal-representation,,0,0,0,0,2,0,0,1
divmod,divmod,,2,0,0,2,3,2,0,1
enet,enet,,0,3,2,3,6,5,9,200
sectionedrecyclerviewadapter,sectionedrecyclerviewadapter,,3,5,9,8,14,17,3,66.666667
mapbox-marker,mapbox-marker,,14,14,21,28,24,49,1,1
request-promise,request-promise,,27,26,57,53,76,110,1,1
labeled-statements,labeled-statements,,0,0,2,0,3,2,3,1
clearos,clearos,,0,0,0,0,1,0,9,1
open-generics,open-generics,,1,1,0,2,4,2,8,1
facebook-sdk-4.x,facebook-sdk-4.x,,4,3,23,7,34,30,3,1
multiple-makefiles,multiple-makefiles,,1,1,0,2,4,2,9,1
mkmapsnapshotter,mkmapsnapshotter,,1,2,1,3,3,4,13,100
log4jdbc,log4jdbc,,0,1,4,1,3,5,3,1
json2xls,json2xls,,0,0,3,0,3,3,1,1
denormalized,denormalized,,2,0,1,2,6,3,4,1
abcpdf,abcpdf,,2,3,8,5,15,13,8,50
srgb,srgb,,3,4,3,7,12,10,0,33.333333
superscript,superscript,,4,8,20,12,33,32,0,100
hce,hce,,7,7,7,14,25,21,3,1
chilkat,chilkat,,20,20,26,40,11,66,4,1
locality-sensitive-hash,locality-sensitive-hash,,1,1,3,2,10,5,2,1
imread,imread,,13,5,11,18,37,29,0,1
laravel-notification,laravel-notification,,5,4,17,9,20,26,4,1
python-pbr,python-pbr,,0,1,0,1,4,1,0,1
ocx,ocx,,4,3,8,7,26,15,8,1
falcor,falcor,,2,0,2,2,2,4,1,1
falcor-router,falcor-router,,2,0,1,2,1,3,1,1
endl,endl,,0,1,3,1,6,4,9,1
ngrok,ngrok,,36,28,60,64,93,124,4,1
dialogviewcontroller,dialogviewcontroller,,0,0,0,0,2,0,13,1
codeanywhere,codeanywhere,,2,0,10,2,18,12,1,1
pstack,pstack,,0,0,0,0,2,0,3,1
mallet,mallet,,19,3,11,22,35,33,0,1
svmlight,svmlight,,2,3,1,5,2,6,0,50
string-conversion,string-conversion,,7,2,12,9,36,21,0,1
boost-variant,boost-variant,,7,1,5,8,24,13,9,1
azure-devops-self-hosted-agent,azure-devops-self-hosted-agent,,16,17,21,33,13,54,8,6.25
web-operating-system,web-operating-system,,0,0,1,0,1,1,8,1
arquillian-drone,arquillian-drone,,0,4,0,4,11,4,3,300
ember-controllers,ember-controllers,,0,0,2,0,2,2,1,1
multiple-select,multiple-select,,6,8,18,14,31,32,1,33.333333
type-annotation,type-annotation,,3,1,5,4,8,9,0,1
postal-code,postal-code,,6,7,11,13,32,24,0,16.666667
python-imageio,python-imageio,,12,6,18,18,36,36,0,1
routines,routines,,1,0,9,1,3,10,6,1
attribution,attribution,,2,5,11,7,17,18,3,150
filterrific,filterrific,,2,2,8,4,7,12,12,1
pact-node,pact-node,,0,0,0,0,5,0,3,1
mlt,mlt,,2,0,7,2,9,9,13,1
gesturedetector,gesturedetector,,13,9,14,22,17,36,3,1
nanotime,nanotime,,8,2,5,10,6,15,3,1
pedometer,pedometer,,6,4,6,10,12,16,13,1
vertx-verticle,vertx-verticle,,4,10,19,14,32,33,3,150
tabbarcontroller,tabbarcontroller,,2,1,6,3,17,9,13,1
transmission-daemon,transmission-daemon,,1,0,2,1,7,3,9,1
accumarray,accumarray,,0,1,1,1,6,2,0,1
katex,katex,,6,7,16,13,13,29,1,16.666667
liferay-theme,liferay-theme,,3,3,13,6,28,19,3,1
sa,sa,,0,0,0,0,2,0,4,1
custom-properties,custom-properties,,1,0,7,1,7,8,8,1
extended-sql,extended-sql,,7,4,13,11,14,24,3,1
rex,rex,,2,0,1,2,4,3,6,1
softkeys,softkeys,,0,0,0,0,7,0,3,1
contextswitchdeadlock,contextswitchdeadlock,,0,1,0,1,1,1,8,1
idisposable,idisposable,,15,7,27,22,47,49,8,1
odroid,odroid,,5,3,7,8,21,15,9,1
network-state,network-state,,0,1,1,1,4,2,3,1
angular2-google-maps,angular2-google-maps,,0,1,1,1,10,2,1,1
mangodb,mangodb,,5,4,5,9,15,14,1,1
android-annotations,android-annotations,,3,5,9,8,23,17,3,66.666667
mariasql,mariasql,,5,3,13,8,25,21,4,1
bundles,bundles,,2,1,11,3,19,14,4,1
strchr,strchr,,4,2,4,6,7,10,9,1
mach-o,mach-o,,3,3,7,6,28,13,13,1
git-for-windows,git-for-windows,,7,5,14,12,30,26,6,1
ng-upgrade,ng-upgrade,,7,8,20,15,30,35,1,14.285714
angular-upgrade,angular-upgrade,,7,11,19,18,27,37,1,57.142857
jgiven,jgiven,,0,0,2,0,1,2,3,1
ibm-verse,ibm-verse,,0,0,0,0,1,0,8,1
renaming,renaming,,11,2,24,13,43,37,0,1
parsedown,parsedown,,0,1,1,1,3,2,4,1
structuremap4,structuremap4,,0,1,3,1,16,4,8,1
oci,oci,,12,13,33,25,49,58,4,8.333333
biztalk-deployment,biztalk-deployment,,0,0,0,0,1,0,8,1
sln-file,sln-file,,3,2,2,5,11,7,8,1
mirc,mirc,,2,0,1,2,2,3,8,1
tableau-public,tableau-public,,22,10,25,32,32,57,4,1
docker-java,docker-java,,4,3,2,7,13,9,6,1
remix,remix,,11,12,36,23,63,59,6,9.090909
guacamole,guacamole,,11,13,11,24,15,35,9,18.181818
sqlmembershipprovider,sqlmembershipprovider,,0,3,2,3,5,5,8,200
didselectrowatindexpath,didselectrowatindexpath,,3,3,16,6,34,22,13,1
google-iam,google-iam,,25,32,45,57,41,102,6,28
sjcl,sjcl,,3,0,1,3,5,4,6,1
gated-checkin,gated-checkin,,1,0,5,1,9,6,8,1
excel-r1c1-notation,excel-r1c1-notation,,3,2,2,5,9,7,5,1
mobile-webkit,mobile-webkit,,2,2,4,4,5,8,1,1
bitrix,bitrix,,5,5,11,10,14,21,4,1
petalinux,petalinux,,5,5,10,10,11,20,9,1
qxmlstreamreader,qxmlstreamreader,,0,0,1,0,7,1,9,1
nanogallery,nanogallery,,0,1,0,1,4,1,1,1
dsx-desktop,dsx-desktop,,2,0,0,2,5,2,0,1
jak,jak,,1,0,0,1,4,1,3,1
prunsrv,prunsrv,,0,2,1,2,1,3,3,100
kubernetes-pvc,kubernetes-pvc,,20,9,26,29,21,55,6,1
revit-api,revit-api,,27,30,50,57,56,107,8,11.111111
backcolor,backcolor,,3,0,6,3,3,9,8,1
ecies,ecies,,0,0,0,0,3,0,6,1
metastore,metastore,,5,2,2,7,17,9,2,1
intune,intune,,16,19,26,35,49,61,8,18.75
sqldataadapter,sqldataadapter,,7,11,10,18,25,28,8,57.142857
oledbdatareader,oledbdatareader,,2,4,7,6,11,13,8,100
fuzzyjoin,fuzzyjoin,,8,5,10,13,18,23,0,1
visualsvn-server,visualsvn-server,,3,2,26,5,27,31,6,1
component-design,component-design,,1,0,0,1,4,1,1,1
unpoly,unpoly,,3,0,0,3,1,3,1,1
video-embedding,video-embedding,,1,1,4,2,8,6,1,1
server-to-server,server-to-server,,2,2,6,4,9,10,4,1
qsortfilterproxymodel,qsortfilterproxymodel,,8,7,9,15,24,24,9,1
choco,choco,,2,3,9,5,17,14,0,50
trailblazer,trailblazer,,0,0,5,0,9,5,12,1
gethashcode,gethashcode,,1,1,11,2,13,13,8,1
resharper-2017,resharper-2017,,0,1,0,1,9,1,8,1
qtconcurrent,qtconcurrent,,2,4,8,6,16,14,9,100
kura,kura,,0,1,2,1,14,3,3,1
victory-charts,victory-charts,,7,21,25,28,33,53,1,200
allauth,allauth,,7,4,11,11,22,22,0,1
inline-editing,inline-editing,,6,0,3,6,11,9,1,1
oft,oft,,2,0,1,2,3,3,5,1
wincvs,wincvs,,0,0,0,0,1,0,6,1
minishift,minishift,,2,16,12,18,37,30,6,700
wsimport,wsimport,,7,10,24,17,45,41,3,42.857143
vstest,vstest,,14,21,34,35,46,69,8,50
md-chip,md-chip,,2,1,2,3,8,5,1,1
guard-statement,guard-statement,,1,1,5,2,3,7,2,1
droppable,droppable,,3,3,7,6,11,13,1,1
shaderlab,shaderlab,,3,4,11,7,11,18,9,33.333333
irq,irq,,7,4,8,11,22,19,9,1
qdbus,qdbus,,1,1,1,2,4,3,9,1
gdbus,gdbus,,9,3,9,12,16,21,9,1
isapi-extension,isapi-extension,,0,0,0,0,1,0,8,1
unnest,unnest,,4,10,17,14,29,31,0,150
application-verifier,application-verifier,,0,0,2,0,4,2,9,1
opencv-contrib,opencv-contrib,,5,4,10,9,28,19,0,1
charactercount,charactercount,,0,2,3,2,5,5,1,100
ispostback,ispostback,,1,1,1,2,3,3,8,1
sw-toolbox,sw-toolbox,,0,1,1,1,10,2,1,1
smart-wizard,smart-wizard,,2,4,4,6,9,10,1,100
flower,flower,,6,3,12,9,26,21,0,1
geometry-shader,geometry-shader,,0,1,8,1,18,9,9,1
inverse,inverse,,11,7,23,18,32,41,0,1
vga,vga,,7,9,12,16,12,28,9,28.571429
angularjs-1.5,angularjs-1.5,,2,2,4,4,10,8,1,1
angularjs-1.6,angularjs-1.6,,4,2,11,6,34,17,1,1
postmark,postmark,,1,2,6,3,8,9,4,100
anki,anki,,4,5,10,9,16,19,1,25
data-security,data-security,,0,2,4,2,9,6,4,100
colorama,colorama,,6,4,7,10,11,17,0,1
gpuarray,gpuarray,,0,1,5,1,3,6,0,1
memory-limit,memory-limit,,2,5,9,7,14,16,4,150
vue-apollo,vue-apollo,,18,31,28,49,21,77,1,72.222222
ajv,ajv,,23,14,26,37,44,63,1,1
nsurlsessionuploadtask,nsurlsessionuploadtask,,6,1,7,7,11,14,13,1
nsurlsessionconfiguration,nsurlsessionconfiguration,,4,6,5,10,9,15,13,50
run-length-encoding,run-length-encoding,,7,6,17,13,21,30,0,1
microsoft-exchange,microsoft-exchange,,2,1,6,3,11,9,8,1
pmta,pmta,,0,0,0,0,4,0,9,1
google-container-builder,google-container-builder,,1,0,4,1,34,5,6,1
agents-jade,agents-jade,,7,6,7,13,28,20,3,1
agent-based-modeling,agent-based-modeling,,31,15,25,46,45,71,0,1
agenda,agenda,,10,2,14,12,16,26,1,1
cics,cics,,4,0,8,4,12,12,3,1
3270,3270,,0,1,4,1,5,5,5,1
email-ext,email-ext,,2,5,8,7,17,15,6,150
jelly,jelly,,1,7,8,8,15,16,6,600
maven-module,maven-module,,3,4,6,7,15,13,3,33.333333
impyla,impyla,,2,2,6,4,11,10,2,1
hardcode,hardcode,,2,4,3,6,10,9,4,100
hardcoded,hardcoded,,0,3,1,3,6,4,3,200
4gl,4gl,,2,2,2,4,9,6,4,1
meetup,meetup,,0,6,4,6,7,10,4,500
fractions,fractions,,17,7,26,24,77,50,0,1
textcolor,textcolor,,7,8,20,15,32,35,3,14.285714
android-variants,android-variants,,0,1,0,1,1,1,3,1
autoquery-servicestack,autoquery-servicestack,,0,0,0,0,3,0,8,1
swift2.3,swift2.3,,1,0,1,1,17,2,13,1
viper-go,viper-go,,1,2,5,3,10,8,6,100
8-puzzle,8-puzzle,,3,2,6,5,18,11,0,1
staging,staging,,10,11,18,21,44,39,6,10
lua-busted,lua-busted,,0,0,1,0,5,1,9,1
pako,pako,,2,5,4,7,10,11,1,150
syntaxnet,syntaxnet,,0,0,2,0,9,2,0,1
iedriverserver,iedriverserver,,8,5,12,13,35,25,3,1
muparser,muparser,,2,0,0,2,2,2,9,1
data-lake,data-lake,,8,10,18,18,24,36,8,25
python-hypothesis,python-hypothesis,,8,9,13,17,13,30,0,12.5
dynamic-variables,dynamic-variables,,3,4,8,7,20,15,4,33.333333
gssapi,gssapi,,7,2,18,9,22,27,2,1
itunesartwork,itunesartwork,,0,0,0,0,1,0,13,1
jedi-vim,jedi-vim,,3,0,1,3,3,4,0,1
provider,provider,,16,21,17,37,58,54,1,31.25
python-performance,python-performance,,0,1,2,1,6,3,0,1
nsbuttoncell,nsbuttoncell,,0,0,2,0,3,2,13,1
hardware-interface,hardware-interface,,2,1,4,3,9,7,9,1
jenkins-groovy,jenkins-groovy,,156,201,141,357,113,498,6,28.846154
twirl,twirl,,2,3,4,5,22,9,2,50
facebook-conceal,facebook-conceal,,0,1,1,1,2,2,3,1
default-programs,default-programs,,0,1,4,1,1,5,9,1
joomla3.8,joomla3.8,,2,0,8,2,12,10,4,1
object-property,object-property,,2,2,4,4,11,8,2,1
tabris,tabris,,0,0,1,0,9,1,1,1
tabris-js,tabris-js,,0,1,0,1,9,1,1,1
jnlp,jnlp,,19,14,29,33,86,62,3,1
wing-ide,wing-ide,,2,2,6,4,4,10,0,1
init.d,init.d,,4,5,12,9,23,21,9,25
hkhealthstore,hkhealthstore,,6,1,9,7,19,16,13,1
data-link-layer,data-link-layer,,0,0,7,0,8,7,9,1
7-bit,7-bit,,1,0,1,1,4,2,9,1
servicenow-rest-api,servicenow-rest-api,,9,10,25,19,25,44,1,11.111111
unobtrusive-javascript,unobtrusive-javascript,,0,0,0,0,3,0,12,1
collection-select,collection-select,,2,2,6,4,11,10,12,1
openj9,openj9,,4,3,3,7,4,10,3,1
comet,comet,,1,0,6,1,8,7,3,1
comet-ml,comet-ml,,0,1,0,1,4,1,0,1
splitter,splitter,,1,4,9,5,16,14,3,300
polymodel,polymodel,,0,0,0,0,2,0,6,1
lpr,lpr,,2,0,2,2,2,4,9,1
mux,mux,,19,15,29,34,45,63,6,1
gridster,gridster,,5,2,3,7,27,10,1,1
ocamlfind,ocamlfind,,1,1,7,2,7,9,0,1
brakeman,brakeman,,0,1,4,1,6,5,12,1
dotnet-test,dotnet-test,,5,0,2,5,4,7,8,1
document.write,document.write,,4,10,20,14,21,34,1,150
dkpro-core,dkpro-core,,3,0,1,3,6,4,3,1
webanno,webanno,,0,1,0,1,2,1,0,1
augraph,augraph,,2,2,2,4,4,6,13,1
orleans,orleans,,7,3,12,10,23,22,8,1
polymorphic-functions,polymorphic-functions,,0,0,1,0,3,1,2,1
aspxgridview,aspxgridview,,10,15,21,25,43,46,8,50
apache-samza,apache-samza,,2,4,5,6,5,11,2,100
contourf,contourf,,10,14,20,24,34,44,0,40
cyclic,cyclic,,6,2,6,8,9,14,0,1
3des,3des,,8,8,14,16,27,30,6,1
cbc-mode,cbc-mode,,8,8,13,16,25,29,6,1
setenv,setenv,,4,3,5,7,5,12,9,1
mpmediaitem,mpmediaitem,,2,2,3,4,17,7,13,1
itunes-sdk,itunes-sdk,,0,1,4,1,6,5,13,1
autofactory,autofactory,,0,0,0,0,3,0,8,1
subforms,subforms,,0,0,0,0,11,0,5,1
neuronesb,neuronesb,,0,0,0,0,3,0,3,1
pyperclip,pyperclip,,4,6,11,10,28,21,0,50
micrometer,micrometer,,24,28,44,52,62,96,3,16.666667
wiql,wiql,,5,5,9,10,22,19,8,1
openair,openair,,8,2,4,10,12,14,0,1
object-fit,object-fit,,3,3,11,6,13,17,1,1
uipagecontrol,uipagecontrol,,13,9,21,22,50,43,13,1
child-theming,child-theming,,3,3,9,6,19,15,4,1
android-graphview,android-graphview,,20,7,33,27,67,60,3,1
proxies,proxies,,1,6,12,7,18,19,6,500
auto-value,auto-value,,5,3,6,8,18,14,3,1
vtd-xml,vtd-xml,,1,5,3,6,13,9,3,400
golint,golint,,1,1,2,2,3,4,6,1
susy,susy,,2,0,1,2,7,3,1,1
susy-sass,susy-sass,,1,0,1,1,3,2,1,1
www-mechanize,www-mechanize,,0,1,4,1,10,5,9,1
net-http,net-http,,7,8,9,15,33,24,12,14.285714
cmmotionmanager,cmmotionmanager,,3,1,3,4,7,7,13,1
libgit2sharp,libgit2sharp,,12,3,23,15,36,38,6,1
content-script,content-script,,9,14,34,23,48,57,1,55.555556
org-babel,org-babel,,4,3,11,7,14,18,9,1
jlayeredpane,jlayeredpane,,3,0,6,3,12,9,3,1
tls1.0,tls1.0,,4,5,10,9,23,19,6,25
algebraic-data-types,algebraic-data-types,,9,14,17,23,42,40,2,55.555556
minimal-json,minimal-json,,0,0,0,0,1,0,1,1
formal-verification,formal-verification,,15,6,16,21,40,37,2,1
nvcc,nvcc,,15,16,19,31,60,50,9,6.666667
firebase-predictions,firebase-predictions,,0,1,0,1,3,1,13,1
proof,proof,,21,11,39,32,75,71,2,1
w2ui,w2ui,,6,1,9,7,20,16,1,1
js-cookie,js-cookie,,7,5,3,12,16,15,1,1
attached-properties,attached-properties,,7,9,13,16,30,29,8,28.571429
csharpcodeprovider,csharpcodeprovider,,2,4,7,6,11,13,8,100
mkmapitem,mkmapitem,,1,1,2,2,5,4,13,1
mklocalsearch,mklocalsearch,,2,2,7,4,7,11,13,1
zeal,zeal,,0,0,0,0,1,0,2,1
linq-to-objects,linq-to-objects,,4,1,8,5,19,13,8,1
async-safe,async-safe,,1,0,0,1,1,1,9,1
google-cloud-launcher,google-cloud-launcher,,0,0,1,0,9,1,6,1
calc,calc,,3,7,20,10,53,30,1,133.333333
azure-monitoring,azure-monitoring,,33,40,42,73,25,115,8,21.212121
pt-query-digest,pt-query-digest,,2,0,0,2,1,2,4,1
tweenlite,tweenlite,,4,1,4,5,12,9,1,1
gl-matrix,gl-matrix,,4,0,4,4,2,8,1,1
eol,eol,,10,2,10,12,22,22,6,1
pact-java,pact-java,,0,1,2,1,8,3,3,1
appstore-approval,appstore-approval,,27,20,39,47,68,86,13,1
microsoft-fakes,microsoft-fakes,,7,10,3,17,21,20,8,42.857143
response.write,response.write,,0,0,3,0,4,3,8,1
special-form,special-form,,0,0,0,0,3,0,0,1
clr-profiling-api,clr-profiling-api,,4,7,2,11,13,13,8,75
copy-on-write,copy-on-write,,4,3,8,7,15,15,9,1
xcode10,xcode10,,105,86,667,191,133,858,13,1
postcss-import,postcss-import,,4,2,2,6,11,8,1,1
nav-pills,nav-pills,,2,5,5,7,9,12,1,150
flask-cli,flask-cli,,1,3,7,4,6,11,0,200
pypi-regex,pypi-regex,,0,0,1,0,3,1,0,1
numberpicker,numberpicker,,7,7,9,14,23,23,3,1
open-basedir,open-basedir,,1,4,1,5,5,6,4,300
defaultmodelbinder,defaultmodelbinder,,0,2,1,2,4,3,8,100
out,out,,9,11,23,20,34,43,8,22.222222
tinymce-rails,tinymce-rails,,2,2,1,4,4,5,12,1
dynamics-ax-2012-r3,dynamics-ax-2012-r3,,4,5,9,9,17,18,8,25
docker-secrets,docker-secrets,,3,5,12,8,14,20,6,66.666667
hardware-programming,hardware-programming,,6,2,17,8,14,25,9,1
window-soft-input-mode,window-soft-input-mode,,4,2,11,6,11,17,3,1
stage,stage,,10,7,21,17,38,38,3,1
pascals-triangle,pascals-triangle,,8,3,8,11,23,19,0,1
adyen,adyen,,6,4,9,10,11,19,4,1
gomail,gomail,,1,1,1,2,4,3,6,1
visual-editor,visual-editor,,4,3,6,7,8,13,4,1
bindable,bindable,,3,6,6,9,8,15,8,100
pdfpages,pdfpages,,3,1,3,4,4,7,0,1
parameter-expansion,parameter-expansion,,3,12,11,15,16,26,9,300
helpcontext,helpcontext,,0,0,0,0,1,0,8,1
qpython3,qpython3,,3,6,6,9,17,15,0,100
emma,emma,,4,1,2,5,4,7,3,1
emmarun,emmarun,,1,0,0,1,1,1,3,1
onlinejudge,onlinejudge,,7,5,6,12,7,18,9,1
laravel-filesystem,laravel-filesystem,,2,3,14,5,18,19,4,50
bitwise-xor,bitwise-xor,,3,7,9,10,13,19,9,133.333333
rebar3,rebar3,,2,1,6,3,17,9,2,1
ispconfig-3,ispconfig-3,,2,0,3,2,7,5,4,1
filesystemobject,filesystemobject,,4,4,8,8,24,16,5,1
mobius,mobius,,1,1,2,2,4,4,2,1
munin,munin,,1,1,0,2,2,2,3,1
extjs3,extjs3,,6,1,14,7,29,21,1,1
scrollpane,scrollpane,,8,7,10,15,32,25,3,1
tradingview-api,tradingview-api,,41,24,59,65,57,124,0,1
pine-script,pine-script,,35,33,46,68,47,114,0,1
font-rendering,font-rendering,,0,2,2,2,9,4,1,100
packed,packed,,0,2,4,2,6,6,9,100
android-custom-drawable,android-custom-drawable,,0,1,1,1,6,2,3,1
racing,racing,,1,0,3,1,3,4,8,1
multipleselection,multipleselection,,7,5,11,12,17,23,13,1
jmockit,jmockit,,15,7,31,22,48,53,3,1
dgml,dgml,,4,1,0,5,2,5,8,1
sonarlint-vs,sonarlint-vs,,1,1,4,2,8,6,3,1
safari-extension,safari-extension,,13,7,26,20,34,46,13,1
scrapy-pipeline,scrapy-pipeline,,10,5,13,15,38,28,0,1
oneclick,oneclick,,4,3,4,7,4,11,8,1
mpd,mpd,,5,3,8,8,13,16,13,1
remote-connection,remote-connection,,3,5,10,8,6,18,4,66.666667
device-admin,device-admin,,13,7,15,20,18,35,3,1
device-owner,device-owner,,13,4,11,17,21,28,3,1
privilege,privilege,,0,0,0,0,9,0,9,1
azure-ad-b2b,azure-ad-b2b,,4,13,15,17,32,32,8,225
google-cloud-internal-load-balancer,google-cloud-internal-load-balancer,,2,0,2,2,3,4,6,1
client-certificates,client-certificates,,40,35,80,75,107,155,6,1
autocommit,autocommit,,3,2,14,5,18,19,3,1
run-script,run-script,,3,1,10,4,10,14,13,1
java-binding,java-binding,,3,1,1,4,6,5,8,1
mdp,mdp,,5,1,3,6,4,9,0,1
execcommand,execcommand,,2,8,18,10,23,28,1,300
asynchronous-postback,asynchronous-postback,,0,0,3,0,1,3,3,1
khan-academy,khan-academy,,3,0,2,3,10,5,1,1
short-filenames,short-filenames,,1,0,1,1,2,2,9,1
pareto-chart,pareto-chart,,2,1,5,3,9,8,0,1
getstream-io,getstream-io,,18,22,15,40,35,55,13,22.222222
state-restoration,state-restoration,,2,5,8,7,6,15,13,150
aspect,aspect,,20,11,24,31,51,55,3,1
hfile,hfile,,4,1,4,5,4,9,2,1
pmd,pmd,,10,15,23,25,39,48,3,50
framework3.5,framework3.5,,1,0,1,1,5,2,8,1
theos,theos,,14,5,3,19,21,22,13,1
tweak,tweak,,13,6,3,19,12,22,13,1
xcuitest,xcuitest,,47,34,63,81,120,144,13,1
listdir,listdir,,6,3,8,9,19,17,0,1
dbm,dbm,,2,2,3,4,11,7,0,1
neo4j-batch-inserter,neo4j-batch-inserter,,0,0,0,0,2,0,2,1
python-click,python-click,,29,11,26,40,55,66,0,1
code-readability,code-readability,,6,4,14,10,27,24,3,1
nshttpcookie,nshttpcookie,,0,0,1,0,7,1,13,1
nshttpcookiestorage,nshttpcookiestorage,,1,0,2,1,4,3,13,1
mix-blend-mode,mix-blend-mode,,5,12,14,17,17,31,1,140
background-blend-mode,background-blend-mode,,1,3,1,4,3,5,1,200
certificate-revocation,certificate-revocation,,4,5,8,9,18,17,6,25
arago,arago,,1,0,0,1,3,1,9,1
chrome-for-android,chrome-for-android,,0,5,2,5,3,7,1,400
react-native-config,react-native-config,,2,1,3,3,3,6,1,1
jaspic,jaspic,,0,0,1,0,6,1,3,1
lapacke,lapacke,,4,3,8,7,9,15,9,1
suppress,suppress,,0,2,6,2,11,8,2,100
capybara-webkit,capybara-webkit,,2,4,7,6,25,13,12,100
react-d3,react-d3,,1,4,4,5,13,9,1,300
virtual-serial-port,virtual-serial-port,,0,0,5,0,11,5,9,1
construct-2,construct-2,,2,1,2,3,13,5,1,1
imapclient,imapclient,,2,2,6,4,4,10,0,1
ob-start,ob-start,,2,2,3,4,10,7,4,1
chr,chr,,1,4,6,5,12,11,0,300
iteritems,iteritems,,2,0,4,2,2,6,0,1
winrar,winrar,,9,2,8,11,16,19,9,1
jks,jks,,14,14,24,28,62,52,6,1
awesomeprint,awesomeprint,,0,0,0,0,3,0,12,1
pyscripter,pyscripter,,2,1,9,3,12,12,0,1
zepto,zepto,,0,3,6,3,6,9,1,200
mediastore,mediastore,,17,13,25,30,67,55,3,1
smart-table,smart-table,,2,5,9,7,29,16,1,150
dmp,dmp,,0,1,4,1,6,5,9,1
extending,extending,,4,6,3,10,12,13,3,50
dollar-sign,dollar-sign,,5,1,7,6,11,13,0,1
datetime64,datetime64,,1,4,5,5,6,10,0,300
buddy-build,buddy-build,,2,0,1,2,5,3,13,1
kubeadm,kubeadm,,37,36,97,73,128,170,6,1
keyeventargs,keyeventargs,,1,1,1,2,5,3,8,1
qtextstream,qtextstream,,1,1,1,2,13,3,9,1
qtreeview,qtreeview,,17,24,50,41,72,91,9,41.176471
buildpath,buildpath,,4,5,8,9,14,17,3,25
log4js-node,log4js-node,,3,8,8,11,16,19,1,166.666667
credential-providers,credential-providers,,10,4,18,14,21,32,9,1
ember-cp-validations,ember-cp-validations,,0,3,1,3,4,4,1,200
titanium-modules,titanium-modules,,1,0,3,1,8,4,13,1
freetype,freetype,,7,15,20,22,39,42,9,114.285714
c#-interactive,c#-interactive,,1,1,2,2,13,4,8,1
aws-dms,aws-dms,,29,17,32,46,41,78,6,1
orange-api,orange-api,,3,2,5,5,4,10,4,1
gitlab-pages,gitlab-pages,,11,6,11,17,20,28,6,1
azure-storage-account,azure-storage-account,,12,7,7,19,23,26,8,1
azure-cloud-shell,azure-cloud-shell,,2,6,12,8,25,20,8,200
array-key,array-key,,2,3,3,5,13,8,4,50
database-security,database-security,,5,2,12,7,14,19,4,1
malmo,malmo,,0,0,1,0,4,1,0,1
swizzling,swizzling,,0,0,7,0,11,7,13,1
method-swizzling,method-swizzling,,1,0,5,1,17,6,13,1
method-hiding,method-hiding,,1,2,2,3,9,5,9,100
freshdesk,freshdesk,,7,4,7,11,18,18,8,1
lettuce,lettuce,,17,26,26,43,27,69,3,52.941176
getpass,getpass,,6,2,5,8,8,13,0,1
kinect.toolbox,kinect.toolbox,,0,0,0,0,1,0,8,1
java-memory-leaks,java-memory-leaks,,1,3,4,4,12,8,3,200
apache-metamodel,apache-metamodel,,0,2,4,2,2,6,3,100
payflowpro,payflowpro,,3,0,2,3,10,5,4,1
processwire,processwire,,1,1,3,2,9,5,4,1
javascript-framework,javascript-framework,,5,2,14,7,20,21,1,1
yammer,yammer,,11,7,15,18,32,33,4,1
photoeditorsdk,photoeditorsdk,,2,1,21,3,41,24,3,1
google-domain-api,google-domain-api,,0,0,3,0,12,3,5,1
glow,glow,,1,2,1,3,8,4,1,100
qsizepolicy,qsizepolicy,,0,3,3,3,3,6,9,200
sqlgeometry,sqlgeometry,,0,1,5,1,11,6,4,1
dynamic-reports,dynamic-reports,,1,4,5,5,11,10,3,300
cucumberjs,cucumberjs,,43,39,78,82,113,160,3,1
formclosing,formclosing,,2,2,5,4,14,9,8,1
xcode-bots,xcode-bots,,1,0,7,1,17,8,13,1
cfc,cfc,,2,4,7,6,13,13,4,100
ion-slide-box,ion-slide-box,,0,0,0,0,2,0,1,1
ptvs,ptvs,,2,2,3,4,6,7,0,1
cordova-cli,cordova-cli,,2,1,6,3,10,9,1,1
sktilemapnode,sktilemapnode,,5,1,10,6,20,16,13,1
documents,documents,,0,0,0,0,18,0,1,1
transactionscope,transactionscope,,18,11,21,29,53,50,8,1
spatial-data-frame,spatial-data-frame,,2,0,3,2,8,5,0,1
angularjs-limitto,angularjs-limitto,,2,0,0,2,6,2,1,1
sugarbean,sugarbean,,5,1,2,6,4,8,4,1
kubernetes-pod,kubernetes-pod,,53,94,65,147,41,212,6,77.358491
msf4j,msf4j,,3,2,2,5,9,7,3,1
wso2msf4j,wso2msf4j,,3,0,1,3,5,4,3,1
captivenetwork,captivenetwork,,2,1,3,3,11,6,3,1
socketpair,socketpair,,1,0,1,1,2,2,9,1
32feet,32feet,,2,2,10,4,19,14,8,1
autotouch,autotouch,,0,0,0,0,2,0,9,1
inflate-exception,inflate-exception,,4,7,7,11,26,18,3,75
asterisk-java,asterisk-java,,2,2,2,4,13,6,13,1
qheaderview,qheaderview,,3,5,2,8,15,10,9,66.666667
sku,sku,,11,6,14,17,15,31,4,1
ca-api-gateway,ca-api-gateway,,3,1,0,4,1,4,6,1
for-in-loop,for-in-loop,,11,14,14,25,46,39,1,27.272727
c14n,c14n,,1,0,0,1,4,1,0,1
maybe,maybe,,4,3,19,7,27,26,2,1
readerwriterlockslim,readerwriterlockslim,,3,1,5,4,3,9,8,1
opennn,opennn,,0,0,0,0,5,0,9,1
context-switching,context-switching,,3,1,3,4,6,7,9,1
irrlicht,irrlicht,,3,1,3,4,7,7,9,1
raytracing,raytracing,,26,19,27,45,41,72,0,1
mci,mci,,2,2,0,4,2,4,13,1
realex-payments-api,realex-payments-api,,2,0,4,2,9,6,4,1
rasterize,rasterize,,4,5,4,9,12,13,0,25
tmx,tmx,,2,2,2,4,6,6,3,1
svc,svc,,9,7,12,16,18,28,0,1
intptr,intptr,,4,2,5,6,17,11,8,1
recursive-descent,recursive-descent,,2,3,6,5,14,11,0,50
full-text-indexing,full-text-indexing,,15,10,24,25,46,49,4,1
level-of-detail,level-of-detail,,0,2,2,2,8,4,4,100
save-image,save-image,,2,3,7,5,10,12,3,50
multivalue,multivalue,,6,6,16,12,19,28,4,1
jacoco-maven-plugin,jacoco-maven-plugin,,12,23,35,35,51,70,3,91.666667
smartercsv,smartercsv,,0,1,1,1,3,2,12,1
sitecore-ucommerce,sitecore-ucommerce,,0,2,0,2,1,2,8,100
justmock,justmock,,1,1,2,2,8,4,8,1
git-log,git-log,,22,26,43,48,75,91,6,18.181818
vuejs-directive,vuejs-directive,,4,6,13,10,36,23,1,50
ereg-replace,ereg-replace,,0,0,2,0,3,2,4,1
jarsigner,jarsigner,,3,7,11,10,25,21,3,133.333333
propertydescriptor,propertydescriptor,,2,2,0,4,2,4,8,1
boost-adaptors,boost-adaptors,,1,1,0,2,2,2,9,1
safe-navigation-operator,safe-navigation-operator,,0,1,3,1,6,4,1,1
ruby-overcommit,ruby-overcommit,,2,0,0,2,3,2,6,1
tablecelleditor,tablecelleditor,,0,0,4,0,11,4,3,1
16-bit,16-bit,,8,4,8,12,27,20,9,1
autoexp.dat,autoexp.dat,,0,0,0,0,2,0,9,1
large-data-volumes,large-data-volumes,,1,2,5,3,8,8,0,100
infragistics,infragistics,,22,9,28,31,73,59,8,1
dbd,dbd,,0,3,5,3,6,8,9,200
vue-tables-2,vue-tables-2,,10,5,22,15,40,37,1,1
qstringlistmodel,qstringlistmodel,,1,0,1,1,5,2,9,1
quartz-graphics,quartz-graphics,,1,0,8,1,9,9,13,1
meteor-helper,meteor-helper,,0,0,0,0,3,0,1,1
flicker,flicker,,22,9,18,31,37,49,1,1
intern,intern,,7,4,5,11,35,16,1,1
leadfoot,leadfoot,,1,0,2,1,6,3,1,1
iphone-4,iphone-4,,0,1,1,1,2,2,13,1
node-horseman,node-horseman,,0,0,1,0,6,1,1,1
sql-import-wizard,sql-import-wizard,,2,2,2,4,9,6,4,1
invantive-query-tool,invantive-query-tool,,0,0,0,0,4,0,4,1
s3-bucket,s3-bucket,,1,1,6,2,30,8,6,1
binaryreader,binaryreader,,1,1,6,2,13,8,8,1
plone-4.x,plone-4.x,,3,2,7,5,27,12,0,1
pymodm,pymodm,,1,2,7,3,4,10,1,100
bing-ads-api,bing-ads-api,,10,2,3,12,18,15,8,1
generic-function,generic-function,,3,2,4,5,7,9,0,1
matplotlib.mlab,matplotlib.mlab,,1,1,1,2,5,3,0,1
mongodb-indexes,mongodb-indexes,,8,9,10,17,30,27,1,12.5
install-referrer,install-referrer,,3,4,9,7,15,16,3,33.333333
cbcentralmanager,cbcentralmanager,,2,5,9,7,27,16,13,150
spring-test-mvc,spring-test-mvc,,17,13,21,30,43,51,3,1
angularjs-controlleras,angularjs-controlleras,,1,0,0,1,12,1,1,1
x-editable,x-editable,,7,6,15,13,37,28,1,1
boehm-gc,boehm-gc,,3,0,3,3,3,6,9,1
refs,refs,,4,5,10,9,26,19,1,25
installation-package,installation-package,,6,3,13,9,15,22,0,1
far,far,,0,2,0,2,1,2,9,100
javascript-import,javascript-import,,5,6,11,11,8,22,1,20
soql,soql,,19,13,23,32,60,55,14,1
ssrs-subscription,ssrs-subscription,,0,3,2,3,3,5,4,200
pint,pint,,2,2,8,4,6,12,0,1
gcovr,gcovr,,3,0,5,3,11,8,9,1
ace-editor,ace-editor,,20,39,46,59,80,105,1,95
tweets,tweets,,25,14,25,39,59,64,0,1
uiaccessibility,uiaccessibility,,24,23,36,47,53,83,13,1
nssortdescriptor,nssortdescriptor,,2,0,6,2,14,8,13,1
private-subnet,private-subnet,,10,4,11,14,14,25,6,1
qttest,qttest,,0,6,7,6,9,13,9,500
clsid,clsid,,1,1,3,2,6,5,9,1
spring-shell,spring-shell,,3,3,7,6,12,13,3,1
facebook-infer,facebook-infer,,0,1,0,1,2,1,9,1
invantive-bridge,invantive-bridge,,0,0,0,0,1,0,4,1
sonarqube-web,sonarqube-web,,2,2,4,4,18,8,3,1
pkcs#12,pkcs#12,,12,9,24,21,47,45,6,1
kendo-template,kendo-template,,2,2,7,4,16,11,1,1
protobuf-java,protobuf-java,,11,17,33,28,28,61,6,54.545455
postgresql-json,postgresql-json,,3,0,3,3,15,6,4,1
wso2developerstudio,wso2developerstudio,,1,2,10,3,6,13,14,100
fillna,fillna,,19,10,27,29,55,56,0,1
sniffing,sniffing,,3,12,13,15,32,28,9,300
android-rom,android-rom,,5,4,3,9,10,12,3,1
cylindrical,cylindrical,,0,1,3,1,4,4,0,1
path-parameter,path-parameter,,5,3,2,8,8,10,3,1
qtconsole,qtconsole,,0,2,8,2,8,10,0,100
apigility,apigility,,2,1,4,3,9,7,4,1
powercli,powercli,,5,10,42,15,64,57,8,100
invokedynamic,invokedynamic,,0,0,2,0,8,2,3,1
gobject-introspection,gobject-introspection,,2,1,2,3,9,5,9,1
stdmove,stdmove,,3,3,10,6,17,16,9,1
vivus,vivus,,0,0,0,0,10,0,1,1
mapi,mapi,,6,12,15,18,44,33,5,100
smalltalk,smalltalk,,35,13,23,48,97,71,13,1
wso2iot,wso2iot,,4,2,10,6,27,16,14,1
wso2ml,wso2ml,,0,0,0,0,3,0,14,1
akka-actor,akka-actor,,7,5,10,12,24,22,2,1
cracking,cracking,,3,6,6,9,17,15,9,100
loadview,loadview,,2,0,1,2,3,3,13,1
server-side-scripting,server-side-scripting,,2,2,9,4,7,13,1,1
uddi,uddi,,0,0,3,0,4,3,3,1
jqxgrid,jqxgrid,,5,5,30,10,21,40,1,1
jqxwidgets,jqxwidgets,,5,3,19,8,17,27,1,1
glip,glip,,2,2,4,4,5,8,3,1
screen-density,screen-density,,2,1,11,3,15,14,3,1
angular2-moment,angular2-moment,,2,0,7,2,22,9,1,1
css-parsing,css-parsing,,0,0,0,0,6,0,1,1
glamorous,glamorous,,0,0,3,0,4,3,1,1
dbg,dbg,,0,0,0,0,7,0,9,1
sysdba,sysdba,,1,0,1,1,3,2,4,1
liferay-hook,liferay-hook,,0,0,1,0,3,1,3,1
gulp-replace,gulp-replace,,0,1,4,1,3,5,1,1
mcsession,mcsession,,0,2,2,2,3,4,13,100
propel2,propel2,,2,0,5,2,9,7,4,1
cowplot,cowplot,,7,12,25,19,44,44,0,71.428571
scala-xml,scala-xml,,7,1,5,8,3,13,2,1
z3py,z3py,,19,18,58,37,71,95,0,1
trygetvalue,trygetvalue,,0,0,3,0,4,3,8,1
derived-types,derived-types,,3,4,9,7,16,16,9,33.333333
node-config,node-config,,4,1,9,5,18,14,1,1
angular2-cli,angular2-cli,,0,0,1,0,9,1,1,1
nsmanagedobjectcontext,nsmanagedobjectcontext,,7,7,15,14,38,29,13,1
usps,usps,,5,3,7,8,10,15,4,1
stamps.com,stamps.com,,0,0,1,0,1,1,4,1
networkonmainthread,networkonmainthread,,2,4,5,6,21,11,3,100
dynamic-view,dynamic-view,,2,2,0,4,3,4,8,1
pkgbuild,pkgbuild,,1,2,5,3,11,8,13,100
pkg-file,pkg-file,,4,2,7,6,6,13,13,1
itemlistener,itemlistener,,2,2,4,4,5,8,3,1
eeglab,eeglab,,1,3,4,4,2,8,0,200
rerender,rerender,,11,9,16,20,32,36,1,1
angular-ng,angular-ng,,0,2,1,2,8,3,1,100
pcntl,pcntl,,3,3,6,6,9,12,4,1
facebook-chat,facebook-chat,,1,4,4,5,5,9,13,300
extended-events,extended-events,,4,2,11,6,12,17,4,1
rhel6,rhel6,,14,8,19,22,25,41,9,1
libgcj,libgcj,,0,0,0,0,1,0,9,1
remap-istanbul,remap-istanbul,,0,0,1,0,4,1,1,1
codegen,codegen,,5,2,10,7,21,17,3,1
auto-generate,auto-generate,,20,11,21,31,47,52,3,1
cxxtest,cxxtest,,0,0,0,0,1,0,1,1
database-metadata,database-metadata,,5,3,9,8,24,17,4,1
modelmetadata,modelmetadata,,0,0,1,0,3,1,8,1
infusionsoft,infusionsoft,,2,1,4,3,22,7,4,1
datagridcolumnheader,datagridcolumnheader,,1,0,3,1,5,4,8,1
mongojs,mongojs,,4,1,13,5,30,18,1,1
mass,mass,,1,5,8,6,7,14,0,400
propertychangesupport,propertychangesupport,,0,0,0,0,2,0,3,1
fastparquet,fastparquet,,4,11,8,15,24,23,0,175
lis,lis,,5,1,3,6,7,9,0,1
qiime,qiime,,3,0,4,3,7,7,0,1
biom,biom,,0,3,1,3,2,4,0,200
unbind,unbind,,4,0,1,4,21,5,1,1
winusb,winusb,,2,2,8,4,9,12,3,1
template-strings,template-strings,,5,7,9,12,30,21,1,40
fileresult,fileresult,,3,2,1,5,6,6,8,1
do-loops,do-loops,,8,5,15,13,53,28,0,1
quickaction,quickaction,,0,1,4,1,4,5,13,1
usergrid,usergrid,,0,1,0,1,4,1,3,1
convert-tz,convert-tz,,0,1,1,1,2,2,4,1
richedit,richedit,,5,2,4,7,10,11,9,1
cricheditctrl,cricheditctrl,,1,0,0,1,4,1,9,1
indy10,indy10,,13,10,31,23,55,54,9,1
watchdog,watchdog,,11,8,29,19,34,48,0,1
doctrine-migrations,doctrine-migrations,,4,8,7,12,9,19,4,100
flynn,flynn,,0,0,0,0,3,0,4,1
microchip,microchip,,14,16,28,30,42,58,9,14.285714
mplab,mplab,,12,11,31,23,56,54,9,1
pic18,pic18,,6,5,3,11,15,14,9,1
python-textprocessing,python-textprocessing,,14,3,12,17,26,29,0,1
reachability,reachability,,7,3,10,10,48,20,13,1
reachability-swift,reachability-swift,,2,1,2,3,9,5,13,1
jsyn,jsyn,,0,0,2,0,5,2,3,1
cifs,cifs,,7,7,17,14,26,31,9,1
spir-v,spir-v,,0,3,8,3,14,11,9,200
chars,chars,,0,0,0,0,27,0,0,1
osx-mavericks,osx-mavericks,,0,3,6,3,11,9,13,200
bento,bento,,0,0,2,0,2,2,13,1
honeywell,honeywell,,6,2,6,8,14,14,3,1
jagged-arrays,jagged-arrays,,15,7,28,22,39,50,8,1
bing,bing,,19,11,32,30,73,62,8,1
string-view,string-view,,3,9,10,12,24,22,9,200
open-uri,open-uri,,1,2,5,3,13,8,12,100
nodetool,nodetool,,4,3,15,7,31,22,2,1
picklist,picklist,,3,2,6,5,10,11,14,1
on-duplicate-key,on-duplicate-key,,7,2,10,9,26,19,4,1
objective-c-runtime,objective-c-runtime,,4,2,11,6,25,17,13,1
delayedvariableexpansion,delayedvariableexpansion,,2,5,11,7,14,18,9,150
cookie-session,cookie-session,,5,4,7,9,13,16,1,1
bitvector,bitvector,,1,4,4,5,11,9,0,300
reverse-geocoding,reverse-geocoding,,11,33,22,44,67,66,1,200
mkplacemark,mkplacemark,,2,0,0,2,1,2,13,1
datagridviewcombobox,datagridviewcombobox,,0,2,8,2,13,10,8,100
flow-router,flow-router,,2,1,4,3,19,7,1,1
equalizer,equalizer,,3,6,19,9,8,28,3,100
mars-simulator,mars-simulator,,45,5,33,50,45,83,9,1
windowed,windowed,,1,2,3,3,5,6,2,100
flood-fill,flood-fill,,8,11,26,19,41,45,0,37.5
requirejs-optimizer,requirejs-optimizer,,0,2,4,2,5,6,1,100
nelmioapidocbundle,nelmioapidocbundle,,8,2,8,10,22,18,4,1
jquery-clone,jquery-clone,,1,0,2,1,12,3,1,1
character-set,character-set,,6,1,8,7,19,15,4,1
azure-role-environment,azure-role-environment,,1,2,2,3,3,5,8,100
msys,msys,,8,7,21,15,30,36,9,1
testify,testify,,3,4,5,7,11,12,6,33.333333
classname,classname,,6,6,21,12,56,33,1,1
luac,luac,,2,1,2,3,11,5,9,1
preconditions,preconditions,,2,3,4,5,10,9,3,50
xfce,xfce,,11,3,28,14,25,42,9,1
sdist,sdist,,1,1,2,2,10,4,0,1
npm-shrinkwrap,npm-shrinkwrap,,2,1,5,3,6,8,1,1
glu,glu,,2,1,4,3,14,7,9,1
program-counter,program-counter,,2,3,0,5,8,5,9,50
delphi-xe4,delphi-xe4,,0,1,2,1,6,3,9,1
max-allowed-packet,max-allowed-packet,,0,2,0,2,8,2,4,100
spark-framework,spark-framework,,0,0,0,0,15,0,3,1
cmdlet,cmdlet,,10,10,15,20,40,35,8,1
pipelinedb,pipelinedb,,2,0,3,2,3,5,4,1
sslsocketfactory,sslsocketfactory,,3,8,14,11,13,25,3,166.666667
manual-retain-release,manual-retain-release,,2,1,1,3,3,4,13,1
lexicon,lexicon,,3,4,4,7,9,11,0,33.333333
wgs84,wgs84,,5,4,6,9,13,15,0,1
imagemagick-montage,imagemagick-montage,,2,1,2,3,8,5,12,1
rails-postgresql,rails-postgresql,,0,0,0,0,17,0,4,1
gdax-api,gdax-api,,2,2,4,4,49,8,4,1
smss,smss,,2,0,3,2,6,5,4,1
osmosis,osmosis,,2,3,6,5,8,11,1,50
future-warning,future-warning,,0,3,3,3,4,6,0,200
setw,setw,,2,3,3,5,11,8,9,50
colorbox,colorbox,,2,7,8,9,17,17,1,250
type-providers,type-providers,,4,6,25,10,45,35,8,50
elastic-grid,elastic-grid,,0,0,0,0,1,0,1,1
chaos,chaos,,4,2,7,6,7,13,0,1
ontouch,ontouch,,9,5,8,14,30,22,3,1
mouseup,mouseup,,4,4,6,8,13,14,1,1
adonis.js,adonis.js,,46,46,43,92,51,135,1,1
compile-time-weaving,compile-time-weaving,,3,3,3,6,7,9,3,1
constraint-layout-chains,constraint-layout-chains,,9,2,8,11,17,19,3,1
set-intersection,set-intersection,,6,3,14,9,20,23,0,1
slash,slash,,6,7,15,13,26,28,4,16.666667
amazon-workmail,amazon-workmail,,5,1,3,6,8,9,6,1
ice40,ice40,,2,0,3,2,6,5,9,1
unique-key,unique-key,,8,6,21,14,38,35,4,1
cakeemail,cakeemail,,0,0,0,0,2,0,4,1
bit-masks,bit-masks,,0,0,0,0,5,0,0,1
winapp,winapp,,0,1,3,1,4,4,8,1
stable-marriage,stable-marriage,,1,0,3,1,1,4,0,1
ini-set,ini-set,,2,0,0,2,5,2,4,1
code-duplication,code-duplication,,8,11,25,19,49,44,3,37.5
symfony-workflows,symfony-workflows,,0,0,2,0,3,2,4,1
exonum,exonum,,0,0,0,0,2,0,6,1
omnifaces,omnifaces,,5,8,28,13,46,41,3,60
terminfo,terminfo,,0,0,1,0,7,1,9,1
termcap,termcap,,2,3,0,5,4,5,9,50
spectron,spectron,,13,13,10,26,30,36,1,1
pdb-files,pdb-files,,17,5,16,22,30,38,8,1
default-method,default-method,,2,2,10,4,19,14,3,1
gldrawarrays,gldrawarrays,,0,0,2,0,3,2,3,1
datasnap,datasnap,,7,2,14,9,21,23,9,1
opcodes,opcodes,,0,0,0,0,4,0,9,1
msmtp,msmtp,,3,1,2,4,5,6,4,1
filenet-process-engine,filenet-process-engine,,0,5,1,5,13,6,15,400
floating-point-exceptions,floating-point-exceptions,,1,0,5,1,8,6,9,1
gulp-jscs,gulp-jscs,,0,1,0,1,2,1,1,1
python-exec,python-exec,,1,5,5,6,5,11,0,400
subclipse,subclipse,,1,1,5,2,9,7,6,1
mta,mta,,3,1,4,4,7,8,8,1
multcompview,multcompview,,2,2,2,4,2,6,0,1
tukeyhsd,tukeyhsd,,4,2,7,6,14,13,0,1
mobilefirst-cli,mobilefirst-cli,,0,0,2,0,15,2,13,1
credit-card,credit-card,,11,16,28,27,50,55,4,45.454545
fraud-prevention,fraud-prevention,,3,2,3,5,11,8,4,1
opendj,opendj,,1,4,9,5,9,14,8,300
openidm,openidm,,0,0,0,0,4,0,3,1
getresponse,getresponse,,1,0,3,1,16,4,4,1
serverside-javascript,serverside-javascript,,2,3,19,5,29,24,1,50
data-stream,data-stream,,8,5,15,13,24,28,2,1
chained-payments,chained-payments,,0,2,2,2,4,4,4,100
heartbeat,heartbeat,,8,3,6,11,23,17,6,1
entity-relationship-model,entity-relationship-model,,6,9,15,15,27,30,4,50
cvxpy,cvxpy,,26,19,49,45,37,94,0,1
system-information,system-information,,4,3,1,7,5,8,9,1
oracle-objects,oracle-objects,,0,1,1,1,3,2,4,1
modifiers,modifiers,,0,0,0,0,6,0,3,1
jslint,jslint,,9,4,13,13,30,26,1,1
pynotify,pynotify,,0,0,0,0,2,0,9,1
notify-send,notify-send,,2,0,5,2,8,7,9,1
pyopenssl,pyopenssl,,9,13,16,22,52,38,6,44.444444
alpn,alpn,,2,2,8,4,10,12,3,1
boost-graph,boost-graph,,14,9,19,23,38,42,9,1
rodeo,rodeo,,0,2,1,2,13,3,0,100
membership,membership,,8,10,19,18,34,37,4,25
pharo,pharo,,10,6,17,16,63,33,13,1
ioutils,ioutils,,0,0,3,0,6,3,3,1
procedural-programming,procedural-programming,,2,2,8,4,16,12,0,1
eventmachine,eventmachine,,3,2,4,5,7,9,12,1
wicked-pdf,wicked-pdf,,17,9,33,26,52,59,12,1
sqlitejdbc,sqlitejdbc,,1,2,2,3,3,5,3,100
proxy-server,proxy-server,,5,2,9,7,20,16,6,1
astronomy,astronomy,,14,12,33,26,40,59,0,1
php-openssl,php-openssl,,10,9,21,19,52,40,4,1
gang-of-four,gang-of-four,,0,0,0,0,12,0,3,1
dropify,dropify,,1,1,2,2,7,4,1,1
move-constructor,move-constructor,,11,4,18,15,35,33,9,1
move-assignment-operator,move-assignment-operator,,1,2,6,3,8,9,9,100
hivemq,hivemq,,3,20,4,23,4,27,6,566.666667
watchservice,watchservice,,4,11,9,15,15,24,3,175
uthash,uthash,,0,0,1,0,2,1,9,1
jansi,jansi,,1,1,1,2,4,3,3,1
rs485,rs485,,11,3,16,14,32,30,9,1
synchronisation,synchronisation,,3,1,6,4,13,10,3,1
cmsamplebuffer,cmsamplebuffer,,2,7,12,9,18,21,13,250
hresult,hresult,,0,2,5,2,5,7,8,100
xqj,xqj,,0,0,0,0,1,0,3,1
xmltable,xmltable,,4,6,10,10,33,20,4,50
fakeroot,fakeroot,,0,1,0,1,2,1,13,1
adpcm,adpcm,,3,0,0,3,2,3,13,1
vagrant-plugin,vagrant-plugin,,0,1,4,1,5,5,4,1
meteor-packages,meteor-packages,,0,0,2,0,4,2,1,1
utorrent,utorrent,,0,1,0,1,2,1,9,1
netbeans-8.2,netbeans-8.2,,7,17,9,24,27,33,3,142.857143
android-elevation,android-elevation,,9,9,12,18,20,30,3,1
psycopg,psycopg,,0,0,1,0,10,1,0,1
ultrawingrid,ultrawingrid,,1,2,0,3,6,3,8,100
promoting,promoting,,0,0,0,0,2,0,6,1
bonjour,bonjour,,3,5,16,8,21,24,13,66.666667
airprint,airprint,,2,3,4,5,11,9,13,50
virtual-printer,virtual-printer,,0,0,2,0,3,2,8,1
jenkins-mstest,jenkins-mstest,,1,0,2,1,6,3,6,1
prelaunch,prelaunch,,1,0,1,1,8,2,3,1
multipart-mixed-replace,multipart-mixed-replace,,1,1,5,2,3,7,3,1
android-settings,android-settings,,4,8,9,12,34,21,3,100
elevatezoom,elevatezoom,,1,0,4,1,5,5,1,1
geom-hline,geom-hline,,3,4,3,7,8,10,0,33.333333
google-advertising-id,google-advertising-id,,7,2,9,9,8,18,3,1
sortablejs,sortablejs,,13,12,9,25,8,34,1,1
hk2,hk2,,12,9,13,21,29,34,3,1
deltaspike,deltaspike,,1,2,6,3,15,9,3,100
preact,preact,,38,24,31,62,71,93,1,1
dangerous-permissions,dangerous-permissions,,0,2,2,2,1,4,3,100
qresource,qresource,,1,3,2,4,5,6,9,200
modelandview,modelandview,,2,1,8,3,15,11,3,1
pinnacle-cart,pinnacle-cart,,0,0,0,0,2,0,1,1
google-domains,google-domains,,18,8,22,26,36,48,4,1
state-management,state-management,,19,30,31,49,41,80,1,57.894737
play-slick,play-slick,,1,1,3,2,7,5,2,1
bytestream,bytestream,,2,6,6,8,17,14,0,200
visualstatemanager,visualstatemanager,,3,3,10,6,9,16,8,1
text-formatting,text-formatting,,7,4,20,11,28,31,9,1
code-separation,code-separation,,0,0,0,0,11,0,9,1
aerogear,aerogear,,0,1,4,1,5,5,13,1
dynamic-binding,dynamic-binding,,5,3,4,8,21,12,9,1
nameservers,nameservers,,12,7,27,19,37,46,4,1
page-object-gem,page-object-gem,,1,5,1,6,16,7,12,400
textacy,textacy,,4,2,5,6,6,11,0,1
fbsdkloginkit,fbsdkloginkit,,3,2,2,5,16,7,13,1
qregexp,qregexp,,2,0,7,2,8,9,9,1
autogen,autogen,,3,2,2,5,4,7,8,1
install.packages,install.packages,,16,13,32,29,66,61,0,1
memorycache,memorycache,,9,5,20,14,36,34,8,1
pyhamcrest,pyhamcrest,,0,0,0,0,2,0,0,1
simpleitk,simpleitk,,12,5,16,17,32,33,0,1
pysqlcipher,pysqlcipher,,2,0,2,2,3,4,3,1
flask-extensions,flask-extensions,,3,0,3,3,8,6,0,1
qtgstreamer,qtgstreamer,,2,0,1,2,3,3,9,1
multiple-join-rows,multiple-join-rows,,0,2,2,2,2,4,4,100
jail-shell,jail-shell,,0,0,0,0,1,0,4,1
nlm,nlm,,0,0,2,0,4,2,0,1
search-tree,search-tree,,0,0,2,0,4,2,0,1
drawrectangle,drawrectangle,,3,4,8,7,23,15,8,33.333333
geojsonio,geojsonio,,1,1,4,2,5,6,1,1
event-bubbling,event-bubbling,,7,5,8,12,24,20,1,1
rounding-error,rounding-error,,4,5,7,9,23,16,0,25
git-shell,git-shell,,0,1,3,1,5,4,6,1
splunk-query,splunk-query,,21,30,47,51,65,98,6,42.857143
splunk-calculation,splunk-calculation,,0,3,5,3,12,8,6,200
splunk-formula,splunk-formula,,1,5,3,6,9,9,6,400
blazor,blazor,,116,220,127,336,49,463,8,89.655172
local-database,local-database,,5,4,4,9,21,13,8,1
registerstartupscript,registerstartupscript,,2,0,0,2,3,2,8,1
aws-aurora,aws-aurora,,26,15,37,41,15,78,6,1
cortex-a,cortex-a,,4,4,4,8,14,12,9,1
prismic.io,prismic.io,,9,13,5,22,8,27,1,44.444444
null-pointer,null-pointer,,5,8,15,13,24,28,9,60
libclang,libclang,,7,5,14,12,22,26,9,1
objectname,objectname,,1,0,0,1,2,1,9,1
ora-02291,ora-02291,,0,0,0,0,3,0,4,1
coreclr,coreclr,,3,4,13,7,29,20,8,33.333333
ag,ag,,6,6,1,12,13,13,9,1
ripgrep,ripgrep,,2,3,0,5,3,5,9,50
webapp-runner,webapp-runner,,1,0,1,1,2,2,3,1
addtarget,addtarget,,4,1,2,5,17,7,13,1
pathgeometry,pathgeometry,,3,2,2,5,7,7,8,1
istringstream,istringstream,,1,3,5,4,12,9,9,200
rdms,rdms,,2,0,5,2,7,7,4,1
server-monitoring,server-monitoring,,1,1,1,2,6,3,6,1
blpapi,blpapi,,2,7,13,9,15,22,0,250
greenlets,greenlets,,0,1,5,1,15,6,0,1
nvda,nvda,,5,8,18,13,30,31,13,60
setuid,setuid,,1,2,11,3,16,14,9,100
phalcon-orm,phalcon-orm,,4,0,5,4,16,9,4,1
angularjs-ng-checked,angularjs-ng-checked,,0,0,2,0,4,2,1,1
aws-sdk-go,aws-sdk-go,,15,10,9,25,34,34,6,1
uibackgroundmode,uibackgroundmode,,0,0,1,0,5,1,13,1
phing,phing,,0,2,2,2,5,4,4,100
aws-codestar,aws-codestar,,9,5,17,14,15,31,6,1
outlook-form,outlook-form,,2,0,4,2,1,6,5,1
mini-batch,mini-batch,,6,4,13,10,20,23,0,1
sess.run,sess.run,,0,2,0,2,3,2,0,100
oracle-soa,oracle-soa,,1,1,2,2,10,4,3,1
oracle-bpm-suite,oracle-bpm-suite,,1,1,2,2,2,4,3,1
vundle,vundle,,3,0,9,3,8,12,9,1
django-cron,django-cron,,2,1,10,3,8,13,0,1
qiskit,qiskit,,3,5,6,8,9,14,0,66.666667
accessibility-api,accessibility-api,,3,2,4,5,13,9,3,1
sata,sata,,0,3,0,3,6,3,9,200
jmspaymentpaypalbundle,jmspaymentpaypalbundle,,0,0,0,0,2,0,4,1
google-app-engine-php,google-app-engine-php,,6,7,19,13,27,32,6,16.666667
pandas-apply,pandas-apply,,9,7,16,16,26,32,0,1
caml-light,caml-light,,0,0,0,0,3,0,0,1
rft,rft,,4,0,5,4,4,9,3,1
sense2vec,sense2vec,,3,0,0,3,3,3,0,1
12factor,12factor,,2,4,3,6,10,9,3,100
major-mode,major-mode,,0,0,1,0,7,1,9,1
parent-pom,parent-pom,,9,12,9,21,32,30,3,33.333333
facebook-gameroom,facebook-gameroom,,0,1,0,1,5,1,8,1
listings,listings,,4,4,3,8,15,11,0,1
x87,x87,,7,5,6,12,19,18,9,1
wpd,wpd,,1,0,2,1,8,3,8,1
pitest,pitest,,9,9,4,18,18,22,3,1
copyright-display,copyright-display,,4,2,7,6,12,13,4,1
typeid,typeid,,1,3,7,4,17,11,9,200
atomicreference,atomicreference,,0,0,1,0,4,1,3,1
jquery-ui-tooltip,jquery-ui-tooltip,,5,5,8,10,27,18,1,1
zipstream,zipstream,,1,1,0,2,1,2,8,1
family-tree,family-tree,,2,1,7,3,8,10,0,1
openehr,openehr,,0,1,0,1,2,1,6,1
generative-adversarial-network,generative-adversarial-network,,38,45,64,83,34,147,0,18.421053
wicket-1.5,wicket-1.5,,2,1,1,3,2,4,3,1
jquery-ui-resizable,jquery-ui-resizable,,2,2,8,4,23,12,1,1
iphone-se,iphone-se,,0,0,2,0,3,2,13,1
telerik-charting,telerik-charting,,1,1,2,2,6,4,8,1
typescript-generics,typescript-generics,,95,105,55,200,48,255,1,10.526316
photolibrary,photolibrary,,1,5,5,6,14,11,13,400
delphi-xe5,delphi-xe5,,2,2,2,4,21,6,9,1
treestore,treestore,,1,2,1,3,3,4,1,100
jointjs,jointjs,,7,11,33,18,51,51,1,57.142857
nopcommerce-3.90,nopcommerce-3.90,,1,4,3,5,12,8,8,300
ones-complement,ones-complement,,2,2,4,4,10,8,9,1
starling-framework,starling-framework,,2,0,3,2,2,5,13,1
feathersui,feathersui,,0,0,0,0,1,0,13,1
cloud-hosting,cloud-hosting,,2,3,5,5,9,10,4,50
java-http-client,java-http-client,,8,8,28,16,7,44,3,1
reminders,reminders,,8,8,12,16,25,28,3,1
gmap.net,gmap.net,,14,11,15,25,28,40,8,1
swift-class,swift-class,,0,0,3,0,7,3,13,1
code128,code128,,1,2,12,3,18,15,3,100
libtorrent,libtorrent,,4,3,3,7,18,10,9,1
onresume,onresume,,7,8,17,15,34,32,3,14.285714
veeam,veeam,,2,1,3,3,4,6,8,1
thephpleague-fractal,thephpleague-fractal,,0,0,7,0,7,7,4,1
nats.io,nats.io,,8,6,12,14,17,26,6,1
esri,esri,,7,16,38,23,55,61,1,128.571429
share-extension,share-extension,,11,15,23,26,41,49,13,36.363636
google-static-maps,google-static-maps,,2,1,10,3,42,13,1,1
mecab,mecab,,2,0,5,2,9,7,0,1
memory-safety,memory-safety,,0,0,2,0,5,2,9,1
nscompoundpredicate,nscompoundpredicate,,0,1,0,1,2,1,13,1
post-meta,post-meta,,5,1,13,6,26,19,4,1
failed-to-connect,failed-to-connect,,1,1,3,2,4,5,3,1
plai,plai,,0,0,1,0,1,1,0,1
home-automation,home-automation,,3,3,11,6,14,17,13,1
video-thumbnails,video-thumbnails,,6,4,9,10,25,19,13,1
etcd,etcd,,16,26,46,42,51,88,6,62.5
etcd3,etcd3,,8,1,4,9,8,13,6,1
jess,jess,,0,8,0,8,14,8,0,700
node-streams,node-streams,,8,16,34,24,35,58,1,100
internals,internals,,20,19,31,39,22,70,9,1
art-runtime,art-runtime,,0,0,0,0,1,0,3,1
php-gettext,php-gettext,,1,1,3,2,3,5,4,1
mod-alias,mod-alias,,6,1,7,7,9,14,4,1
nslocale,nslocale,,4,1,4,5,17,9,13,1
netflow,netflow,,8,2,3,10,13,13,9,1
hex-editors,hex-editors,,2,3,6,5,7,11,0,50
nsprintoperation,nsprintoperation,,2,3,2,5,3,7,13,50
nsprintinfo,nsprintinfo,,0,1,0,1,4,1,13,1
assimp,assimp,,10,14,25,24,31,49,9,40
xul,xul,,2,1,3,3,4,6,1,1
cookiestore,cookiestore,,0,1,3,1,4,4,1,1
session-scope,session-scope,,2,0,4,2,10,6,3,1
onos,onos,,7,2,12,9,6,21,9,1
activeandroid,activeandroid,,3,6,5,9,10,14,3,100
unity-interception,unity-interception,,0,0,1,0,4,1,8,1
redmine-plugins,redmine-plugins,,7,5,11,12,20,23,12,1
blackberry-10,blackberry-10,,0,1,2,1,15,3,3,1
blackberry-cascades,blackberry-cascades,,0,0,1,0,3,1,3,1
tess-two,tess-two,,3,1,7,4,17,11,3,1
quantlib-swig,quantlib-swig,,3,3,4,6,5,10,0,1
normalizr,normalizr,,10,6,30,16,41,46,1,1
lasso-regression,lasso-regression,,15,19,25,34,45,59,0,26.666667
virtual-address-space,virtual-address-space,,4,3,9,7,18,16,9,1
stm32-hal,stm32-hal,,2,0,2,2,5,4,9,1
mysqlcheck,mysqlcheck,,0,1,2,1,1,3,4,1
textscan,textscan,,4,0,5,4,18,9,0,1
dxva,dxva,,0,0,3,0,8,3,9,1
wpf-mediakit,wpf-mediakit,,1,0,2,1,8,3,8,1
motion,motion,,10,6,20,16,30,36,0,1
intermec,intermec,,2,1,2,3,6,5,3,1
array-walk,array-walk,,1,2,8,3,3,11,4,100
idp,idp,,14,12,27,26,29,53,8,1
blackfin,blackfin,,0,1,1,1,3,2,9,1
wunderground,wunderground,,3,0,1,3,9,4,0,1
scip,scip,,9,8,13,17,26,30,0,1
geckofx,geckofx,,13,13,33,26,44,59,8,1
unity-test-framework,unity-test-framework,,1,0,1,1,1,2,1,1
webautomation,webautomation,,13,16,28,29,32,57,3,23.076923
appcelerator-studio,appcelerator-studio,,2,3,13,5,31,18,13,50
navigation-properties,navigation-properties,,5,7,10,12,25,22,8,40
mage,mage,,1,0,5,1,5,6,8,1
uifontdescriptor,uifontdescriptor,,1,0,0,1,2,1,13,1
pointer-address,pointer-address,,0,1,0,1,1,1,9,1
uploader,uploader,,3,1,10,4,8,14,4,1
ignite-ui,ignite-ui,,2,2,6,4,22,10,8,1
iggrid,iggrid,,1,1,6,2,12,8,8,1
nebula,nebula,,4,5,3,9,12,12,3,25
nativecall,nativecall,,0,4,7,4,21,11,9,300
teensy,teensy,,5,8,7,13,16,20,9,60
fireloop,fireloop,,0,0,1,0,3,1,1,1
ios-background-mode,ios-background-mode,,6,9,19,15,21,34,13,50
ntdll,ntdll,,2,0,7,2,14,9,8,1
wkt,wkt,,3,4,10,7,21,17,0,33.333333
redbean,redbean,,14,6,7,20,8,27,4,1
stm32f7,stm32f7,,10,10,14,20,21,34,9,1
elasticsearch-analyzers,elasticsearch-analyzers,,6,5,4,11,15,15,6,1
react-router-native,react-router-native,,3,2,3,5,11,8,1,1
atom-beautify,atom-beautify,,0,3,4,3,9,7,0,200
iocp,iocp,,5,4,11,9,22,20,9,1
back-button-control,back-button-control,,0,2,2,2,7,4,3,100
tethering,tethering,,3,0,10,3,18,13,3,1
mention,mention,,8,4,10,12,17,22,1,1
toolkit,toolkit,,4,5,21,9,21,30,8,25
selectall,selectall,,8,3,3,11,12,14,1,1
manualresetevent,manualresetevent,,1,0,2,1,8,3,8,1
pintos,pintos,,1,2,4,3,6,7,9,100
displaylist,displaylist,,1,0,0,1,2,1,13,1
silent,silent,,6,3,12,9,19,21,3,1
liskov-substitution-principle,liskov-substitution-principle,,8,5,9,13,20,22,3,1
evil-mode,evil-mode,,4,1,2,5,14,7,9,1
geomap,geomap,,8,2,5,10,5,15,0,1
backbone-views,backbone-views,,0,1,4,1,9,5,1,1
backbone-events,backbone-events,,0,2,0,2,9,2,1,100
uninitialized-constant,uninitialized-constant,,1,1,0,2,6,2,12,1
request-pipeline,request-pipeline,,0,0,0,0,6,0,8,1
stackexchange-api,stackexchange-api,,3,15,8,18,29,26,4,400
polymer-3.x,polymer-3.x,,48,31,110,79,61,189,1,1
kotlinx.coroutines,kotlinx.coroutines,,3,0,187,3,106,190,3,1
local-files,local-files,,1,0,5,1,6,6,1,1
grape,grape,,9,11,15,20,28,35,12,22.222222
help-system,help-system,,0,0,2,0,4,2,0,1
neutronium,neutronium,,2,0,0,2,1,2,8,1
image-masking,image-masking,,7,4,5,11,10,16,0,1
random-walk,random-walk,,8,6,15,14,23,29,0,1
soapheader,soapheader,,3,6,9,9,10,18,3,100
activity-manager,activity-manager,,4,0,2,4,10,6,3,1
ubuntu-unity,ubuntu-unity,,1,0,3,1,1,4,9,1
package-control,package-control,,1,0,5,1,6,6,0,1
xv6,xv6,,11,7,17,18,27,35,9,1
html-parser,html-parser,,5,1,8,6,10,14,0,1
character-class,character-class,,2,2,3,4,5,7,0,1
cross-site,cross-site,,5,4,12,9,11,21,1,1
eclipse-pdt,eclipse-pdt,,1,2,12,3,29,15,4,100
csvjdbc,csvjdbc,,0,0,1,0,1,1,3,1
splay-tree,splay-tree,,1,2,2,3,6,5,0,100
jline,jline,,2,1,5,3,9,8,3,1
odoo-domain,odoo-domain,,0,0,1,0,3,1,0,1
kotlinx-html,kotlinx-html,,2,0,0,2,6,2,3,1
subcomponent,subcomponent,,4,0,7,4,4,11,3,1
eventaggregator,eventaggregator,,6,1,6,7,17,13,8,1
scope-chain,scope-chain,,0,0,0,0,3,0,1,1
large-title,large-title,,2,2,4,4,24,8,13,1
network-shares,network-shares,,0,0,2,0,9,2,8,1
lz77,lz77,,1,0,3,1,3,4,0,1
eyed3,eyed3,,0,1,5,1,6,6,0,1
qgraphicsitem,qgraphicsitem,,20,12,24,32,60,56,9,1
heap-pollution,heap-pollution,,0,0,0,0,3,0,3,1
kaldi,kaldi,,6,5,10,11,14,21,0,1
react-toolbox,react-toolbox,,2,3,2,5,11,7,1,50
google-cloud-networking,google-cloud-networking,,8,9,28,17,32,45,6,12.5
wininet,wininet,,12,7,9,19,40,28,9,1
file-attributes,file-attributes,,4,3,7,7,9,14,9,1
music21,music21,,5,10,10,15,16,25,0,100
word-2013,word-2013,,0,0,0,0,8,0,5,1
nativescript-plugin,nativescript-plugin,,33,25,61,58,32,119,1,1
angular-seed-advanced,angular-seed-advanced,,0,0,0,0,4,0,1,1
osc,osc,,10,5,17,15,10,32,0,1
acceleration,acceleration,,2,2,5,4,19,9,0,1
leap-second,leap-second,,3,3,1,6,3,7,0,1
windowsiot,windowsiot,,7,4,10,11,37,21,8,1
business-logic-layer,business-logic-layer,,0,2,2,2,9,4,8,100
qbxml,qbxml,,6,8,9,14,25,23,4,33.333333
spoofing,spoofing,,6,10,13,16,16,29,9,66.666667
buddypress,buddypress,,21,22,32,43,41,75,4,4.761905
ogg-theora,ogg-theora,,0,0,0,0,1,0,13,1
trialware,trialware,,0,0,1,0,4,1,1,1
java-mission-control,java-mission-control,,4,0,3,4,6,7,3,1
time-limiting,time-limiting,,0,2,5,2,4,7,0,100
dependent-type,dependent-type,,20,7,35,27,90,62,2,1
sum-of-digits,sum-of-digits,,1,2,3,3,3,6,0,100
zbar,zbar,,11,11,19,22,30,41,3,1
bigcartel,bigcartel,,3,2,8,5,7,13,1,1
particle-swarm,particle-swarm,,5,8,12,13,12,25,0,60
differential-evolution,differential-evolution,,3,6,9,9,9,18,0,100
main-activity,main-activity,,6,0,11,6,25,17,3,1
azure-china,azure-china,,3,1,2,4,4,6,8,1
edward,edward,,5,3,6,8,11,14,0,1
expirationhandler,expirationhandler,,0,1,0,1,4,1,13,1
graphframes,graphframes,,10,8,19,18,24,37,2,1
phone-state-listener,phone-state-listener,,7,10,11,17,11,28,3,42.857143
react-native-component,react-native-component,,2,3,6,5,3,11,1,50
cdf,cdf,,8,8,12,16,32,28,0,1
flink-sql,flink-sql,,10,13,28,23,49,51,2,30
airdrop,airdrop,,1,2,7,3,4,10,13,100
dbforge,dbforge,,2,2,2,4,4,6,4,1
rom,rom,,5,4,16,9,22,25,3,1
sparkpost,sparkpost,,5,1,12,6,21,18,4,1
serverspec,serverspec,,2,1,4,3,7,7,12,1
slicknav,slicknav,,0,0,3,0,2,3,1,1
android-multiple-users,android-multiple-users,,3,1,1,4,4,5,3,1
android-managed-profile,android-managed-profile,,1,1,3,2,3,5,3,1
image2pipe,image2pipe,,0,0,0,0,2,0,13,1
datadirectory,datadirectory,,1,0,1,1,5,2,8,1
twofish,twofish,,1,0,1,1,4,2,6,1
variable-templates,variable-templates,,0,4,3,4,8,7,9,300
table-alias,table-alias,,0,1,5,1,4,6,4,1
helper-functions,helper-functions,,2,0,2,2,5,4,9,1
dynamic-class,dynamic-class,,0,1,2,1,3,3,1,1
news-feed,news-feed,,6,2,12,8,19,20,4,1
sendgrid-templates,sendgrid-templates,,11,2,17,13,11,30,4,1
viewpropertyanimator,viewpropertyanimator,,1,1,2,2,4,4,3,1
clipboarddata,clipboarddata,,3,3,15,6,25,21,1,1
vnc-viewer,vnc-viewer,,11,7,4,18,10,22,9,1
jupyter-kernel,jupyter-kernel,,1,4,10,5,6,15,0,300
rust-piston,rust-piston,,0,2,8,2,7,10,9,100
hipchat,hipchat,,1,1,1,2,9,3,4,1
cpplint,cpplint,,1,0,4,1,9,5,9,1
game-maker,game-maker,,7,7,19,14,36,33,2,1
game-maker-language,game-maker-language,,10,3,13,13,25,26,2,1
game-maker-studio-1.4,game-maker-studio-1.4,,2,1,4,3,15,7,2,1
game-maker-studio-2,game-maker-studio-2,,10,2,24,12,19,36,2,1
game-maker-legacy,game-maker-legacy,,0,0,0,0,1,0,2,1
simplexml-load-string,simplexml-load-string,,5,4,4,9,16,13,4,1
source-insight,source-insight,,0,0,2,0,5,2,9,1
time-frequency,time-frequency,,1,4,7,5,5,12,0,300
redis-cluster,redis-cluster,,33,38,36,71,56,107,3,15.151515
attachedbehaviors,attachedbehaviors,,2,1,3,3,5,6,8,1
cl.exe,cl.exe,,3,3,5,6,9,11,9,1
ucfirst,ucfirst,,0,1,1,1,4,2,4,1
rappid,rappid,,2,1,14,3,24,17,1,1
dmg,dmg,,8,5,14,13,12,27,13,1
django-wkhtmltopdf,django-wkhtmltopdf,,0,1,4,1,10,5,8,1
dd-wrt,dd-wrt,,2,2,1,4,7,5,9,1
angular-gettext,angular-gettext,,0,1,0,1,4,1,1,1
ecmascript-3,ecmascript-3,,2,2,4,4,4,8,1,1
newlib,newlib,,4,2,4,6,16,10,9,1
tab-ordering,tab-ordering,,1,0,6,1,7,7,1,1
gitlab-ce,gitlab-ce,,13,26,20,39,25,59,6,100
api-doc,api-doc,,6,3,9,9,17,18,3,1
lidar,lidar,,18,16,10,34,21,44,0,1
maven-bundle-plugin,maven-bundle-plugin,,3,2,7,5,10,12,3,1
contract-first,contract-first,,0,0,1,0,2,1,3,1
clearquest,clearquest,,0,2,0,2,2,2,3,100
phpwkhtmltopdf,phpwkhtmltopdf,,3,3,4,6,7,10,8,1
htmldoc,htmldoc,,0,1,0,1,4,1,1,1
drop-table,drop-table,,6,3,8,9,16,17,4,1
sqitch,sqitch,,0,0,1,0,3,1,4,1
odp.net,odp.net,,18,23,34,41,61,75,8,27.777778
adjustpan,adjustpan,,4,4,11,8,10,19,3,1
if-modified-since,if-modified-since,,1,1,2,2,4,4,4,1
cassandra-2.2,cassandra-2.2,,1,0,2,1,10,3,2,1
exasolution,exasolution,,7,6,13,13,12,26,4,1
sizetocontent,sizetocontent,,0,0,1,0,3,1,8,1
uitableviewautomaticdimension,uitableviewautomaticdimension,,9,4,11,13,36,24,13,1
compiled-language,compiled-language,,0,1,0,1,3,1,9,1
octokit.net,octokit.net,,2,5,9,7,8,16,6,150
gettimeofday,gettimeofday,,1,1,2,2,6,4,9,1
db-first,db-first,,3,3,10,6,9,16,8,1
theano.scan,theano.scan,,0,2,3,2,3,5,0,100
flickity,flickity,,17,8,16,25,29,41,1,1
zipper,zipper,,4,2,6,6,7,12,2,1
cursors,cursors,,5,6,13,11,18,24,4,20
libdispatch,libdispatch,,2,2,1,4,8,5,13,1
orb,orb,,10,9,18,19,30,37,0,1
android-reboot,android-reboot,,1,0,6,1,5,7,3,1
gpt,gpt,,0,6,6,6,9,12,1,500
resource-management,resource-management,,2,2,3,4,7,7,9,1
razorgenerator,razorgenerator,,3,0,2,3,9,5,8,1
activity-stack,activity-stack,,0,2,6,2,7,8,3,100
apple-id,apple-id,,6,1,9,7,15,16,13,1
simplejson,simplejson,,9,3,11,12,14,23,0,1
pheanstalk,pheanstalk,,1,1,1,2,2,3,4,1
waitformultipleobjects,waitformultipleobjects,,0,1,0,1,2,1,9,1
raise,raise,,5,5,10,10,13,20,3,1
kif,kif,,1,1,1,2,6,3,13,1
dotted-line,dotted-line,,5,0,1,5,3,6,13,1
hashbytes,hashbytes,,1,2,2,3,7,5,4,100
calendarcontract,calendarcontract,,0,0,3,0,2,3,3,1
opennebula,opennebula,,1,1,4,2,10,6,9,1
cognos-bi,cognos-bi,,10,7,21,17,35,38,4,1
glimmer.js,glimmer.js,,1,1,1,2,6,3,1,1
scylla,scylla,,11,14,29,25,29,54,2,27.272727
smartcardio,smartcardio,,1,2,4,3,7,7,3,100
commoncrypto,commoncrypto,,5,5,5,10,15,15,13,1
weex,weex,,0,0,8,0,26,8,1,1
frozenset,frozenset,,7,6,5,13,10,18,0,1
uicollectionviewdelegate,uicollectionviewdelegate,,3,1,4,4,14,8,13,1
mongoid3,mongoid3,,0,0,0,0,3,0,12,1
h2o-http,h2o-http,,1,2,0,3,1,3,8,100
stsadm,stsadm,,0,0,0,0,1,0,8,1
object-graph,object-graph,,1,0,2,1,4,3,13,1
angular-tree-component,angular-tree-component,,4,1,0,5,2,5,1,1
cp1251,cp1251,,1,0,0,1,4,1,0,1
tiled,tiled,,8,7,19,15,38,34,3,1
rawsql,rawsql,,2,3,3,5,4,8,4,50
git-fetch,git-fetch,,9,11,25,20,40,45,6,22.222222
robospice,robospice,,0,0,0,0,2,0,3,1
ehcache-3,ehcache-3,,20,16,15,36,27,51,3,1
simple-form-for,simple-form-for,,8,6,7,14,33,21,12,1
datashader,datashader,,3,5,14,8,17,22,0,66.666667
radlistview,radlistview,,6,8,21,14,4,35,1,33.333333
concrete5,concrete5,,5,5,14,10,36,24,4,1
concrete5-8.x,concrete5-8.x,,1,1,5,2,28,7,4,1
negative-lookbehind,negative-lookbehind,,8,7,11,15,11,26,0,1
kingfisher,kingfisher,,7,8,23,15,37,38,13,14.285714
lazy-sequences,lazy-sequences,,3,7,8,10,20,18,2,133.333333
pathlib,pathlib,,26,20,38,46,43,84,0,1
asp.net-charts,asp.net-charts,,0,1,0,1,5,1,8,1
eclipse-juno,eclipse-juno,,0,1,1,1,8,2,3,1
intel-galileo,intel-galileo,,0,1,1,1,2,2,9,1
rollbar,rollbar,,9,11,11,20,19,31,12,22.222222
windows-mobile,windows-mobile,,2,2,8,4,14,12,8,1
windows-mobile-6.1,windows-mobile-6.1,,0,0,0,0,2,0,8,1
plotrix,plotrix,,2,2,6,4,12,10,0,1
auto-import,auto-import,,1,2,7,3,8,10,9,100
quantstrat,quantstrat,,3,10,19,13,42,32,0,233.333333
rfacebook,rfacebook,,1,1,0,2,17,2,0,1
httpresponsemessage,httpresponsemessage,,9,9,15,18,28,33,8,1
using-declaration,using-declaration,,5,4,6,9,17,15,9,1
generic-collections,generic-collections,,7,6,15,13,33,28,8,1
capture-group,capture-group,,2,3,7,5,21,12,0,50
contribute,contribute,,0,1,1,1,5,2,6,1
spl-autoload-register,spl-autoload-register,,3,3,4,6,10,10,4,1
email-address,email-address,,1,4,5,5,13,10,4,300
mvel,mvel,,2,1,8,3,15,11,3,1
mib,mib,,17,4,15,21,20,36,9,1
pxssh,pxssh,,5,2,11,7,7,18,0,1
visa,visa,,4,4,8,8,19,16,0,1
retrolambda,retrolambda,,1,0,5,1,9,6,3,1
utl-file,utl-file,,9,2,10,11,13,21,4,1
saddle,saddle,,0,0,0,0,2,0,2,1
xcdatamodel,xcdatamodel,,1,0,1,1,5,2,13,1
massmail,massmail,,0,0,2,0,2,2,4,1
createthread,createthread,,1,1,3,2,5,5,9,1
vibed,vibed,,0,2,3,2,2,5,9,100
msxml,msxml,,3,5,13,8,29,21,5,66.666667
multiple-views,multiple-views,,4,1,4,5,9,9,3,1
enctype,enctype,,2,1,4,3,5,7,1,1
hotfix,hotfix,,2,3,4,5,8,9,6,50
register-transfer-level,register-transfer-level,,6,6,10,12,17,22,9,1
eway,eway,,0,0,1,0,6,1,4,1
hamming-numbers,hamming-numbers,,1,0,2,1,3,3,2,1
smooth-numbers,smooth-numbers,,0,0,2,0,3,2,2,1
azure-marketplace,azure-marketplace,,6,0,13,6,16,19,8,1
fatfs,fatfs,,8,6,9,14,13,23,9,1
google-realtime-api,google-realtime-api,,1,0,2,1,4,3,3,1
parsey-mcparseface,parsey-mcparseface,,0,0,3,0,3,3,0,1
hl7-v2,hl7-v2,,2,6,7,8,19,15,14,200
mirth-connect,mirth-connect,,2,0,17,2,41,19,14,1
adt,adt,,4,6,14,10,19,24,9,50
wchar,wchar,,2,6,5,8,7,13,9,200
scribe,scribe,,1,1,4,2,8,6,3,1
haskell-diagrams,haskell-diagrams,,1,0,3,1,9,4,2,1
gedit,gedit,,5,3,3,8,20,11,9,1
periodicity,periodicity,,3,5,10,8,13,18,0,66.666667
android-usb,android-usb,,6,4,10,10,7,20,3,1
relate,relate,,0,0,0,0,1,0,0,1
contentmode,contentmode,,1,0,1,1,7,2,13,1
onepage-checkout,onepage-checkout,,3,1,2,4,4,6,4,1
avspeechutterance,avspeechutterance,,6,1,2,7,5,9,13,1
lync-2010,lync-2010,,0,0,1,0,1,1,8,1
ikvm,ikvm,,2,6,8,8,19,16,8,200
svgkit,svgkit,,0,1,2,1,5,3,13,1
epplus-4,epplus-4,,6,3,7,9,33,16,8,1
stackoverflow-bot,stackoverflow-bot,,0,0,1,0,1,1,1,1
implicit-declaration,implicit-declaration,,0,0,1,0,4,1,9,1
higher-kinded-types,higher-kinded-types,,10,3,15,13,32,28,2,1
type-projection,type-projection,,1,0,2,1,4,3,2,1
http-request2,http-request2,,1,0,0,1,5,1,4,1
fmod,fmod,,6,3,5,9,17,14,9,1
webcam.js,webcam.js,,2,3,7,5,12,12,1,50
google-api-dotnet-client,google-api-dotnet-client,,17,16,54,33,95,87,5,1
xamarin-binding,xamarin-binding,,3,4,15,7,14,22,8,33.333333
slidy,slidy,,0,1,2,1,2,3,0,1
nanohttpd,nanohttpd,,6,8,8,14,28,22,3,33.333333
uiviewpropertyanimator,uiviewpropertyanimator,,8,6,16,14,20,30,13,1
treetableview,treetableview,,3,1,9,4,19,13,3,1
rbokeh,rbokeh,,1,2,7,3,7,10,0,100
master-data-services,master-data-services,,2,2,6,4,17,10,4,1
master-data-management,master-data-management,,1,2,5,3,4,8,4,100
nuxeo,nuxeo,,3,5,2,8,13,10,3,66.666667
autofield,autofield,,0,0,0,0,3,0,3,1
flash-cs4,flash-cs4,,0,1,0,1,4,1,13,1
error-code,error-code,,6,15,27,21,41,48,9,150
dijit.form,dijit.form,,1,4,8,5,14,13,1,300
whoops,whoops,,0,0,4,0,6,4,4,1
file-listing,file-listing,,0,1,3,1,10,4,0,1
nsexception,nsexception,,4,2,7,6,23,13,13,1
nsnull,nsnull,,1,0,1,1,3,2,13,1
fileparsing,fileparsing,,3,4,11,7,14,18,0,33.333333
.doc,.doc,,3,2,6,5,7,11,0,1
fileinfo,fileinfo,,5,6,4,11,17,15,8,20
heap-dump,heap-dump,,12,8,22,20,37,42,3,1
hogan.js,hogan.js,,0,1,2,1,3,3,1,1
tpm,tpm,,6,10,17,16,23,33,6,66.666667
bitlocker,bitlocker,,4,7,16,11,19,27,8,75
contravariance,contravariance,,12,7,24,19,34,43,8,1
dataexplorer,dataexplorer,,4,6,12,10,8,22,4,50
easylogging++,easylogging++,,0,0,1,0,4,1,9,1
react-devtools,react-devtools,,9,10,12,19,18,31,1,11.111111
customvalidator,customvalidator,,11,7,39,18,17,57,1,1
validationmessage,validationmessage,,0,1,1,1,5,2,1,1
nativescript-cli,nativescript-cli,,3,2,12,5,20,17,1,1
screens,screens,,0,0,0,0,8,0,3,1
sfsafariviewcontroller,sfsafariviewcontroller,,7,7,30,14,30,44,13,1
git-history-graph,git-history-graph,,2,0,0,2,4,2,6,1
active-users,active-users,,1,0,1,1,3,2,3,1
zend-mail,zend-mail,,1,2,2,3,6,5,4,100
git-cherry-pick,git-cherry-pick,,4,9,22,13,40,35,6,125
xaringan,xaringan,,13,7,20,20,23,40,0,1
odt,odt,,7,3,11,10,17,21,5,1
odt.net,odt.net,,1,0,1,1,1,2,4,1
direct3d9,direct3d9,,2,2,4,4,5,8,9,1
kendo-ui-mvc,kendo-ui-mvc,,6,7,10,13,17,23,1,16.666667
kendo-upload,kendo-upload,,2,6,6,8,9,14,1,200
telegraf,telegraf,,33,26,45,59,58,104,6,1
hla,hla,,0,1,5,1,5,6,9,1
nscache,nscache,,5,2,6,7,12,13,13,1
watcom,watcom,,1,2,1,3,3,4,9,100
80286,80286,,0,1,0,1,2,1,9,1
reprojection-error,reprojection-error,,1,2,3,3,4,6,0,100
ddd-service,ddd-service,,5,0,5,5,12,10,8,1
automapper-6,automapper-6,,1,5,10,6,67,16,8,400
confirm-dialog,confirm-dialog,,3,0,4,3,5,7,1,1
cognos-8,cognos-8,,1,1,7,2,11,9,4,1
angular-oauth2-oidc,angular-oauth2-oidc,,4,5,7,9,19,16,1,25
oracle-jet,oracle-jet,,4,5,23,9,43,32,1,25
jstack,jstack,,1,3,10,4,8,14,3,200
utilization,utilization,,3,0,3,3,5,6,0,1
inotify,inotify,,13,17,17,30,42,47,9,30.769231
surfaceflinger,surfaceflinger,,1,3,2,4,5,6,3,200
verifyerror,verifyerror,,3,1,6,4,16,10,3,1
conform,conform,,0,0,3,0,2,3,13,1
datapump,datapump,,5,6,7,11,20,18,4,20
createsamples,createsamples,,0,0,1,0,3,1,0,1
apache-commons-dbcp,apache-commons-dbcp,,8,7,14,15,26,29,3,1
pthread-barriers,pthread-barriers,,0,0,4,0,7,4,9,1
createquery,createquery,,0,6,6,6,5,12,3,500
web-administration,web-administration,,1,1,4,2,6,6,8,1
sysdeo,sysdeo,,0,0,0,0,1,0,3,1
web-controls,web-controls,,0,2,4,2,16,6,8,100
mel,mel,,6,3,17,9,42,26,0,1
nusmv,nusmv,,5,2,10,7,13,17,0,1
dng,dng,,0,3,5,3,6,8,13,200
mpic++,mpic++,,1,0,3,1,1,4,9,1
xfa,xfa,,6,2,7,8,13,15,8,1
nested-repeater,nested-repeater,,0,0,4,0,5,4,8,1
embeddable,embeddable,,4,3,8,7,12,15,3,1
right-align,right-align,,4,0,3,4,13,7,1,1
teamcity-9.0,teamcity-9.0,,3,0,6,3,17,9,8,1
pointcut,pointcut,,4,3,10,7,19,17,3,1
conditional-split,conditional-split,,1,3,0,4,7,4,4,200
enthought,enthought,,3,1,5,4,16,9,0,1
traitsui,traitsui,,0,1,6,1,14,7,0,1
predictionio,predictionio,,6,5,9,11,25,20,2,1
openvr,openvr,,3,6,15,9,13,24,8,100
service-principal,service-principal,,10,14,10,24,18,34,8,40
excel-match,excel-match,,3,3,6,6,16,12,5,1
cursive,cursive,,4,3,8,7,8,15,2,1
hyphenation,hyphenation,,0,4,3,4,13,7,3,300
google-crawlers,google-crawlers,,10,12,14,22,35,36,4,20
vcf,vcf,,7,13,13,20,19,33,3,85.714286
carddav,carddav,,0,2,3,2,5,5,4,100
qmessagebox,qmessagebox,,1,5,7,6,29,13,0,400
blockchain.info-api,blockchain.info-api,,1,1,21,2,22,23,6,1
sta,sta,,4,2,8,6,15,14,8,1
dotras,dotras,,1,2,5,3,6,8,8,100
wow.js,wow.js,,7,6,11,13,16,24,1,1
non-english,non-english,,4,0,6,4,17,10,0,1
meteor-collections,meteor-collections,,0,0,1,0,12,1,1,1
fcntl,fcntl,,8,5,13,13,18,26,9,1
uimodaltransitionstyle,uimodaltransitionstyle,,0,2,0,2,2,2,13,100
log-shipping,log-shipping,,4,2,6,6,6,12,4,1
inspector,inspector,,7,7,20,14,34,34,8,1
concurrent-queue,concurrent-queue,,1,2,3,3,9,6,3,100
node-rest-client,node-rest-client,,1,0,5,1,7,6,1,1
pyusb,pyusb,,5,7,20,12,17,32,0,40
programmatically-created,programmatically-created,,7,6,20,13,28,33,13,1
onactionexecuting,onactionexecuting,,1,0,1,1,4,2,8,1
hanami-model,hanami-model,,1,0,3,1,3,4,12,1
conan,conan,,14,30,31,44,35,75,9,114.285714
gin,gin,,19,18,20,37,27,57,6,1
go-gin,go-gin,,2,2,17,4,23,21,6,1
chromakey,chromakey,,5,2,8,7,9,15,13,1
sigterm,sigterm,,6,10,9,16,22,25,9,66.666667
ruby-paranoia,ruby-paranoia,,2,0,3,2,5,5,12,1
tablefooterview,tablefooterview,,3,0,1,3,4,4,13,1
cloudboost,cloudboost,,0,0,0,0,4,0,1,1
jquery-load,jquery-load,,2,2,4,4,4,8,1,1
formarray,formarray,,34,46,54,80,78,134,1,35.294118
akka-remoting,akka-remoting,,1,1,4,2,12,6,2,1
bulksms,bulksms,,1,1,2,2,9,4,8,1
public-folders,public-folders,,1,2,3,3,6,6,8,100
mappingexception,mappingexception,,2,1,3,3,8,6,3,1
onlongclicklistener,onlongclicklistener,,6,5,7,11,16,18,3,1
fw1,fw1,,1,1,3,2,4,5,4,1
oim,oim,,7,6,3,13,13,16,4,1
code-search,code-search,,0,0,2,0,5,2,8,1
milo,milo,,3,3,15,6,32,21,8,1
mass-emails,mass-emails,,2,1,5,3,4,8,4,1
kingswaysoft,kingswaysoft,,6,5,6,11,21,17,4,1
ojalgo,ojalgo,,5,3,1,8,15,9,0,1
groove,groove,,1,0,2,1,2,3,0,1
newman,newman,,21,21,49,42,58,91,4,1
groovysh,groovysh,,0,0,2,0,4,2,3,1
surrogate-pairs,surrogate-pairs,,4,1,2,5,14,7,0,1
source-sets,source-sets,,1,4,4,5,12,9,3,300
react-dropzone,react-dropzone,,16,13,31,29,37,60,1,1
check-digit,check-digit,,0,0,0,0,6,0,0,1
looker,looker,,6,2,5,8,9,13,4,1
helicontech,helicontech,,0,0,0,0,2,0,8,1
heliconzoo,heliconzoo,,0,0,0,0,1,0,8,1
top-down,top-down,,0,0,0,0,6,0,8,1
icollection,icollection,,3,1,10,4,14,14,8,1
shell-extensions,shell-extensions,,10,3,9,13,17,22,9,1
fitness,fitness,,5,4,5,9,11,14,0,1
spring.net,spring.net,,4,1,0,5,6,5,8,1
variable-names,variable-names,,13,8,9,21,20,30,0,1
getnameinfo,getnameinfo,,0,0,0,0,1,0,9,1
liferay-ide,liferay-ide,,2,4,5,6,8,11,3,100
fetchall,fetchall,,3,1,9,4,17,13,4,1
motif,motif,,1,1,3,2,3,5,9,1
meteor-publications,meteor-publications,,1,1,5,2,10,7,1,1
wildcard-expansion,wildcard-expansion,,1,0,1,1,4,2,0,1
geoalchemy,geoalchemy,,0,2,2,2,3,4,0,100
kotlin-html-builder,kotlin-html-builder,,0,0,0,0,2,0,3,1
minesweeper,minesweeper,,9,2,16,11,33,27,0,1
wwdc,wwdc,,0,8,3,8,10,11,13,700
option-rom,option-rom,,0,0,0,0,2,0,9,1
aspwizard,aspwizard,,0,0,1,0,2,1,8,1
mkstorekit,mkstorekit,,0,0,1,0,2,1,13,1
xamarin.forms-styles,xamarin.forms-styles,,0,2,8,2,6,10,8,100
xamarin.forms.entry,xamarin.forms.entry,,2,3,4,5,3,9,8,50
homekit,homekit,,3,2,19,5,16,24,13,1
vim-registers,vim-registers,,0,0,1,0,4,1,9,1
www-mechanize-firefox,www-mechanize-firefox,,0,0,0,0,3,0,9,1
woocommerce-theming,woocommerce-theming,,8,6,19,14,30,33,4,1
gridfs-stream,gridfs-stream,,8,5,20,13,17,33,1,1
vertex-attributes,vertex-attributes,,0,0,3,0,8,3,9,1
go-gl,go-gl,,0,0,0,0,1,0,9,1
sfauthenticationsession,sfauthenticationsession,,1,2,7,3,13,10,13,100
javafx-webengine,javafx-webengine,,3,8,14,11,18,25,3,166.666667
csplit,csplit,,1,1,4,2,7,6,9,1
yaxis,yaxis,,18,21,35,39,65,74,0,16.666667
nsurlprotocol,nsurlprotocol,,1,0,4,1,4,5,13,1
differentiation,differentiation,,4,8,19,12,23,31,0,100
roman-numerals,roman-numerals,,3,0,7,3,17,10,0,1
jwk,jwk,,9,6,17,15,11,32,4,1
async-iterator,async-iterator,,4,1,5,5,3,10,1,1
linecache,linecache,,0,1,2,1,5,3,0,1
bibliography,bibliography,,6,9,11,15,24,26,0,50
citations,citations,,7,6,16,13,25,29,0,1
validationexception,validationexception,,1,1,0,2,2,2,6,1
tcsh,tcsh,,9,10,27,19,56,46,9,11.111111
squeryl,squeryl,,0,0,3,0,3,3,2,1
ssms-2016,ssms-2016,,5,3,18,8,34,26,4,1
anti-cheat,anti-cheat,,1,1,4,2,8,6,1,1
amstock,amstock,,1,0,8,1,13,9,1,1
slimscroll,slimscroll,,0,0,6,0,7,6,1,1
cpanm,cpanm,,4,10,7,14,9,21,9,150
word-list,word-list,,4,3,3,7,6,10,0,1
timber-android,timber-android,,0,0,4,0,8,4,3,1
polly,polly,,12,13,34,25,41,59,8,8.333333
plperl,plperl,,0,0,1,0,5,1,9,1
kendo-combobox,kendo-combobox,,9,3,7,12,15,19,1,1
downgrade,downgrade,,7,4,18,11,28,29,1,1
imagelist,imagelist,,7,1,12,8,11,20,8,1
amazon-elastic-transcoder,amazon-elastic-transcoder,,4,3,10,7,20,17,6,1
video-on-demand,video-on-demand,,1,0,2,1,5,3,13,1
gnome-builder,gnome-builder,,1,3,5,4,7,9,9,200
ecm,ecm,,1,0,2,1,12,3,3,1
nock,nock,,12,11,34,23,46,57,1,1
mc,mc,,0,0,4,0,4,4,9,1
microphone,microphone,,20,34,50,54,85,104,13,70
paperclip-validation,paperclip-validation,,0,0,1,0,4,1,12,1
namespace-package,namespace-package,,2,2,1,4,4,5,0,1
lxd,lxd,,10,9,11,19,28,30,6,1
system.in,system.in,,3,4,10,7,12,17,3,33.333333
frequency-analysis,frequency-analysis,,10,10,27,20,21,47,0,1
fad,fad,,0,0,0,0,1,0,0,1
ssdt-bi,ssdt-bi,,2,4,4,6,11,10,4,100
input-devices,input-devices,,3,0,3,3,11,6,3,1
django-filters,django-filters,,13,14,12,27,33,39,0,7.692308
clickable-image,clickable-image,,0,0,2,0,3,2,3,1
insertafter,insertafter,,2,2,7,4,7,11,1,1
minmax,minmax,,8,6,15,14,18,29,0,1
arrayofarrays,arrayofarrays,,2,3,8,5,15,13,1,50
qinputdialog,qinputdialog,,1,3,5,4,3,9,0,200
dumpdata,dumpdata,,3,1,3,4,3,7,0,1
dom7,dom7,,1,1,1,2,5,3,1,1
emptydatatemplate,emptydatatemplate,,0,0,0,0,1,0,8,1
timeunit,timeunit,,0,1,3,1,8,4,3,1
twilio-click-to-call,twilio-click-to-call,,5,6,18,11,26,29,13,20
ksoap,ksoap,,2,1,5,3,5,8,3,1
nvenc,nvenc,,2,2,3,4,15,7,13,1
pander,pander,,0,0,5,0,15,5,0,1
zxing.net,zxing.net,,8,6,23,14,35,37,8,1
xmltask,xmltask,,1,0,1,1,5,2,3,1
xmlcatalog,xmlcatalog,,0,1,0,1,5,1,3,1
go-ethereum,go-ethereum,,14,13,53,27,131,80,6,1
amazon-macie,amazon-macie,,0,1,2,1,3,3,6,1
service-worker-events,service-worker-events,,10,8,22,18,40,40,1,1
accumulator,accumulator,,8,2,15,10,25,25,2,1
matter.js,matter.js,,6,5,9,11,10,20,1,1
adorner,adorner,,3,1,3,4,8,7,8,1
sharepoint-2016,sharepoint-2016,,18,29,37,47,42,84,8,61.111111
web-parts,web-parts,,12,10,23,22,36,45,8,1
filefilter,filefilter,,2,0,3,2,12,5,3,1
syphon,syphon,,0,0,1,0,2,1,1,1
es6-module-loader,es6-module-loader,,6,3,14,9,22,23,1,1
printer-control-language,printer-control-language,,2,2,3,4,21,7,8,1
log4,log4,,1,3,1,4,11,5,3,200
detours,detours,,2,5,4,7,9,11,9,150
flashplayer-9,flashplayer-9,,0,0,0,0,1,0,13,1
color-blending,color-blending,,0,1,5,1,5,6,1,1
android-ksoap2,android-ksoap2,,8,6,17,14,23,31,3,1
mbedtls,mbedtls,,10,3,12,13,23,25,9,1
google-cloud-dataprep,google-cloud-dataprep,,13,11,32,24,56,56,6,1
directus,directus,,5,6,15,11,6,26,4,20
android-support-design,android-support-design,,3,2,4,5,20,9,3,1
modeless-dialog,modeless-dialog,,0,2,2,2,1,4,9,100
cross-correlation,cross-correlation,,14,8,23,22,32,45,0,1
wkinterfacetable,wkinterfacetable,,2,0,3,2,7,5,13,1
mkmapviewdelegate,mkmapviewdelegate,,1,3,1,4,11,5,13,200
mkpointannotation,mkpointannotation,,0,2,4,2,8,6,13,100
endorsed,endorsed,,0,0,0,0,7,0,3,1
xmlsec,xmlsec,,1,4,7,5,9,12,3,300
libltdl,libltdl,,0,0,1,0,1,1,9,1
xmlsec1,xmlsec1,,0,1,1,1,5,2,3,1
ccavenue,ccavenue,,3,10,22,13,19,35,4,233.333333
docvariable,docvariable,,1,1,0,2,5,2,5,1
id3v2,id3v2,,3,1,4,4,7,8,0,1
libimobiledevice,libimobiledevice,,3,2,8,5,8,13,13,1
textblob,textblob,,24,13,28,37,50,65,0,1
acm,acm,,3,2,4,5,9,9,6,1
c#-7.1,c#-7.1,,1,1,4,2,12,6,8,1
4d,4d,,4,2,10,6,18,16,0,1
datacontext,datacontext,,12,17,35,29,47,64,8,41.666667
motherboard,motherboard,,0,4,4,4,4,8,9,300
pluralize,pluralize,,0,1,6,1,8,7,13,1
backoffice,backoffice,,6,9,16,15,19,31,3,50
explicit-instantiation,explicit-instantiation,,1,2,6,3,14,9,9,100
xsd.exe,xsd.exe,,4,1,4,5,19,9,3,1
angular-kendo,angular-kendo,,1,3,3,4,2,7,1,200
iron-list,iron-list,,2,1,0,3,6,3,1,1
packetbeat,packetbeat,,4,2,2,6,12,8,6,1
mediacontroller,mediacontroller,,5,3,10,8,24,18,3,1
sshfs,sshfs,,9,4,7,13,18,20,9,1
heroku-api,heroku-api,,6,4,7,10,23,17,1,1
node-imap,node-imap,,2,2,7,4,10,11,1,1
jsonschema2pojo,jsonschema2pojo,,6,8,6,14,27,20,3,33.333333
longest-substring,longest-substring,,2,6,12,8,16,20,0,200
social-authentication,social-authentication,,1,3,6,4,15,10,4,200
build-management,build-management,,0,1,1,1,1,2,8,1
maven-exec-plugin,maven-exec-plugin,,1,3,6,4,5,10,3,200
finalizer,finalizer,,7,6,18,13,18,31,8,1
ionide,ionide,,2,3,5,5,14,10,8,50
starttls,starttls,,10,5,22,15,22,37,4,1
linode,linode,,13,7,11,20,15,31,4,1
sqlclient,sqlclient,,19,6,17,25,34,42,8,1
clamp,clamp,,3,1,3,4,6,7,0,1
dropbox-js,dropbox-js,,1,1,5,2,8,7,4,1
rspec-mocks,rspec-mocks,,2,2,4,4,4,8,12,1
typelite,typelite,,0,0,0,0,5,0,1,1
dynamic-execution,dynamic-execution,,1,0,1,1,2,2,0,1
preferencescreen,preferencescreen,,5,1,12,6,13,18,3,1
sublimelinter,sublimelinter,,0,3,6,3,23,9,0,200
presentmodalviewcontroller,presentmodalviewcontroller,,3,4,11,7,12,18,13,33.333333
drawtextinrect,drawtextinrect,,0,0,0,0,1,0,13,1
tchromium,tchromium,,0,2,1,2,7,3,9,100
weibo,weibo,,0,1,2,1,3,3,4,1
sinaweibo,sinaweibo,,0,1,1,1,2,2,4,1
onmousedown,onmousedown,,3,0,13,3,13,16,1,1
code-migration,code-migration,,1,0,5,1,4,6,13,1
with-clause,with-clause,,1,1,2,2,2,4,4,1
metrolog,metrolog,,0,0,0,0,3,0,8,1
virsh,virsh,,2,4,5,6,15,11,9,100
fax,fax,,2,5,5,7,22,12,13,150
acts-as-nested-set,acts-as-nested-set,,0,0,0,0,1,0,12,1
jxpath,jxpath,,1,2,3,3,2,6,3,100
jmeter-4.0,jmeter-4.0,,24,20,70,44,107,114,3,1
kraken.com,kraken.com,,0,2,3,2,12,5,0,100
rrule,rrule,,7,8,18,15,11,33,0,14.285714
waitress,waitress,,6,6,11,12,9,23,0,1
scim2,scim2,,6,3,11,9,10,20,14,1
insets,insets,,0,0,6,0,5,6,0,1
precompiled-headers,precompiled-headers,,12,5,20,17,19,37,9,1
django-debug-toolbar,django-debug-toolbar,,1,5,12,6,17,18,0,400
demandware,demandware,,2,2,9,4,17,13,14,1
trello,trello,,26,13,28,39,42,67,12,1
bootstrap-material-design,bootstrap-material-design,,7,2,10,9,14,19,1,1
expdp,expdp,,5,3,13,8,21,21,4,1
stack-pointer,stack-pointer,,7,2,6,9,11,15,9,1
jsonobjectrequest,jsonobjectrequest,,7,5,13,12,36,25,3,1
downsampling,downsampling,,9,7,12,16,16,28,0,1
jquery-csv,jquery-csv,,1,1,0,2,10,2,1,1
dimple.js,dimple.js,,0,0,6,0,14,6,1,1
uinavigation,uinavigation,,2,2,4,4,7,8,13,1
django-messages,django-messages,,1,6,8,7,18,15,0,500
chrome-datasaver,chrome-datasaver,,1,0,1,1,1,2,0,1
android-datasaver,android-datasaver,,2,0,2,2,1,4,0,1
delphi-ide,delphi-ide,,0,0,1,0,2,1,9,1
timagelist,timagelist,,1,2,4,3,4,7,9,100
gentoo,gentoo,,5,2,12,7,16,19,9,1
elytron,elytron,,5,3,8,8,10,16,3,1
android-auto,android-auto,,9,13,18,22,18,40,3,44.444444
angular2-select,angular2-select,,0,0,0,0,4,0,1,1
sqlite.net,sqlite.net,,1,1,2,2,14,4,8,1
eigenclass,eigenclass,,1,0,0,1,2,1,12,1
nested-form-for,nested-form-for,,1,1,2,2,10,4,12,1
visual-paradigm,visual-paradigm,,3,3,8,6,15,14,3,1
archimate,archimate,,0,1,2,1,3,3,3,1
vertx-httpclient,vertx-httpclient,,0,1,8,1,10,9,3,1
x3dom,x3dom,,4,2,5,6,5,11,1,1
chown,chown,,11,8,18,19,23,37,9,1
inner-query,inner-query,,0,1,2,1,5,3,4,1
authy,authy,,8,6,6,14,15,20,13,1
sql-server-2008r2-express,sql-server-2008r2-express,,1,0,1,1,5,2,4,1
fakeiteasy,fakeiteasy,,7,3,11,10,25,21,8,1
pdfrw,pdfrw,,7,5,8,12,4,20,0,1
webex,webex,,4,2,5,6,3,11,6,1
delphi-2006,delphi-2006,,0,0,0,0,7,0,9,1
airconsole,airconsole,,0,0,5,0,5,5,8,1
sieve-of-eratosthenes,sieve-of-eratosthenes,,4,7,14,11,38,25,0,75
mindbody,mindbody,,1,1,3,2,1,5,1,1
winrs,winrs,,0,2,1,2,4,3,8,100
code-collaborator,code-collaborator,,0,0,1,0,4,1,6,1
fish,fish,,19,18,39,37,73,76,9,1
nehotspothelper,nehotspothelper,,2,3,3,5,13,8,13,50
sitemapprovider,sitemapprovider,,1,0,0,1,3,1,8,1
sharepoint-list,sharepoint-list,,10,11,29,21,27,50,8,10
vaadin-elements,vaadin-elements,,0,2,0,2,6,2,1,100
gradle-apt-plugin,gradle-apt-plugin,,0,0,0,0,2,0,3,1
dynamicquery,dynamicquery,,8,8,11,16,33,27,4,1
recursive-mutex,recursive-mutex,,0,0,2,0,4,2,9,1
plyr.js,plyr.js,,1,4,20,5,9,25,1,300
pydal,pydal,,0,0,1,0,6,1,0,1
clevertap,clevertap,,2,4,4,6,9,10,13,100
publish-actions,publish-actions,,0,0,2,0,6,2,13,1
datatemplateselector,datatemplateselector,,2,0,5,2,10,7,8,1
pingdom,pingdom,,0,0,7,0,5,7,4,1
gtmetrix,gtmetrix,,8,10,15,18,19,33,4,25
gridpanel,gridpanel,,0,0,5,0,11,5,1,1
robotium-recorder,robotium-recorder,,0,0,2,0,2,2,3,1
imperative,imperative,,1,1,4,2,2,6,6,1
spring-security-cas,spring-security-cas,,1,1,2,2,1,4,3,1
deflatestream,deflatestream,,1,2,2,3,4,5,8,100
mbtiles,mbtiles,,5,4,9,9,20,18,1,1
todataurl,todataurl,,6,4,6,10,19,16,1,1
random-access,random-access,,2,1,2,3,13,5,9,1
flarum,flarum,,0,0,1,0,4,1,4,1
nstextattachment,nstextattachment,,4,3,9,7,19,16,13,1
couchbase-java-api,couchbase-java-api,,3,7,11,10,14,21,3,133.333333
pdf-writer,pdf-writer,,3,2,3,5,2,8,8,1
viewlayout,viewlayout,,0,0,1,0,1,1,8,1
sass-lint,sass-lint,,4,0,3,4,7,7,1,1
angular-templatecache,angular-templatecache,,0,0,3,0,11,3,1,1
tagged-corpus,tagged-corpus,,2,1,6,3,2,9,0,1
googlebot,googlebot,,7,16,19,23,22,42,4,128.571429
pybuilder,pybuilder,,3,1,5,4,14,9,0,1
framerjs,framerjs,,1,3,4,4,12,8,1,200
searchable,searchable,,0,6,5,6,7,11,4,500
transit,transit,,3,3,2,6,7,8,1,1
phantomjs-node,phantomjs-node,,1,2,0,3,9,3,1,100
netldap,netldap,,0,0,3,0,2,3,8,1
trayicon,trayicon,,4,3,5,7,15,12,8,1
method-call,method-call,,10,12,20,22,23,42,3,20
silent-installer,silent-installer,,6,5,11,11,26,22,8,1
key-protect,key-protect,,0,0,0,0,2,0,6,1
windows-creators,windows-creators,,0,0,0,0,3,0,3,1
http-put,http-put,,12,5,13,17,19,30,4,1
requestfiltering,requestfiltering,,3,1,2,4,2,6,3,1
privateobject.invoke,privateobject.invoke,,0,0,0,0,3,0,8,1
jqassistant,jqassistant,,0,1,4,1,7,5,2,1
cheminformatics,cheminformatics,,1,2,3,3,3,6,0,100
natvis,natvis,,1,1,7,2,14,9,8,1
f#-fake,f#-fake,,4,2,9,6,21,15,8,1
vuzix,vuzix,,3,3,3,6,4,9,3,1
ios8-share-extension,ios8-share-extension,,4,1,6,5,30,11,13,1
flyspell,flyspell,,0,0,0,0,1,0,9,1
libgit2,libgit2,,15,4,20,19,37,39,6,1
usernotifications,usernotifications,,3,9,22,12,38,34,13,200
minimax,minimax,,26,13,38,39,84,77,0,1
jasmine-ajax,jasmine-ajax,,2,0,0,2,3,2,1,1
lcm,lcm,,1,1,7,2,15,9,0,1
devdefined-oauth,devdefined-oauth,,0,0,1,0,1,1,13,1
regexp-like,regexp-like,,6,9,19,15,21,34,4,50
nested-routes,nested-routes,,10,8,14,18,31,32,1,1
guice-3,guice-3,,1,1,4,2,6,6,3,1
cmocka,cmocka,,7,4,2,11,10,13,9,1
qt4.7,qt4.7,,0,0,0,0,1,0,9,1
azure-mcd,azure-mcd,,0,0,0,0,1,0,8,1
regular-language,regular-language,,27,17,56,44,78,100,0,1
bfcache,bfcache,,0,0,1,0,2,1,1,1
wificonfiguration,wificonfiguration,,2,4,16,6,20,22,3,100
tasklet,tasklet,,1,0,0,1,5,1,3,1
writetofile,writetofile,,3,6,4,9,22,13,0,100
filetable,filetable,,2,6,1,8,11,9,4,200
rx-groovy,rx-groovy,,0,0,0,0,2,0,3,1
win64,win64,,3,5,8,8,14,16,9,66.666667
vba7,vba7,,2,0,1,2,2,3,5,1
themoviedb-api,themoviedb-api,,5,10,6,15,16,21,3,100
fedora-commons,fedora-commons,,1,0,1,1,3,2,3,1
iperf3,iperf3,,3,0,8,3,11,11,9,1
iconutil,iconutil,,0,0,0,0,1,0,13,1
immutable-collections,immutable-collections,,3,5,5,8,10,13,1,66.666667
readme,readme,,5,6,17,11,32,28,6,20
requiredfieldvalidator,requiredfieldvalidator,,7,3,13,10,24,23,8,1
info-plist,info-plist,,6,6,4,12,10,16,13,1
stdbind,stdbind,,5,9,20,14,39,34,9,80
dapper-contrib,dapper-contrib,,2,4,5,6,21,11,8,100
google-developers-console,google-developers-console,,17,27,44,44,67,88,5,58.823529
autogeneratecolumn,autogeneratecolumn,,2,0,1,2,3,3,8,1
nano,nano,,6,0,14,6,29,20,9,1
sap-gui,sap-gui,,10,13,10,23,25,33,5,30
stubbing,stubbing,,6,4,13,10,26,23,1,1
money-rails,money-rails,,0,1,5,1,6,6,12,1
xlform,xlform,,0,1,1,1,3,2,13,1
klein-mvc,klein-mvc,,0,0,1,0,7,1,0,1
bindingsource,bindingsource,,11,9,16,20,34,36,8,1
sql-server-2012-datatools,sql-server-2012-datatools,,0,0,1,0,1,1,4,1
s,s,,2,0,13,2,14,15,9,1
libxml2,libxml2,,16,26,33,42,56,75,3,62.5
angular-schematics,angular-schematics,,20,11,32,31,19,63,1,1
watir-classic,watir-classic,,0,0,0,0,2,0,12,1
drat,drat,,0,0,1,0,1,1,0,1
tiles2,tiles2,,0,0,2,0,3,2,3,1
compositecollection,compositecollection,,0,0,3,0,4,3,8,1
rblpapi,rblpapi,,3,6,7,9,4,16,0,100
python-chess,python-chess,,4,0,7,4,4,11,0,1
aws-sdk-ruby,aws-sdk-ruby,,9,6,4,15,15,19,6,1
ril,ril,,0,1,1,1,5,2,3,1
core.async,core.async,,1,1,6,2,20,8,2,1
writealltext,writealltext,,0,0,0,0,4,0,8,1
grunt-contrib-less,grunt-contrib-less,,0,0,1,0,2,1,1,1
tether,tether,,1,1,0,2,8,2,1,1
root-element,root-element,,0,1,0,1,3,1,3,1
raw-ethernet,raw-ethernet,,4,2,6,6,12,12,9,1
docker-toolbox,docker-toolbox,,21,19,36,40,64,76,6,1
silverstripe-4,silverstripe-4,,27,18,53,45,100,98,4,1
hmisc,hmisc,,3,6,14,9,27,23,0,100
bftask,bftask,,0,0,0,0,1,0,3,1
cartography,cartography,,3,3,6,6,8,12,0,1
windres,windres,,2,1,2,3,5,5,9,1
azure-node-sdk,azure-node-sdk,,5,4,13,9,14,22,8,1
wpf-extended-toolkit,wpf-extended-toolkit,,0,1,0,1,5,1,8,1
nmatrix,nmatrix,,0,1,1,1,1,2,12,1
commandlink,commandlink,,0,1,1,1,6,2,3,1
trinidad,trinidad,,3,0,9,3,6,12,3,1
userprincipal,userprincipal,,2,1,6,3,15,9,8,1
aws-sam,aws-sam,,37,47,48,84,18,132,6,27.027027
theorem,theorem,,0,2,1,2,3,3,0,100
wm-paint,wm-paint,,2,0,1,2,7,3,9,1
vmware-player,vmware-player,,3,4,11,7,15,18,6,33.333333
jsartoolkit,jsartoolkit,,1,6,0,7,8,7,1,500
edifabric,edifabric,,0,0,0,0,1,0,8,1
silhouette,silhouette,,6,3,9,9,30,18,2,1
bbedit,bbedit,,3,2,4,5,17,9,0,1
sycl,sycl,,1,3,3,4,9,7,0,200
grunt-contrib-concat,grunt-contrib-concat,,1,0,1,1,8,2,1,1
jsonslurper,jsonslurper,,9,2,7,11,16,18,3,1
dynamic-controls,dynamic-controls,,2,2,5,4,8,9,8,1
googleway,googleway,,5,6,18,11,35,29,0,20
code-access-security,code-access-security,,1,0,4,1,4,5,8,1
database-locking,database-locking,,6,3,3,9,11,12,4,1
node.js-stream,node.js-stream,,3,3,16,6,8,22,1,1
deepstream.io,deepstream.io,,0,0,0,0,10,0,1,1
mesh-network,mesh-network,,0,3,2,3,6,5,3,200
dspack,dspack,,0,0,1,0,1,1,9,1
ftp-client,ftp-client,,12,16,31,28,57,59,4,33.333333
ng2-datepicker,ng2-datepicker,,0,1,1,1,8,2,1,1
sharefile,sharefile,,2,3,3,5,5,8,4,50
html-rendering,html-rendering,,5,11,10,16,21,26,1,120
database-project,database-project,,9,6,12,15,29,27,4,1
european-data-format,european-data-format,,1,2,4,3,10,7,0,100
jsse,jsse,,1,7,14,8,24,22,3,600
grdb,grdb,,1,2,0,3,8,3,13,100
mysql-error-1452,mysql-error-1452,,1,1,0,2,7,2,4,1
imgur,imgur,,18,11,24,29,35,53,4,1
target-framework,target-framework,,1,1,1,2,10,3,8,1
type-2-dimension,type-2-dimension,,2,1,2,3,2,5,4,1
stateful,stateful,,18,12,35,30,31,65,13,1
cryptographic-hash-function,cryptographic-hash-function,,5,1,5,6,15,11,6,1
ora2pg,ora2pg,,2,1,4,3,5,7,4,1
schtasks.exe,schtasks.exe,,3,1,3,4,15,7,9,1
doorkeeper,doorkeeper,,6,13,14,19,27,33,12,116.666667
django-oracle,django-oracle,,0,0,0,0,3,0,0,1
blockingcollection,blockingcollection,,6,3,6,9,15,15,8,1
tinyioc,tinyioc,,0,0,1,0,5,1,8,1
music-notation,music-notation,,1,2,5,3,5,8,0,100
backspace,backspace,,3,8,7,11,24,18,0,166.666667
svcutil.exe,svcutil.exe,,7,4,6,11,12,17,8,1
wcf-endpoint,wcf-endpoint,,2,1,1,3,6,4,8,1
angular-nvd3,angular-nvd3,,4,2,5,6,17,11,1,1
azure-function-app-proxy,azure-function-app-proxy,,2,5,21,7,27,28,8,150
kestrel,kestrel,,23,18,30,41,55,71,8,1
msbuild-15,msbuild-15,,0,0,6,0,15,6,8,1
mappings,mappings,,0,0,0,0,8,0,6,1
neo4j-embedded,neo4j-embedded,,3,1,3,4,6,7,2,1
arangodb-php,arangodb-php,,0,1,4,1,2,5,2,1
es6-map,es6-map,,7,8,9,15,24,24,1,14.285714
wpfgrid,wpfgrid,,1,3,9,4,13,13,8,200
adventure,adventure,,1,2,3,3,16,6,0,100
alternating,alternating,,2,3,3,5,11,8,0,50
expss,expss,,10,10,15,20,11,35,0,1
angular-guards,angular-guards,,10,15,19,25,22,44,1,50
management-studio-express,management-studio-express,,5,2,3,7,10,10,4,1
identify,identify,,6,7,5,13,16,18,0,16.666667
delphi-mocks,delphi-mocks,,1,0,0,1,2,1,9,1
azure-machine-learning-workbench,azure-machine-learning-workbench,,0,3,6,3,24,9,8,200
aranchor,aranchor,,1,3,4,4,5,8,13,200
video-player,video-player,,18,13,34,31,47,65,1,1
sharpgl,sharpgl,,1,0,3,1,12,4,8,1
mysql-error-1030,mysql-error-1030,,0,0,0,0,1,0,4,1
check-mk,check-mk,,2,4,9,6,6,15,6,100
python-siphon,python-siphon,,0,1,0,1,1,1,0,1
node-fibers,node-fibers,,1,0,2,1,10,3,1,1
unityads,unityads,,3,10,4,13,11,17,3,233.333333
btrfs,btrfs,,2,2,6,4,6,10,9,1
spark-avro,spark-avro,,13,13,10,26,33,36,2,1
fastroute,fastroute,,0,1,5,1,7,6,4,1
revisionable,revisionable,,0,0,1,0,3,1,4,1
esri-arc-engine,esri-arc-engine,,2,1,2,3,4,5,1,1
health-monitoring,health-monitoring,,15,16,44,31,48,75,3,6.666667
rundll32,rundll32,,1,2,2,3,4,5,8,100
insert-statement,insert-statement,,0,0,1,0,5,1,4,1
android-mediasession,android-mediasession,,10,5,19,15,28,34,3,1
ios-multithreading,ios-multithreading,,3,1,7,4,8,11,13,1
osx-gatekeeper,osx-gatekeeper,,2,5,8,7,6,15,13,150
alteryx,alteryx,,9,6,19,15,21,34,4,1
opentbs,opentbs,,2,9,13,11,20,24,4,350
tinybutstrong,tinybutstrong,,2,8,12,10,18,22,4,300
operations-research,operations-research,,10,3,3,13,12,16,0,1
system.net,system.net,,6,2,14,8,26,22,8,1
django-formwizard,django-formwizard,,4,9,15,13,16,28,0,125
optimistic-locking,optimistic-locking,,8,6,21,14,28,35,3,1
commonmark,commonmark,,0,1,4,1,5,5,0,1
oracledb,oracledb,,18,22,33,40,72,73,1,22.222222
gitlab-api,gitlab-api,,23,25,29,48,58,77,6,8.695652
mod-autoindex,mod-autoindex,,2,0,0,2,2,2,4,1
python-3.3,python-3.3,,5,3,7,8,12,15,0,1
paramarray,paramarray,,0,1,1,1,4,2,5,1
lightbox2,lightbox2,,7,6,11,13,21,24,1,1
md2,md2,,0,0,0,0,1,0,1,1
mlxtend,mlxtend,,6,7,13,13,8,26,0,16.666667
portletbridge,portletbridge,,0,0,1,0,1,1,3,1
revert,revert,,6,3,14,9,40,23,6,1
tizen-native-app,tizen-native-app,,7,5,7,12,28,19,13,1
karma-chrome-launcher,karma-chrome-launcher,,1,4,5,5,4,10,1,300
oltu,oltu,,2,0,2,2,6,4,3,1
source-engine,source-engine,,1,0,0,1,3,1,0,1
wikimedia,wikimedia,,3,8,5,11,17,16,2,166.666667
string-table,string-table,,0,0,0,0,2,0,9,1
compute-shader,compute-shader,,11,12,20,23,46,43,9,9.090909
azure-vm-role,azure-vm-role,,1,0,0,1,9,1,8,1
blanket.js,blanket.js,,0,0,0,0,1,0,1,1
jscoverage,jscoverage,,1,0,0,1,1,1,1,1
clear-cache,clear-cache,,0,0,4,0,7,4,3,1
schema-design,schema-design,,0,0,0,0,4,0,2,1
voldemort,voldemort,,1,0,0,1,3,1,3,1
iterated-function,iterated-function,,1,0,4,1,4,5,0,1
program-slicing,program-slicing,,0,3,2,3,4,5,3,200
azcopy,azcopy,,22,16,11,38,30,49,8,1
xcasset,xcasset,,5,7,9,12,23,21,13,40
ef-model-first,ef-model-first,,1,5,2,6,5,8,8,400
uicollisionbehavior,uicollisionbehavior,,1,0,0,1,2,1,13,1
vanilla-typescript,vanilla-typescript,,8,4,6,12,12,18,1,1
titleview,titleview,,7,3,7,10,13,17,13,1
urlmon,urlmon,,0,1,1,1,3,2,5,1
mpfr,mpfr,,6,1,4,7,13,11,9,1
html-help,html-help,,1,0,0,1,5,1,8,1
html-help-workshop,html-help-workshop,,1,2,2,3,5,5,8,100
mmu,mmu,,2,5,10,7,16,17,9,150
image-formats,image-formats,,2,2,7,4,5,11,0,1
mongodb2,mongodb2,,0,0,0,0,2,0,1,1
har,har,,8,11,14,19,15,33,3,37.5
scalactic,scalactic,,0,0,0,0,2,0,2,1
sensitive-data,sensitive-data,,1,3,2,4,6,6,4,200
tableheader,tableheader,,8,2,5,10,11,15,13,1
serviceknowntype,serviceknowntype,,0,0,0,0,1,0,8,1
binding.scala,binding.scala,,2,0,6,2,16,8,2,1
locals,locals,,0,0,0,0,7,0,0,1
jdk-tools,jdk-tools,,0,0,0,0,1,0,3,1
jmod,jmod,,0,3,2,3,2,5,3,200
jwrapper,jwrapper,,0,0,0,0,1,0,13,1
gcdasyncsocket,gcdasyncsocket,,1,0,2,1,9,3,13,1
strtoull,strtoull,,1,1,1,2,2,3,9,1
viewpanel,viewpanel,,0,0,2,0,3,2,5,1
star-schema,star-schema,,5,8,11,13,32,24,4,60
fact-table,fact-table,,3,5,3,8,10,11,4,66.666667
ember-emojione,ember-emojione,,0,0,0,0,1,0,1,1
libtiff,libtiff,,5,10,20,15,24,35,0,100
mlpack,mlpack,,2,1,6,3,4,9,9,1
jquery-multiselect,jquery-multiselect,,0,0,0,0,8,0,1,1
ozeki,ozeki,,1,3,3,4,4,7,13,200
year2038,year2038,,1,3,3,4,4,7,0,200
nstreecontroller,nstreecontroller,,0,0,2,0,6,2,13,1
uefi,uefi,,17,15,20,32,41,52,9,1
mrunit,mrunit,,1,0,1,1,3,2,2,1
mod-deflate,mod-deflate,,0,1,3,1,10,4,4,1
tnsnames,tnsnames,,2,7,16,9,20,25,4,250
tnsping,tnsping,,0,2,1,2,4,3,4,100
pysal,pysal,,3,5,13,8,6,21,0,66.666667
sp-executesql,sp-executesql,,3,3,10,6,18,16,4,1
cilk,cilk,,0,0,0,0,4,0,9,1
magicmock,magicmock,,4,5,7,9,21,16,0,25
leaf,leaf,,3,2,3,5,12,8,13,1
flask-appbuilder,flask-appbuilder,,5,5,17,10,23,27,0,1
swiftocr,swiftocr,,2,0,0,2,2,2,13,1
prop,prop,,13,9,14,22,31,36,1,1
numpy-einsum,numpy-einsum,,13,8,11,21,23,32,0,1
entrust,entrust,,3,1,5,4,17,9,4,1
elastic-map-reduce,elastic-map-reduce,,0,0,0,0,20,0,2,1
bluetooth-profile,bluetooth-profile,,2,1,2,3,3,5,3,1
aslr,aslr,,3,5,7,8,10,15,9,66.666667
hermite,hermite,,2,0,0,2,7,2,0,1
response.transmitfile,response.transmitfile,,1,0,1,1,3,2,8,1
pathinfo,pathinfo,,0,3,1,3,7,4,4,200
xunit2,xunit2,,0,2,1,2,3,3,8,100
koa-router,koa-router,,2,0,17,2,24,19,1,1
des,des,,18,10,17,28,31,45,6,1
recording,recording,,15,7,25,22,42,47,13,1
rpscreenrecorder,rpscreenrecorder,,0,0,1,0,7,1,13,1
apikit,apikit,,1,1,1,2,5,3,14,1
fmi,fmi,,5,7,20,12,13,32,0,40
jmodelica,jmodelica,,13,10,20,23,15,43,0,1
appearance,appearance,,4,4,7,8,15,15,13,1
math-functions,math-functions,,0,1,6,1,9,7,8,1
acrofields,acrofields,,5,4,6,9,14,15,8,1
directx-12,directx-12,,17,10,12,27,20,39,9,1
jsmooth,jsmooth,,0,2,1,2,2,3,3,100
maildir,maildir,,0,1,1,1,3,2,4,1
crashlytics-android,crashlytics-android,,20,19,52,39,98,91,3,1
clojure-maven-plugin,clojure-maven-plugin,,0,0,0,0,1,0,3,1
booleanquery,booleanquery,,4,1,3,5,17,8,0,1
tempdata,tempdata,,3,5,13,8,19,21,8,66.666667
typed,typed,,1,0,5,1,9,6,1,1
cp1252,cp1252,,2,2,5,4,14,9,0,1
arrayofstring,arrayofstring,,1,0,2,1,8,3,9,1
harvard-architecture,harvard-architecture,,0,0,1,0,3,1,9,1
publish-profiles,publish-profiles,,1,1,3,2,7,5,8,1
zeebe,zeebe,,0,0,0,0,1,0,3,1
magic-methods,magic-methods,,7,7,14,14,33,28,0,1
spring-cloud-security,spring-cloud-security,,3,4,0,7,8,7,3,33.333333
bower-install,bower-install,,2,2,5,4,14,9,1,1
angular-route-segment,angular-route-segment,,1,1,0,2,11,2,1,1
integer-arithmetic,integer-arithmetic,,7,7,19,14,34,33,0,1
apache-commons-dbutils,apache-commons-dbutils,,4,3,6,7,10,13,3,1
persistent-volumes,persistent-volumes,,25,27,40,52,54,92,6,8
openstack-swift,openstack-swift,,2,3,8,5,29,13,6,50
geneos,geneos,,0,0,2,0,5,2,9,1
pg-search,pg-search,,3,2,9,5,22,14,12,1
messagedialog,messagedialog,,1,1,3,2,9,5,8,1
staggered-gridview,staggered-gridview,,3,0,6,3,12,9,3,1
staggeredgridlayout,staggeredgridlayout,,2,2,2,4,13,6,3,1
capped-collections,capped-collections,,0,0,1,0,5,1,1,1
geometry-instancing,geometry-instancing,,0,4,1,4,5,5,9,300
eclipse-databinding,eclipse-databinding,,0,1,0,1,2,1,3,1
query-hints,query-hints,,0,2,1,2,3,3,4,100
easystroke,easystroke,,0,0,0,0,1,0,9,1
spring-surf,spring-surf,,0,1,0,1,2,1,3,1
jrockit,jrockit,,2,1,0,3,4,3,3,1
webkitgtk,webkitgtk,,4,2,4,6,8,10,9,1
microsoft-graph-sdks,microsoft-graph-sdks,,51,59,78,110,9,188,8,15.686275
ng-packagr,ng-packagr,,18,14,44,32,68,76,1,1
unison,unison,,0,1,5,1,11,6,9,1
bulk-delete,bulk-delete,,2,0,3,2,8,5,1,1
xcore,xcore,,0,1,2,1,4,3,3,1
android-typeface,android-typeface,,3,2,13,5,24,18,3,1
scenic,scenic,,0,1,0,1,1,1,12,1
newrow,newrow,,1,0,1,1,6,2,5,1
live-templates,live-templates,,3,2,12,5,19,17,3,1
android-gradle-2.2,android-gradle-2.2,,0,0,2,0,2,2,3,1
protobuf-3,protobuf-3,,4,3,2,7,5,9,6,1
systemd-nspawn,systemd-nspawn,,1,0,1,1,4,2,9,1
embedded-ruby,embedded-ruby,,0,0,1,0,7,1,12,1
page-tables,page-tables,,10,4,11,14,12,25,9,1
application-warmup,application-warmup,,0,0,0,0,4,0,8,1
pull-queue,pull-queue,,0,0,0,0,2,0,6,1
xdt-transform,xdt-transform,,0,3,10,3,6,13,8,200
juno-ide,juno-ide,,3,1,7,4,9,11,0,1
grocery-crud,grocery-crud,,2,5,13,7,17,20,4,150
tstringgrid,tstringgrid,,1,2,4,3,8,7,9,100
webtest,webtest,,5,3,7,8,23,15,8,1
groff,groff,,2,1,4,3,5,7,9,1
troff,troff,,0,1,3,1,2,4,9,1
import-from-csv,import-from-csv,,11,7,23,18,37,41,0,1
css-calc,css-calc,,12,8,17,20,16,37,1,1
contentful-vault,contentful-vault,,0,0,0,0,1,0,13,1
express-generator,express-generator,,2,0,5,2,13,7,1,1
bolt-cms,bolt-cms,,3,0,9,3,18,12,4,1
linker-flags,linker-flags,,4,5,3,9,9,12,9,25
systems-programming,systems-programming,,9,6,14,15,21,29,9,1
ejabberd-api,ejabberd-api,,2,3,18,5,14,23,3,50
exmpp,exmpp,,0,0,0,0,1,0,3,1
kryonet,kryonet,,1,2,3,3,8,6,3,100
datawriter,datawriter,,0,1,0,1,4,1,8,1
stripping,stripping,,0,2,1,2,3,3,0,100
afnetworking-3,afnetworking-3,,3,1,4,4,25,8,13,1
gulp-inject,gulp-inject,,0,2,3,2,11,5,1,100
attach-api,attach-api,,0,1,0,1,3,1,3,1
tuareg,tuareg,,0,1,0,1,2,1,9,1
boon,boon,,0,0,0,0,1,0,3,1
term,term,,5,5,15,10,20,25,4,1
configurable,configurable,,1,0,1,1,6,2,4,1
idempotent,idempotent,,10,6,11,16,18,27,3,1
dotnet-sdk,dotnet-sdk,,2,4,7,6,7,13,8,100
output-redirect,output-redirect,,0,1,3,1,9,4,9,1
auth-request,auth-request,,3,3,5,6,8,11,6,1
fauxton,fauxton,,0,2,6,2,14,8,1,100
qdate,qdate,,0,3,1,3,5,4,9,200
qlocale,qlocale,,1,0,1,1,4,2,9,1
bloom-filter,bloom-filter,,7,7,10,14,26,24,0,1
facebook-friends,facebook-friends,,1,3,2,4,8,6,13,200
ifd,ifd,,0,0,0,0,1,0,8,1
binaryformatter,binaryformatter,,5,2,17,7,24,24,8,1
afnetworking-2,afnetworking-2,,0,0,2,0,5,2,13,1
nsnumber,nsnumber,,6,2,7,8,22,15,13,1
biztalk-schemas,biztalk-schemas,,2,0,0,2,2,2,8,1
downloadfileasync,downloadfileasync,,4,2,3,6,4,9,8,1
windows-phone,windows-phone,,0,1,5,1,19,6,8,1
game-ai,game-ai,,16,14,50,30,65,80,0,1
monte-carlo-tree-search,monte-carlo-tree-search,,15,14,21,29,24,50,0,1
pixelate,pixelate,,3,4,1,7,4,8,1,33.333333
xcode6,xcode6,,1,0,9,1,9,10,13,1
adventureworks,adventureworks,,5,2,10,7,29,17,4,1
arcamera,arcamera,,0,0,5,0,11,5,13,1
packery,packery,,1,1,4,2,9,6,1,1
keyedcollection,keyedcollection,,1,0,2,1,2,3,8,1
wordpress-flamingo-plugin,wordpress-flamingo-plugin,,1,0,0,1,2,1,4,1
celltemplate,celltemplate,,1,1,2,2,5,4,8,1
ftp-server,ftp-server,,4,2,9,6,10,15,4,1
phalcon-routing,phalcon-routing,,3,5,3,8,9,11,4,66.666667
jsrender,jsrender,,5,6,11,11,25,22,1,20
jsviews,jsviews,,1,5,11,6,15,17,1,400
abort,abort,,7,12,22,19,31,41,9,71.428571
userfrosting,userfrosting,,1,0,2,1,3,3,4,1
fullcontact,fullcontact,,0,0,0,0,2,0,1,1
defined,defined,,5,5,9,10,21,19,0,1
corner-detection,corner-detection,,4,2,9,6,19,15,0,1
license-key,license-key,,3,2,11,5,18,16,8,1
sharpdevelop,sharpdevelop,,7,3,5,10,9,15,8,1
obfuscar,obfuscar,,1,1,1,2,6,3,8,1
rspec-expectations,rspec-expectations,,0,1,0,1,2,1,12,1
jsbn,jsbn,,0,0,0,0,1,0,6,1
univocity,univocity,,8,6,10,14,17,24,0,1
android-phone-call,android-phone-call,,8,10,15,18,21,33,3,25
validate.js,validate.js,,1,2,4,3,8,7,1,100
logical-purity,logical-purity,,1,0,2,1,6,3,0,1
ganymede,ganymede,,0,0,0,0,2,0,3,1
webmethods,webmethods,,0,5,6,5,18,11,3,400
gridgain,gridgain,,6,5,10,11,30,21,3,1
office-ui-fabric,office-ui-fabric,,23,31,68,54,47,122,1,34.782609
icepdf,icepdf,,1,0,9,1,4,10,3,1
winforms-interop,winforms-interop,,4,1,10,5,11,15,8,1
openvdb,openvdb,,0,1,1,1,4,2,9,1
validates-uniqueness-of,validates-uniqueness-of,,0,0,2,0,4,2,12,1
xsd-1.1,xsd-1.1,,3,1,7,4,21,11,3,1
telerik-open-access,telerik-open-access,,0,0,2,0,3,2,8,1
imagefield,imagefield,,8,8,11,16,24,27,0,1
mpvolumeview,mpvolumeview,,3,2,5,5,11,10,13,1
translators,translators,,2,2,1,4,6,5,1,1
comvisible,comvisible,,2,2,1,4,4,5,8,1
irp,irp,,2,0,0,2,3,2,9,1
obex,obex,,2,2,6,4,9,10,3,1
build.xml,build.xml,,3,6,14,9,20,23,3,100
idispatchmessageinspector,idispatchmessageinspector,,1,0,2,1,3,3,8,1
sqlclr,sqlclr,,2,9,22,11,60,33,4,350
scons,scons,,17,5,21,22,42,43,9,1
google-sites,google-sites,,13,13,24,26,39,50,5,1
django-deployment,django-deployment,,2,7,7,9,15,16,0,250
react-table,react-table,,59,81,125,140,104,265,1,37.288136
pysam,pysam,,0,2,2,2,8,4,0,100
circuit-breaker,circuit-breaker,,15,6,25,21,33,46,3,1
mosca,mosca,,4,1,7,5,7,12,6,1
renderdoc,renderdoc,,1,1,2,2,4,4,9,1
hosted-app,hosted-app,,1,0,2,1,3,3,8,1
pyenchant,pyenchant,,1,1,2,2,18,4,0,1
woocommerce-memberships,woocommerce-memberships,,9,4,1,13,5,14,4,1
javafx-gradle-plugin,javafx-gradle-plugin,,0,0,1,0,9,1,3,1
export-to-word,export-to-word,,2,1,1,3,17,4,5,1
gen-class,gen-class,,0,0,0,0,2,0,2,1
phpdbg,phpdbg,,1,2,1,3,4,4,4,100
graphicspath,graphicspath,,2,0,5,2,6,7,8,1
quaggajs,quaggajs,,2,2,8,4,8,12,1,1
recvfrom,recvfrom,,4,2,5,6,13,11,9,1
business-catalyst,business-catalyst,,0,0,0,0,4,0,1,1
xml-formatting,xml-formatting,,2,1,3,3,6,6,3,1
optimistic-concurrency,optimistic-concurrency,,4,5,12,9,17,21,8,25
aspell,aspell,,2,0,2,2,8,4,0,1
cljsbuild,cljsbuild,,1,0,3,1,5,4,2,1
google-angle,google-angle,,0,0,0,0,2,0,9,1
qtcpserver,qtcpserver,,2,4,4,6,12,10,9,100
monit,monit,,6,2,13,8,24,21,9,1
standard-layout,standard-layout,,1,0,4,1,5,5,9,1
deluge,deluge,,3,3,7,6,6,13,4,1
ionic-popup,ionic-popup,,1,0,0,1,4,1,1,1
auto-vectorization,auto-vectorization,,0,5,8,5,16,13,9,400
tfs-migration,tfs-migration,,2,1,5,3,7,8,8,1
matlab-coder,matlab-coder,,5,3,14,8,10,22,0,1
conditional-rendering,conditional-rendering,,15,10,19,25,21,44,1,1
idn,idn,,0,1,1,1,7,2,4,1
asp.net-mvc-scaffolding,asp.net-mvc-scaffolding,,8,6,13,14,26,27,8,1
html5-fullscreen,html5-fullscreen,,8,8,16,16,18,32,1,1
word-frequency,word-frequency,,9,6,17,15,27,32,0,1
sourceforge,sourceforge,,2,1,4,3,5,7,3,1
optgroup,optgroup,,2,5,7,7,23,14,1,150
express-handlebars,express-handlebars,,39,20,74,59,75,133,1,1
mousehover,mousehover,,10,7,33,17,40,50,1,1
fn,fn,,2,1,4,3,5,7,6,1
sslcontext,sslcontext,,4,5,4,9,21,13,6,25
strict-mode,strict-mode,,4,3,2,7,7,9,1,1
uigraphicscontext,uigraphicscontext,,6,6,7,12,35,19,13,1
textmatebundles,textmatebundles,,0,0,1,0,4,1,9,1
imputets,imputets,,0,0,5,0,7,5,0,1
interact.js,interact.js,,1,2,3,3,13,6,1,100
gitk,gitk,,2,3,3,5,8,8,6,50
fuelphp,fuelphp,,1,2,4,3,13,7,4,100
siema,siema,,4,0,2,4,3,6,1,1
biztalk-2010,biztalk-2010,,4,3,5,7,21,12,8,1
disconnected,disconnected,,4,2,4,6,6,10,3,1
laravel-cashier,laravel-cashier,,15,15,18,30,29,48,4,1
credssp,credssp,,0,0,1,0,4,1,8,1
adx,adx,,0,0,0,0,3,0,0,1
xamarin.droid,xamarin.droid,,0,1,1,1,7,2,8,1
murmurhash,murmurhash,,0,3,7,3,7,10,12,200
opentype,opentype,,9,7,15,16,15,31,1,1
service-virtualization,service-virtualization,,1,1,3,2,5,5,3,1
sbrk,sbrk,,3,1,6,4,9,10,9,1
corert,corert,,1,2,1,3,2,4,8,100
requesthandler,requesthandler,,1,1,2,2,3,4,1,1
mathgl,mathgl,,1,0,2,1,1,3,9,1
azure-dsvm,azure-dsvm,,0,1,3,1,16,4,8,1
camera-flash,camera-flash,,0,1,2,1,4,3,3,1
creators-update,creators-update,,0,0,0,0,8,0,8,1
maximize-window,maximize-window,,2,2,6,4,12,10,8,1
window-chrome,window-chrome,,0,1,2,1,6,3,8,1
openoffice-api,openoffice-api,,0,0,0,0,3,0,3,1
scala-macro-paradise,scala-macro-paradise,,5,2,3,7,7,10,2,1
r-optimization,r-optimization,,0,1,2,1,4,3,0,1
rivets.js,rivets.js,,1,0,1,1,7,2,1,1
extentreports,extentreports,,48,27,71,75,99,146,3,1
ora-00947,ora-00947,,0,0,0,0,3,0,4,1
adfs2.1,adfs2.1,,0,0,0,0,3,0,8,1
registrykey,registrykey,,8,6,14,14,30,28,9,1
klaxon,klaxon,,1,3,2,4,17,6,3,200
cs4,cs4,,0,0,1,0,2,1,13,1
uptime,uptime,,8,2,6,10,10,16,9,1
extension-modules,extension-modules,,2,1,0,3,2,3,0,1
deviceid,deviceid,,4,4,8,8,13,16,3,1
jaro-winkler,jaro-winkler,,3,4,5,7,8,12,0,33.333333
claudiajs,claudiajs,,1,4,6,5,20,11,6,300
redgate,redgate,,2,4,11,6,14,17,4,100
tcmalloc,tcmalloc,,2,2,1,4,10,5,9,1
nsrect,nsrect,,0,0,1,0,1,1,13,1
http.rb,http.rb,,0,0,0,0,1,0,12,1
parfor,parfor,,4,2,20,6,37,26,0,1
xaml-binding,xaml-binding,,0,2,1,2,7,3,8,100
facebook-c#-sdk,facebook-c#-sdk,,3,0,2,3,17,5,8,1
simplenlg,simplenlg,,0,0,0,0,1,0,0,1
type-kinds,type-kinds,,0,1,3,1,5,4,2,1
receipt,receipt,,8,6,20,14,17,34,13,1
delete-directory,delete-directory,,0,2,5,2,8,7,9,100
chaco,chaco,,0,2,2,2,1,4,0,100
installed-applications,installed-applications,,1,3,4,4,6,8,3,200
apache-commons-daemon,apache-commons-daemon,,0,5,1,5,5,6,3,400
adminhtml,adminhtml,,2,0,1,2,4,3,4,1
wmi-query,wmi-query,,5,7,20,12,49,32,8,40
sts-springsourcetoolsuite,sts-springsourcetoolsuite,,1,1,3,2,10,5,3,1
scroll-paging,scroll-paging,,1,2,2,3,5,5,13,100
system-error,system-error,,0,1,6,1,10,7,9,1
smile,smile,,3,2,4,5,2,9,0,1
texture-atlas,texture-atlas,,4,2,3,6,11,9,9,1
virtualizingstackpanel,virtualizingstackpanel,,1,0,4,1,1,5,8,1
documentationjs,documentationjs,,0,0,1,0,3,1,1,1
js-search,js-search,,0,0,0,0,1,0,1,1
google-client,google-client,,4,12,20,16,21,36,5,200
facebook-ios-sdk-4.0,facebook-ios-sdk-4.0,,0,0,1,0,7,1,13,1
mantis,mantis,,3,1,6,4,13,10,4,1
function-parameter,function-parameter,,5,3,9,8,31,17,9,1
modx-resources,modx-resources,,0,0,0,0,4,0,4,1
genstage,genstage,,0,0,3,0,14,3,2,1
pdfview,pdfview,,9,6,20,15,29,35,13,1
automapper-5,automapper-5,,1,1,3,2,8,5,8,1
diagrammer,diagrammer,,7,10,21,17,31,38,0,42.857143
mermaid,mermaid,,7,4,8,11,19,19,0,1
template-mixins,template-mixins,,0,0,0,0,1,0,9,1
psr-11,psr-11,,0,1,0,1,1,1,4,1
proc-report,proc-report,,2,0,4,2,8,6,0,1
p,p,,5,6,9,11,17,20,1,20
background-music,background-music,,5,3,6,8,9,14,3,1
primavera,primavera,,1,4,4,5,2,9,3,300
autodesk-bim360,autodesk-bim360,,6,11,27,17,19,44,14,83.333333
mobilefirst-server,mobilefirst-server,,5,3,14,8,44,22,13,1
mahout-recommender,mahout-recommender,,2,0,4,2,9,6,3,1
jail,jail,,1,0,2,1,8,3,6,1
listbuffer,listbuffer,,1,0,3,1,8,4,2,1
analytical,analytical,,3,0,4,3,6,7,4,1
robotc,robotc,,0,1,3,1,2,4,0,1
jmenu,jmenu,,1,1,4,2,17,6,3,1
vector-tiles,vector-tiles,,8,4,12,12,14,24,1,1
sbt-native-packager,sbt-native-packager,,8,5,8,13,31,21,2,1
ie-automation,ie-automation,,1,1,2,2,24,4,5,1
angularjs-provider,angularjs-provider,,2,0,3,2,5,5,1,1
soundex,soundex,,3,2,6,5,15,11,4,1
svgpanzoom,svgpanzoom,,8,4,8,12,7,20,1,1
redeclare,redeclare,,0,1,0,1,3,1,4,1
gigya,gigya,,0,8,3,8,10,11,3,700
soundpool,soundpool,,12,8,22,20,19,42,3,1
activity-oncreateview,activity-oncreateview,,0,0,1,0,5,1,3,1
dynatable,dynatable,,2,2,3,4,6,7,1,1
browser-tab,browser-tab,,2,2,2,4,8,6,1,1
run-middleware,run-middleware,,0,0,0,0,1,0,1,1
cadence,cadence,,1,5,10,6,10,16,9,400
codelite,codelite,,5,7,8,12,22,20,9,40
atdd,atdd,,0,2,4,2,4,6,3,100
swipeview,swipeview,,3,1,2,4,6,6,9,1
exacttarget,exacttarget,,1,0,7,1,9,8,14,1
recover,recover,,6,11,12,17,21,29,9,83.333333
active-hdl,active-hdl,,0,0,2,0,10,2,9,1
aws-reserved-instances,aws-reserved-instances,,2,1,3,3,3,6,6,1
intel-8080,intel-8080,,1,1,2,2,3,4,9,1
mintty,mintty,,4,2,6,6,11,12,9,1
sharepoint-webservice,sharepoint-webservice,,0,1,0,1,4,1,8,1
qstylesheet,qstylesheet,,0,0,1,0,16,1,9,1
qpalette,qpalette,,1,0,1,1,7,2,9,1
scopus,scopus,,2,0,8,2,8,10,0,1
stdset,stdset,,4,4,11,8,23,19,9,1
message-digest,message-digest,,3,4,5,7,12,12,6,33.333333
alignof,alignof,,1,0,0,1,2,1,9,1
package-management,package-management,,5,4,8,9,12,17,0,1
jjwt,jjwt,,5,7,8,12,26,20,3,40
extractor,extractor,,1,8,6,9,21,15,3,700
bitstring,bitstring,,2,4,5,6,13,11,0,100
google-http-client,google-http-client,,1,1,5,2,5,7,3,1
polylang,polylang,,12,9,30,21,47,51,4,1
ackermann,ackermann,,2,1,0,3,7,3,0,1
pdl,pdl,,1,2,3,3,3,6,9,100
metronome,metronome,,1,1,1,2,9,3,13,1
jcreator,jcreator,,1,0,4,1,10,5,3,1
ptx,ptx,,3,1,3,4,10,7,0,1
yargs,yargs,,7,3,10,10,16,20,1,1
openexr,openexr,,3,3,7,6,14,13,0,1
amazon-ebs,amazon-ebs,,8,6,13,14,31,27,6,1
net-ssh,net-ssh,,2,3,8,5,7,13,12,50
buddy.com,buddy.com,,0,0,1,0,2,1,13,1
django-tests,django-tests,,11,21,28,32,55,60,0,90.909091
spacebars,spacebars,,2,3,7,5,12,12,1,50
scalafx,scalafx,,5,3,7,8,21,15,2,1
qfont,qfont,,1,1,7,2,6,9,9,1
react-admin,react-admin,,82,83,140,165,93,305,1,1.219512
zelle-graphics,zelle-graphics,,9,6,14,15,23,29,0,1
textchanged,textchanged,,4,4,5,8,21,13,8,1
alassetslibrary,alassetslibrary,,0,1,2,1,4,3,13,1
prepros,prepros,,1,3,6,4,7,10,1,200
pact-broker,pact-broker,,2,1,8,3,12,11,3,1
rmagick,rmagick,,9,2,15,11,36,26,12,1
flex-grow,flex-grow,,3,0,4,3,11,7,1,1
correlated-subquery,correlated-subquery,,12,17,31,29,51,60,4,41.666667
jberet,jberet,,2,0,4,2,17,6,3,1
ion-slides,ion-slides,,12,10,11,22,21,33,1,1
y2k,y2k,,0,0,0,0,1,0,1,1
light-scattering,light-scattering,,0,0,0,0,2,0,9,1
sql-generation,sql-generation,,0,0,0,0,3,0,8,1
square-root,square-root,,6,4,15,10,32,25,0,1
angular-transitions,angular-transitions,,1,1,4,2,5,6,1,1
conference,conference,,3,5,8,8,14,16,13,66.666667
principal,principal,,3,1,10,4,9,14,3,1
sessioncontext,sessioncontext,,1,0,1,1,4,2,3,1
great-firewall-of-china,great-firewall-of-china,,3,8,3,11,17,14,6,166.666667
gulp-karma,gulp-karma,,1,0,2,1,10,3,1,1
genbank,genbank,,2,1,2,3,3,5,0,1
renderpartial,renderpartial,,1,1,5,2,10,7,8,1
durable-subscription,durable-subscription,,2,1,3,3,5,6,3,1
page-fault,page-fault,,7,7,11,14,12,25,9,1
huge-pages,huge-pages,,7,8,4,15,14,19,9,14.285714
sigbus,sigbus,,2,1,2,3,5,5,9,1
winexe,winexe,,0,0,1,0,5,1,9,1
amazon-alb,amazon-alb,,6,1,8,7,13,15,6,1
vtune,vtune,,2,3,2,5,10,7,9,50
ruby-hash,ruby-hash,,5,3,8,8,28,16,12,1
credstash,credstash,,0,0,2,0,4,2,6,1
elastix,elastix,,3,0,6,3,13,9,13,1
riemann,riemann,,0,0,3,0,5,3,2,1
backlight,backlight,,2,0,4,2,2,6,3,1
wysihtml5,wysihtml5,,1,3,1,4,10,5,1,200
j-interop,j-interop,,0,0,1,0,1,1,5,1
quickpay,quickpay,,2,0,1,2,2,3,4,1
buckets,buckets,,0,0,1,0,11,1,6,1
mongoosastic,mongoosastic,,4,1,8,5,9,13,6,1
sonarcloud,sonarcloud,,9,16,10,25,21,35,3,77.777778
tortoisemerge,tortoisemerge,,0,1,1,1,3,2,6,1
calling-convention,calling-convention,,32,16,45,48,64,93,9,1
app-update,app-update,,2,4,8,6,14,14,3,100
rendermonkey,rendermonkey,,0,0,0,0,1,0,9,1
mappedbytebuffer,mappedbytebuffer,,3,2,2,5,8,7,3,1
typescript1.4,typescript1.4,,0,0,2,0,3,2,1,1
maskedtextbox,maskedtextbox,,3,5,6,8,6,14,8,66.666667
database-tuning,database-tuning,,4,6,9,10,7,19,4,50
fulltext-index,fulltext-index,,4,5,6,9,11,15,4,25
django-compressor,django-compressor,,3,1,5,4,14,9,0,1
eclipse-3.4,eclipse-3.4,,0,0,0,0,1,0,3,1
xceed-datagrid,xceed-datagrid,,2,0,3,2,8,5,8,1
haxm,haxm,,1,8,24,9,40,33,3,700
spring-cloud-task,spring-cloud-task,,14,6,27,20,55,47,3,1
lego,lego,,1,3,8,4,6,12,0,200
parse-android-sdk,parse-android-sdk,,20,5,2,25,5,27,13,1
gcc4,gcc4,,0,0,2,0,6,2,9,1
servicecontroller,servicecontroller,,2,2,2,4,6,6,8,1
shared-data,shared-data,,4,0,3,4,5,7,8,1
dotnetopenauth,dotnetopenauth,,1,4,9,5,8,14,8,300
oauth-1.0a,oauth-1.0a,,6,6,17,12,18,29,4,1
opentsdb,opentsdb,,11,3,13,14,16,27,2,1
docfx,docfx,,10,13,8,23,8,31,8,30
diffobj,diffobj,,0,0,0,0,2,0,0,1
jpos,jpos,,4,6,6,10,21,16,3,50
angularjs-ng-href,angularjs-ng-href,,2,1,2,3,6,5,1,1
expandablerecyclerview,expandablerecyclerview,,5,6,11,11,17,22,3,20
vue-meta,vue-meta,,2,2,5,4,6,9,1,1
swift-data,swift-data,,0,0,0,0,2,0,13,1
sql-sessions,sql-sessions,,0,1,1,1,1,2,3,1
gmsplace,gmsplace,,1,1,5,2,6,7,13,1
getboundingclientrect,getboundingclientrect,,8,3,7,11,13,18,1,1
data-transfer-process,data-transfer-process,,1,0,0,1,2,1,4,1
watson-knowledge-studio,watson-knowledge-studio,,2,0,11,2,21,13,6,1
ognl,ognl,,2,2,6,4,16,10,3,1
opencpu,opencpu,,10,7,14,17,34,31,0,1
jade4j,jade4j,,2,2,4,4,10,8,1,1
indexed-views,indexed-views,,0,0,0,0,4,0,4,1
parse4cn1,parse4cn1,,1,0,0,1,9,1,3,1
output-buffering,output-buffering,,3,2,9,5,15,14,4,1
zeit-pkg,zeit-pkg,,3,2,8,5,16,13,1,1
object-tag,object-tag,,0,0,8,0,10,8,1,1
meep,meep,,0,0,3,0,3,3,9,1
pgbadger,pgbadger,,2,1,1,3,1,4,4,1
jtcalendar,jtcalendar,,0,0,1,0,6,1,13,1
actiondispatch,actiondispatch,,2,0,5,2,9,7,12,1
doctest,doctest,,15,9,18,24,38,42,0,1
airwatch,airwatch,,4,10,11,14,17,25,13,150
data-ingestion,data-ingestion,,3,10,13,13,25,26,2,233.333333
target-platform,target-platform,,5,1,2,6,6,8,3,1
scrollrect,scrollrect,,1,1,4,2,6,6,8,1
include-once,include-once,,0,2,0,2,7,2,4,100
selectonemenu,selectonemenu,,5,3,5,8,16,13,3,1
x-macros,x-macros,,1,1,3,2,5,5,9,1
responsivevoice,responsivevoice,,0,5,4,5,3,9,1,400
drupal-theming,drupal-theming,,4,5,10,9,16,19,4,25
cue,cue,,1,0,2,1,3,3,13,1
defunct,defunct,,3,0,2,3,3,5,9,1
expression-blend-4,expression-blend-4,,0,1,1,1,2,2,8,1
xhprof,xhprof,,0,0,1,0,6,1,4,1
tidygraph,tidygraph,,7,7,6,14,12,20,0,1
custom-view,custom-view,,13,10,21,23,47,44,3,1
scrumboard,scrumboard,,1,0,3,1,4,4,8,1
imessagefilter,imessagefilter,,0,0,2,0,3,2,8,1
ms-query,ms-query,,8,9,7,17,10,24,5,12.5
cocoscreator,cocoscreator,,6,5,12,11,8,23,3,1
jsqlparser,jsqlparser,,0,1,6,1,9,7,3,1
n3dr,n3dr,,0,0,2,0,3,2,3,1
d3-force-directed,d3-force-directed,,6,13,17,19,31,36,1,116.666667
nsfilehandle,nsfilehandle,,2,2,2,4,3,6,13,1
utility-method,utility-method,,0,1,1,1,5,2,3,1
genesys,genesys,,1,1,3,2,5,5,8,1
workspace-desktop-edition,workspace-desktop-edition,,0,0,1,0,2,1,8,1
genesys-platform-sdk,genesys-platform-sdk,,1,0,1,1,3,2,8,1
xcode9.1,xcode9.1,,0,1,3,1,87,4,13,1
prettyfaces,prettyfaces,,1,1,1,2,11,3,3,1
appxmanifest,appxmanifest,,8,6,4,14,16,18,8,1
pixel-shader,pixel-shader,,4,8,12,12,19,24,9,100
quickform,quickform,,0,0,0,0,1,0,1,1
ggtree,ggtree,,3,5,5,8,7,13,0,66.666667
google-webmaster-tools,google-webmaster-tools,,11,9,29,20,48,49,4,1
roundcube,roundcube,,3,7,15,10,20,25,4,133.333333
php-deployer,php-deployer,,2,5,7,7,13,14,4,150
thingsboard,thingsboard,,26,22,50,48,56,98,6,1
system-codedom-compiler,system-codedom-compiler,,1,1,2,2,3,4,8,1
read-data,read-data,,4,10,8,14,20,22,0,150
android-wear-data-api,android-wear-data-api,,2,1,11,3,6,14,3,1
typedarray,typedarray,,3,1,1,4,6,5,3,1
jopendocument,jopendocument,,0,0,1,0,1,1,3,1
hbase-client,hbase-client,,0,0,7,0,4,7,2,1
code-design,code-design,,2,6,10,8,5,18,3,200
armcc,armcc,,2,4,5,6,6,11,9,100
include-guards,include-guards,,1,2,3,3,7,6,9,100
gii,gii,,1,0,5,1,12,6,4,1
wikimedia-commons,wikimedia-commons,,2,8,2,10,5,12,2,300
tpersistent,tpersistent,,0,0,0,0,2,0,9,1
tcollectionitem,tcollectionitem,,0,0,0,0,3,0,9,1
ods,ods,,6,4,14,10,15,24,0,1
random-time-generation,random-time-generation,,0,0,0,0,1,0,0,1
unchecked,unchecked,,3,2,6,5,14,11,3,1
xmmp,xmmp,,0,0,2,0,1,2,13,1
apache-mina,apache-mina,,10,4,18,14,15,32,3,1
splitpane,splitpane,,1,2,7,3,17,10,3,100
grunt-sass-lint,grunt-sass-lint,,1,0,0,1,2,1,1,1
auth-guard,auth-guard,,9,4,24,13,33,37,1,1
fancytree,fancytree,,8,6,12,14,33,26,1,1
tablespace,tablespace,,10,5,9,15,26,24,4,1
mongoexport,mongoexport,,5,2,14,7,26,21,1,1
executescalar,executescalar,,5,1,6,6,11,12,8,1
executereader,executereader,,3,0,2,3,7,5,8,1
c++-modules,c++-modules,,2,4,2,6,14,8,9,100
ws-client,ws-client,,3,2,9,5,7,14,2,1
kdiff3,kdiff3,,2,0,6,2,9,8,6,1
amd-gpu,amd-gpu,,2,3,5,5,8,10,0,50
parseexception,parseexception,,6,4,9,10,17,19,3,1
sidenav,sidenav,,6,7,23,13,29,36,1,16.666667
mailsystem.net,mailsystem.net,,0,0,1,0,2,1,8,1
firefox-profile,firefox-profile,,2,2,13,4,19,17,3,1
pybrain,pybrain,,1,0,0,1,10,1,0,1
name-collision,name-collision,,1,1,5,2,7,7,9,1
diskusage,diskusage,,1,0,4,1,3,5,9,1
expansion,expansion,,6,8,14,14,20,28,9,33.333333
svg-android,svg-android,,0,0,2,0,3,2,3,1
action-mapping,action-mapping,,0,0,0,0,3,0,3,1
redirectstandardoutput,redirectstandardoutput,,5,2,4,7,13,11,8,1
uiactionsheet,uiactionsheet,,1,9,10,10,19,20,13,800
nutiteq,nutiteq,,0,0,1,0,2,1,1,1
bins,bins,,6,7,17,13,27,30,0,16.666667
clearance,clearance,,9,1,2,10,9,12,12,1
electronic-signature,electronic-signature,,5,4,9,9,11,18,6,1
21cfr11,21cfr11,,0,0,0,0,1,0,6,1
philips-hue,philips-hue,,7,2,12,9,27,21,6,1
rom-rb,rom-rb,,1,0,2,1,3,3,12,1
rom-sql,rom-sql,,0,0,1,0,2,1,12,1
integrate,integrate,,6,10,22,16,37,38,0,66.666667
fgetcsv,fgetcsv,,7,7,16,14,30,30,4,1
pg-copy,pg-copy,,0,0,0,0,1,0,4,1
communication-protocol,communication-protocol,,2,2,8,4,5,12,9,1
resolution-independence,resolution-independence,,0,0,0,0,1,0,8,1
wpf-graphics,wpf-graphics,,0,0,0,0,1,0,8,1
principalpermission,principalpermission,,0,0,0,0,4,0,8,1
experience-editor,experience-editor,,1,1,1,2,5,3,8,1
selectmanycheckbox,selectmanycheckbox,,1,0,2,1,3,3,3,1
code-signing-entitlements,code-signing-entitlements,,4,2,14,6,8,20,13,1
iis-5,iis-5,,0,0,0,0,1,0,8,1
elastic-cloud,elastic-cloud,,8,4,8,12,12,20,6,1
react-transition-group,react-transition-group,,27,15,45,42,62,87,1,1
percona-xtradb-cluster,percona-xtradb-cluster,,0,4,8,4,22,12,4,300
equals-operator,equals-operator,,1,1,4,2,13,6,8,1
houghlinesp,houghlinesp,,6,6,6,12,5,18,0,1
response.redirect,response.redirect,,7,7,13,14,13,27,8,1
audioqueue,audioqueue,,1,0,2,1,4,3,13,1
echo-cancellation,echo-cancellation,,0,1,2,1,3,3,13,1
mawk,mawk,,2,0,3,2,5,5,9,1
actionresult,actionresult,,9,6,13,15,26,28,8,1
odp.net-managed,odp.net-managed,,4,1,4,5,7,9,8,1
react-dates,react-dates,,9,9,26,18,27,44,1,1
gentelella,gentelella,,1,3,3,4,10,7,1,200
google-cloud-iam,google-cloud-iam,,17,21,22,38,42,60,6,23.529412
ng-messages,ng-messages,,1,2,5,3,13,8,1,100
multirow,multirow,,3,1,4,4,10,8,4,1
glossary,glossary,,2,2,2,4,4,6,0,1
zend-server,zend-server,,0,1,2,1,5,3,4,1
faulthandler,faulthandler,,0,0,1,0,2,1,0,1
rdcomclient,rdcomclient,,5,5,17,10,24,27,0,1
sqlite-journal-mode,sqlite-journal-mode,,0,0,2,0,5,2,3,1
serverless-framework-offline,serverless-framework-offline,,1,0,3,1,10,4,6,1
meson-build,meson-build,,8,12,19,20,17,39,9,50
ahah,ahah,,0,0,0,0,1,0,1,1
autodesk-data-management,autodesk-data-management,,5,9,23,14,28,37,14,80
undirected-graph,undirected-graph,,11,6,21,17,28,38,0,1
program-o,program-o,,0,0,0,0,5,0,0,1
modbus-tcp,modbus-tcp,,13,8,33,21,30,54,0,1
sanitizer,sanitizer,,0,3,3,3,17,6,9,200
formhelper,formhelper,,0,0,0,0,5,0,4,1
llblgenpro,llblgenpro,,1,2,2,3,5,5,8,100
llblgen,llblgen,,2,2,1,4,6,5,8,1
equivalent,equivalent,,8,5,13,13,18,26,0,1
high-resolution-time,high-resolution-time,,1,0,1,1,2,2,0,1
yandex,yandex,,1,7,30,8,18,38,4,600
yandex-metrika,yandex-metrika,,1,2,3,3,1,6,4,100
notification-listener,notification-listener,,2,3,18,5,18,23,3,50
uiscrollviewdelegate,uiscrollviewdelegate,,8,1,8,9,24,17,13,1
argonaut,argonaut,,3,1,3,4,5,7,2,1
netdata,netdata,,8,4,2,12,5,14,6,1
asp.net-mvc-5.1,asp.net-mvc-5.1,,0,2,0,2,6,2,8,100
appodeal,appodeal,,2,1,7,3,23,10,3,1
user-defined-aggregate,user-defined-aggregate,,2,2,4,4,10,8,2,1
tensorflow-transform,tensorflow-transform,,5,12,13,17,12,30,0,140
well-formed,well-formed,,1,0,3,1,5,4,9,1
uirepeat,uirepeat,,1,3,3,4,6,7,3,200
oraclereports,oraclereports,,19,7,25,26,26,51,4,1
changeset,changeset,,7,9,14,16,23,30,8,28.571429
pkill,pkill,,0,3,3,3,7,6,9,200
getselection,getselection,,4,1,1,5,13,6,1,1
qmediaplayer,qmediaplayer,,6,5,16,11,20,27,9,1
react-native-popup-menu,react-native-popup-menu,,3,2,12,5,8,17,1,1
relaycommand,relaycommand,,7,1,5,8,20,13,8,1
lightgallery,lightgallery,,4,2,16,6,17,22,1,1
maven-bom,maven-bom,,5,3,9,8,17,17,3,1
maxent,maxent,,7,1,7,8,11,15,0,1
s4,s4,,14,12,21,26,49,47,0,1
flysystem,flysystem,,7,4,12,11,17,23,4,1
core-data-migration,core-data-migration,,13,5,13,18,24,31,13,1
cls,cls,,2,1,3,3,5,6,0,1
paradox,paradox,,2,3,4,5,11,9,9,50
oauth2client,oauth2client,,5,9,15,14,27,29,5,80
mysql-error-1136,mysql-error-1136,,0,0,2,0,2,2,4,1
lowest-common-ancestor,lowest-common-ancestor,,1,0,2,1,6,3,0,1
debounce,debounce,,17,15,26,32,62,58,1,1
artisan-migrate,artisan-migrate,,6,2,14,8,32,22,4,1
grunt-shell,grunt-shell,,0,0,0,0,3,0,2,1
sas-jmp,sas-jmp,,2,3,6,5,5,11,4,50
azure-eventgrid,azure-eventgrid,,22,26,46,48,59,94,8,18.181818
long-running-processes,long-running-processes,,5,6,5,11,15,16,1,20
merge-module,merge-module,,1,0,4,1,5,5,8,1
sticky-session,sticky-session,,5,5,10,10,18,20,6,1
metadata-extractor,metadata-extractor,,3,2,5,5,11,10,8,1
rcs,rcs,,1,0,2,1,2,3,6,1
flat,flat,,4,4,5,8,11,13,1,1
request-unit,request-unit,,0,0,0,0,1,0,8,1
tmb,tmb,,1,2,1,3,7,4,0,100
watershed,watershed,,9,8,9,17,15,26,0,1
abcpdf9,abcpdf9,,1,1,0,2,3,2,8,1
assistant,assistant,,14,3,30,17,13,47,13,1
flashback,flashback,,0,1,6,1,7,7,4,1
catch-unit-test,catch-unit-test,,4,0,9,4,19,13,9,1
finalize,finalize,,2,2,14,4,14,18,3,1
class-constructors,class-constructors,,4,2,5,6,6,11,9,1
scramble,scramble,,3,1,8,4,5,12,0,1
sails-hook,sails-hook,,0,0,1,0,2,1,1,1
nslayoutanchor,nslayoutanchor,,2,0,8,2,16,10,13,1
bipartite,bipartite,,14,5,25,19,33,44,0,1
self-reference,self-reference,,15,9,15,24,34,39,9,1
marklogic-7,marklogic-7,,0,6,6,6,6,12,3,500
trusted-timestamp,trusted-timestamp,,0,2,5,2,6,7,6,100
livebindings,livebindings,,0,3,6,3,5,9,9,200
robobrowser,robobrowser,,5,5,6,10,21,16,0,1
ember-observable,ember-observable,,0,0,0,0,2,0,1,1
jekyll-theme,jekyll-theme,,11,14,16,25,27,41,1,27.272727
parse-dashboard,parse-dashboard,,1,0,7,1,11,8,13,1
econnreset,econnreset,,2,0,5,2,10,7,1,1
virtual-table,virtual-table,,1,3,2,4,10,6,9,200
peoplesoft,peoplesoft,,13,9,30,22,52,52,4,1
levelplot,levelplot,,5,2,8,7,21,15,0,1
rastervis,rastervis,,4,3,8,7,15,15,0,1
imagenamed,imagenamed,,0,0,0,0,2,0,13,1
nmssh,nmssh,,0,1,0,1,3,1,13,1
bignum,bignum,,4,6,15,10,22,25,9,50
pike,pike,,0,0,0,0,4,0,0,1
paw-app,paw-app,,2,3,3,5,10,8,4,50
presentation-layer,presentation-layer,,0,0,1,0,1,1,13,1
yii-url-manager,yii-url-manager,,0,1,2,1,13,3,4,1
activemodel,activemodel,,10,7,15,17,31,32,12,1
sqlbuilder,sqlbuilder,,2,0,3,2,4,5,4,1
transient,transient,,7,5,10,12,23,22,3,1
osxfuse,osxfuse,,1,1,1,2,4,3,13,1
arrayfire,arrayfire,,4,11,6,15,19,21,0,175
orphan,orphan,,1,1,3,2,13,5,3,1
soapserver,soapserver,,3,5,12,8,19,20,3,66.666667
multifile,multifile,,1,0,7,1,10,8,9,1
realsense,realsense,,10,14,26,24,33,50,0,40
color-depth,color-depth,,1,3,7,4,1,11,0,200
nested-queries,nested-queries,,10,6,17,16,30,33,4,1
event-triggers,event-triggers,,0,0,0,0,12,0,4,1
templatebinding,templatebinding,,2,3,4,5,7,9,8,50
set-union,set-union,,2,1,1,3,15,4,0,1
key-management,key-management,,1,1,9,2,15,11,6,1
avcaptureoutput,avcaptureoutput,,3,2,6,5,8,11,13,1
jvmti,jvmti,,1,0,13,1,11,14,3,1
prototype-chain,prototype-chain,,3,4,6,7,13,13,1,33.333333
aurelia-event-aggregator,aurelia-event-aggregator,,0,0,2,0,2,2,1,1
zsh-zle,zsh-zle,,0,2,3,2,3,5,9,100
webservices-client,webservices-client,,0,0,0,0,17,0,3,1
strength-reduction,strength-reduction,,0,0,0,0,1,0,9,1
node-static,node-static,,0,0,1,0,2,1,1,1
inbox,inbox,,2,0,6,2,15,8,4,1
modeshape,modeshape,,0,0,0,0,3,0,3,1
electron-forge,electron-forge,,9,9,22,18,19,40,1,1
fsm,fsm,,11,6,21,17,46,38,9,1
sslv3,sslv3,,2,6,2,8,12,10,6,200
http-post-vars,http-post-vars,,0,1,0,1,4,1,4,1
windows-shell,windows-shell,,10,7,8,17,30,25,9,1
powerbuilder.net,powerbuilder.net,,0,0,0,0,4,0,8,1
kony,kony,,4,1,9,5,9,14,13,1
isparta,isparta,,0,0,0,0,4,0,1,1
ios4,ios4,,0,1,1,1,1,2,13,1
critical-css,critical-css,,1,0,4,1,9,5,1,1
drupal-services,drupal-services,,1,0,1,1,2,2,4,1
quartz-2d,quartz-2d,,3,0,2,3,2,5,13,1
disqus,disqus,,5,8,13,13,22,26,1,60
string-to-datetime,string-to-datetime,,12,4,16,16,23,32,0,1
instamojo,instamojo,,4,6,7,10,17,17,4,50
sensormanager,sensormanager,,6,3,6,9,8,15,3,1
eclipse-adt,eclipse-adt,,1,0,3,1,6,4,3,1
grakn,grakn,,0,6,6,6,14,12,2,500
ibrokers,ibrokers,,0,1,4,1,8,5,0,1
tws,tws,,3,7,4,10,15,14,0,133.333333
azure-data-catalog,azure-data-catalog,,1,2,3,3,5,6,8,100
pdfrenderer,pdfrenderer,,3,3,2,6,13,8,3,1
createprocessasuser,createprocessasuser,,1,6,3,7,12,10,8,500
setwindowshookex,setwindowshookex,,2,9,8,11,19,19,9,350
akka-testkit,akka-testkit,,2,4,11,6,12,17,2,100
merging-data,merging-data,,3,6,10,9,13,19,0,100
vcpkg,vcpkg,,12,22,20,34,26,54,9,83.333333
actframework,actframework,,0,0,0,0,1,0,4,1
lisp-macros,lisp-macros,,6,1,2,7,4,9,0,1
lazydatamodel,lazydatamodel,,2,0,4,2,2,6,3,1
psi,psi,,0,3,2,3,2,5,8,200
sql-to-linq-conversion,sql-to-linq-conversion,,4,6,12,10,18,22,8,50
instantsearch.js,instantsearch.js,,9,9,20,18,23,38,4,1
eventreceiver,eventreceiver,,0,0,0,0,1,0,8,1
artifact-deployer,artifact-deployer,,0,0,0,0,2,0,3,1
angular-ng-class,angular-ng-class,,0,2,4,2,13,6,1,100
roaming,roaming,,1,3,2,4,8,6,3,200
unary-operator,unary-operator,,4,7,8,11,21,19,9,75
revision,revision,,2,5,11,7,10,18,6,150
postdelayed,postdelayed,,4,1,5,5,12,10,3,1
stddeque,stddeque,,2,2,1,4,3,5,9,1
goclipse,goclipse,,0,0,1,0,1,1,3,1
signalr-backplane,signalr-backplane,,2,4,6,6,11,12,8,100
local-security-policy,local-security-policy,,1,0,2,1,2,3,9,1
yii-migrations,yii-migrations,,0,0,0,0,1,0,4,1
dirent.h,dirent.h,,3,2,6,5,14,11,9,1
mounted-volumes,mounted-volumes,,3,8,7,11,8,18,6,166.666667
documentum,documentum,,6,7,10,13,34,23,16,16.666667
operation,operation,,12,13,31,25,56,56,0,8.333333
hotjar,hotjar,,2,2,3,4,4,7,1,1
secure-element,secure-element,,3,0,6,3,5,9,3,1
memory-sanitizer,memory-sanitizer,,1,0,1,1,6,2,9,1
dynamic-class-creation,dynamic-class-creation,,1,1,3,2,9,5,3,1
lineseries,lineseries,,1,1,3,2,4,5,8,1
cycle-detection,cycle-detection,,2,0,1,2,5,3,0,1
pimpl-idiom,pimpl-idiom,,5,7,7,12,15,19,9,40
audioformat,audioformat,,0,2,4,2,4,6,13,100
docker-ucp,docker-ucp,,1,2,5,3,16,8,6,100
radius,radius,,10,14,37,24,37,61,9,40
tinyradius,tinyradius,,1,2,0,3,4,3,3,100
menhir,menhir,,0,3,1,3,8,4,0,200
addrange,addrange,,1,1,3,2,4,5,8,1
php-5.4,php-5.4,,8,2,11,10,13,21,4,1
apache-tailer,apache-tailer,,0,0,1,0,1,1,3,1
react-modal,react-modal,,15,15,22,30,44,52,1,1
android-memory,android-memory,,8,5,13,13,17,26,3,1
jppf,jppf,,0,0,1,0,1,1,3,1
drupal-forms,drupal-forms,,2,3,3,5,6,8,4,50
form-api,form-api,,1,0,5,1,5,6,4,1
radgridview,radgridview,,11,1,9,12,28,21,8,1
god,god,,1,2,4,3,1,7,12,100
entity-framework-4,entity-framework-4,,4,5,15,9,33,24,8,25
selectbooleancheckbox,selectbooleancheckbox,,0,0,3,0,2,3,3,1
itsdangerous,itsdangerous,,3,5,0,8,2,8,0,66.666667
cassandra-cli,cassandra-cli,,0,0,0,0,1,0,2,1
x11-forwarding,x11-forwarding,,2,5,17,7,17,24,9,150
spss-modeler,spss-modeler,,4,9,8,13,18,21,0,125
directshow.net,directshow.net,,4,1,10,5,9,15,13,1
drf-nested-routers,drf-nested-routers,,1,1,3,2,5,5,0,1
inline-scripting,inline-scripting,,0,1,0,1,5,1,1,1
backticks,backticks,,5,4,11,9,17,20,9,1
beaker,beaker,,2,1,5,3,10,8,0,1
r-commander,r-commander,,1,0,4,1,6,5,0,1
private-inheritance,private-inheritance,,0,2,2,2,3,4,9,100
datagridviewrow,datagridviewrow,,1,1,5,2,9,7,8,1
kendospreadsheet,kendospreadsheet,,2,0,4,2,3,6,1,1
ragel,ragel,,0,2,1,2,4,3,6,100
pervasive-sql,pervasive-sql,,3,4,16,7,18,23,4,33.333333
ar.js,ar.js,,17,18,30,35,53,65,1,5.882353
xcrun,xcrun,,2,3,13,5,9,18,13,50
uicomponents,uicomponents,,3,2,6,5,10,11,4,1
fleetctl,fleetctl,,0,0,0,0,2,0,6,1
enumerate-devices,enumerate-devices,,2,0,2,2,4,4,8,1
drupal-commerce,drupal-commerce,,7,1,15,8,15,23,4,1
http-token-authentication,http-token-authentication,,3,3,8,6,16,14,4,1
lpc,lpc,,5,4,6,9,6,15,9,1
vnc-server,vnc-server,,3,13,14,16,14,30,9,333.333333
django-socialauth,django-socialauth,,11,5,13,16,39,29,0,1
pdftron,pdftron,,6,5,9,11,33,20,8,1
yaml-cpp,yaml-cpp,,3,4,9,7,30,16,9,33.333333
android-instant-run,android-instant-run,,3,0,6,3,24,9,3,1
brotli,brotli,,5,6,13,11,15,24,0,20
hashalgorithm,hashalgorithm,,0,0,0,0,4,0,8,1
netweaver,netweaver,,0,8,13,8,23,21,5,700
parking,parking,,5,2,2,7,7,9,0,1
detox,detox,,36,34,64,70,112,134,1,1
foselasticabundle,foselasticabundle,,12,3,12,15,24,27,4,1
symfony-components,symfony-components,,1,3,5,4,4,9,4,200
perfmon,perfmon,,3,3,9,6,18,15,8,1
window-server,window-server,,7,10,19,17,18,36,8,42.857143
background-application,background-application,,1,1,1,2,5,3,13,1
qmodelindex,qmodelindex,,2,3,4,5,6,9,9,50
commonschunkplugin,commonschunkplugin,,0,1,4,1,25,5,1,1
reactivemongo-play-json,reactivemongo-play-json,,0,0,1,0,3,1,2,1
la4j,la4j,,0,0,0,0,2,0,9,1
ng-required,ng-required,,0,0,2,0,6,2,1,1
ora-06553,ora-06553,,0,0,1,0,1,1,4,1
jscodeshift,jscodeshift,,1,2,1,3,7,4,1,100
headset,headset,,7,4,10,11,10,21,3,1
android-speech-api,android-speech-api,,1,3,2,4,7,6,3,200
freerdp,freerdp,,3,2,3,5,7,8,9,1
power-law,power-law,,2,5,7,7,8,14,0,150
converse.js,converse.js,,3,3,5,6,13,11,3,1
mysql-function,mysql-function,,1,2,7,3,15,10,4,100
isql,isql,,5,3,8,8,11,16,4,1
openlink-virtuoso,openlink-virtuoso,,3,4,2,7,12,9,2,33.333333
libmemcached,libmemcached,,4,3,3,7,8,10,4,1
bindservice,bindservice,,2,3,5,5,6,10,3,50
apache-storm-flux,apache-storm-flux,,0,0,2,0,2,2,2,1
iptv,iptv,,2,7,13,9,12,22,13,250
spectacle,spectacle,,0,0,3,0,6,3,1,1
alter-column,alter-column,,1,3,2,4,3,6,4,200
winrt-xaml,winrt-xaml,,1,6,7,7,25,14,8,500
node-canvas,node-canvas,,9,4,6,13,8,19,1,1
d-pad,d-pad,,3,0,5,3,6,8,3,1
rpivottable,rpivottable,,6,3,15,9,8,24,0,1
bootstrap-tour,bootstrap-tour,,1,1,4,2,27,6,1,1
incremental-build,incremental-build,,4,7,14,11,17,25,3,75
boundfield,boundfield,,0,0,1,0,5,1,8,1
datafield,datafield,,1,1,3,2,2,5,5,1
angular-seed,angular-seed,,1,0,2,1,11,3,1,1
jeasyui,jeasyui,,2,1,6,3,5,9,1,1
query-tuning,query-tuning,,6,3,7,9,18,16,4,1
multiscreen,multiscreen,,3,1,5,4,10,9,3,1
kendo-react-ui,kendo-react-ui,,6,6,14,12,16,26,1,1
event-flow,event-flow,,0,2,1,2,6,3,8,100
rust-rocket,rust-rocket,,7,8,11,15,11,26,9,14.285714
remoteapp,remoteapp,,2,1,5,3,6,8,8,1
actuator,actuator,,3,1,3,4,12,7,3,1
fujitsu-fortran,fujitsu-fortran,,0,0,0,0,2,0,9,1
byval,byval,,0,1,1,1,5,2,5,1
type-signature,type-signature,,6,2,5,8,12,13,2,1
bacpac,bacpac,,2,3,9,5,16,14,4,50
xcode9.1-beta,xcode9.1-beta,,0,0,0,0,3,0,13,1
line-endings,line-endings,,10,11,18,21,36,39,6,10
noscript,noscript,,4,2,13,6,11,19,1,1
buffered,buffered,,1,2,1,3,7,4,3,100
browser-console,browser-console,,2,2,5,4,14,9,1,1
commodity,commodity,,0,0,0,0,1,0,4,1
mockitowhen,mockitowhen,,0,0,0,0,2,0,3,1
atlassian-fisheye,atlassian-fisheye,,1,0,2,1,4,3,6,1
intraweb,intraweb,,2,2,2,4,3,6,9,1
qtestlib,qtestlib,,3,1,4,4,14,8,9,1
toarray,toarray,,4,2,5,6,15,11,3,1
wikitude-sdk,wikitude-sdk,,1,1,3,2,11,5,3,1
3nf,3nf,,2,3,4,5,11,9,4,50
kdbg,kdbg,,1,0,0,1,4,1,9,1
backbone-routing,backbone-routing,,1,1,0,2,1,2,1,1
hotmail,hotmail,,1,5,9,6,9,15,4,400
jpreloader,jpreloader,,0,0,0,0,1,0,1,1
compiler-theory,compiler-theory,,2,0,5,2,3,7,9,1
jquery-deferred,jquery-deferred,,8,7,18,15,44,33,1,1
mount-point,mount-point,,5,3,10,8,17,18,9,1
memory-overhead,memory-overhead,,0,0,1,0,1,1,2,1
conduit,conduit,,4,3,12,7,25,19,2,1
jsonstream,jsonstream,,4,4,2,8,10,10,1,1
linear-equation,linear-equation,,10,4,18,14,18,32,0,1
jquery-ui-menu,jquery-ui-menu,,0,1,1,1,2,2,1,1
grails-rest-api,grails-rest-api,,0,1,0,1,2,1,3,1
msbuild-14.0,msbuild-14.0,,0,0,1,0,3,1,8,1
language-ext,language-ext,,0,1,3,1,5,4,8,1
min-heap,min-heap,,5,0,10,5,21,15,0,1
request.querystring,request.querystring,,1,4,6,5,9,11,4,300
react-big-calendar,react-big-calendar,,23,24,26,47,24,73,1,4.347826
vtt,vtt,,2,0,8,2,2,10,1,1
stacked-area-chart,stacked-area-chart,,3,6,11,9,16,20,1,100
node-opencv,node-opencv,,0,1,0,1,3,1,1,1
itemtemplate,itemtemplate,,4,6,14,10,28,24,8,50
kendo-maskedtextbox,kendo-maskedtextbox,,0,0,0,0,3,0,1,1
needleman-wunsch,needleman-wunsch,,0,1,0,1,1,1,0,1
plaintext,plaintext,,7,10,14,17,32,31,0,42.857143
hashids,hashids,,1,2,5,3,7,8,4,100
word-contentcontrol,word-contentcontrol,,5,5,12,10,13,22,5,1
playstation,playstation,,0,0,2,0,2,2,3,1
project-types,project-types,,0,0,0,0,1,0,9,1
weekend,weekend,,3,1,4,4,9,8,0,1
sgplot,sgplot,,7,1,2,8,5,10,0,1
get-transform,get-transform,,1,0,0,1,4,1,5,1
javax.activation,javax.activation,,1,0,0,1,3,1,3,1
sas-iml,sas-iml,,1,0,3,1,11,4,0,1
java.lang,java.lang,,3,1,1,4,11,5,3,1
scnmaterial,scnmaterial,,1,0,1,1,12,2,13,1
rails-models,rails-models,,3,1,1,4,9,5,12,1
ebcli,ebcli,,2,4,9,6,19,15,6,100
custom-painting,custom-painting,,6,6,6,12,11,18,3,1
html-validation,html-validation,,3,3,6,6,15,12,1,1
closed-captions,closed-captions,,3,6,7,9,10,16,1,100
custom-routes,custom-routes,,1,5,5,6,10,11,12,400
indirection,indirection,,0,1,4,1,8,5,9,1
vstest.console.exe,vstest.console.exe,,8,6,12,14,21,26,8,1
ivalueconverter,ivalueconverter,,8,5,12,13,42,25,8,1
gnome-shell-extensions,gnome-shell-extensions,,1,2,8,3,19,11,9,100
gzipinputstream,gzipinputstream,,2,0,3,2,9,5,3,1
friendly-id,friendly-id,,5,4,11,9,30,20,12,1
textmate,textmate,,6,6,13,12,19,25,9,1
enterprise-miner,enterprise-miner,,0,1,1,1,3,2,0,1
dice,dice,,24,18,59,42,52,101,0,1
bqplot,bqplot,,1,3,1,4,7,5,0,200
file-association,file-association,,6,1,13,7,18,20,9,1
xamlbuild,xamlbuild,,0,0,3,0,3,3,8,1
tween,tween,,9,3,17,12,16,29,1,1
donut-chart,donut-chart,,8,12,14,20,46,34,1,50
tfs-query,tfs-query,,1,2,0,3,4,3,8,100
spring-io,spring-io,,2,2,3,4,5,7,3,1
wicket-6,wicket-6,,2,4,5,6,18,11,3,100
wicketstuff,wicketstuff,,5,0,4,5,7,9,3,1
lwp,lwp,,6,2,5,8,14,13,9,1
property-files,property-files,,1,0,3,1,9,4,3,1
atmosphere,atmosphere,,5,5,10,10,23,20,3,1
marklogic-corb,marklogic-corb,,1,1,4,2,7,6,3,1
zgrep,zgrep,,1,1,3,2,3,5,9,1
viewaction,viewaction,,0,1,0,1,2,1,3,1
up-button,up-button,,0,0,6,0,6,6,3,1
maven-checkstyle-plugin,maven-checkstyle-plugin,,5,5,8,10,18,18,3,1
debouncing,debouncing,,8,10,19,18,23,37,1,25
f-string,f-string,,19,16,31,35,29,66,0,1
spring-roo,spring-roo,,2,1,7,3,13,10,3,1
roo,roo,,2,3,11,5,5,16,12,50
createwindow,createwindow,,0,0,0,0,5,0,9,1
boost-bind,boost-bind,,1,1,2,2,10,4,9,1
disruptor-pattern,disruptor-pattern,,6,0,6,6,12,12,3,1
digital-logic,digital-logic,,2,0,2,2,18,4,9,1
securezeromemory,securezeromemory,,0,0,0,0,2,0,9,1
testdroid,testdroid,,0,0,0,0,6,0,3,1
angular-factory,angular-factory,,1,1,3,2,17,5,1,1
take,take,,4,1,5,5,7,10,0,1
grails-3.2,grails-3.2,,0,0,3,0,6,3,3,1
maven-gae-plugin,maven-gae-plugin,,0,0,0,0,3,0,3,1
archiving,archiving,,1,2,12,3,17,15,13,100
ranking-functions,ranking-functions,,7,14,10,21,8,31,4,100
terraform-provider-azure,terraform-provider-azure,,52,57,76,109,51,185,8,9.615385
swagger-maven-plugin,swagger-maven-plugin,,0,4,4,4,6,8,3,300
toolchain,toolchain,,14,16,35,30,68,65,9,14.285714
kendo-multiselect,kendo-multiselect,,12,5,10,17,17,27,1,1
sitecore-media-library,sitecore-media-library,,0,0,1,0,4,1,8,1
workday-api,workday-api,,9,6,8,15,22,23,3,1
iframe-app,iframe-app,,0,0,2,0,7,2,1,1
pack,pack,,14,13,23,27,35,50,0,1
react-highcharts,react-highcharts,,11,9,35,20,25,55,1,1
minimongo,minimongo,,1,1,4,2,14,6,1,1
xctestexpectation,xctestexpectation,,0,0,2,0,4,2,13,1
dask-delayed,dask-delayed,,12,21,19,33,47,52,0,75
fingerprinting,fingerprinting,,4,7,10,11,16,21,3,75
cross-application,cross-application,,2,3,2,5,4,7,8,50
idl,idl,,6,13,16,19,17,35,9,116.666667
greenfoot,greenfoot,,3,1,6,4,14,10,3,1
omniauth-linkedin,omniauth-linkedin,,2,4,1,6,2,7,12,100
rasterizing,rasterizing,,9,7,10,16,22,26,0,1
lead,lead,,10,16,29,26,32,55,4,60
unreachable-code,unreachable-code,,1,5,5,6,17,11,3,400
edgar,edgar,,7,6,4,13,6,17,0,1
minute,minute,,8,3,4,11,17,15,0,1
task-management,task-management,,0,2,3,2,4,5,8,100
bufferstrategy,bufferstrategy,,2,0,4,2,10,6,3,1
abseil,abseil,,0,1,1,1,6,2,9,1
glsurfaceview,glsurfaceview,,4,6,15,10,21,25,3,50
parametric-polymorphism,parametric-polymorphism,,8,9,16,17,13,33,2,12.5
yamldotnet,yamldotnet,,1,4,10,5,15,15,8,300
kprobe,kprobe,,1,1,3,2,11,5,9,1
report-designer,report-designer,,1,4,7,5,11,12,4,300
delimited-continuations,delimited-continuations,,0,0,6,0,4,6,2,1
httpbuilder,httpbuilder,,1,4,3,5,10,8,3,300
ppi,ppi,,1,1,2,2,5,4,1,1
idfa,idfa,,6,2,5,8,8,13,13,1
quil,quil,,3,0,4,3,3,7,2,1
perfect-square,perfect-square,,0,1,2,1,7,3,0,1
serving,serving,,4,7,10,11,7,21,0,75
scala-reflect,scala-reflect,,3,17,18,20,22,38,2,466.666667
bisection,bisection,,9,5,17,14,21,31,0,1
numpy-ufunc,numpy-ufunc,,6,6,18,12,22,30,0,1
qlistview,qlistview,,2,10,18,12,27,30,9,400
ui-select2,ui-select2,,2,2,4,4,7,8,1,1
intercept,intercept,,8,7,17,15,32,32,0,1
sequel-gem,sequel-gem,,0,1,1,1,3,2,12,1
keyboard-input,keyboard-input,,2,3,6,5,15,11,9,50
juggernaut,juggernaut,,0,0,0,0,1,0,3,1
map-function,map-function,,26,23,47,49,78,96,0,1
attach-to-process,attach-to-process,,0,0,4,0,6,4,8,1
jquery-confirm,jquery-confirm,,2,3,2,5,13,7,1,50
angularjs-templates,angularjs-templates,,3,1,2,4,6,6,1,1
haskell-platform,haskell-platform,,7,2,10,9,13,19,2,1
authorize,authorize,,3,3,10,6,17,16,8,1
point-in-polygon,point-in-polygon,,5,6,10,11,20,21,0,20
uritemplate,uritemplate,,1,1,1,2,3,3,8,1
kitematic,kitematic,,5,5,13,10,12,23,6,1
server-load,server-load,,1,0,2,1,1,3,4,1
android-shapedrawable,android-shapedrawable,,1,3,1,4,10,5,3,200
rx-binding,rx-binding,,4,3,15,7,28,22,3,1
leaderboard,leaderboard,,11,7,29,18,24,47,3,1
msisdn,msisdn,,0,1,2,1,2,3,4,1
attr-accessor,attr-accessor,,0,0,1,0,9,1,12,1
staf,staf,,0,0,0,0,1,0,9,1
distributed-caching,distributed-caching,,4,5,8,9,17,17,3,25
toolbars,toolbars,,0,0,0,0,1,0,8,1
vdm++,vdm++,,0,0,0,0,1,0,4,1
hebrew,hebrew,,8,6,32,14,51,46,0,1
tapandhold,tapandhold,,0,0,0,0,1,0,13,1
request-mapping,request-mapping,,14,11,22,25,40,47,3,1
unity3d-gui,unity3d-gui,,5,2,4,7,8,11,8,1
teardown,teardown,,1,6,6,7,10,13,3,500
plug-and-play,plug-and-play,,2,1,1,3,1,4,8,1
formatted-input,formatted-input,,0,0,2,0,9,2,9,1
qtspim,qtspim,,9,5,19,14,28,33,9,1
reuseidentifier,reuseidentifier,,3,0,6,3,9,9,13,1
epoll,epoll,,13,13,31,26,64,57,9,1
eintr,eintr,,0,0,0,0,1,0,9,1
java-flow,java-flow,,1,0,1,1,7,2,3,1
filesavepicker,filesavepicker,,0,0,1,0,4,1,8,1
apple-maps,apple-maps,,7,4,14,11,21,25,13,1
node-cluster,node-cluster,,6,2,12,8,21,20,1,1
headphones,headphones,,5,8,4,13,12,17,3,60
adaptor,adaptor,,0,1,2,1,8,3,3,1
app-certification-kit,app-certification-kit,,1,1,7,2,4,9,8,1
maxdate,maxdate,,0,3,5,3,14,8,4,200
unslider,unslider,,0,0,0,0,7,0,1,1
microtime,microtime,,0,2,2,2,4,4,4,100
requires,requires,,0,0,0,0,3,0,3,1
dynamic-url,dynamic-url,,5,3,5,8,14,13,4,1
strip-tags,strip-tags,,3,5,8,8,11,16,4,66.666667
amazon-simpledb,amazon-simpledb,,1,0,1,1,6,2,6,1
i386,i386,,6,3,6,9,16,15,9,1
writer,writer,,13,13,17,26,34,43,0,1
css-to-pdf,css-to-pdf,,0,0,3,0,6,3,1,1
batch-updates,batch-updates,,2,5,6,7,12,13,3,150
laravel-testing,laravel-testing,,12,1,18,13,17,31,4,1
jdom-2,jdom-2,,6,1,2,7,6,9,3,1
pkg-config,pkg-config,,10,19,18,29,31,47,9,90
amba,amba,,1,1,5,2,3,7,9,1
petsc,petsc,,3,4,1,7,7,8,9,33.333333
java-gstreamer,java-gstreamer,,0,1,0,1,1,1,13,1
gnonlin,gnonlin,,0,0,0,0,1,0,13,1
inheritdoc,inheritdoc,,0,0,0,0,1,0,8,1
smartsheet-c#-sdk-v2,smartsheet-c#-sdk-v2,,6,1,6,7,5,13,8,1
anonymous-class,anonymous-class,,13,7,26,20,42,46,3,1
lab-color-space,lab-color-space,,2,0,4,2,7,6,0,1
papaparse,papaparse,,12,16,30,28,40,58,1,33.333333
qvboxlayout,qvboxlayout,,2,4,1,6,5,7,0,100
ebay-sdk,ebay-sdk,,1,8,3,9,5,12,4,700
go-interface,go-interface,,3,3,8,6,13,14,6,1
exceptionhandler,exceptionhandler,,5,3,10,8,15,18,3,1
meteor-galaxy,meteor-galaxy,,0,1,2,1,6,3,1,1
social-likes,social-likes,,1,0,0,1,4,1,3,1
flask-bootstrap,flask-bootstrap,,4,7,12,11,16,23,0,75
flask-nav,flask-nav,,0,0,0,0,4,0,0,1
mern,mern,,47,51,88,98,79,186,1,8.510638
tadoquery,tadoquery,,0,3,4,3,6,7,9,200
client-dataset,client-dataset,,0,0,0,0,1,0,9,1
ghc-pkg,ghc-pkg,,0,0,0,0,3,0,2,1
javax.crypto,javax.crypto,,0,0,3,0,5,3,3,1
int128,int128,,0,2,6,2,4,8,9,100
marquee,marquee,,8,10,24,18,39,42,1,25
microbenchmark,microbenchmark,,9,14,27,23,47,50,9,55.555556
isapi-redirect,isapi-redirect,,0,1,0,1,1,1,3,1
script-component,script-component,,9,7,9,16,18,25,4,1
cardinality,cardinality,,8,5,7,13,19,20,4,1
loglog,loglog,,4,4,2,8,7,10,0,1
alt,alt,,10,8,20,18,24,38,1,1
remoteobject,remoteobject,,0,0,1,0,2,1,9,1
swig-template,swig-template,,1,2,1,3,12,4,1,100
view-hierarchy,view-hierarchy,,0,3,3,3,5,6,13,200
stddraw,stddraw,,1,0,6,1,5,7,3,1
short-circuiting,short-circuiting,,6,9,13,15,30,28,0,50
pace.js,pace.js,,0,0,2,0,1,2,1,1
structural-search,structural-search,,1,1,12,2,14,14,3,1
feign,feign,,44,36,50,80,63,130,3,1
jfr,jfr,,12,4,13,16,15,29,3,1
web-technologies,web-technologies,,2,2,2,4,11,6,1,1
linq-query-syntax,linq-query-syntax,,3,0,11,3,7,14,8,1
linq-method-syntax,linq-method-syntax,,3,1,1,4,4,5,8,1
gravatar,gravatar,,2,3,4,5,13,9,4,50
interfax,interfax,,0,0,0,0,2,0,13,1
searchdisplaycontroller,searchdisplaycontroller,,0,0,0,0,1,0,13,1
line-plot,line-plot,,8,18,20,26,25,46,0,125
ebnf,ebnf,,6,2,11,8,22,19,0,1
nsobjectprotocol,nsobjectprotocol,,2,0,2,2,2,4,13,1
grapevine,grapevine,,4,1,0,5,6,5,8,1
system.net.webexception,system.net.webexception,,4,3,6,7,14,13,8,1
pac,pac,,4,1,9,5,16,14,6,1
equations,equations,,0,0,0,0,19,0,0,1
getfiles,getfiles,,0,4,7,4,20,11,8,300
urxvt,urxvt,,5,3,4,8,9,12,9,1
jupyter-irkernel,jupyter-irkernel,,4,4,13,8,23,21,0,1
readable,readable,,2,0,3,2,8,5,1,1
newsequentialid,newsequentialid,,1,0,1,1,1,2,4,1
northwind,northwind,,10,3,12,13,15,25,4,1
insert-query,insert-query,,0,1,0,1,2,1,4,1
honeypot,honeypot,,4,4,7,8,10,15,4,1
bresenham,bresenham,,6,6,6,12,14,18,0,1
custom-notificaiton,custom-notificaiton,,2,1,5,3,17,8,3,1
phassetslibrary,phassetslibrary,,0,0,1,0,3,1,13,1
qtip2,qtip2,,2,2,6,4,15,10,1,1
max-size,max-size,,0,0,3,0,4,3,0,1
piano,piano,,1,2,3,3,12,6,8,100
gulp-data,gulp-data,,0,0,1,0,2,1,1,1
postorder,postorder,,2,0,9,2,9,11,0,1
memory-corruption,memory-corruption,,4,2,10,6,9,16,9,1
android-designer,android-designer,,2,2,4,4,10,8,3,1
user-accounts,user-accounts,,11,13,17,24,36,41,4,18.181818
dropzone,dropzone,,31,26,87,57,96,144,1,1
sobel,sobel,,6,3,16,9,24,25,0,1
gulp-4,gulp-4,,16,16,25,32,18,57,1,1
boxsizer,boxsizer,,1,2,0,3,6,3,0,100
control-theory,control-theory,,7,3,2,10,11,12,0,1
ets,ets,,1,0,11,1,14,12,2,1
reswift,reswift,,2,3,2,5,9,7,13,50
detail,detail,,0,0,1,0,11,1,3,1
android-loader,android-loader,,0,1,2,1,13,3,3,1
bootswatch,bootswatch,,4,1,4,5,28,9,1,1
webviewclient,webviewclient,,8,2,7,10,17,17,3,1
android-runtime,android-runtime,,5,9,8,14,16,22,3,80
xsb,xsb,,0,0,1,0,2,1,0,1
npm-run,npm-run,,7,10,16,17,16,33,1,42.857143
neomake,neomake,,0,0,2,0,3,2,9,1
f-bounded-polymorphism,f-bounded-polymorphism,,2,3,5,5,11,10,2,50
tail-call-optimization,tail-call-optimization,,1,1,0,2,9,2,0,1
.d.ts,.d.ts,,6,6,8,12,18,20,1,1
declaration-files,declaration-files,,1,1,4,2,8,6,1,1
inverted-index,inverted-index,,6,6,9,12,7,21,0,1
rcu,rcu,,2,2,0,4,8,4,9,1
calligraphy,calligraphy,,1,0,2,1,12,3,3,1
rebol3,rebol3,,0,0,0,0,4,0,0,1
guard-clause,guard-clause,,3,3,4,6,4,10,2,1
pattern-guards,pattern-guards,,1,0,0,1,2,1,2,1
rvds,rvds,,0,0,0,0,1,0,9,1
file-inclusion,file-inclusion,,0,1,3,1,1,4,4,1
priority-web-sdk,priority-web-sdk,,3,1,1,4,4,5,1,1
geopoints,geopoints,,3,5,11,8,9,19,13,66.666667
numpy-memmap,numpy-memmap,,3,0,9,3,21,12,0,1
background-sync,background-sync,,6,1,13,7,8,20,1,1
jquery-ui-dialog,jquery-ui-dialog,,9,7,24,16,47,40,1,1
jquery-ui-button,jquery-ui-button,,0,0,0,0,2,0,1,1
coalescing,coalescing,,2,2,3,4,3,7,0,1
nstouchbar,nstouchbar,,2,1,8,3,6,11,13,1
iverilog,iverilog,,7,2,4,9,22,13,9,1
synopsys-vcs,synopsys-vcs,,2,2,7,4,6,11,9,1
pdf-to-html,pdf-to-html,,6,4,4,10,6,14,0,1
kate,kate,,2,2,1,4,9,5,9,1
cupy,cupy,,11,22,18,33,8,51,0,100
farsi,farsi,,15,6,3,21,5,24,0,1
wrapall,wrapall,,0,1,2,1,2,3,1,1
nextuntil,nextuntil,,0,0,1,0,4,1,1,1
divide-by-zero,divide-by-zero,,6,13,20,19,35,39,0,116.666667
rawimage,rawimage,,2,8,3,10,9,13,0,300
avalonedit,avalonedit,,5,1,6,6,11,12,8,1
propertychangelistener,propertychangelistener,,0,0,2,0,5,2,3,1
kombu,kombu,,5,0,6,5,14,11,0,1
shift-register,shift-register,,1,1,5,2,7,7,9,1
public-html,public-html,,1,1,8,2,14,10,4,1
onpreferenceclicklistener,onpreferenceclicklistener,,0,0,0,0,1,0,3,1
odb,odb,,0,1,3,1,6,4,4,1
tarsosdsp,tarsosdsp,,2,5,5,7,6,12,3,150
i18n-node,i18n-node,,1,5,1,6,4,7,1,400
qmediarecorder,qmediarecorder,,0,0,0,0,2,0,9,1
kernel-mode,kernel-mode,,4,2,6,6,15,12,9,1
export-to-text,export-to-text,,2,2,4,4,11,8,5,1
anpr,anpr,,4,1,0,5,3,5,0,1
payu,payu,,2,4,11,6,23,17,4,100
tarjans-algorithm,tarjans-algorithm,,0,2,0,2,3,2,0,100
seconds,seconds,,5,11,8,16,23,24,0,120
rust-chrono,rust-chrono,,1,1,0,2,8,2,9,1
stack-corruption,stack-corruption,,3,0,1,3,7,4,9,1
stateless-session-bean,stateless-session-bean,,0,1,1,1,13,2,3,1
apex-trigger,apex-trigger,,4,5,0,9,5,9,14,25
oracle-maf,oracle-maf,,0,1,7,1,9,8,3,1
plnkr.co,plnkr.co,,0,0,0,0,4,0,1,1
supertype,supertype,,2,0,3,2,3,5,4,1
lucidchart,lucidchart,,0,1,4,1,1,5,4,1
react-native-cli,react-native-cli,,7,17,15,24,16,39,1,142.857143
technical-indicator,technical-indicator,,5,3,5,8,18,13,0,1
scsi,scsi,,3,2,6,5,9,11,9,1
esx,esx,,2,2,5,4,7,9,6,1
resource-monitor,resource-monitor,,2,1,2,3,4,5,9,1
blowfish,blowfish,,8,2,7,10,20,17,6,1
metis,metis,,2,1,8,3,6,11,0,1
promotions,promotions,,5,1,10,6,10,16,3,1
clockwork,clockwork,,0,0,0,0,7,0,12,1
cypress,cypress,,228,209,298,437,212,735,3,1
csla,csla,,0,1,2,1,4,3,8,1
mechanicalsoup,mechanicalsoup,,6,9,15,15,36,30,0,50
google-chrome-theme,google-chrome-theme,,0,1,2,1,2,3,1,1
angular2-di,angular2-di,,0,0,0,0,2,0,1,1
character-limit,character-limit,,1,1,2,2,5,4,5,1
jake,jake,,0,1,0,1,1,1,1,1
webgrabber,webgrabber,,0,0,0,0,3,0,0,1
lintr,lintr,,3,2,1,5,6,6,0,1
ionic-events,ionic-events,,0,0,1,0,2,1,1,1
app-distribution,app-distribution,,1,5,2,6,9,8,13,400
amplpy,amplpy,,0,0,1,0,1,1,0,1
c-ares,c-ares,,0,0,3,0,5,3,9,1
long-press,long-press,,5,5,9,10,19,19,13,1
gulp-spritesmith,gulp-spritesmith,,0,0,2,0,2,2,1,1
adobe-reader,adobe-reader,,5,5,7,10,11,17,8,1
multiboot,multiboot,,0,3,5,3,2,8,9,200
gwt2,gwt2,,1,0,2,1,2,3,3,1
errai,errai,,3,1,1,4,1,5,3,1
go-cobra,go-cobra,,1,7,8,8,15,16,6,600
ssa,ssa,,2,2,1,4,12,5,9,1
llvm-codegen,llvm-codegen,,1,4,5,5,3,10,9,300
c++builder-10.1-berlin,c++builder-10.1-berlin,,0,1,0,1,9,1,9,1
django-commands,django-commands,,1,4,3,5,6,8,0,300
sortedlist,sortedlist,,7,3,10,10,28,20,0,1
context-switch,context-switch,,7,3,13,10,19,23,9,1
dropnet,dropnet,,0,0,0,0,1,0,8,1
collection-initializer,collection-initializer,,0,1,2,1,6,3,8,1
graphql-subscriptions,graphql-subscriptions,,17,23,20,40,37,60,1,35.294118
parallel-data-warehouse,parallel-data-warehouse,,2,0,1,2,9,3,4,1
ejbca,ejbca,,1,1,7,2,6,9,6,1
cielab,cielab,,0,1,2,1,6,3,0,1
qt5.5,qt5.5,,2,0,6,2,7,8,9,1
ektorp,ektorp,,2,0,0,2,4,2,3,1
openafs,openafs,,0,0,1,0,2,1,0,1
gfx,gfx,,0,2,2,2,3,4,9,100
pdfstamper,pdfstamper,,3,0,6,3,11,9,8,1
thai,thai,,6,0,5,6,11,11,0,1
usbserial,usbserial,,7,13,24,20,29,44,9,85.714286
upstream-branch,upstream-branch,,4,1,4,5,10,9,6,1
tensorflow-probability,tensorflow-probability,,27,29,21,56,8,77,0,7.407407
httpcontent,httpcontent,,3,4,8,7,8,15,8,33.333333
aws-cloud-config,aws-cloud-config,,0,1,4,1,5,5,6,1
cooja,cooja,,18,11,13,29,19,42,9,1
pyldap,pyldap,,1,0,1,1,3,2,0,1
android-bottom-nav-view,android-bottom-nav-view,,5,4,15,9,15,24,3,1
apex-data-loader,apex-data-loader,,0,1,0,1,4,1,14,1
javapackager,javapackager,,4,5,12,9,21,21,3,25
icns,icns,,0,0,3,0,1,3,13,1
vega,vega,,28,15,47,43,50,90,0,1
scratch-file,scratch-file,,1,1,4,2,2,6,3,1
windows-administration,windows-administration,,2,0,2,2,4,4,8,1
date-math,date-math,,1,1,0,2,6,2,0,1
qmap,qmap,,7,2,9,9,11,18,9,1
openquery,openquery,,13,14,15,27,35,42,4,7.692308
automatic-differentiation,automatic-differentiation,,8,2,10,10,16,20,0,1
natural-logarithm,natural-logarithm,,2,1,1,3,9,4,0,1
django-south,django-south,,1,1,2,2,1,4,0,1
fdf,fdf,,0,2,2,2,9,4,8,100
xfdf,xfdf,,0,2,2,2,4,4,8,100
golden-layout,golden-layout,,5,2,5,7,10,12,1,1
mod-proxy-balancer,mod-proxy-balancer,,2,2,1,4,7,5,4,1
laravel-exceptions,laravel-exceptions,,0,1,4,1,5,5,4,1
printstacktrace,printstacktrace,,1,1,0,2,5,2,3,1
ppm,ppm,,4,6,18,10,20,28,0,50
testlink,testlink,,2,4,11,6,15,17,3,100
createinstance,createinstance,,2,2,2,4,10,6,8,1
excel-dates,excel-dates,,4,0,1,4,1,5,5,1
w3c-geolocation,w3c-geolocation,,3,0,4,3,9,7,1,1
sling-models,sling-models,,3,1,9,4,7,13,3,1
drawtext,drawtext,,7,15,16,22,21,38,13,114.285714
mp4box,mp4box,,4,2,11,6,20,17,13,1
fragment-transitions,fragment-transitions,,4,1,3,5,4,8,3,1
peer,peer,,14,10,31,24,21,55,6,1
functional-java,functional-java,,2,1,3,3,3,6,3,1
lua-api,lua-api,,1,1,3,2,8,5,9,1
domain-mapping,domain-mapping,,3,3,5,6,6,11,4,1
hgignore,hgignore,,0,0,2,0,6,2,6,1
log4php,log4php,,1,0,2,1,5,3,4,1
information-hiding,information-hiding,,0,0,5,0,8,5,9,1
non-virtual-interface,non-virtual-interface,,0,0,1,0,1,1,9,1
sequence-alignment,sequence-alignment,,3,2,7,5,9,12,0,1
redis-server,redis-server,,6,8,10,14,17,24,3,33.333333
efpocoadapter,efpocoadapter,,0,0,0,0,1,0,8,1
jaydebeapi,jaydebeapi,,6,9,15,15,14,30,0,50
flask-pymongo,flask-pymongo,,1,8,6,9,16,15,0,700
qfilesystemmodel,qfilesystemmodel,,1,5,12,6,19,18,9,400
backpressure,backpressure,,7,5,11,12,24,23,3,1
mediawiki-templates,mediawiki-templates,,2,1,12,3,12,15,4,1
embedded-documents,embedded-documents,,5,0,7,5,9,12,1,1
flatpak,flatpak,,6,3,16,9,14,25,9,1
dropdownlistfor,dropdownlistfor,,8,8,14,16,27,30,8,1
bad-alloc,bad-alloc,,6,6,10,12,26,22,9,1
expression-templates,expression-templates,,6,2,1,8,5,9,9,1
nested-resources,nested-resources,,6,2,8,8,14,16,12,1
communicator,communicator,,1,0,2,1,1,3,9,1
package-development,package-development,,1,1,8,2,6,10,0,1
text-based,text-based,,4,2,6,6,19,12,0,1
gnu-efi,gnu-efi,,0,1,2,1,7,3,9,1
incompatibletypeerror,incompatibletypeerror,,8,6,15,14,18,29,3,1
dbatools,dbatools,,3,3,5,6,7,11,8,1
conversion-operator,conversion-operator,,2,4,7,6,10,13,9,100
klee,klee,,0,0,3,0,3,3,9,1
switchcompat,switchcompat,,1,1,7,2,13,9,3,1
couchapp,couchapp,,0,1,1,1,7,2,1,1
ambiguous-grammar,ambiguous-grammar,,1,4,10,5,12,15,0,300
phonegap-desktop-app,phonegap-desktop-app,,0,0,0,0,10,0,1,1
sendmailr,sendmailr,,4,3,6,7,11,13,0,1
na.approx,na.approx,,2,0,2,2,1,4,0,1
row-height,row-height,,1,3,2,4,18,6,13,200
pppoe,pppoe,,2,0,4,2,3,6,9,1
new-style-class,new-style-class,,0,0,0,0,4,0,0,1
sourcekitservice,sourcekitservice,,0,0,0,0,1,0,13,1
torque,torque,,3,7,2,10,22,12,0,133.333333
system-center,system-center,,1,0,4,1,12,5,8,1
highest,highest,,1,1,5,2,12,7,0,1
clientscript,clientscript,,1,5,3,6,2,9,14,400
staruml,staruml,,0,2,8,2,16,10,3,100
svn-repository,svn-repository,,0,0,2,0,9,2,6,1
ndis,ndis,,4,3,0,7,6,7,9,1
django-logging,django-logging,,7,4,13,11,11,24,0,1
parameterized-constructor,parameterized-constructor,,1,2,4,3,6,7,9,100
wso2cep,wso2cep,,1,1,1,2,19,3,14,1
sitecore-dms,sitecore-dms,,2,0,0,2,5,2,8,1
language-concepts,language-concepts,,0,0,4,0,9,4,9,1
youtube-analytics,youtube-analytics,,2,1,5,3,11,8,5,1
array-unique,array-unique,,5,2,6,7,16,13,4,1
ecl,ecl,,4,0,1,4,2,5,0,1
elasticsearch-head,elasticsearch-head,,0,0,0,0,2,0,6,1
android-actionbar-compat,android-actionbar-compat,,2,3,3,5,9,8,3,50
vc6,vc6,,1,0,5,1,12,6,9,1
ubuntu-13.10,ubuntu-13.10,,0,0,0,0,1,0,0,1
vbo,vbo,,6,2,16,8,24,24,9,1
fogbugz,fogbugz,,1,0,1,1,2,2,6,1
fogbugz-api,fogbugz-api,,1,0,1,1,2,2,6,1
react-motion,react-motion,,1,1,7,2,4,9,1,1
sails-mssqlserver,sails-mssqlserver,,0,0,2,0,4,2,1,1
react-lifecycle,react-lifecycle,,15,8,27,23,49,50,1,1
self-invoking-function,self-invoking-function,,1,1,4,2,12,6,1,1
magento-1.7,magento-1.7,,8,8,11,16,28,27,4,1
email-spam,email-spam,,7,4,15,11,19,26,4,1
dat-protocol,dat-protocol,,3,6,2,9,4,11,1,100
common-crawl,common-crawl,,2,1,4,3,9,7,0,1
warc,warc,,2,0,5,2,7,7,0,1
sunpkcs11,sunpkcs11,,1,3,6,4,5,10,6,200
activity-transition,activity-transition,,4,1,1,5,4,6,3,1
scalatra,scalatra,,6,1,4,7,12,11,2,1
release-builds,release-builds,,4,4,5,8,4,13,3,1
tree-balancing,tree-balancing,,0,0,3,0,9,3,0,1
multitargeting,multitargeting,,1,4,9,5,9,14,8,300
packets,packets,,0,0,0,0,23,0,9,1
tmemo,tmemo,,1,0,1,1,1,2,9,1
exfat,exfat,,0,1,0,1,2,1,9,1
jax-rpc,jax-rpc,,3,0,2,3,4,5,3,1
wiki-markup,wiki-markup,,0,0,2,0,3,2,6,1
bonfire,bonfire,,1,0,1,1,4,2,4,1
pylintrc,pylintrc,,9,4,7,13,13,20,0,1
expanduser,expanduser,,1,0,2,1,1,3,0,1
bootstrap-switch,bootstrap-switch,,1,3,4,4,9,8,1,200
angulartics2,angulartics2,,1,2,9,3,8,12,1,100
luke,luke,,1,0,3,1,6,4,2,1
scalable,scalable,,5,2,3,7,12,10,1,1
litjson,litjson,,1,0,2,1,3,3,8,1
rx-kotlin2,rx-kotlin2,,17,13,15,30,33,45,3,1
artifact,artifact,,16,11,28,27,33,55,3,1
redux-devtools-extension,redux-devtools-extension,,3,4,6,7,12,13,1,33.333333
mvc-mini-profiler,mvc-mini-profiler,,1,3,2,4,3,6,8,200
asp.net-mvc-validation,asp.net-mvc-validation,,2,0,4,2,6,6,8,1
forever-monitor,forever-monitor,,1,0,2,1,2,3,1,1
flowlayoutpanel,flowlayoutpanel,,8,5,8,13,17,21,8,1
tableofcontents,tableofcontents,,11,14,27,25,40,52,0,27.272727
tkinter-layout,tkinter-layout,,14,7,24,21,51,45,0,1
gitlab-omnibus,gitlab-omnibus,,6,12,26,18,61,44,6,100
terminal-emulator,terminal-emulator,,11,7,9,18,14,27,9,1
xtermjs,xtermjs,,2,4,9,6,10,15,1,100
qtplugin,qtplugin,,1,1,4,2,12,6,9,1
emcee,emcee,,2,6,4,8,8,12,0,200
exchange-server-2007,exchange-server-2007,,1,2,1,3,5,4,8,100
exchange-server-2016,exchange-server-2016,,2,3,12,5,8,17,8,50
fminsearch,fminsearch,,4,7,8,11,10,19,0,75
nreco,nreco,,6,8,15,14,35,29,8,33.333333
appserver,appserver,,1,4,3,5,9,8,4,300
tapi,tapi,,0,2,6,2,14,8,8,100
docker-dind,docker-dind,,0,0,1,0,4,1,6,1
core-video,core-video,,5,4,9,9,23,18,13,1
mdc,mdc,,10,10,22,20,29,42,3,1
dapper-extensions,dapper-extensions,,3,4,6,7,10,13,8,33.333333
babelify,babelify,,4,4,9,8,17,17,1,1
exchangelib,exchangelib,,17,5,10,22,39,32,0,1
oracle-manageddataaccess,oracle-manageddataaccess,,9,13,11,22,22,33,8,44.444444
nettcpbinding,nettcpbinding,,2,4,4,6,15,10,8,100
basichttpbinding,basichttpbinding,,2,1,4,3,13,7,8,1
highpass-filter,highpass-filter,,2,1,2,3,6,5,0,1
dryscrape,dryscrape,,0,0,2,0,7,2,0,1
ascii-art,ascii-art,,8,3,18,11,27,29,0,1
bash-trap,bash-trap,,13,4,11,17,2,28,9,1
dual-sim,dual-sim,,2,3,7,5,15,12,3,50
dialing,dialing,,0,0,0,0,2,0,9,1
facebook-app-invites,facebook-app-invites,,0,0,0,0,6,0,13,1
ff4j,ff4j,,3,0,2,3,3,5,3,1
mysqlbackup.net,mysqlbackup.net,,2,1,0,3,1,3,4,1
fts5,fts5,,0,1,3,1,8,4,3,1
amphp,amphp,,7,0,10,7,8,17,4,1
php-pm,php-pm,,0,0,0,0,1,0,4,1
circularreveal,circularreveal,,0,1,2,1,7,3,3,1
twitter-typeahead,twitter-typeahead,,1,4,7,5,9,12,1,300
vorpal.js,vorpal.js,,0,1,2,1,4,3,1,1
turtle-rdf,turtle-rdf,,10,2,19,12,30,31,2,1
crystal-reports-server,crystal-reports-server,,0,0,2,0,2,2,8,1
gracenote,gracenote,,0,1,1,1,3,2,3,1
npm-update,npm-update,,3,0,8,3,12,11,1,1
device-mapper,device-mapper,,2,1,9,3,8,12,6,1
ghost4j,ghost4j,,1,1,1,2,5,3,3,1
qsettings,qsettings,,5,5,10,10,13,20,9,1
siesta,siesta,,1,0,0,1,9,1,1,1
google-caja,google-caja,,0,0,0,0,1,0,1,1
touches,touches,,1,1,5,2,9,7,13,1
doanswer,doanswer,,0,0,0,0,2,0,3,1
seesaw,seesaw,,0,0,0,0,10,0,2,1
aspose.words,aspose.words,,6,5,13,11,42,24,8,1
bloomapi,bloomapi,,0,0,0,0,2,0,5,1
gs-vlookup,gs-vlookup,,37,86,12,123,11,135,5,132.432432
reformat,reformat,,4,5,6,9,5,15,0,25
reformatting,reformatting,,4,4,3,8,17,11,0,1
json-schema-faker,json-schema-faker,,1,0,2,1,3,3,1,1
bluestacks,bluestacks,,5,4,10,9,12,19,3,1
dbf,dbf,,16,13,33,29,52,62,4,1
sslexception,sslexception,,2,2,5,4,11,9,3,1
draw.io,draw.io,,11,9,12,20,12,32,1,1
buildnumber-maven-plugin,buildnumber-maven-plugin,,0,0,1,0,7,1,3,1
multiplatform,multiplatform,,6,4,19,10,24,29,3,1
imagemagick-identify,imagemagick-identify,,1,0,4,1,5,5,12,1
textedit-editor,textedit-editor,,0,0,0,0,1,0,13,1
alternate,alternate,,2,2,4,4,10,8,4,1
meteor-react,meteor-react,,2,0,8,2,22,10,1,1
gpgme,gpgme,,3,4,4,7,7,11,6,33.333333
user-defined-literals,user-defined-literals,,5,0,7,5,20,12,9,1
configserver,configserver,,15,14,15,29,18,44,3,1
globalize3,globalize3,,0,0,1,0,2,1,12,1
gamepad,gamepad,,7,14,17,21,34,38,8,100
fedena,fedena,,1,0,0,1,4,1,12,1
node-async,node-async,,1,2,1,3,10,4,1,100
node-https,node-https,,2,1,5,3,5,8,1,1
bing-speech,bing-speech,,1,0,3,1,27,4,8,1
prompt-toolkit,prompt-toolkit,,3,5,3,8,3,11,0,66.666667
samsung-touchwiz,samsung-touchwiz,,0,0,1,0,5,1,3,1
applozic,applozic,,1,1,2,2,14,4,3,1
qfontmetrics,qfontmetrics,,0,0,2,0,6,2,9,1
doctype,doctype,,3,5,9,8,21,17,1,66.666667
test-bench,test-bench,,7,9,14,16,39,30,9,28.571429
embedded-fonts,embedded-fonts,,0,0,3,0,2,3,8,1
sqlbindparameter,sqlbindparameter,,1,1,1,2,3,3,4,1
tally,tally,,7,5,11,12,13,23,3,1
gmail-contextual-gadgets,gmail-contextual-gadgets,,0,0,2,0,9,2,5,1
stocktwits,stocktwits,,0,2,2,2,4,4,4,100
stroke-dasharray,stroke-dasharray,,2,5,6,7,9,13,1,150
security-policy,security-policy,,1,1,0,2,3,2,3,1
target-sdk,target-sdk,,2,1,7,3,12,10,3,1
docking,docking,,2,2,2,4,4,6,8,1
database-indexes,database-indexes,,23,13,27,36,61,63,4,1
html-formhandler,html-formhandler,,0,1,0,1,2,1,9,1
gulp-newer,gulp-newer,,0,0,0,0,1,0,1,1
muse,muse,,1,1,4,2,14,6,1,1
fittextjs,fittextjs,,0,0,0,0,4,0,1,1
spark-csv,spark-csv,,1,4,4,5,29,9,2,300
subdocument,subdocument,,12,12,16,24,21,40,1,1
usertype,usertype,,1,1,2,2,5,4,3,1
qstackedwidget,qstackedwidget,,2,1,6,3,21,9,0,1
easysnmp,easysnmp,,1,2,4,3,1,7,9,100
html.textboxfor,html.textboxfor,,1,2,8,3,10,11,8,100
bounce,bounce,,9,5,16,14,14,30,1,1
kotlintest,kotlintest,,2,7,10,9,17,19,3,250
railscasts,railscasts,,0,0,1,0,1,1,12,1
easypost,easypost,,2,4,2,6,3,8,4,100
dexclassloader,dexclassloader,,1,2,2,3,6,5,3,100
haar-wavelet,haar-wavelet,,1,3,4,4,6,8,0,200
pywt,pywt,,1,2,4,3,4,7,0,100
modelmapper,modelmapper,,25,20,35,45,53,80,3,1
xwiki,xwiki,,2,2,5,4,16,9,3,1
merkle-tree,merkle-tree,,4,2,8,6,9,14,6,1
property-testing,property-testing,,0,1,1,1,5,2,2,1
vavr-test,vavr-test,,0,1,0,1,2,1,3,1
filefield,filefield,,8,5,7,13,17,20,0,1
seaside,seaside,,3,0,3,3,7,6,13,1
dolphin-smalltalk,dolphin-smalltalk,,0,0,0,0,3,0,13,1
aida,aida,,0,0,0,0,1,0,13,1
corrupt-data,corrupt-data,,0,0,2,0,7,2,9,1
rebuild,rebuild,,10,4,15,14,26,29,4,1
memoise,memoise,,0,0,3,0,5,3,0,1
monospace,monospace,,3,6,3,9,8,12,1,100
nvarchar,nvarchar,,11,8,9,19,35,28,4,1
spongycastle,spongycastle,,3,4,5,7,18,12,6,33.333333
uwp-maps,uwp-maps,,1,2,4,3,25,7,8,100
sql-server-job,sql-server-job,,1,1,2,2,4,4,4,1
reactivekit,reactivekit,,0,3,2,3,5,5,13,200
meteor-methods,meteor-methods,,1,0,2,1,5,3,1,1
seh,seh,,5,0,6,5,9,11,9,1
unboxing,unboxing,,3,3,7,6,11,13,3,1
rda,rda,,3,3,8,6,16,14,0,1
spring-integration-http,spring-integration-http,,4,8,15,12,19,27,3,100
anyobject,anyobject,,0,3,4,3,13,7,13,200
graphileon,graphileon,,0,0,2,0,3,2,2,1
format-patch,format-patch,,0,1,2,1,3,3,6,1
start-process,start-process,,7,8,9,15,24,24,8,14.285714
tidyquant,tidyquant,,6,1,13,7,14,20,0,1
high-resolution,high-resolution,,3,2,4,5,8,9,9,1
flare,flare,,5,13,3,18,1,21,13,160
sonar-plugin,sonar-plugin,,0,0,2,0,7,2,3,1
universal,universal,,9,11,22,20,44,42,1,22.222222
pgloader,pgloader,,4,6,6,10,8,16,4,50
print-job-control,print-job-control,,0,1,0,1,3,1,3,1
ts-node,ts-node,,20,16,29,36,35,65,1,1
hibernate-4.x,hibernate-4.x,,2,2,7,4,12,11,3,1
neo4j-dotnet-driver,neo4j-dotnet-driver,,1,0,0,1,2,1,2,1
sendgrid-ruby,sendgrid-ruby,,3,0,1,3,2,4,12,1
django-notification,django-notification,,1,3,4,4,7,8,0,200
jquery-click-event,jquery-click-event,,5,1,3,6,12,9,1,1
jquery-rails,jquery-rails,,0,0,3,0,7,3,12,1
.net-reflector,.net-reflector,,1,0,1,1,1,2,8,1
object-reference,object-reference,,6,4,5,10,25,15,8,1
node-debugger,node-debugger,,1,0,4,1,10,5,1,1
voicemail,voicemail,,0,0,3,0,5,3,3,1
figaro-ruby,figaro-ruby,,0,0,7,0,4,7,12,1
autoscalemode,autoscalemode,,1,0,0,1,6,1,8,1
omnikey,omnikey,,0,2,4,2,2,6,3,100
clarion,clarion,,0,0,1,0,4,1,8,1
amazon-kinesis-kpl,amazon-kinesis-kpl,,7,4,13,11,10,24,6,1
shellexecute,shellexecute,,10,2,11,12,25,23,9,1
dsolve,dsolve,,2,0,2,2,6,4,0,1
epoch.js,epoch.js,,0,0,0,0,1,0,1,1
jquery-gmap3,jquery-gmap3,,1,0,0,1,4,1,1,1
uat,uat,,0,0,1,0,4,1,3,1
uibarbuttonsystemitem,uibarbuttonsystemitem,,0,0,1,0,1,1,13,1
arcobjects,arcobjects,,3,1,8,4,11,12,8,1
measures,measures,,0,0,1,0,8,1,5,1
oneplusthree,oneplusthree,,0,1,6,1,11,7,3,1
hybrid-cloud,hybrid-cloud,,2,0,1,2,5,3,8,1
piracy-prevention,piracy-prevention,,0,2,0,2,4,2,3,100
java-security-manager,java-security-manager,,1,8,10,9,13,19,3,700
domain-object,domain-object,,4,0,0,4,5,4,3,1
iso-15693,iso-15693,,2,1,5,3,5,8,3,1
system-properties,system-properties,,3,2,9,5,21,14,3,1
redux-subspace,redux-subspace,,0,0,0,0,1,0,1,1
matlab-cvst,matlab-cvst,,3,3,0,6,11,6,0,1
blobstorage,blobstorage,,3,2,1,5,8,6,8,1
bookmarklet,bookmarklet,,21,12,35,33,69,68,1,1
dotfuscator,dotfuscator,,3,7,8,10,19,18,8,133.333333
servlet-4,servlet-4,,2,1,1,3,6,4,3,1
infineon,infineon,,4,2,0,6,12,6,9,1
commandparameter,commandparameter,,2,0,1,2,7,3,8,1
mysql-group-replication,mysql-group-replication,,3,0,7,3,7,10,4,1
idiorm,idiorm,,0,0,1,0,3,1,4,1
df,df,,10,20,3,30,11,33,0,100
spliterator,spliterator,,3,3,4,6,17,10,3,1
http-equiv,http-equiv,,1,0,2,1,4,3,1,1
dominate,dominate,,1,0,1,1,3,2,1,1
sapi,sapi,,17,2,7,19,8,26,8,1
outlet,outlet,,3,0,4,3,7,7,13,1
android-monitor,android-monitor,,0,0,1,0,4,1,3,1
spurious-wakeup,spurious-wakeup,,1,1,1,2,2,3,3,1
anylogic,anylogic,,27,27,58,54,85,112,3,1
codefixprovider,codefixprovider,,2,0,4,2,8,6,8,1
commandbar,commandbar,,2,1,8,3,9,11,8,1
lseek,lseek,,1,5,4,6,4,10,9,400
flip-flop,flip-flop,,4,2,9,6,16,15,9,1
kcfinder,kcfinder,,1,0,7,1,8,8,4,1
angular2-zone,angular2-zone,,0,0,0,0,1,0,1,1
math.sqrt,math.sqrt,,1,2,6,3,7,9,0,100
function-query,function-query,,1,1,1,2,1,3,4,1
stdcall,stdcall,,0,0,5,0,15,5,9,1
hypervisor,hypervisor,,11,9,25,20,19,45,6,1
uipickerviewdatasource,uipickerviewdatasource,,1,1,1,2,7,3,13,1
tvbox,tvbox,,1,1,2,2,4,4,3,1
libiconv,libiconv,,2,2,4,4,2,8,0,1
hmmlearn,hmmlearn,,5,7,11,12,25,23,0,40
clcircleregion,clcircleregion,,0,0,0,0,2,0,13,1
hot-reload,hot-reload,,21,17,25,38,36,63,1,1
rfc3986,rfc3986,,3,2,3,5,4,8,4,1
isr,isr,,3,4,13,7,33,20,9,33.333333
dithering,dithering,,5,1,6,6,6,12,0,1
regsvr32,regsvr32,,1,0,8,1,9,9,8,1
intellij-15,intellij-15,,3,3,5,6,9,11,3,1
math.js,math.js,,3,3,4,6,9,10,1,1
jcrop,jcrop,,6,5,6,11,16,17,1,1
x12,x12,,5,4,5,9,17,14,8,1
edifact,edifact,,2,4,6,6,17,12,8,100
conceptual,conceptual,,6,12,12,18,15,30,0,100
file-mapping,file-mapping,,2,0,0,2,8,2,9,1
nsdatadetector,nsdatadetector,,1,1,2,2,5,4,13,1
trustmanager,trustmanager,,1,1,4,2,3,6,6,1
setdefault,setdefault,,3,0,4,3,5,7,0,1
formpanel,formpanel,,1,0,0,1,2,1,3,1
offline-mode,offline-mode,,5,3,8,8,15,16,1,1
symbol-server,symbol-server,,3,2,1,5,11,6,8,1
symstore,symstore,,0,0,0,0,1,0,8,1
samsung-mobile-sdk,samsung-mobile-sdk,,1,2,9,3,16,12,3,100
objc-bridging-header,objc-bridging-header,,3,0,9,3,19,12,13,1
nodebb,nodebb,,5,2,3,7,6,10,1,1
iot-for-automotive,iot-for-automotive,,1,0,1,1,3,2,9,1
motionevent,motionevent,,5,7,19,12,33,31,3,40
geoxml3,geoxml3,,0,0,3,0,9,3,1,1
geoxml,geoxml,,0,0,0,0,1,0,1,1
ruby-on-rails-3.1,ruby-on-rails-3.1,,1,1,0,2,1,2,12,1
typeorm,typeorm,,85,151,144,236,104,380,1,77.647059
boundary,boundary,,12,6,19,18,41,37,0,1
exp,exp,,4,4,15,8,22,23,0,1
symfony-http-foundation,symfony-http-foundation,,0,5,5,5,6,10,4,400
javascript-automation,javascript-automation,,10,13,12,23,21,35,13,30
fastmm,fastmm,,1,2,4,3,6,7,9,100
uiresponder,uiresponder,,2,4,5,6,7,11,13,100
plistlib,plistlib,,0,0,0,0,5,0,0,1
kogrid,kogrid,,0,0,2,0,4,2,1,1
print-css,print-css,,3,0,3,3,8,6,1,1
datawedge,datawedge,,1,1,3,2,2,5,3,1
phishing,phishing,,2,8,11,10,6,21,4,300
pyro,pyro,,4,0,8,4,10,12,0,1
aggregate-initialization,aggregate-initialization,,7,3,3,10,16,13,9,1
sbatch,sbatch,,8,9,10,17,15,27,0,12.5
rtmps,rtmps,,1,0,2,1,4,3,13,1
oracle9i,oracle9i,,6,3,8,9,20,17,4,1
cloudsight,cloudsight,,0,0,0,0,3,0,4,1
java-opts,java-opts,,0,1,3,1,6,4,3,1
audio-route,audio-route,,0,0,0,0,1,0,3,1
ibm-wdt,ibm-wdt,,0,0,0,0,5,0,3,1
flowplayer,flowplayer,,2,5,5,7,14,12,13,150
database-tuning-advisor,database-tuning-advisor,,0,0,1,0,3,1,4,1
vssdk,vssdk,,3,3,3,6,14,9,8,1
automatic-failover,automatic-failover,,2,2,5,4,6,9,4,1
odk,odk,,3,2,5,5,7,10,6,1
ddrmenu,ddrmenu,,0,0,0,0,2,0,3,1
dwg,dwg,,4,4,4,8,10,12,5,1
wiris,wiris,,2,0,3,2,4,5,1,1
block-device,block-device,,0,2,3,2,17,5,9,100
lacontext,lacontext,,1,1,4,2,7,6,13,1
burn,burn,,6,5,22,11,24,33,8,1
neo4j-php-ogm,neo4j-php-ogm,,0,0,0,0,6,0,2,1
criteriaquery,criteriaquery,,4,5,10,9,16,19,3,25
html-safe,html-safe,,1,1,2,2,7,4,12,1
connectexception,connectexception,,0,0,3,0,7,3,3,1
groupbox,groupbox,,4,2,14,6,16,20,8,1
zend-studio,zend-studio,,0,1,6,1,6,7,4,1
bacnet,bacnet,,0,1,5,1,4,6,9,1
bacnet4j,bacnet4j,,1,0,0,1,4,1,3,1
tika-server,tika-server,,5,4,9,9,10,18,3,1
mithril.js,mithril.js,,12,5,8,17,17,25,1,1
static-content,static-content,,2,8,9,10,19,19,3,300
openshift-php-cartidges,openshift-php-cartidges,,0,0,0,0,1,0,6,1
celeryd,celeryd,,3,1,4,4,12,8,0,1
device-policy-manager,device-policy-manager,,9,2,12,11,15,23,3,1
leptonica,leptonica,,1,4,8,5,17,13,0,300
ctc,ctc,,7,6,6,13,1,19,0,1
regasm,regasm,,5,5,2,10,11,12,8,1
fsunit,fsunit,,1,1,1,2,4,3,8,1
temporal-tables,temporal-tables,,4,5,13,9,28,22,4,25
google-checkout,google-checkout,,0,1,0,1,1,1,3,1
fragment-tab-host,fragment-tab-host,,1,1,3,2,8,5,3,1
database-permissions,database-permissions,,6,1,15,7,10,22,4,1
numpydoc,numpydoc,,3,1,1,4,3,5,0,1
sipml5,sipml5,,2,3,3,5,7,8,1,50
routing-slip,routing-slip,,0,0,3,0,4,3,8,1
post-commit,post-commit,,1,0,2,1,3,3,6,1
vertical-text,vertical-text,,3,0,5,3,5,8,1,1
pax-web,pax-web,,0,0,1,0,2,1,3,1
directory-browsing,directory-browsing,,0,1,0,1,3,1,9,1
communicate,communicate,,1,1,7,2,7,9,0,1
stateless-session,stateless-session,,1,1,2,2,6,4,3,1
git-rev-list,git-rev-list,,0,1,4,1,3,5,6,1
simple-salesforce,simple-salesforce,,7,5,6,12,8,18,0,1
drive-mapping,drive-mapping,,0,0,2,0,3,2,8,1
prettyphoto,prettyphoto,,1,2,6,3,9,9,1,100
nullif,nullif,,1,1,4,2,10,6,4,1
xml-binding,xml-binding,,1,5,4,6,5,10,3,400
pyephem,pyephem,,5,2,12,7,13,19,0,1
terasort,terasort,,0,0,1,0,4,1,2,1
teragen,teragen,,0,0,0,0,1,0,2,1
filelist,filelist,,2,3,9,5,15,14,1,50
bcmath,bcmath,,5,1,4,6,10,10,4,1
qdesktopservices,qdesktopservices,,1,0,1,1,2,2,0,1
dart2js,dart2js,,4,1,9,5,7,14,13,1
unoconv,unoconv,,0,2,5,2,7,7,9,100
kaltura,kaltura,,1,0,2,1,7,3,13,1
flatfiledestination,flatfiledestination,,1,1,2,2,3,4,4,1
numpad,numpad,,4,6,4,10,12,14,13,50
relative-url,relative-url,,2,0,1,2,3,3,1,1
ecore,ecore,,2,5,13,7,11,20,3,150
eclipse-atl,eclipse-atl,,0,0,2,0,1,2,3,1
windows-phone-silverlight,windows-phone-silverlight,,0,0,0,0,2,0,8,1
mongo-collection,mongo-collection,,4,3,5,7,10,12,1,1
lru,lru,,6,6,13,12,25,25,3,1
determinants,determinants,,5,4,14,9,11,23,0,1
prolog-setof,prolog-setof,,0,0,3,0,5,3,0,1
nononsense-filepicker,nononsense-filepicker,,0,0,0,0,1,0,3,1
libpd,libpd,,0,0,1,0,6,1,13,1
ferret,ferret,,0,1,0,1,2,1,12,1
acts-as-ferret,acts-as-ferret,,0,0,0,0,2,0,12,1
pipedrive-api,pipedrive-api,,3,0,2,3,8,5,1,1
apple-app-site-associate,apple-app-site-associate,,2,2,4,4,5,8,13,1
onlyoffice,onlyoffice,,1,3,3,4,17,7,4,200
texture2d,texture2d,,8,5,20,13,39,33,8,1
bus-error,bus-error,,3,1,1,4,11,5,9,1
narrowing,narrowing,,1,2,7,3,12,10,9,100
pdostatement,pdostatement,,1,0,1,1,4,2,4,1
qt4.8,qt4.8,,4,7,7,11,12,18,9,75
rstan,rstan,,11,13,36,24,48,60,0,18.181818
rstanarm,rstanarm,,5,1,5,6,10,11,0,1
scrapy-middleware,scrapy-middleware,,0,0,3,0,4,3,0,1
hybris-data-hub,hybris-data-hub,,2,0,8,2,9,10,3,1
uilocalizedcollation,uilocalizedcollation,,1,1,1,2,1,3,13,1
uipreviewaction,uipreviewaction,,1,0,1,1,1,2,13,1
unsigned-char,unsigned-char,,5,2,4,7,20,11,9,1
google-pie-chart,google-pie-chart,,1,1,5,2,9,7,1,1
joblib,joblib,,49,36,56,85,78,141,0,1
gmsplacepicker,gmsplacepicker,,5,4,3,9,15,12,13,1
google-tasks,google-tasks,,6,8,7,14,7,21,5,33.333333
signaturepad,signaturepad,,5,5,13,10,29,23,1,1
live-preview,live-preview,,0,0,1,0,3,1,1,1
onload-event,onload-event,,5,0,4,5,12,9,1,1
wix3,wix3,,7,9,19,16,32,35,8,28.571429
prettify,prettify,,1,0,2,1,6,3,0,1
extraction-operator,extraction-operator,,1,1,0,2,1,2,9,1
working-directory,working-directory,,10,4,23,14,20,37,9,1
quadprog,quadprog,,3,1,6,4,6,10,0,1
callbyname,callbyname,,0,3,2,3,9,5,9,200
ietf-netconf,ietf-netconf,,7,11,8,18,21,26,9,57.142857
predicates,predicates,,0,0,0,0,16,0,3,1
stdev,stdev,,1,3,2,4,8,6,4,200
testcontainers,testcontainers,,27,30,27,57,22,84,3,11.111111
google-iap,google-iap,,6,8,18,14,17,32,6,33.333333
experimental-design,experimental-design,,3,2,4,5,15,9,0,1
full-trust,full-trust,,5,0,2,5,3,7,8,1
squishit,squishit,,0,0,0,0,1,0,8,1
jquery-nestable,jquery-nestable,,2,1,5,3,8,8,1,1
slidingpanelayout,slidingpanelayout,,0,1,0,1,6,1,3,1
twitter-widget,twitter-widget,,0,0,0,0,3,0,1,1
apple-music,apple-music,,11,9,11,20,26,31,13,1
apple-musickit,apple-musickit,,13,10,17,23,35,40,13,1
espruino,espruino,,0,0,1,0,3,1,9,1
scriplets,scriplets,,1,0,5,1,9,6,3,1
planar-graph,planar-graph,,2,1,1,3,5,4,0,1
google-cloud-firestore,google-cloud-firestore,,1967,1893,3083,3860,4375,6943,13,1
wicket-7,wicket-7,,1,3,4,4,22,8,3,200
herestring,herestring,,1,1,4,2,3,6,9,1
google-chrome-arc,google-chrome-arc,,0,0,0,0,3,0,3,1
appledoc,appledoc,,0,0,0,0,2,0,13,1
live-unit-tests,live-unit-tests,,0,4,1,4,9,5,8,300
spherical-coordinate,spherical-coordinate,,2,4,7,6,11,13,0,100
blockui,blockui,,2,2,3,4,8,7,1,1
inspinia,inspinia,,1,1,1,2,4,3,1,1
newsletter2go,newsletter2go,,0,0,1,0,3,1,4,1
alt-key,alt-key,,0,0,0,0,2,0,0,1
angular-dragula,angular-dragula,,0,0,6,0,9,6,1,1
table-lock,table-lock,,0,1,0,1,5,1,4,1
qcustomplot,qcustomplot,,6,5,8,11,25,19,9,1
data-layer,data-layer,,0,0,1,0,8,1,5,1
mediatypeformatter,mediatypeformatter,,0,0,3,0,4,3,8,1
adsi,adsi,,5,2,5,7,12,12,8,1
angular2-guards,angular2-guards,,0,0,0,0,2,0,1,1
sangria,sangria,,3,1,6,4,18,10,2,1
proj4js,proj4js,,3,0,5,3,6,8,1,1
whatsapi,whatsapi,,8,7,10,15,24,25,3,1
fluent-design,fluent-design,,1,1,1,2,19,3,8,1
palette,palette,,7,5,7,12,25,19,3,1
leanft,leanft,,8,3,13,11,36,24,3,1
ienumerator,ienumerator,,5,10,14,15,32,29,8,100
nbitcoin,nbitcoin,,2,0,4,2,8,6,8,1
dbgrid,dbgrid,,2,4,6,6,12,12,9,100
tdbgrid,tdbgrid,,1,1,3,2,7,5,9,1
xml-sitemap,xml-sitemap,,3,1,2,4,1,6,4,1
android-version,android-version,,5,7,8,12,24,20,3,40
etw-eventsource,etw-eventsource,,2,2,0,4,4,4,8,1
applescript-excel,applescript-excel,,0,2,3,2,6,5,13,100
tinker,tinker,,6,4,11,10,21,21,4,1
qtwidgets,qtwidgets,,9,7,10,16,41,26,9,1
misra,misra,,12,10,30,22,54,52,9,1
equational-reasoning,equational-reasoning,,0,0,0,0,1,0,2,1
izpack,izpack,,0,0,11,0,3,11,3,1
phpdesktop,phpdesktop,,5,6,6,11,8,17,4,20
prettytable,prettytable,,8,1,7,9,14,16,0,1
botan,botan,,6,7,1,13,10,14,9,16.666667
post-install,post-install,,3,4,5,7,7,12,1,33.333333
cdo,cdo,,2,3,8,5,15,13,5,50
opendap,opendap,,1,2,4,3,5,7,0,100
s-expression,s-expression,,1,3,2,4,8,6,0,200
angular-directive-link,angular-directive-link,,1,0,0,1,4,1,1,1
jfxpanel,jfxpanel,,1,3,2,4,7,6,3,200
line-drawing,line-drawing,,0,0,5,0,3,5,0,1
scalameta,scalameta,,3,5,5,8,18,13,2,66.666667
spam-prevention,spam-prevention,,20,7,25,27,40,52,4,1
osx,osx,,0,0,0,0,3,0,0,1
handleerror,handleerror,,0,0,1,0,2,1,1,1
nvprof,nvprof,,7,7,7,14,19,21,0,1
st,st,,3,1,11,4,17,15,9,1
react-on-rails,react-on-rails,,8,5,12,13,33,25,12,1
asp-net-core-spa-services,asp-net-core-spa-services,,12,8,17,20,38,37,8,1
mariadb-connect-engine,mariadb-connect-engine,,4,4,5,8,6,13,4,1
pywin,pywin,,1,1,2,2,5,4,0,1
android-wireless,android-wireless,,2,1,1,3,4,4,3,1
android-checkedtextview,android-checkedtextview,,0,1,0,1,3,1,3,1
tstringlist,tstringlist,,3,1,1,4,5,5,9,1
paragraphs,paragraphs,,0,0,1,0,13,1,4,1
nerves-project,nerves-project,,3,1,2,4,2,6,2,1
bluemix-app-scan,bluemix-app-scan,,1,2,3,3,9,6,4,100
raty,raty,,4,0,2,4,6,6,12,1
assertj,assertj,,14,13,24,27,60,51,3,1
htmlcollection,htmlcollection,,7,3,12,10,14,22,1,1
comonad,comonad,,0,1,3,1,6,4,2,1
implements,implements,,12,5,24,17,34,41,3,1
date-manipulation,date-manipulation,,1,2,1,3,6,4,0,100
hoplon,hoplon,,0,0,0,0,7,0,2,1
test-runner,test-runner,,6,5,11,11,11,22,3,1
yap,yap,,0,1,1,1,3,2,0,1
cordova-android,cordova-android,,4,12,24,16,29,40,1,200
silverlight-5.0,silverlight-5.0,,0,1,8,1,4,9,8,1
unity3d-5,unity3d-5,,0,0,0,0,4,0,8,1
grape-api,grape-api,,4,4,6,8,26,14,12,1
stringtokenizer,stringtokenizer,,12,3,13,15,34,28,3,1
postico,postico,,2,2,8,4,2,12,4,1
llvmlite,llvmlite,,1,2,5,3,5,8,0,100
mysql-error-1052,mysql-error-1052,,1,0,0,1,2,1,4,1
rtaudio,rtaudio,,0,1,5,1,3,6,9,1
user-variables,user-variables,,1,3,5,4,3,9,4,200
boost-test,boost-test,,0,4,11,4,12,15,9,300
google-breakpad,google-breakpad,,2,4,4,6,7,10,9,100
dih,dih,,1,4,10,5,11,15,2,300
keystone,keystone,,6,3,9,9,31,18,6,1
php-5.2,php-5.2,,1,1,2,2,7,4,4,1
go-iris,go-iris,,0,2,8,2,10,10,6,100
mixed-mode,mixed-mode,,1,2,2,3,5,5,8,100
prime31,prime31,,0,0,1,0,1,1,3,1
pattern-finding,pattern-finding,,0,0,1,0,2,1,8,1
deform,deform,,2,4,2,6,4,8,0,100
sceneform,sceneform,,46,48,95,94,50,189,3,4.347826
social-gaming,social-gaming,,1,0,1,1,2,2,8,1
react-native-firebase,react-native-firebase,,81,99,155,180,155,335,1,22.222222
custom-receiver,custom-receiver,,1,1,2,2,8,4,13,1
nstaggedpointerstring,nstaggedpointerstring,,1,1,0,2,1,2,13,1
norton,norton,,0,0,0,0,3,0,6,1
openhab,openhab,,8,10,14,18,12,32,6,25
aloha,aloha,,0,0,0,0,1,0,9,1
suffix,suffix,,6,6,15,12,28,27,0,1
rewritemap,rewritemap,,5,4,2,9,7,11,4,1
offline-storage,offline-storage,,0,0,1,0,4,1,1,1
globalcompositeoperation,globalcompositeoperation,,2,1,1,3,1,4,1,1
compound-literals,compound-literals,,0,2,5,2,11,7,9,100
redisml,redisml,,0,0,0,0,1,0,3,1
ef-bulkinsert,ef-bulkinsert,,0,0,4,0,2,4,8,1
multiuserchat,multiuserchat,,0,5,17,5,16,22,3,400
coclass,coclass,,0,0,0,0,2,0,8,1
complete,complete,,5,6,15,11,22,26,0,20
model-driven-development,model-driven-development,,0,4,2,4,1,6,3,300
sql-date-functions,sql-date-functions,,4,4,16,8,34,24,4,1
sqldatetime,sqldatetime,,0,3,8,3,20,11,4,200
devicetoken,devicetoken,,2,1,4,3,9,7,13,1
oneops,oneops,,0,0,0,0,2,0,6,1
tmuxinator,tmuxinator,,2,1,4,3,7,7,9,1
progmem,progmem,,3,2,2,5,5,7,9,1
routeboxer,routeboxer,,0,0,0,0,2,0,1,1
poptoviewcontroller,poptoviewcontroller,,1,0,0,1,4,1,13,1
vue.js-directives,vue.js-directives,,2,2,8,4,7,12,1,1
subproject,subproject,,2,1,6,3,10,9,6,1
gccgo,gccgo,,5,0,3,5,9,8,6,1
control-m,control-m,,6,2,12,8,15,20,9,1
tetris,tetris,,6,2,12,8,14,20,1,1
monetdb,monetdb,,2,2,13,4,17,17,4,1
parse-ios-sdk,parse-ios-sdk,,7,2,5,9,1,14,13,1
nvidia-docker,nvidia-docker,,19,18,27,37,40,64,6,1
graphql-relay,graphql-relay,,4,1,1,5,5,6,1,1
goinstall,goinstall,,1,0,3,1,1,4,6,1
ckeditor5,ckeditor5,,57,53,84,110,93,194,1,1
morelikethis,morelikethis,,5,4,4,9,10,13,6,1
event-based-programming,event-based-programming,,0,1,2,1,2,3,3,1
vader,vader,,3,9,4,12,12,16,0,200
magento-1.8,magento-1.8,,1,3,6,4,18,10,4,200
fortran2008,fortran2008,,0,2,3,2,24,5,9,100
utf-32,utf-32,,0,0,0,0,6,0,0,1
cctray,cctray,,0,0,0,0,1,0,6,1
ccmenu,ccmenu,,0,0,0,0,1,0,6,1
chatscript,chatscript,,0,0,0,0,7,0,9,1
spip,spip,,0,0,0,0,2,0,4,1
qbfc,qbfc,,0,5,3,5,22,8,4,400
tungsten-replicator,tungsten-replicator,,1,0,1,1,2,2,4,1
pygmentize,pygmentize,,1,1,3,2,1,5,9,1
oc4j,oc4j,,2,1,3,3,6,6,3,1
jdk1.5,jdk1.5,,0,1,2,1,4,3,3,1
hyperthreading,hyperthreading,,3,3,6,6,18,12,9,1
characteristics,characteristics,,3,4,5,7,9,12,3,33.333333
avi,avi,,10,10,11,20,32,31,13,1
fckeditor,fckeditor,,0,3,6,3,8,9,1,200
postconstruct,postconstruct,,8,3,10,11,19,21,3,1
delphi-6,delphi-6,,2,1,2,3,8,5,9,1
delphi-unicode,delphi-unicode,,1,0,0,1,1,1,9,1
purge,purge,,3,2,4,5,26,9,4,1
internal-class,internal-class,,1,0,0,1,1,1,8,1
push-api,push-api,,2,0,3,2,12,5,13,1
saved-searches,saved-searches,,3,13,18,16,25,34,14,333.333333
libreoffice-base,libreoffice-base,,6,2,15,8,13,23,5,1
mercurial-hook,mercurial-hook,,3,2,5,5,8,10,6,1
qx,qx,,0,1,1,1,1,2,9,1
datagridcolumn,datagridcolumn,,0,0,4,0,8,4,8,1
zenity,zenity,,4,0,10,4,13,14,9,1
pyudev,pyudev,,4,1,1,5,5,6,0,1
app-bundle,app-bundle,,5,3,10,8,4,18,3,1
httphandler,httphandler,,7,10,18,17,32,35,8,42.857143
totality,totality,,0,1,3,1,9,4,2,1
kuka-krl,kuka-krl,,1,0,1,1,2,2,0,1
zonejs,zonejs,,3,4,12,7,17,19,1,33.333333
routed-commands,routed-commands,,2,1,2,3,13,5,8,1
routedcommand,routedcommand,,0,0,0,0,1,0,8,1
oltp,oltp,,2,1,1,3,7,4,4,1
microdata,microdata,,8,13,23,21,41,44,4,62.5
kendo-treelist,kendo-treelist,,8,5,14,13,6,27,1,1
cufft,cufft,,3,6,5,9,20,14,0,100
xlsb,xlsb,,5,6,13,11,7,24,5,20
dstu2-fhir,dstu2-fhir,,4,4,3,8,4,11,14,1
tex-live,tex-live,,5,5,5,10,6,15,0,1
weighted-graph,weighted-graph,,8,9,11,17,19,28,0,12.5
windowsformsintegration,windowsformsintegration,,0,0,1,0,3,1,8,1
ruamel.yaml,ruamel.yaml,,17,22,27,39,51,66,0,29.411765
parallelism-amdahl,parallelism-amdahl,,1,12,2,13,32,15,0,1100
parallel-builds,parallel-builds,,0,1,0,1,10,1,9,1
angularjs-ng-disabled,angularjs-ng-disabled,,0,0,3,0,15,3,1,1
toolbaritems,toolbaritems,,1,1,4,2,11,6,8,1
primer3,primer3,,0,0,1,0,1,1,0,1
voice-recording,voice-recording,,3,6,9,9,11,18,3,100
image-comparison,image-comparison,,3,6,6,9,14,15,0,100
cometchat,cometchat,,3,3,3,6,8,9,13,1
web3-java,web3-java,,9,6,20,15,33,35,6,1
change-notification,change-notification,,0,1,1,1,3,2,9,1
codefluentruntimeclient,codefluentruntimeclient,,0,0,0,0,1,0,8,1
braces,braces,,5,3,7,8,13,15,0,1
web-content,web-content,,0,1,4,1,10,5,3,1
asyncfileupload,asyncfileupload,,1,5,6,6,15,12,8,400
multiple-file-upload,multiple-file-upload,,5,6,13,11,14,24,4,20
webiopi,webiopi,,0,0,2,0,2,2,4,1
storage-class-specifier,storage-class-specifier,,2,4,4,6,5,10,9,100
pubmed,pubmed,,9,6,9,15,24,24,0,1
highlightjs,highlightjs,,2,1,4,3,7,7,1,1
sorcery,sorcery,,2,2,5,4,11,9,12,1
devforce,devforce,,1,2,1,3,8,4,8,100
lemur,lemur,,0,0,1,0,4,1,0,1
indri,indri,,1,0,1,1,2,2,0,1
ibm-cloud-tools,ibm-cloud-tools,,0,3,7,3,17,10,6,200
diego,diego,,2,2,3,4,3,7,3,1
android-custom-keyboard,android-custom-keyboard,,6,2,9,8,18,17,3,1
type-coercion,type-coercion,,0,8,3,8,8,11,1,700
nmbrs,nmbrs,,0,0,0,0,7,0,4,1
onfling,onfling,,0,1,4,1,3,5,3,1
select-string,select-string,,8,7,14,15,20,29,8,1
system.graphics,system.graphics,,0,0,1,0,1,1,8,1
comobject,comobject,,9,6,13,15,12,28,8,1
pivotal-web-services,pivotal-web-services,,3,2,5,5,19,10,3,1
calendly,calendly,,4,1,1,5,3,6,1,1
p4merge,p4merge,,0,0,1,0,5,1,6,1
tinycss,tinycss,,0,0,0,0,1,0,3,1
facebook-debugger,facebook-debugger,,1,3,5,4,9,9,13,200
mvcgrid,mvcgrid,,1,1,1,2,3,3,8,1
pdf-form,pdf-form,,4,6,11,10,20,21,8,50
imovie,imovie,,0,0,0,0,4,0,13,1
batching,batching,,4,4,10,8,14,18,0,1
c1flexgrid,c1flexgrid,,0,0,1,0,5,1,8,1
django-custom-user,django-custom-user,,15,9,15,24,34,39,0,1
ietf-netmod-yang,ietf-netmod-yang,,15,9,12,24,21,36,9,1
ietf-restconf,ietf-restconf,,2,3,7,5,2,12,9,50
httpentity,httpentity,,5,0,3,5,8,8,3,1
angularjs-ng-resource,angularjs-ng-resource,,1,0,4,1,4,5,1,1
geolite2,geolite2,,1,3,6,4,8,10,4,200
geoip2,geoip2,,3,4,15,7,19,22,4,33.333333
automated-refactoring,automated-refactoring,,4,9,19,13,32,32,3,125
axshockwaveflash,axshockwaveflash,,0,0,2,0,2,2,8,1
custom-headers,custom-headers,,6,4,7,10,9,17,4,1
libreoffice-writer,libreoffice-writer,,4,2,8,6,12,14,5,1
kannada,kannada,,0,0,1,0,5,1,3,1
noflo,noflo,,2,3,1,5,7,6,1,50
graph-coloring,graph-coloring,,7,2,10,9,11,19,0,1
boost-coroutine2,boost-coroutine2,,2,0,0,2,1,2,9,1
xmltextreader,xmltextreader,,0,1,1,1,8,2,8,1
telerik-radbutton,telerik-radbutton,,0,0,0,0,2,0,8,1
windowserror,windowserror,,0,1,5,1,7,6,0,1
spservices,spservices,,4,2,6,6,14,12,8,1
modular,modular,,4,2,10,6,20,16,1,1
treelistview,treelistview,,0,0,4,0,4,4,8,1
spring-portlet-mvc,spring-portlet-mvc,,2,1,2,3,9,5,3,1
vlad-vector,vlad-vector,,0,0,2,0,2,2,0,1
covariogram,covariogram,,2,0,1,2,4,3,0,1
apachebench,apachebench,,7,2,13,9,19,22,3,1
rabbitmq-shovel,rabbitmq-shovel,,0,2,5,2,9,7,3,100
angular-daterangepicker,angular-daterangepicker,,3,1,5,4,12,9,1,1
webkit2,webkit2,,1,1,7,2,4,9,9,1
ms-jet-ace,ms-jet-ace,,0,2,1,2,10,3,5,100
reserved,reserved,,2,1,4,3,5,7,9,1
database-link,database-link,,2,1,5,3,11,8,4,1
vugen,vugen,,7,8,9,15,26,24,3,14.285714
sql-server-json,sql-server-json,,3,1,4,4,12,8,4,1
node-mssql,node-mssql,,7,10,16,17,19,33,1,42.857143
authenticator,authenticator,,6,3,8,9,7,17,8,1
force-download,force-download,,2,0,6,2,9,8,4,1
yaws,yaws,,0,1,4,1,4,5,2,1
nitrogen,nitrogen,,0,0,3,0,4,3,2,1
erlang-ports,erlang-ports,,1,0,2,1,4,3,2,1
inets,inets,,1,0,0,1,7,1,2,1
createobject,createobject,,2,5,6,7,12,13,5,150
tweetstream,tweetstream,,3,1,1,4,6,5,0,1
procrun,procrun,,3,4,1,7,10,8,3,33.333333
pyflakes,pyflakes,,0,3,0,3,8,3,0,200
mef2,mef2,,0,2,0,2,2,2,8,100
sigpipe,sigpipe,,2,1,1,3,6,4,9,1
gwtp,gwtp,,1,0,4,1,5,5,3,1
3ds,3ds,,4,3,9,7,8,16,0,1
xs,xs,,1,2,4,3,9,7,9,100
report-viewer2016,report-viewer2016,,1,2,1,3,4,4,8,100
slapd,slapd,,1,0,7,1,12,8,8,1
async-onprogressupdate,async-onprogressupdate,,2,0,0,2,5,2,3,1
set-include-path,set-include-path,,0,0,1,0,2,1,9,1
external-display,external-display,,0,0,6,0,4,6,13,1
ncks,ncks,,0,0,2,0,4,2,0,1
system.transactions,system.transactions,,0,0,1,0,4,1,8,1
windows64,windows64,,1,2,4,3,9,7,0,100
fat32,fat32,,2,4,6,6,6,12,9,100
bidi,bidi,,5,0,4,5,14,9,0,1
referential-integrity,referential-integrity,,2,3,5,5,15,10,4,50
glx,glx,,3,2,3,5,11,8,9,1
riscv,riscv,,27,27,43,54,68,97,9,1
outlook-2013,outlook-2013,,4,5,15,9,20,24,5,25
blue-screen-of-death,blue-screen-of-death,,1,1,2,2,5,4,3,1
simexception,simexception,,0,0,0,0,1,0,3,1
jclouds,jclouds,,1,2,1,3,24,4,6,100
restlet-2.0,restlet-2.0,,2,2,5,4,2,9,14,1
hdr,hdr,,11,9,15,20,13,35,0,1
konsole,konsole,,1,2,3,3,7,6,9,100
peoplepicker,peoplepicker,,5,1,5,6,9,11,8,1
logify,logify,,0,0,0,0,1,0,8,1
custom-code,custom-code,,1,0,1,1,6,2,4,1
gnu-toolchain,gnu-toolchain,,3,2,3,5,9,8,9,1
elastisch,elastisch,,0,0,0,0,1,0,2,1
taint,taint,,3,0,1,3,3,4,8,1
find-sec-bugs,find-sec-bugs,,2,1,3,3,2,6,3,1
bpy,bpy,,1,2,2,3,6,5,0,100
timelinemax,timelinemax,,2,5,5,7,5,12,1,150
column-width,column-width,,9,4,4,13,17,17,1,1
ahoy,ahoy,,8,6,7,14,16,21,12,1
non-clustered-index,non-clustered-index,,2,6,10,8,17,18,4,200
aptitude,aptitude,,3,1,1,4,7,5,9,1
ora-01722,ora-01722,,1,1,1,2,8,3,4,1
pyexcel,pyexcel,,4,3,5,7,18,12,0,1
magento2-extensions,magento2-extensions,,0,0,0,0,2,0,4,1
reactfire,reactfire,,0,0,0,0,2,0,1,1
foldleft,foldleft,,5,2,10,7,11,17,2,1
hosted,hosted,,6,3,8,9,4,17,4,1
time-measurement,time-measurement,,1,0,1,1,5,2,0,1
as-if,as-if,,0,1,0,1,2,1,9,1
table-footer,table-footer,,0,0,2,0,3,2,13,1
firefox-addon-sdk,firefox-addon-sdk,,5,1,6,6,19,12,1,1
oaf,oaf,,3,0,3,3,7,6,3,1
sql-server-on-linux,sql-server-on-linux,,1,2,1,3,1,4,4,100
sql-server-vnext,sql-server-vnext,,0,0,0,0,1,0,4,1
memory-leak-detector,memory-leak-detector,,2,3,1,5,4,6,9,50
leak-sanitizer,leak-sanitizer,,0,1,1,1,6,2,9,1
objectinstantiation,objectinstantiation,,3,3,4,6,7,10,9,1
jsfl,jsfl,,1,0,2,1,4,3,1,1
grunt-contrib-watch,grunt-contrib-watch,,3,0,10,3,16,13,1,1
gui-builder,gui-builder,,1,2,4,3,7,7,3,100
maintainscrollpositionon,maintainscrollpositionon,,1,0,1,1,2,2,8,1
roulette-wheel-selection,roulette-wheel-selection,,0,2,3,2,7,5,0,100
icd,icd,,1,0,3,1,3,4,0,1
javaplot,javaplot,,0,0,3,0,1,3,3,1
enum-class,enum-class,,7,6,9,13,9,22,9,1
avcapturephotosettings,avcapturephotosettings,,0,0,1,0,5,1,13,1
cookiecontainer,cookiecontainer,,1,1,4,2,3,6,8,1
pearson,pearson,,2,3,6,5,9,11,0,50
median-of-medians,median-of-medians,,2,0,4,2,3,6,0,1
ifft,ifft,,4,0,6,4,32,10,0,1
mail-sender,mail-sender,,4,2,9,6,13,15,4,1
thick-client,thick-client,,0,2,2,2,2,4,4,100
alfred,alfred,,3,1,4,4,10,8,13,1
queryparam,queryparam,,3,1,3,4,11,7,1,1
sony-xperia,sony-xperia,,3,0,3,3,6,6,3,1
extra,extra,,1,2,6,3,13,9,3,100
bulkloader,bulkloader,,0,0,0,0,2,0,8,1
wp-cli,wp-cli,,9,9,13,18,22,31,4,1
python-rq,python-rq,,7,2,5,9,19,14,0,1
wicket-1.6,wicket-1.6,,1,3,1,4,4,5,3,200
const-cast,const-cast,,5,4,13,9,15,22,9,1
carbon-fields,carbon-fields,,1,3,1,4,3,5,4,200
carbon-fields-2,carbon-fields-2,,0,1,0,1,2,1,4,1
geshi,geshi,,0,0,0,0,2,0,4,1
enoent,enoent,,7,2,8,9,18,17,1,1
interactive-brokers,interactive-brokers,,14,15,18,29,35,47,0,7.142857
custom-data-type,custom-data-type,,5,6,10,11,28,21,2,20
boost-locale,boost-locale,,1,0,1,1,4,2,9,1
rjags,rjags,,4,10,12,14,22,26,0,150
client-side-validation,client-side-validation,,5,1,3,6,19,9,12,1
cfpreferences,cfpreferences,,2,0,1,2,1,3,13,1
aptana,aptana,,0,5,4,5,14,9,0,400
aptana3,aptana3,,0,6,2,6,14,8,0,500
file-in-use,file-in-use,,1,0,2,1,3,3,8,1
josephus,josephus,,1,1,1,2,3,3,0,1
clplacemark,clplacemark,,3,0,0,3,4,3,13,1
apple-watch-glances,apple-watch-glances,,0,0,0,0,1,0,13,1
iphone-vibrate,iphone-vibrate,,0,0,1,0,2,1,13,1
soffice,soffice,,2,0,3,2,4,5,5,1
sql-navigator,sql-navigator,,0,0,2,0,2,2,4,1
windows-server-2003,windows-server-2003,,1,3,12,4,11,16,8,200
psftp,psftp,,2,3,3,5,8,8,9,50
mechanize-python,mechanize-python,,5,6,3,11,7,14,0,20
servlet-dispatching,servlet-dispatching,,0,0,1,0,3,1,3,1
ramdisk,ramdisk,,0,3,6,3,9,9,9,200
cloud-automation-manager,cloud-automation-manager,,0,0,4,0,8,4,6,1
private-functions,private-functions,,1,0,0,1,3,1,0,1
baqend,baqend,,0,0,1,0,5,1,1,1
powerbi-custom-visuals,powerbi-custom-visuals,,17,20,2,37,3,39,5,17.647059
template-instantiation,template-instantiation,,3,2,8,5,5,13,9,1
memento,memento,,0,2,2,2,6,4,3,100
mkdirs,mkdirs,,3,2,3,5,5,8,3,1
rufus-scheduler,rufus-scheduler,,1,1,1,2,12,3,12,1
data-export,data-export,,2,2,9,4,6,13,8,1
distributed-filesystem,distributed-filesystem,,2,1,4,3,7,7,2,1
gfs,gfs,,0,0,2,0,2,2,0,1
jboss-weld,jboss-weld,,2,5,5,7,22,12,3,150
mpu6050,mpu6050,,10,5,10,15,19,25,9,1
battery-saver,battery-saver,,6,2,7,8,9,15,3,1
aws-console,aws-console,,6,4,9,10,17,19,6,1
prettyplotlib,prettyplotlib,,0,0,0,0,2,0,0,1
diophantine,diophantine,,1,1,2,2,2,4,0,1
filepicker,filepicker,,12,4,14,16,24,30,3,1
schema.yml,schema.yml,,0,1,3,1,1,4,6,1
chai-enzyme,chai-enzyme,,1,0,4,1,14,5,1,1
qdoc,qdoc,,2,1,4,3,1,7,9,1
nopcommerce-3.80,nopcommerce-3.80,,1,2,6,3,3,9,8,100
nopcommerce-themes,nopcommerce-themes,,0,0,0,0,2,0,8,1
requestcontext,requestcontext,,1,5,0,6,2,6,3,400
round-robin,round-robin,,17,3,20,20,24,40,9,1
autoit-c#-wrapper,autoit-c#-wrapper,,0,2,3,2,3,5,3,100
google-place-report,google-place-report,,1,0,0,1,1,1,1,1
jasmine-maven-plugin,jasmine-maven-plugin,,0,0,0,0,2,0,3,1
dart-async,dart-async,,8,6,13,14,11,27,13,1
uikeyboardtype,uikeyboardtype,,0,0,3,0,3,3,13,1
revenue,revenue,,3,3,3,6,3,9,5,1
jinjava,jinjava,,1,1,1,2,1,3,3,1
sql2o,sql2o,,3,1,2,4,4,6,3,1
java-aot,java-aot,,0,0,1,0,3,1,3,1
exchange-server-2013,exchange-server-2013,,0,1,4,1,15,5,8,1
cloudrail,cloudrail,,0,0,1,0,14,1,8,1
mockwebserver,mockwebserver,,14,9,12,23,16,35,3,1
aws-resource-group,aws-resource-group,,0,1,1,1,1,2,6,1
hook.io,hook.io,,0,0,0,0,1,0,6,1
picketlink,picketlink,,0,3,4,3,8,7,3,200
qmenu,qmenu,,14,10,18,24,11,42,0,1
androidasync-koush,androidasync-koush,,0,1,1,1,4,2,3,1
jansson,jansson,,1,1,3,2,8,5,9,1
loadjava,loadjava,,0,0,1,0,4,1,4,1
phonetics,phonetics,,2,1,6,3,9,9,0,1
word-size,word-size,,0,0,1,0,1,1,9,1
husky,husky,,11,12,13,23,6,36,6,9.090909
viewpage,viewpage,,1,0,4,1,4,5,3,1
l2cap,l2cap,,1,3,7,4,9,11,13,200
r-whisker,r-whisker,,0,0,0,0,2,0,0,1
queryover,queryover,,4,6,6,10,22,16,8,50
laravel-horizon,laravel-horizon,,10,9,13,19,25,32,4,1
internalsvisibleto,internalsvisibleto,,0,1,1,1,5,2,8,1
servletcontextlistener,servletcontextlistener,,3,4,11,7,19,18,3,33.333333
videoquality,videoquality,,1,1,1,2,4,3,13,1
tabu-search,tabu-search,,1,1,1,2,4,3,0,1
dolphin-browser,dolphin-browser,,0,0,0,0,1,0,9,1
dstream,dstream,,1,4,6,5,23,11,2,300
2checkout,2checkout,,2,5,1,7,6,8,4,150
multi-configuration,multi-configuration,,0,1,4,1,6,5,6,1
exploit,exploit,,15,19,47,34,67,81,9,26.666667
die,die,,3,0,4,3,13,7,4,1
apns-sharp,apns-sharp,,0,0,0,0,1,0,8,1
manateeworks,manateeworks,,0,0,0,0,2,0,8,1
analytics.js,analytics.js,,1,1,6,2,10,8,5,1
computation-expression,computation-expression,,2,2,5,4,18,9,8,1
customproperty,customproperty,,0,0,2,0,3,2,8,1
dynamics-crm-portals,dynamics-crm-portals,,4,4,15,8,18,23,8,1
allegro,allegro,,2,4,12,6,19,18,9,100
userspace,userspace,,4,5,7,9,13,16,9,25
unsubscribe,unsubscribe,,5,3,13,8,24,21,1,1
litmus,litmus,,1,1,1,2,3,3,1,1
dalsoft.restclient,dalsoft.restclient,,0,0,0,0,2,0,8,1
uicollectionviewflowlayout,uicollectionviewflowlayout,,19,11,33,30,49,63,13,1
pivotitem,pivotitem,,1,0,4,1,7,5,5,1
jep,jep,,1,1,2,2,4,4,3,1
dataguard,dataguard,,3,2,1,5,2,6,4,1
jol,jol,,0,0,0,0,6,0,3,1
prolog-cut,prolog-cut,,1,1,3,2,10,5,0,1
oh-my-fish,oh-my-fish,,0,0,0,0,1,0,9,1
groovyclassloader,groovyclassloader,,0,2,2,2,3,4,3,100
omnisharp,omnisharp,,6,5,21,11,24,32,8,1
turn,turn,,14,10,34,24,37,58,1,1
hilbert-curve,hilbert-curve,,1,0,6,1,8,7,0,1
dvd,dvd,,3,3,6,6,8,12,13,1
vob,vob,,0,0,0,0,2,0,13,1
libgccjit,libgccjit,,0,0,0,0,1,0,9,1
infernojs,infernojs,,1,1,2,2,8,4,1,1
file-manipulation,file-manipulation,,5,5,10,10,17,20,0,1
oledbdestination,oledbdestination,,2,1,2,3,4,5,4,1
jqchart,jqchart,,0,0,0,0,1,0,1,1
masspay,masspay,,0,0,0,0,2,0,4,1
registerhotkey,registerhotkey,,0,2,3,2,6,5,8,100
varbinary,varbinary,,8,6,14,14,30,28,4,1
hssfworkbook,hssfworkbook,,5,6,8,11,8,19,3,20
event-processor-host,event-processor-host,,0,3,0,3,7,3,8,200
voltdb,voltdb,,8,3,11,11,18,22,4,1
string-search,string-search,,5,5,8,10,23,18,0,1
protobuf-dt,protobuf-dt,,0,0,0,0,2,0,3,1
ident,ident,,0,0,0,0,3,0,0,1
dynamic-import,dynamic-import,,19,16,43,35,34,78,1,1
react-loadable,react-loadable,,13,15,52,28,54,80,1,15.384615
red-black-tree,red-black-tree,,11,2,17,13,40,30,0,1
netmask,netmask,,4,0,3,4,6,7,9,1
multilingual-app-toolkit,multilingual-app-toolkit,,1,0,2,1,3,3,8,1
codesandbox,codesandbox,,11,9,21,20,14,41,1,1
shinybs,shinybs,,5,5,4,10,18,14,0,1
swc,swc,,0,1,0,1,1,1,13,1
alphavantage,alphavantage,,4,9,17,13,18,30,0,125
surface-pro,surface-pro,,1,1,5,2,6,7,8,1
google-indoor-maps,google-indoor-maps,,1,3,3,4,5,7,3,200
firebase-security-rules,firebase-security-rules,,216,175,334,391,336,725,13,1
vb5,vb5,,0,0,1,0,3,1,8,1
ossec,ossec,,1,1,5,2,8,7,6,1
build-definition,build-definition,,3,6,7,9,37,16,8,100
kurtosis,kurtosis,,2,2,4,4,3,8,0,1
aws-appstream,aws-appstream,,0,0,7,0,6,7,6,1
choicefield,choicefield,,6,4,7,10,19,17,0,1
lame,lame,,8,4,7,12,11,19,13,1
tabitem,tabitem,,6,6,6,12,16,18,8,1
catiledlayer,catiledlayer,,0,0,1,0,5,1,13,1
django-localflavor,django-localflavor,,0,0,0,0,4,0,0,1
ld-preload,ld-preload,,3,3,9,6,24,15,9,1
pls-00201,pls-00201,,1,1,0,2,2,2,4,1
smartclient,smartclient,,0,0,1,0,1,1,3,1
mediafire,mediafire,,1,0,0,1,2,1,8,1
switchpreference,switchpreference,,1,3,2,4,1,6,3,200
ms.extensions.logging,ms.extensions.logging,,0,0,0,0,1,0,8,1
print-spooler-api,print-spooler-api,,0,0,3,0,13,3,9,1
gcloud-cli,gcloud-cli,,4,0,2,4,7,6,6,1
edit-and-continue,edit-and-continue,,1,0,4,1,7,5,8,1
user-friendly,user-friendly,,0,1,0,1,7,1,4,1
extjs-grid,extjs-grid,,0,0,3,0,13,3,1,1
sql-returning,sql-returning,,2,3,8,5,12,13,4,50
onmouseclick,onmouseclick,,0,0,3,0,3,3,1,1
lumen-5.4,lumen-5.4,,9,2,6,11,21,17,4,1
office-automation,office-automation,,0,1,2,1,7,3,8,1
svn-checkout,svn-checkout,,2,3,4,5,11,9,6,50
sanctuary,sanctuary,,2,0,3,2,14,5,2,1
objectoutputstream,objectoutputstream,,15,3,17,18,29,35,3,1
cherokee,cherokee,,0,0,1,0,1,1,4,1
vim-syntastic,vim-syntastic,,1,1,1,2,4,3,9,1
api-manager,api-manager,,7,3,11,10,14,21,14,1
apiconnect,apiconnect,,7,7,28,14,31,42,6,1
gon,gon,,3,1,1,4,3,5,12,1
awr,awr,,1,1,5,2,3,7,4,1
node-expat,node-expat,,0,0,0,0,3,0,1,1
tomography-reconstruction,tomography-reconstruction,,2,2,0,4,5,4,0,1
optimizely,optimizely,,3,0,0,3,7,3,13,1
reflow,reflow,,5,1,5,6,11,11,1,1
wsadmin,wsadmin,,8,2,12,10,22,22,3,1
eclipse-pde,eclipse-pde,,6,2,17,8,16,25,3,1
git-grep,git-grep,,0,1,2,1,5,3,6,1
peek,peek,,1,2,4,3,12,7,3,100
datetime-comparison,datetime-comparison,,5,2,4,7,17,11,3,1
tabula,tabula,,17,14,17,31,30,48,0,1
sailpoint,sailpoint,,1,4,2,5,4,7,3,300
httpsurlconnection,httpsurlconnection,,5,7,20,12,30,32,3,40
eclipse-orion,eclipse-orion,,1,0,3,1,4,4,3,1
ekevent,ekevent,,3,1,12,4,18,16,13,1
unlock,unlock,,4,7,9,11,16,20,3,75
mtp,mtp,,3,6,15,9,9,24,3,100
fileobserver,fileobserver,,2,1,5,3,18,8,3,1
disparity-mapping,disparity-mapping,,7,4,13,11,25,24,0,1
access-levels,access-levels,,0,2,5,2,7,7,9,100
ttml,ttml,,0,0,3,0,3,3,13,1
solution-explorer,solution-explorer,,2,3,5,5,11,10,8,50
get-eventlog,get-eventlog,,1,0,4,1,5,5,8,1
css-content,css-content,,0,0,3,0,8,3,1,1
ept,ept,,1,0,1,1,2,2,6,1
exim4,exim4,,2,1,4,3,4,7,4,1
compodoc,compodoc,,4,6,2,10,7,12,1,50
wordpad,wordpad,,1,1,1,2,5,3,5,1
wadl,wadl,,2,3,9,5,17,14,3,50
pagecontext,pagecontext,,1,0,1,1,3,2,3,1
documents4j,documents4j,,0,1,2,1,6,3,3,1
pprint,pprint,,2,3,5,5,18,10,0,50
haskell-turtle,haskell-turtle,,0,2,0,2,14,2,2,100
ie11-developer-tools,ie11-developer-tools,,2,1,5,3,14,8,1,1
knox-gateway,knox-gateway,,1,1,1,2,14,3,2,1
sharepointdocumentlibrary,sharepointdocumentlibrary,,2,2,4,4,10,8,8,1
containskey,containskey,,1,1,3,2,5,5,3,1
kendo-draggable,kendo-draggable,,0,0,1,0,3,1,1,1
angular-chartist.js,angular-chartist.js,,1,2,3,3,5,6,1,100
xrange,xrange,,4,3,5,7,6,12,1,1
subsampling,subsampling,,1,3,5,4,7,9,0,200
mogrify,mogrify,,4,3,8,7,13,15,12,1
balanced-groups,balanced-groups,,0,0,1,0,3,1,0,1
state-diagram,state-diagram,,7,0,4,7,7,11,3,1
add-this-event,add-this-event,,0,0,0,0,2,0,1,1
near-cache,near-cache,,0,0,1,0,4,1,3,1
grunt-contrib-compass,grunt-contrib-compass,,0,0,1,0,3,1,1,1
dead-code,dead-code,,4,3,8,7,12,15,9,1
ppp,ppp,,1,1,5,2,19,7,9,1
syntactic-sugar,syntactic-sugar,,4,5,19,9,25,28,9,25
scrap-your-boilerplate,scrap-your-boilerplate,,0,1,0,1,4,1,2,1
apache-commons-codec,apache-commons-codec,,1,2,2,3,6,5,3,100
iequalitycomparer,iequalitycomparer,,2,5,8,7,18,15,8,150
lshell,lshell,,0,0,0,0,1,0,9,1
jsreport,jsreport,,10,8,29,18,28,47,8,1
sysctl,sysctl,,0,3,14,3,16,17,9,200
setsockopt,setsockopt,,3,2,4,5,11,9,9,1
twebbrowser,twebbrowser,,7,6,15,13,19,28,9,1
uci,uci,,2,5,4,7,6,11,0,150
berkeley-db,berkeley-db,,1,3,15,4,15,19,9,200
berkeley-db-je,berkeley-db-je,,2,0,5,2,3,7,3,1
struts-tags,struts-tags,,1,0,1,1,2,2,3,1
appdynamics,appdynamics,,11,2,13,13,20,26,3,1
kendo-panelbar,kendo-panelbar,,1,2,5,3,3,8,1,100
asp.net-web-api-odata,asp.net-web-api-odata,,2,2,4,4,5,8,8,1
spring-social-twitter,spring-social-twitter,,0,0,6,0,10,6,3,1
pytest-benchmark,pytest-benchmark,,0,2,0,2,4,2,0,100
devart,devart,,6,7,13,13,26,26,8,16.666667
member-initialization,member-initialization,,4,2,3,6,8,9,9,1
uipushbehavior,uipushbehavior,,1,0,1,1,1,2,13,1
iron-form,iron-form,,0,0,3,0,7,3,1,1
ruby-on-rails-plugins,ruby-on-rails-plugins,,0,1,2,1,1,3,12,1
artax,artax,,0,0,0,0,1,0,4,1
angular-cdk,angular-cdk,,43,53,103,96,69,199,1,23.255814
plugman,plugman,,2,1,2,3,7,5,1,1
guardian,guardian,,1,6,9,7,18,16,2,500
guardian-db,guardian-db,,0,0,0,0,3,0,2,1
elgg,elgg,,1,0,0,1,5,1,4,1
clipping,clipping,,12,6,15,18,43,33,1,1
semantic-release,semantic-release,,3,2,6,5,3,11,6,1
jquery-mobile-select,jquery-mobile-select,,0,0,0,0,1,0,1,1
angularjs-ui-utils,angularjs-ui-utils,,0,0,2,0,1,2,1,1
mendeley,mendeley,,5,4,10,9,13,19,0,1
number-sequence,number-sequence,,0,0,1,0,5,1,0,1
hapi-swagger,hapi-swagger,,1,0,2,1,9,3,1,1
azure-billing-api,azure-billing-api,,5,4,4,9,13,13,8,1
traminer,traminer,,4,4,14,8,11,22,0,1
crf,crf,,10,8,16,18,14,34,0,1
composite-types,composite-types,,1,3,3,4,6,7,4,200
ios-lifecycle,ios-lifecycle,,0,0,5,0,7,5,13,1
report-builder2.0,report-builder2.0,,0,0,3,0,7,3,4,1
makemaker,makemaker,,0,0,1,0,2,1,9,1
codahale-metrics,codahale-metrics,,7,2,12,9,14,21,3,1
simpledialog,simpledialog,,1,2,6,3,5,9,0,100
password-checker,password-checker,,1,0,3,1,4,4,0,1
eregi,eregi,,2,0,1,2,3,3,4,1
logitech,logitech,,6,8,11,14,13,25,9,33.333333
log-files,log-files,,0,0,0,0,6,0,9,1
mongo-dart,mongo-dart,,1,0,2,1,1,3,13,1
fetching-strategy,fetching-strategy,,0,0,0,0,2,0,4,1
atom-runner,atom-runner,,0,0,1,0,1,1,0,1
toad-data-point,toad-data-point,,1,5,0,6,2,6,4,400
square-bracket,square-bracket,,4,1,7,5,23,12,0,1
statet,statet,,1,1,3,2,12,5,0,1
quora,quora,,5,0,8,5,10,13,0,1
sched-deadline,sched-deadline,,0,0,2,0,3,2,9,1
neato,neato,,3,2,1,5,6,6,0,1
mbr,mbr,,5,2,10,7,9,17,9,1
pymatgen,pymatgen,,0,0,2,0,1,2,0,1
scribble,scribble,,0,1,1,1,1,2,0,1
database-view,database-view,,2,2,7,4,8,11,4,1
file-move,file-move,,7,1,3,8,9,11,0,1
plpython,plpython,,6,4,10,10,16,20,4,1
jongo,jongo,,0,1,4,1,7,5,1,1
document-classification,document-classification,,0,3,5,3,14,8,0,200
mayavi,mayavi,,17,27,36,44,60,80,0,58.823529
boost-multi-array,boost-multi-array,,0,1,1,1,3,2,9,1
colander,colander,,0,1,1,1,6,2,0,1
kirby,kirby,,3,0,6,3,2,9,1,1
confidentiality,confidentiality,,2,0,4,2,1,6,6,1
mptt,mptt,,2,0,5,2,6,7,0,1
nessus,nessus,,5,5,8,10,5,18,9,1
c2664,c2664,,0,2,0,2,6,2,9,100
mapfragment,mapfragment,,3,0,3,3,8,6,3,1
postfix-operator,postfix-operator,,0,6,7,6,9,13,9,500
infix-operator,infix-operator,,1,4,4,5,10,9,9,300
equivalence-classes,equivalence-classes,,1,1,0,2,3,2,0,1
kotlin-js,kotlin-js,,10,8,27,18,8,45,3,1
core-ui,core-ui,,7,7,24,14,16,38,1,1
jenkins-2,jenkins-2,,0,0,4,0,22,4,6,1
eflags,eflags,,0,3,1,3,7,4,9,200
cap-theorem,cap-theorem,,4,4,1,8,14,9,3,1
resiliency,resiliency,,0,3,1,3,6,4,3,200
xampp-vm,xampp-vm,,2,0,5,2,9,7,4,1
setimagebitmap,setimagebitmap,,1,0,0,1,2,1,3,1
ora-00936,ora-00936,,1,0,1,1,4,2,4,1
nsusernotification,nsusernotification,,0,1,0,1,5,1,13,1
unique-lock,unique-lock,,1,1,1,2,9,3,9,1
negative-integer,negative-integer,,2,0,2,2,3,4,0,1
machform,machform,,0,0,2,0,2,2,4,1
angular-grid,angular-grid,,1,1,0,2,5,2,1,1
multipass,multipass,,0,0,2,0,2,2,9,1
safe-browsing,safe-browsing,,1,2,2,3,8,5,5,100
feed-forward,feed-forward,,5,6,5,11,15,16,0,20
classview,classview,,1,2,0,3,5,3,0,100
vocabulary,vocabulary,,2,3,6,5,18,11,0,50
data-cube,data-cube,,4,1,1,5,10,6,0,1
bucardo,bucardo,,2,0,2,2,3,4,4,1
jquery-ui-multiselect,jquery-ui-multiselect,,4,2,7,6,7,13,1,1
ps4,ps4,,0,5,3,5,7,8,8,400
akka-supervision,akka-supervision,,1,1,4,2,5,6,2,1
akka-kafka,akka-kafka,,1,1,0,2,8,2,2,1
turkish,turkish,,0,0,6,0,10,6,0,1
dymola,dymola,,21,14,24,35,49,59,0,1
browser-addons,browser-addons,,2,0,3,2,8,5,1,1
axios-mock-adapter,axios-mock-adapter,,9,4,9,13,14,22,1,1
dxgrid,dxgrid,,1,0,1,1,1,2,1,1
binary-serialization,binary-serialization,,1,2,6,3,12,9,8,100
eloqua,eloqua,,1,4,9,5,10,14,4,300
driver-signing,driver-signing,,0,0,1,0,6,1,9,1
dynamic-splash-screen,dynamic-splash-screen,,1,0,0,1,3,1,1,1
xmla,xmla,,12,6,7,18,9,25,4,1
amazon-appstore,amazon-appstore,,2,2,8,4,3,12,3,1
ryujit,ryujit,,0,0,0,0,2,0,8,1
system.numerics,system.numerics,,3,2,2,5,7,7,8,1
google-cloud-shell,google-cloud-shell,,13,20,27,33,40,60,6,53.846154
hotdeploy,hotdeploy,,2,3,0,5,6,5,3,50
xml-configuration,xml-configuration,,3,4,5,7,16,12,3,33.333333
ibinspectable,ibinspectable,,8,0,10,8,20,18,13,1
application-icon,application-icon,,0,0,2,0,3,2,8,1
data-gateway,data-gateway,,3,2,9,5,8,14,8,1
excel-external-data,excel-external-data,,0,1,1,1,5,2,5,1
jetpack,jetpack,,14,17,16,31,21,47,4,21.428571
dbms-job,dbms-job,,0,0,1,0,10,1,4,1
struts2-rest-plugin,struts2-rest-plugin,,0,0,1,0,3,1,3,1
truncated,truncated,,5,6,9,11,16,20,0,20
sideloading,sideloading,,2,5,8,7,10,15,8,150
cheetah,cheetah,,1,0,0,1,7,1,0,1
cobbler,cobbler,,0,0,1,0,2,1,6,1
graphaware,graphaware,,5,7,3,12,16,15,2,40
project-setup,project-setup,,1,1,0,2,1,2,3,1
cmtime,cmtime,,0,1,8,1,10,9,13,1
transformable,transformable,,0,0,0,0,9,0,13,1
edid,edid,,0,0,1,0,4,1,0,1
jpa-2.2,jpa-2.2,,2,19,5,21,15,26,3,850
fongo,fongo,,0,1,6,1,4,7,3,1
http-chunked,http-chunked,,1,1,2,2,4,4,4,1
mergeddictionaries,mergeddictionaries,,0,0,1,0,1,1,8,1
amp-ad,amp-ad,,2,2,4,4,7,8,1,1
sulu,sulu,,2,2,2,4,10,6,4,1
magnetometer,magnetometer,,6,6,11,12,17,23,3,1
session-replication,session-replication,,2,1,3,3,5,6,3,1
guice-servlet,guice-servlet,,0,0,1,0,6,1,3,1
scriptlet,scriptlet,,6,3,7,9,18,16,3,1
htmlpurifier,htmlpurifier,,8,5,12,13,13,25,4,1
bufferedstrategy,bufferedstrategy,,0,1,0,1,1,1,3,1
invalidoperationexception,invalidoperationexception,,5,1,12,6,22,18,8,1
legacy-sql,legacy-sql,,6,6,11,12,33,23,4,1
async-components,async-components,,3,0,1,3,2,4,1,1
python-huey,python-huey,,4,2,1,6,10,7,0,1
htmleditorextender,htmleditorextender,,1,1,0,2,3,2,8,1
notserializableexception,notserializableexception,,4,3,3,7,9,10,3,1
identity-management,identity-management,,4,2,7,6,13,13,4,1
hermes-jms,hermes-jms,,2,3,3,5,4,8,3,50
django-model-field,django-model-field,,3,3,10,6,8,16,0,1
angular-router-loader,angular-router-loader,,0,0,0,0,7,0,1,1
onrestoreinstancestate,onrestoreinstancestate,,1,1,4,2,15,6,3,1
templating-engine,templating-engine,,2,1,6,3,7,9,1,1
magicsuggest,magicsuggest,,1,1,3,2,4,5,1,1
xamarin-workbooks,xamarin-workbooks,,0,0,0,0,1,0,8,1
mesa-abm,mesa-abm,,4,0,4,4,2,8,0,1
validationrules,validationrules,,4,2,7,6,16,13,8,1
dos2unix,dos2unix,,1,2,3,3,8,6,9,100
ojb,ojb,,0,0,1,0,2,1,3,1
bigsql,bigsql,,2,2,1,4,6,5,4,1
csg,csg,,3,1,5,4,5,9,0,1
nscalendar,nscalendar,,4,2,8,6,21,14,13,1
data-tier-applications,data-tier-applications,,1,1,1,2,2,3,4,1
android-webservice,android-webservice,,2,3,8,5,22,13,3,50
qproperty,qproperty,,0,0,2,0,8,2,9,1
message-bundle,message-bundle,,0,0,0,0,1,0,3,1
cortex-a8,cortex-a8,,0,1,5,1,1,6,9,1
dotdotdot,dotdotdot,,0,1,0,1,2,1,1,1
pyjamas,pyjamas,,0,0,0,0,1,0,0,1
powermta,powermta,,0,0,4,0,1,4,4,1
dyndns,dyndns,,1,2,5,3,9,8,4,100
dynamic-websites,dynamic-websites,,0,1,1,1,7,2,4,1
arcmap,arcmap,,12,4,22,16,23,38,0,1
maven-enforcer-plugin,maven-enforcer-plugin,,4,3,5,7,16,12,3,1
dateadd,dateadd,,17,10,22,27,38,49,4,1
verisign,verisign,,0,0,0,0,3,0,8,1
timestamping,timestamping,,1,3,3,4,2,7,6,200
jwi,jwi,,0,1,1,1,4,2,0,1
jmenubar,jmenubar,,2,1,2,3,11,5,3,1
astah,astah,,0,2,1,2,1,3,3,100
dynamics-nav-2013,dynamics-nav-2013,,0,0,0,0,3,0,8,1
bugsnag,bugsnag,,6,5,9,11,15,20,1,1
inet,inet,,42,23,30,65,43,95,9,1
paginate,paginate,,12,7,12,19,27,31,4,1
ncalc,ncalc,,0,0,1,0,3,1,8,1
wpm,wpm,,0,0,0,0,1,0,0,1
headroom.js,headroom.js,,0,1,2,1,1,3,1,1
fenics,fenics,,4,2,10,6,10,16,0,1
node-odbc,node-odbc,,0,1,0,1,4,1,4,1
gst-launch,gst-launch,,2,0,4,2,11,6,13,1
android-build-flavors,android-build-flavors,,11,5,14,16,14,30,3,1
getpixel,getpixel,,0,2,6,2,9,8,8,100
db2-zos,db2-zos,,9,7,14,16,20,30,4,1
minima,minima,,0,1,4,1,7,5,0,1
webargs,webargs,,1,1,5,2,6,7,0,1
applicationcontroller,applicationcontroller,,0,0,3,0,5,3,12,1
impressionist,impressionist,,0,0,3,0,6,3,12,1
livecycle-designer,livecycle-designer,,1,2,8,3,8,11,8,100
google-appengine-node,google-appengine-node,,5,2,9,7,10,16,6,1
int32,int32,,5,3,3,8,11,11,0,1
covariant,covariant,,1,0,1,1,6,2,9,1
lua-5.1,lua-5.1,,2,4,7,6,5,13,9,100
sybase-asa,sybase-asa,,2,1,5,3,8,8,4,1
sybase-rs,sybase-rs,,0,0,0,0,2,0,4,1
oracle-adf-mobile,oracle-adf-mobile,,0,0,0,0,1,0,3,1
beeline,beeline,,9,16,37,25,58,62,2,77.777778
jasny-bootstrap,jasny-bootstrap,,1,0,2,1,1,3,1,1
media-type,media-type,,5,4,15,9,11,24,3,1
incron,incron,,3,0,3,3,4,6,9,1
system-integration,system-integration,,1,1,0,2,1,2,3,1
vue-devtools,vue-devtools,,5,3,5,8,13,13,1,1
non-nullable,non-nullable,,6,6,9,12,19,21,3,1
turn.js,turn.js,,3,3,3,6,1,9,1,1
fixed-data-table,fixed-data-table,,0,0,1,0,8,1,1,1
azure-managed-disk,azure-managed-disk,,3,2,7,5,11,12,8,1
myeclipse,myeclipse,,2,2,9,4,13,13,3,1
dynamic-expresso,dynamic-expresso,,0,0,1,0,3,1,8,1
shebang,shebang,,12,10,24,22,35,46,9,1
angular2-build,angular2-build,,0,1,0,1,3,1,1,1
pci-dss,pci-dss,,2,3,3,5,9,8,4,50
datarepeater,datarepeater,,0,1,2,1,2,3,8,1
function-handle,function-handle,,1,3,5,4,8,9,0,200
atan2,atan2,,3,3,5,6,6,11,0,1
native-code,native-code,,2,2,4,4,9,8,3,1
qobject,qobject,,9,6,15,15,21,30,9,1
ironjacamar,ironjacamar,,0,1,3,1,1,4,3,1
invalid-pointer,invalid-pointer,,0,2,1,2,3,3,9,100
pandas-to-sql,pandas-to-sql,,5,2,22,7,20,29,0,1
mappoint,mappoint,,0,0,0,0,1,0,5,1
flipud,flipud,,0,0,0,0,2,0,0,1
fragment-lifecycle,fragment-lifecycle,,7,3,9,10,16,19,3,1
aws-lib,aws-lib,,0,1,0,1,1,1,6,1
signaling,signaling,,1,1,2,2,7,4,1,1
typewriter,typewriter,,3,3,5,6,12,11,1,1
delimited,delimited,,3,5,9,8,16,17,4,66.666667
amazon-dynamodb-dax,amazon-dynamodb-dax,,6,4,10,10,19,20,6,1
scala-2.12,scala-2.12,,4,2,8,6,15,14,2,1
jsr,jsr,,3,3,8,6,10,14,3,1
jdk1.7,jdk1.7,,0,3,6,3,10,9,3,200
xsp4,xsp4,,0,0,1,0,3,1,8,1
octokit,octokit,,6,2,11,8,14,19,6,1
plumatic-schema,plumatic-schema,,1,0,6,1,4,7,1,1
azure-artifacts,azure-artifacts,,19,19,33,38,44,71,8,1
currency-exchange-rates,currency-exchange-rates,,1,0,3,1,11,4,0,1
exi,exi,,0,0,1,0,2,1,3,1
claims,claims,,16,15,16,31,49,47,8,1
site-packages,site-packages,,2,11,8,13,17,21,0,450
objloader,objloader,,2,3,6,5,22,11,1,50
cfmail,cfmail,,2,2,2,4,3,6,4,1
optionsettype,optionsettype,,0,0,2,0,4,2,8,1
interactivepopgesture,interactivepopgesture,,1,1,1,2,4,3,13,1
rjsonio,rjsonio,,0,2,4,2,8,6,0,100
javax.ws.rs,javax.ws.rs,,0,1,8,1,10,9,3,1
nsusernotificationcenter,nsusernotificationcenter,,0,0,1,0,4,1,13,1
tfs2012,tfs2012,,6,7,10,13,21,23,8,16.666667
graphql-ruby,graphql-ruby,,6,4,16,10,30,26,12,1
sesame,sesame,,0,1,0,1,8,1,2,1
factor-analysis,factor-analysis,,4,6,22,10,15,32,0,50
iis-logs,iis-logs,,3,2,4,5,7,9,8,1
message-bus,message-bus,,1,1,5,2,7,7,3,1
randoop,randoop,,3,0,3,3,5,6,3,1
terminator,terminator,,4,5,5,9,10,14,9,25
cookie-httponly,cookie-httponly,,3,4,11,7,9,18,4,33.333333
galaxy-tab,galaxy-tab,,0,0,0,0,1,0,3,1
django-admin-tools,django-admin-tools,,2,4,5,6,8,11,0,100
django-jet,django-jet,,1,1,2,2,5,4,0,1
boost-tokenizer,boost-tokenizer,,1,0,0,1,6,1,9,1
alpha-transparency,alpha-transparency,,7,7,18,14,39,32,1,1
xinetd,xinetd,,1,0,2,1,4,3,9,1
inetd,inetd,,0,0,1,0,2,1,9,1
vis.js-timeline,vis.js-timeline,,7,6,18,13,31,31,1,1
continuous-testing,continuous-testing,,1,1,5,2,5,7,3,1
dagre-d3,dagre-d3,,5,1,3,6,14,9,1,1
jbehave-maven-plugin,jbehave-maven-plugin,,0,0,1,0,1,1,3,1
uipickerviewcontroller,uipickerviewcontroller,,4,1,3,5,6,8,13,1
arpack,arpack,,2,1,2,3,3,5,0,1
netlib,netlib,,0,0,1,0,1,1,2,1
retention,retention,,9,7,12,16,15,28,4,1
labelled-generic,labelled-generic,,1,0,1,1,2,2,2,1
xp-cmdshell,xp-cmdshell,,4,7,9,11,18,20,4,75
mercurial-extension,mercurial-extension,,1,0,5,1,8,6,6,1
peek-pop,peek-pop,,2,1,2,3,4,5,13,1
simctl,simctl,,0,0,6,0,10,6,13,1
kudan,kudan,,0,1,0,1,4,1,3,1
arcgis-runtime,arcgis-runtime,,10,3,14,13,31,27,8,1
cilk-plus,cilk-plus,,1,0,4,1,2,5,9,1
light-inject,light-inject,,1,2,2,3,9,5,8,100
treetop,treetop,,0,2,0,2,6,2,12,100
kubernetes-mesos,kubernetes-mesos,,0,0,1,0,3,1,6,1
web-forms-for-marketers,web-forms-for-marketers,,1,1,1,2,4,3,8,1
goal-tracking,goal-tracking,,1,2,6,3,10,9,5,100
pagerduty,pagerduty,,2,2,7,4,10,11,6,1
testdoublejs,testdoublejs,,1,1,0,2,4,2,1,1
goodness-of-fit,goodness-of-fit,,2,0,10,2,12,12,0,1
libxml-ruby,libxml-ruby,,0,0,1,0,2,1,12,1
qdockwidget,qdockwidget,,8,2,10,10,19,20,9,1
web-site-project,web-site-project,,14,23,25,37,18,62,8,64.285714
aspnet-merge,aspnet-merge,,0,0,1,0,1,1,8,1
layouttransition,layouttransition,,0,0,0,0,1,0,3,1
rgba,rgba,,13,13,26,26,37,52,0,1
hdcp,hdcp,,1,0,0,1,3,1,6,1
dc.leaflet.js,dc.leaflet.js,,3,1,0,4,2,4,1,1
tensorflow-estimator,tensorflow-estimator,,104,74,185,178,277,363,0,1
modeladmin,modeladmin,,3,1,4,4,4,8,0,1
ms-access-reports,ms-access-reports,,10,9,10,19,16,29,5,1
mpi-io,mpi-io,,2,3,2,5,10,7,9,50
kue,kue,,2,1,6,3,14,9,1,1
selectlistitem,selectlistitem,,8,2,4,10,13,14,8,1
torquebox,torquebox,,0,0,0,0,1,0,1,1
d3-request,d3-request,,0,1,0,1,1,1,1,1
turing-complete,turing-complete,,0,2,5,2,8,7,0,100
awtrobot,awtrobot,,9,12,24,21,37,45,3,33.333333
winrt-xaml-toolkit,winrt-xaml-toolkit,,0,0,2,0,7,2,8,1
setpropertyactionlistener,setpropertyactionlistener,,2,0,0,2,2,2,3,1
iseries-navigator,iseries-navigator,,1,2,4,3,12,7,4,100
ups-api,ups-api,,0,0,2,0,2,2,3,1
conky,conky,,4,2,5,6,4,11,9,1
reference-wrapper,reference-wrapper,,0,1,5,1,11,6,9,1
statnet,statnet,,9,3,5,12,11,17,0,1
eurekalog,eurekalog,,0,0,1,0,2,1,9,1
myhdl,myhdl,,2,0,3,2,1,5,9,1
rapidjson,rapidjson,,12,13,14,25,35,39,9,8.333333
boyer-moore,boyer-moore,,3,3,7,6,3,13,0,1
keypaths,keypaths,,2,7,7,9,17,16,13,250
django-1.7,django-1.7,,0,1,2,1,6,3,0,1
stata-macros,stata-macros,,8,5,11,13,38,24,0,1
html-head,html-head,,3,1,3,4,10,7,1,1
scalatags,scalatags,,0,1,2,1,4,3,2,1
opentext,opentext,,2,1,7,3,12,10,8,1
javascript-engine,javascript-engine,,4,3,9,7,14,16,1,1
frameset,frameset,,1,4,3,5,12,8,1,300
react-native-linking,react-native-linking,,6,5,6,11,12,17,1,1
arrayaccess,arrayaccess,,2,0,0,2,5,2,4,1
spring-json,spring-json,,0,0,0,0,1,0,3,1
spring-data-envers,spring-data-envers,,1,4,3,5,8,8,3,300
over-the-air,over-the-air,,0,0,1,0,3,1,13,1
alpha-beta-pruning,alpha-beta-pruning,,7,5,12,12,31,24,0,1
perforce-client-spec,perforce-client-spec,,2,0,0,2,4,2,6,1
scala-streams,scala-streams,,0,0,2,0,11,2,2,1
scratchpad,scratchpad,,0,2,3,2,5,5,1,100
styleframe,styleframe,,0,7,4,7,7,11,0,600
android-input-filter,android-input-filter,,0,1,4,1,6,5,3,1
programmers-notepad,programmers-notepad,,2,0,2,2,8,4,0,1
timescaledb,timescaledb,,12,15,22,27,25,49,4,25
authhttp,authhttp,,1,0,0,1,6,1,1,1
raspistill,raspistill,,0,1,2,1,5,3,0,1
brython,brython,,0,3,4,3,8,7,0,200
azure-security,azure-security,,5,10,17,15,25,32,8,100
asyncsocket,asyncsocket,,6,6,29,12,24,41,9,1
liferay-service-builder,liferay-service-builder,,2,2,4,4,18,8,3,1
spark-launcher,spark-launcher,,3,2,2,5,6,7,2,1
io-completion-ports,io-completion-ports,,0,0,2,0,5,2,9,1
exceed,exceed,,1,0,1,1,6,2,1,1
stringio,stringio,,16,13,8,29,30,37,0,1
passlib,passlib,,2,2,4,4,9,8,0,1
twitter-bootstrap-4-beta,twitter-bootstrap-4-beta,,0,0,1,0,27,1,1,1
eclipse-luna,eclipse-luna,,3,1,8,4,11,12,3,1
arrayobject,arrayobject,,12,4,12,16,30,28,1,1
linguijs,linguijs,,1,0,2,1,1,3,1,1
gitea,gitea,,5,10,8,15,12,23,6,100
soundfont,soundfont,,1,3,3,4,5,7,0,200
flashplayer-10,flashplayer-10,,1,0,2,1,3,3,13,1
openpgp.js,openpgp.js,,2,2,9,4,5,13,6,1
clientip,clientip,,1,3,2,4,11,6,6,200
test-reporting,test-reporting,,3,3,3,6,11,9,3,1
zbar-sdk,zbar-sdk,,1,1,0,2,4,2,3,1
vuelidate,vuelidate,,16,9,28,25,22,53,1,1
x-forwarded-for,x-forwarded-for,,6,3,7,9,8,16,4,1
nintendo,nintendo,,1,0,3,1,3,4,3,1
android-job,android-job,,2,1,7,3,17,10,3,1
jsni,jsni,,1,4,4,5,11,9,3,300
conversion-tracking,conversion-tracking,,0,2,3,2,5,5,5,100
nestedscrollview,nestedscrollview,,11,5,12,16,28,28,3,1
minimist,minimist,,0,3,2,3,1,5,1,200
kaizala,kaizala,,5,2,4,7,10,11,8,1
kaizala-action,kaizala-action,,2,1,3,3,8,6,8,1
ownership-semantics,ownership-semantics,,2,1,1,3,11,4,9,1
gcsfuse,gcsfuse,,6,7,12,13,14,25,6,16.666667
synaptic.js,synaptic.js,,0,0,1,0,5,1,0,1
openfb,openfb,,0,0,0,0,1,0,13,1
ssd,ssd,,5,4,9,9,15,18,0,1
acs,acs,,2,1,4,3,16,7,8,1
inputmismatchexception,inputmismatchexception,,8,4,13,12,23,25,3,1
servlet-listeners,servlet-listeners,,1,3,5,4,7,9,3,200
nsmenuitem,nsmenuitem,,2,0,6,2,12,8,13,1
nsstatusitem,nsstatusitem,,0,3,4,3,9,7,13,200
nsstatusbar,nsstatusbar,,0,2,3,2,6,5,13,100
webkitaudiocontext,webkitaudiocontext,,3,2,4,5,4,9,1,1
embeddedwebserver,embeddedwebserver,,2,4,3,6,2,9,4,100
ildasm,ildasm,,0,1,2,1,8,3,8,1
getuikit,getuikit,,9,14,27,23,35,50,1,55.555556
activesupport-concern,activesupport-concern,,6,4,6,10,14,16,12,1
lrc,lrc,,0,0,2,0,1,2,9,1
chalk,chalk,,0,0,2,0,7,2,1,1
rowdeleting,rowdeleting,,7,3,5,10,11,15,0,1
cloudways,cloudways,,1,2,2,3,8,5,4,100
winghci,winghci,,1,0,3,1,2,4,2,1
pyexiv2,pyexiv2,,2,2,2,4,1,6,0,1
hpcc,hpcc,,0,0,3,0,3,3,0,1
mathematical-expressions,mathematical-expressions,,3,4,9,7,23,16,0,33.333333
multiple-choice,multiple-choice,,5,1,10,6,21,16,0,1
omr,omr,,2,3,1,5,5,6,0,50
eclipse-3.6,eclipse-3.6,,0,0,0,0,2,0,9,1
geturl,geturl,,3,4,6,7,4,13,0,33.333333
android-fullscreen,android-fullscreen,,7,7,12,14,22,26,3,1
easing-functions,easing-functions,,1,1,2,2,2,4,1,1
smarty2,smarty2,,2,0,2,2,11,4,4,1
cctv,cctv,,3,3,4,6,7,10,13,1
gcc5.2,gcc5.2,,0,0,0,0,1,0,9,1
php-mysqlidb,php-mysqlidb,,1,0,3,1,3,4,4,1
nexmo,nexmo,,7,9,19,16,47,35,4,28.571429
m4v,m4v,,1,1,1,2,2,3,13,1
802.11,802.11,,9,8,14,17,17,31,9,1
nanopi,nanopi,,2,4,3,6,7,9,9,100
search-path,search-path,,1,2,2,3,8,5,4,100
accent-insensitive,accent-insensitive,,1,1,3,2,6,5,0,1
jsonlines,jsonlines,,6,6,8,12,22,20,1,1
direct-buffer,direct-buffer,,0,0,0,0,4,0,3,1
android-paging,android-paging,,31,32,78,63,66,141,3,3.225806
icomparable,icomparable,,2,2,7,4,18,11,8,1
metadatatype,metadatatype,,0,0,1,0,3,1,8,1
incognito-mode,incognito-mode,,3,3,9,6,12,15,1,1
pyjwt,pyjwt,,1,0,10,1,6,11,0,1
wakeup,wakeup,,4,6,8,10,18,18,3,50
sleep-mode,sleep-mode,,7,9,12,16,16,28,3,28.571429
jquery-ajaxq,jquery-ajaxq,,2,5,7,7,17,14,1,150
noop,noop,,1,0,5,1,4,6,3,1
blinker,blinker,,0,0,1,0,2,1,0,1
memory-optimization,memory-optimization,,0,1,2,1,6,3,0,1
custom-widgets,custom-widgets,,2,3,13,5,4,18,13,50
ibm-content-navigator,ibm-content-navigator,,4,2,7,6,19,13,15,1
absinthe,absinthe,,7,4,9,11,19,20,2,1
juniper,juniper,,4,6,16,10,12,26,6,50
nsalert,nsalert,,2,1,4,3,9,7,13,1
color-conversion,color-conversion,,6,1,2,7,4,9,0,1
stochastic,stochastic,,10,7,21,17,23,38,0,1
hill-climbing,hill-climbing,,7,1,9,8,12,17,0,1
ie-compatibility-mode,ie-compatibility-mode,,2,0,0,2,1,2,1,1
boost-beast,boost-beast,,20,11,23,31,42,54,9,1
bigchaindb,bigchaindb,,5,3,8,8,19,16,6,1
decimal.js,decimal.js,,1,1,0,2,7,2,1,1
gprof,gprof,,3,3,8,6,20,14,9,1
wdf,wdf,,4,1,3,5,7,8,9,1
image-editor,image-editor,,0,3,4,3,4,7,1,200
pycups,pycups,,3,0,4,3,3,7,9,1
zalenium,zalenium,,7,13,8,20,10,28,3,85.714286
osascript,osascript,,5,4,16,9,21,25,13,1
wordpress-4.8,wordpress-4.8,,0,0,0,0,1,0,4,1
tufte,tufte,,4,2,4,6,7,10,0,1
jquery-mobile-navbar,jquery-mobile-navbar,,0,0,3,0,5,3,1,1
symfony-cache,symfony-cache,,1,1,1,2,7,3,4,1
slamdata,slamdata,,1,1,1,2,4,3,3,1
image-whitening,image-whitening,,1,0,0,1,1,1,0,1
emokit,emokit,,0,0,1,0,1,1,9,1
fluxible,fluxible,,0,0,0,0,2,0,1,1
takesscreenshot,takesscreenshot,,6,3,4,9,1,13,3,1
googleads-mobile-unity,googleads-mobile-unity,,0,0,3,0,12,3,3,1
phppresentation,phppresentation,,1,3,5,4,6,9,4,200
sigint,sigint,,8,14,12,22,34,34,9,75
mongoose-plugins,mongoose-plugins,,1,0,1,1,11,2,1,1
front-camera,front-camera,,5,1,5,6,6,11,3,1
urlclassloader,urlclassloader,,9,8,10,17,26,27,3,1
processmaker,processmaker,,1,3,4,4,8,8,4,200
omniauth-google-oauth2,omniauth-google-oauth2,,3,1,7,4,9,11,12,1
lines-of-code,lines-of-code,,1,0,2,1,2,3,6,1
qabstractitemview,qabstractitemview,,1,0,2,1,6,3,9,1
kmalloc,kmalloc,,3,1,2,4,5,6,9,1
skeleton-css-boilerplate,skeleton-css-boilerplate,,1,0,2,1,4,3,1,1
dokan,dokan,,8,5,10,13,9,23,4,1
video-conversion,video-conversion,,1,1,10,2,10,12,13,1
template-aliases,template-aliases,,1,1,5,2,2,7,9,1
grasshopper,grasshopper,,3,6,10,9,10,19,8,100
rhino3d,rhino3d,,4,1,7,5,6,12,8,1
opendata,opendata,,6,6,5,12,11,17,2,1
android-x86,android-x86,,7,3,14,10,9,24,3,1
profile-picture,profile-picture,,0,2,3,2,11,5,3,100
consolas,consolas,,0,0,3,0,2,3,0,1
php-7.2,php-7.2,,87,66,221,153,200,374,4,1
automationanywhere,automationanywhere,,22,19,32,41,50,73,5,1
query-expressions,query-expressions,,3,6,5,9,15,14,8,100
dtruss,dtruss,,0,0,1,0,5,1,13,1
loaded,loaded,,1,2,2,3,9,5,1,100
znodes,znodes,,1,0,1,1,2,2,2,1
resize-image,resize-image,,1,1,1,2,8,3,0,1
comint-mode,comint-mode,,0,1,2,1,2,3,9,1
predis,predis,,3,9,15,12,27,27,4,200
message-driven-bean,message-driven-bean,,7,4,9,11,16,20,3,1
nsindexpath,nsindexpath,,4,0,1,4,19,5,13,1
android-tabactivity,android-tabactivity,,0,2,2,2,5,4,3,100
libtool,libtool,,6,4,15,10,29,25,9,1
ol3-google-maps,ol3-google-maps,,0,0,1,0,2,1,1,1
processhandle,processhandle,,1,0,0,1,3,1,3,1
phinx,phinx,,2,7,5,9,15,14,4,250
spy++,spy++,,4,2,4,6,9,10,9,1
npmignore,npmignore,,0,1,2,1,6,3,1,1
google-material-icons,google-material-icons,,15,13,15,28,33,43,1,1
file.readalllines,file.readalllines,,1,0,2,1,14,3,8,1
gluon-desktop,gluon-desktop,,5,3,4,8,10,12,3,1
sssd,sssd,,2,2,10,4,11,14,9,1
linker-scripts,linker-scripts,,13,18,20,31,42,51,9,38.461538
epollet,epollet,,0,1,3,1,7,4,9,1
codeigniter-hmvc,codeigniter-hmvc,,0,0,0,0,3,0,4,1
persistence-unit,persistence-unit,,0,0,0,0,1,0,3,1
wide-column-store,wide-column-store,,1,4,4,5,3,9,2,300
brokeredmessage,brokeredmessage,,3,1,0,4,9,4,8,1
filelock,filelock,,3,2,8,5,10,13,3,1
bridging,bridging,,0,2,4,2,7,6,13,100
cactivedataprovider,cactivedataprovider,,0,1,1,1,3,2,4,1
starscream,starscream,,3,4,6,7,11,13,13,33.333333
listactivity,listactivity,,0,3,1,3,2,4,3,200
gupshup,gupshup,,5,3,3,8,9,11,8,1
http-status-code-307,http-status-code-307,,1,2,7,3,4,10,4,100
torsocks,torsocks,,2,2,1,4,3,5,0,1
mcafee,mcafee,,3,1,7,4,13,11,8,1
django-static,django-static,,1,2,8,3,3,11,0,100
build.gradle.kts,build.gradle.kts,,0,0,0,0,1,0,3,1
modi,modi,,1,0,2,1,4,3,8,1
message-system,message-system,,0,0,0,0,1,0,4,1
cvs2git,cvs2git,,0,2,1,2,4,3,6,100
alice,alice,,0,0,0,0,3,0,0,1
pose-estimation,pose-estimation,,23,9,19,32,24,51,0,1
iqr,iqr,,1,2,1,3,11,4,0,100
bash-completion,bash-completion,,9,0,11,9,21,20,9,1
rowfilter,rowfilter,,3,1,11,4,18,15,8,1
gofmt,gofmt,,5,2,5,7,2,12,6,1
bootstrap-loader,bootstrap-loader,,0,0,1,0,1,1,1,1
hypergraph,hypergraph,,1,0,3,1,1,4,0,1
korean-nlp,korean-nlp,,0,1,0,1,3,1,0,1
researchkit,researchkit,,2,4,9,6,7,15,13,100
gridcontrol,gridcontrol,,3,2,12,5,18,17,8,1
beta-testing,beta-testing,,3,4,6,7,16,13,13,33.333333
transaction-isolation,transaction-isolation,,10,1,9,11,20,20,3,1
rowlocking,rowlocking,,1,4,8,5,8,13,4,300
escrow,escrow,,0,0,0,0,1,0,4,1
kamon,kamon,,2,1,11,3,8,14,2,1
akka-monitoring,akka-monitoring,,1,1,5,2,3,7,2,1
nghttp2,nghttp2,,2,1,10,3,11,13,3,1
urwid,urwid,,3,6,7,9,28,16,0,100
aws-ebs,aws-ebs,,11,8,20,19,40,39,6,1
qi,qi,,0,1,3,1,2,4,9,1
mysql-insert-id,mysql-insert-id,,1,1,3,2,5,5,4,1
cypher-3.1,cypher-3.1,,1,0,9,1,19,10,2,1
rfh2,rfh2,,1,0,0,1,1,1,3,1
json2csharp,json2csharp,,1,0,0,1,1,1,8,1
returnurl,returnurl,,1,2,2,3,8,5,8,100
liclipse,liclipse,,1,0,3,1,9,4,0,1
onrender,onrender,,1,0,0,1,3,1,0,1
vibration,vibration,,6,9,10,15,30,25,3,50
system-clock,system-clock,,4,2,3,6,7,9,9,1
network-printers,network-printers,,10,11,6,21,11,27,8,10
elixir-poison,elixir-poison,,0,0,6,0,13,6,2,1
table-functions,table-functions,,4,0,2,4,9,6,4,1
hana-studio,hana-studio,,1,1,8,2,11,10,5,1
kmdf,kmdf,,9,4,4,13,21,17,9,1
wdm,wdm,,3,1,6,4,12,10,9,1
glcanvas,glcanvas,,2,0,1,2,4,3,3,1
sciter,sciter,,1,0,1,1,2,2,6,1
database-table,database-table,,3,2,9,5,17,14,4,1
ropes,ropes,,0,0,0,0,1,0,0,1
terminate,terminate,,17,9,30,26,60,56,0,1
clang-tidy,clang-tidy,,8,7,23,15,40,38,9,1
web-inf,web-inf,,0,1,9,1,7,10,3,1
localreport,localreport,,1,0,1,1,6,2,8,1
org-table,org-table,,0,0,0,0,3,0,9,1
sails.io.js,sails.io.js,,0,2,2,2,8,4,1,100
appsflyer-android-sdk,appsflyer-android-sdk,,1,3,3,4,8,7,3,200
any23,any23,,0,0,1,0,1,1,3,1
powerset,powerset,,5,1,13,6,19,19,0,1
log-rotation,log-rotation,,4,8,6,12,22,18,3,100
formio,formio,,16,8,14,24,3,38,1,1
nios,nios,,5,2,7,7,7,14,9,1
newscoop,newscoop,,0,0,1,0,2,1,4,1
stenciljs,stenciljs,,32,51,49,83,52,132,1,59.375
flask-mongoengine,flask-mongoengine,,10,9,15,19,22,34,0,1
spring-security-kerberos,spring-security-kerberos,,5,5,6,10,11,16,3,1
generic-derivation,generic-derivation,,0,1,3,1,3,4,2,1
disable-link,disable-link,,0,0,0,0,2,0,4,1
mongodb-replica-set,mongodb-replica-set,,12,7,14,19,27,33,1,1
flutterwave,flutterwave,,3,2,16,5,3,21,4,1
bluetooth-printing,bluetooth-printing,,0,4,1,4,8,5,3,300
phpgrid,phpgrid,,2,0,2,2,6,4,4,1
500px,500px,,0,0,0,0,1,0,4,1
graphical-layout-editor,graphical-layout-editor,,1,1,0,2,4,2,3,1
simplification,simplification,,7,3,7,10,10,17,0,1
structuremap3,structuremap3,,0,0,0,0,2,0,8,1
win32ole,win32ole,,3,3,7,6,8,13,9,1
talend-mdm,talend-mdm,,2,1,5,3,19,8,4,1
asp.net-core-viewcomponent,asp.net-core-viewcomponent,,7,8,27,15,26,42,8,14.285714
jacob,jacob,,1,3,10,4,12,14,3,200
amazon-read-replica,amazon-read-replica,,2,2,4,4,10,8,6,1
msxml2,msxml2,,5,2,7,7,7,14,5,1
cisco-ios,cisco-ios,,4,12,7,16,16,23,6,200
html-pdf,html-pdf,,8,8,19,16,25,35,1,1
using-statement,using-statement,,9,4,5,13,12,18,8,1
patternlab.io,patternlab.io,,0,1,4,1,5,5,1,1
micro-orm,micro-orm,,0,1,1,1,6,2,8,1
gocql,gocql,,3,1,9,4,9,13,2,1
tiki-wiki,tiki-wiki,,0,0,0,0,3,0,4,1
qmetaobject,qmetaobject,,0,2,3,2,7,5,9,100
pgpool,pgpool,,8,5,11,13,17,24,4,1
android-bottomnav,android-bottomnav,,10,5,17,15,25,32,3,1
responders,responders,,0,0,2,0,3,2,12,1
rails-roar,rails-roar,,0,0,0,0,1,0,12,1
nupic,nupic,,0,1,0,1,2,1,0,1
multiple-languages,multiple-languages,,0,0,2,0,17,2,4,1
smalot-datetimepicker,smalot-datetimepicker,,0,0,0,0,4,0,1,1
readdir,readdir,,3,4,7,7,18,14,1,33.333333
secretary,secretary,,1,0,0,1,2,1,2,1
flooding,flooding,,0,2,1,2,6,3,4,100
geos,geos,,8,6,8,14,16,22,0,1
edx,edx,,5,6,20,11,31,31,0,20
django-oauth,django-oauth,,12,6,11,18,26,29,0,1
error-messages-for,error-messages-for,,1,0,0,1,3,1,1,1
boost-program-options,boost-program-options,,3,1,7,4,20,11,9,1
aio,aio,,4,1,8,5,13,13,9,1
mediator,mediator,,12,10,12,22,26,34,14,1
gprs,gprs,,8,4,13,12,19,25,9,1
silvershop,silvershop,,2,2,0,4,1,4,4,1
html-injections,html-injections,,0,3,0,3,3,3,1,200
spring-boot-devtools,spring-boot-devtools,,8,1,15,9,24,24,3,1
oscommerce,oscommerce,,3,0,5,3,8,8,4,1
prezto,prezto,,0,1,2,1,3,3,9,1
scala-compiler,scala-compiler,,2,3,5,5,15,10,2,50
ceres-solver,ceres-solver,,5,7,7,12,20,19,9,40
gulp-uncss,gulp-uncss,,0,0,2,0,3,2,1,1
xaf,xaf,,7,3,25,10,14,35,8,1
appcelerator-hyperloop,appcelerator-hyperloop,,1,0,5,1,8,6,13,1
carp,carp,,0,0,0,0,1,0,9,1
debuggerdisplay,debuggerdisplay,,1,0,3,1,2,4,8,1
cargo,cargo,,2,5,7,7,2,14,3,150
android-emulator-plugin,android-emulator-plugin,,0,0,2,0,6,2,3,1
mitk,mitk,,2,0,1,2,4,3,9,1
formvalidation-plugin,formvalidation-plugin,,1,1,4,2,8,6,1,1
transcrypt,transcrypt,,0,1,5,1,29,6,0,1
urbancode,urbancode,,3,4,4,7,12,11,6,33.333333
udeploy,udeploy,,1,3,11,4,14,15,6,200
nestjs,nestjs,,231,255,277,486,158,763,1,10.38961
apns-php,apns-php,,2,2,4,4,8,8,13,1
uint,uint,,3,2,5,5,14,10,13,1
openedx,openedx,,16,11,30,27,22,57,0,1
ber,ber,,1,0,4,1,7,5,6,1
m3u,m3u,,3,6,10,9,15,19,13,100
llvm5,llvm5,,0,0,0,0,1,0,9,1
android-runonuithread,android-runonuithread,,7,4,12,11,27,23,3,1
csslint,csslint,,3,1,4,4,7,8,1,1
ruby-2.1,ruby-2.1,,0,0,1,0,2,1,12,1
ruby-1.8,ruby-1.8,,0,0,0,0,3,0,12,1
vcr,vcr,,3,2,7,5,9,12,12,1
litespeed,litespeed,,5,10,17,15,18,32,4,100
codemirror-modes,codemirror-modes,,0,2,4,2,5,6,1,100
maven-webstart-plugin,maven-webstart-plugin,,0,1,3,1,5,4,3,1
menu-items,menu-items,,3,2,2,5,27,7,3,1
elastalert,elastalert,,11,4,17,15,18,32,6,1
aeson,aeson,,12,6,28,18,44,46,2,1
entity-sql,entity-sql,,0,0,0,0,2,0,4,1
pic24,pic24,,1,1,4,2,12,6,9,1
jquery-mobile-dialog,jquery-mobile-dialog,,0,0,0,0,1,0,1,1
passport-azure-ad,passport-azure-ad,,3,1,13,4,7,17,1,1
postgresql-10,postgresql-10,,49,25,147,74,179,221,4,1
custom-error-pages,custom-error-pages,,9,9,16,18,37,34,8,1
pscl,pscl,,2,2,1,4,4,5,0,1
angular7,angular7,,1587,1102,1766,2689,6,4455,1,1
surface-controller,surface-controller,,0,0,0,0,3,0,8,1
ui-virtualization,ui-virtualization,,2,1,1,3,5,4,8,1
wallpaper,wallpaper,,9,7,24,16,29,40,3,1
multiple-indirection,multiple-indirection,,0,0,0,0,1,0,9,1
weak-ptr,weak-ptr,,5,8,4,13,21,17,9,60
exporter,exporter,,4,8,7,12,9,19,6,100
apollo-ios,apollo-ios,,1,0,2,1,5,3,1,1
stamp,stamp,,2,1,2,3,4,5,0,1
apache-tomee,apache-tomee,,1,1,6,2,9,8,3,1
elastix-itk,elastix-itk,,0,0,1,0,5,1,0,1
addsubview,addsubview,,6,5,16,11,28,27,13,1
scada,scada,,4,1,6,5,20,11,5,1
scadalts,scadalts,,0,0,3,0,4,3,5,1
number-systems,number-systems,,2,0,2,2,11,4,0,1
qabstractbutton,qabstractbutton,,1,1,0,2,3,2,0,1
vector-space,vector-space,,1,2,0,3,3,3,0,100
dr.racket,dr.racket,,0,0,1,0,5,1,0,1
dynatrace,dynatrace,,7,3,15,10,14,25,3,1
mvs,mvs,,2,1,4,3,9,7,4,1
anycpu,anycpu,,0,2,2,2,5,4,8,100
ixmlserializable,ixmlserializable,,1,0,3,1,7,4,8,1
cbperipheralmanager,cbperipheralmanager,,3,1,2,4,11,6,13,1
solr-query-syntax,solr-query-syntax,,5,8,3,13,18,16,2,60
eventargs,eventargs,,1,1,4,2,12,6,8,1
idhttp,idhttp,,8,8,15,16,29,31,9,1
android-internet,android-internet,,1,2,7,3,9,10,3,100
accelerate-haskell,accelerate-haskell,,1,0,2,1,2,3,2,1
automerge,automerge,,1,0,2,1,1,3,6,1
dundas,dundas,,0,1,1,1,3,2,8,1
openxls,openxls,,0,0,0,0,7,0,0,1
scalatra-sbt,scalatra-sbt,,0,0,0,0,2,0,2,1
bind-variables,bind-variables,,3,2,6,5,12,11,4,1
hibernate-cascade,hibernate-cascade,,2,4,5,6,7,11,3,100
tikzdevice,tikzdevice,,1,3,0,4,8,4,0,200
picture-in-picture,picture-in-picture,,5,12,13,17,10,30,3,140
mongodb-oplog,mongodb-oplog,,3,3,5,6,12,11,1,1
log-level,log-level,,2,3,6,5,11,11,3,50
invalidation,invalidation,,3,3,16,6,32,22,3,1
pdflib,pdflib,,3,2,3,5,12,8,4,1
rworldmap,rworldmap,,3,5,7,8,13,15,0,66.666667
fastparse,fastparse,,1,1,0,2,2,2,0,1
php-glide,php-glide,,0,0,0,0,3,0,4,1
mormot,mormot,,1,1,1,2,5,3,9,1
security-testing,security-testing,,2,3,11,5,6,16,4,50
queryinterceptor,queryinterceptor,,0,0,0,0,4,0,8,1
mediawiki-api,mediawiki-api,,4,11,19,15,39,34,4,175
java.nio.file,java.nio.file,,3,2,7,5,16,12,3,1
docker-entrypoint,docker-entrypoint,,10,16,15,26,17,41,6,60
stl-algorithm,stl-algorithm,,4,1,13,5,32,18,9,1
clistbox,clistbox,,0,0,0,0,3,0,9,1
olap4j,olap4j,,3,0,3,3,6,6,4,1
usagestatsmanager,usagestatsmanager,,1,3,8,4,22,12,3,200
usageevents,usageevents,,0,1,0,1,5,1,3,1
dia,dia,,0,0,3,0,3,3,4,1
yahoo-kafka-manager,yahoo-kafka-manager,,1,2,2,3,5,5,2,100
zend-form,zend-form,,9,1,17,10,32,27,4,1
roxygen,roxygen,,3,1,4,4,12,8,0,1
clickjacking,clickjacking,,4,3,7,7,14,14,4,1
qthelp,qthelp,,0,0,2,0,1,2,9,1
off-canvas-menu,off-canvas-menu,,1,1,5,2,10,7,1,1
organized,organized,,0,0,1,0,3,1,0,1
ora-hash,ora-hash,,0,0,2,0,1,2,4,1
django-subdomains,django-subdomains,,1,0,0,1,5,1,0,1
data-storage,data-storage,,7,10,13,17,12,30,4,42.857143
tarfile,tarfile,,14,8,12,22,16,34,0,1
uiimagepngrepresentation,uiimagepngrepresentation,,1,0,4,1,5,5,13,1
uint64,uint64,,3,3,2,6,15,8,9,1
hangouts-chat,hangouts-chat,,17,18,22,35,30,57,5,5.882353
particle.js,particle.js,,0,4,3,4,3,7,1,300
combn,combn,,6,2,5,8,14,13,0,1
tridion-core-services,tridion-core-services,,0,0,1,0,1,1,8,1
midlet,midlet,,0,1,1,1,1,2,3,1
stubs,stubs,,0,0,0,0,6,0,1,1
bullseye,bullseye,,0,1,1,1,2,2,3,1
real-time-clock,real-time-clock,,10,5,11,15,29,26,9,1
mdns,mdns,,8,9,16,17,21,33,9,12.5
avalara,avalara,,3,1,2,4,4,6,8,1
fastlane-snapshot,fastlane-snapshot,,3,1,2,4,10,6,13,1
popuppanel,popuppanel,,0,0,0,0,1,0,1,1
sneakers,sneakers,,1,0,4,1,7,5,12,1
wss4j,wss4j,,5,8,13,13,25,26,3,60
jdl,jdl,,8,3,21,11,32,32,3,1
json-query,json-query,,7,13,16,20,32,36,4,85.714286
edt,edt,,0,0,3,0,3,3,3,1
qwebengineview,qwebengineview,,16,17,31,33,62,64,0,6.25
contention,contention,,0,0,0,0,9,0,3,1
nvidia-digits,nvidia-digits,,1,1,4,2,21,6,0,1
transform-stream,transform-stream,,1,2,2,3,2,5,1,100
datastep,datastep,,5,5,11,10,19,21,0,1
perl-io,perl-io,,0,0,2,0,2,2,9,1
dwm,dwm,,5,7,5,12,10,17,9,40
msgpack,msgpack,,25,11,24,36,47,60,8,1
skeletal-animation,skeletal-animation,,3,2,8,5,4,13,9,1
ghprb,ghprb,,0,2,1,2,1,3,6,100
morse-code,morse-code,,2,0,9,2,24,11,0,1
choetl,choetl,,2,3,3,5,5,8,8,50
qvideoframe,qvideoframe,,1,0,3,1,2,4,9,1
factorization,factorization,,5,3,11,8,21,19,0,1
azure-database-postgresql,azure-database-postgresql,,1,1,0,2,5,2,8,1
skcameranode,skcameranode,,1,0,2,1,6,3,13,1
angular-ui-bootstrap-tab,angular-ui-bootstrap-tab,,1,1,1,2,6,3,1,1
pagedlist,pagedlist,,23,12,23,35,40,58,8,1
reply,reply,,2,7,12,9,18,21,4,250
adobe-javascript,adobe-javascript,,1,0,3,1,5,4,1,1
vendoring,vendoring,,2,1,1,3,3,4,6,1
iiif,iiif,,0,1,0,1,3,1,12,1
ggridges,ggridges,,4,5,10,9,19,19,0,25
wgl,wgl,,2,0,0,2,7,2,9,1
padr,padr,,0,1,0,1,6,1,0,1
meta-raspberrypi,meta-raspberrypi,,1,0,3,1,5,4,9,1
network-security-groups,network-security-groups,,3,5,7,8,14,15,8,66.666667
azure-nsg,azure-nsg,,6,1,11,7,4,18,8,1
earthdistance,earthdistance,,2,0,2,2,2,4,4,1
net.tcp,net.tcp,,0,0,5,0,9,5,8,1
distance-matrix,distance-matrix,,11,6,19,17,15,36,0,1
watchface,watchface,,0,0,2,0,12,2,3,1
cloud-bare-metal,cloud-bare-metal,,0,0,6,0,5,6,6,1
vgam,vgam,,2,0,0,2,1,2,0,1
mattermost,mattermost,,8,9,12,17,19,29,6,12.5
mean-square-error,mean-square-error,,13,3,8,16,11,24,0,1
qsignalspy,qsignalspy,,1,1,1,2,2,3,9,1
snmpsharpnet,snmpsharpnet,,0,0,3,0,1,3,9,1
instafeedjs,instafeedjs,,1,1,6,2,14,8,1,1
bcc,bcc,,3,3,6,6,12,12,4,1
apple-live-photos,apple-live-photos,,2,1,2,3,7,5,13,1
will-change,will-change,,1,0,2,1,3,3,1,1
rhino,rhino,,7,12,20,19,37,39,1,71.428571
code-composer,code-composer,,8,2,15,10,15,25,9,1
haskell-warp,haskell-warp,,1,1,1,2,3,3,2,1
mongoose-models,mongoose-models,,0,2,10,2,6,12,1,100
python-jira,python-jira,,7,10,20,17,24,37,6,42.857143
magickwand,magickwand,,3,0,1,3,6,4,0,1
smart-device,smart-device,,2,1,3,3,8,6,8,1
hfp,hfp,,0,1,4,1,7,5,3,1
bluetooth-sco,bluetooth-sco,,1,1,0,2,1,2,3,1
flambo,flambo,,0,0,0,0,3,0,2,1
markov-models,markov-models,,1,2,6,3,12,9,0,100
pdftotext,pdftotext,,16,16,20,32,30,52,0,1
androidpdfviewer,androidpdfviewer,,1,5,9,6,8,15,3,400
pseudo-globals,pseudo-globals,,0,0,0,0,1,0,12,1
gini,gini,,4,1,4,5,17,9,0,1
catextlayer,catextlayer,,2,1,2,3,11,5,13,1
applescript-objc,applescript-objc,,5,6,13,11,8,24,13,20
cartogram,cartogram,,1,0,1,1,2,2,0,1
monthcalendar,monthcalendar,,4,6,11,10,20,21,8,50
magento-rules,magento-rules,,0,0,0,0,1,0,4,1
pong,pong,,4,13,14,17,28,31,0,225
computer-name,computer-name,,2,1,3,3,7,6,9,1
android-implicit-intent,android-implicit-intent,,1,1,8,2,17,10,3,1
fparsec,fparsec,,7,6,16,13,17,29,8,1
hpf,hpf,,1,0,0,1,1,1,3,1
debug-backtrace,debug-backtrace,,0,3,1,3,5,4,4,200
nscombobox,nscombobox,,0,3,3,3,8,6,13,200
synthesize,synthesize,,0,0,1,0,2,1,13,1
deviation,deviation,,0,2,1,2,5,3,0,100
htmlelements,htmlelements,,4,6,3,10,4,13,1,50
android-number-picker,android-number-picker,,3,2,6,5,19,11,3,1
krypton-toolkit,krypton-toolkit,,0,0,0,0,4,0,8,1
sam,sam,,1,5,9,6,11,15,6,400
timecop,timecop,,0,0,1,0,3,1,12,1
struts1,struts1,,0,0,1,0,20,1,3,1
rocket,rocket,,2,1,5,3,7,8,9,1
snowball,snowball,,1,1,3,2,5,5,0,1
cuba,cuba,,0,0,0,0,3,0,3,1
roundtrip,roundtrip,,1,1,0,2,3,2,9,1
image-editing,image-editing,,2,2,10,4,16,14,0,1
jquery-easyui,jquery-easyui,,12,3,10,15,22,25,1,1
googleplacesautocomplete,googleplacesautocomplete,,37,35,53,72,65,125,1,1
transcode,transcode,,1,1,4,2,4,6,13,1
socketasynceventargs,socketasynceventargs,,1,0,1,1,1,2,9,1
cyclic-graph,cyclic-graph,,1,2,1,3,2,4,0,100
google-document-viewer,google-document-viewer,,1,4,4,5,6,9,8,300
parallel-port,parallel-port,,0,1,3,1,7,4,9,1
xauth,xauth,,2,4,1,6,3,7,9,100
bundle-install,bundle-install,,0,0,1,0,3,1,12,1
bsearch,bsearch,,1,2,3,3,4,6,9,100
message-handlers,message-handlers,,3,1,3,4,6,7,8,1
graphql-php,graphql-php,,0,4,6,4,8,10,1,300
websvn,websvn,,0,0,0,0,1,0,4,1
or-mapper,or-mapper,,1,0,0,1,1,1,3,1
add-custom-command,add-custom-command,,4,4,2,8,8,10,9,1
bootstrap-timepicker,bootstrap-timepicker,,0,2,1,2,3,3,1,100
livesearch,livesearch,,4,1,9,5,28,14,1,1
crate,crate,,3,2,9,5,17,14,4,1
ultraedit,ultraedit,,3,2,5,5,7,10,0,1
dynamic-routing,dynamic-routing,,3,4,7,7,14,14,1,33.333333
intermediate-code,intermediate-code,,0,1,1,1,2,2,9,1
tfs2005,tfs2005,,0,0,0,0,1,0,8,1
pyfftw,pyfftw,,5,5,1,10,6,11,0,1
sizzle,sizzle,,1,0,0,1,5,1,1,1
castle,castle,,1,0,2,1,10,3,8,1
android-activitymanager,android-activitymanager,,1,3,4,4,6,8,3,200
packaged-task,packaged-task,,2,4,3,6,3,9,9,100
hessian,hessian,,4,4,6,8,9,14,0,1
typo3-console,typo3-console,,0,0,1,0,3,1,4,1
maven-jdeps-plugin,maven-jdeps-plugin,,1,0,0,1,3,1,3,1
google-cloud-iot,google-cloud-iot,,10,17,23,27,45,50,6,70
django-transmeta,django-transmeta,,0,0,0,0,1,0,0,1
ash,ash,,4,4,5,8,16,13,9,1
awql,awql,,0,2,5,2,4,7,5,100
guideline-support-library,guideline-support-library,,1,2,3,3,9,6,9,100
tabpy,tabpy,,5,2,2,7,8,9,0,1
pdf-rasterizer,pdf-rasterizer,,0,2,1,2,1,3,1,100
react-templates,react-templates,,0,1,1,1,1,2,1,1
django-sekizai,django-sekizai,,0,0,0,0,1,0,0,1
apache-commons-collection,apache-commons-collection,,0,1,1,1,3,2,3,1
taurus,taurus,,4,2,17,6,24,23,3,1
baud-rate,baud-rate,,3,4,14,7,19,21,9,33.333333
project-web-access,project-web-access,,0,0,0,0,1,0,8,1
mktemp,mktemp,,2,0,1,2,2,3,9,1
formvalidation.io,formvalidation.io,,3,0,10,3,18,13,1,1
apache-spark-xml,apache-spark-xml,,3,5,7,8,21,15,2,66.666667
qa-c,qa-c,,3,1,5,4,4,9,9,1
grunt-spritesmith,grunt-spritesmith,,0,0,1,0,1,1,1,1
configurationproperty,configurationproperty,,1,0,0,1,4,1,3,1
qubit,qubit,,4,0,0,4,11,4,0,1
icu4j,icu4j,,3,3,1,6,6,7,3,1
initialization-list,initialization-list,,1,1,2,2,5,4,9,1
swizzle,swizzle,,1,0,0,1,3,1,13,1
sqlacodegen,sqlacodegen,,0,1,0,1,4,1,0,1
clam,clam,,7,0,6,7,10,13,9,1
indirect-objects,indirect-objects,,0,0,0,0,4,0,8,1
.net-core-angular,.net-core-angular,,0,0,1,0,2,1,8,1
tde,tde,,4,6,4,10,18,14,4,50
linq-to-excel,linq-to-excel,,4,0,5,4,12,9,8,1
incompatibility,incompatibility,,5,1,6,6,17,12,3,1
mysql-error-1005,mysql-error-1005,,2,0,3,2,2,5,4,1
oval,oval,,2,0,1,2,4,3,1,1
wijmo,wijmo,,2,4,2,6,10,8,1,100
antrl4,antrl4,,2,0,1,2,4,3,0,1
canonical-link,canonical-link,,11,7,12,18,25,30,4,1
spark-streaming-kafka,spark-streaming-kafka,,33,23,28,56,11,84,2,1
secure-crt,secure-crt,,6,2,3,8,4,11,9,1
rvo,rvo,,4,4,5,8,19,13,9,1
tokudb,tokudb,,0,0,1,0,2,1,4,1
annuity,annuity,,1,0,2,1,1,3,4,1
imodelbinder,imodelbinder,,1,0,1,1,2,2,8,1
jquery-mask,jquery-mask,,1,5,5,6,4,11,1,400
carrierwave-backgrounder,carrierwave-backgrounder,,2,0,3,2,1,5,12,1
trusted-computing,trusted-computing,,0,0,2,0,11,2,6,1
modula-2,modula-2,,0,0,0,0,3,0,9,1
oberon,oberon,,0,0,0,0,2,0,9,1
passcode,passcode,,1,0,3,1,8,4,13,1
crowdsourcing,crowdsourcing,,0,1,1,1,3,2,1,1
s3fs,s3fs,,11,2,12,13,19,25,6,1
ligature,ligature,,4,4,2,8,14,10,1,1
subparsers,subparsers,,1,0,1,1,8,2,0,1
drupal-nodes,drupal-nodes,,1,1,2,2,4,4,4,1
simplemodal,simplemodal,,6,2,6,8,12,14,1,1
mks-integrity,mks-integrity,,0,0,1,0,6,1,9,1
multi-table,multi-table,,2,0,4,2,8,6,4,1
gulp-concat,gulp-concat,,3,3,7,6,19,13,1,1
noexcept,noexcept,,4,4,14,8,36,22,9,1
docker-link,docker-link,,0,1,2,1,3,3,6,1
unobtrusive-ajax,unobtrusive-ajax,,1,1,7,2,7,9,8,1
kiba-etl,kiba-etl,,0,1,0,1,3,1,12,1
google-maps-timezone,google-maps-timezone,,1,0,0,1,3,1,1,1
rangy,rangy,,2,7,3,9,9,12,1,250
document-database,document-database,,9,0,18,9,30,27,8,1
avmutablecomposition,avmutablecomposition,,4,6,17,10,19,27,13,50
dfsort,dfsort,,2,1,2,3,8,5,4,1
pst,pst,,5,7,9,12,8,21,5,40
tippecanoe,tippecanoe,,1,1,4,2,6,6,1,1
qtpy,qtpy,,1,1,2,2,4,4,0,1
jqwidget,jqwidget,,7,10,15,17,20,32,1,42.857143
one-time-binding,one-time-binding,,0,0,2,0,3,2,1,1
packrat,packrat,,4,6,16,10,15,26,0,50
iobluetooth,iobluetooth,,1,0,1,1,6,2,13,1
turbogears2,turbogears2,,1,2,4,3,3,7,0,100
xclip,xclip,,0,3,2,3,3,5,9,200
xcode-command-line-tools,xcode-command-line-tools,,0,1,12,1,8,13,13,1
colorize,colorize,,3,2,2,5,5,7,9,1
django-2.0,django-2.0,,31,19,89,50,261,139,0,1
tomcat-valve,tomcat-valve,,1,3,5,4,4,9,3,200
mod-proxy-wstunnel,mod-proxy-wstunnel,,0,0,2,0,5,2,4,1
readonly-collection,readonly-collection,,2,0,5,2,4,7,8,1
outputcache,outputcache,,11,3,6,14,22,20,8,1
adonetappender,adonetappender,,0,1,1,1,1,2,8,1
inotifycollectionchanged,inotifycollectionchanged,,0,0,5,0,6,5,8,1
countrows,countrows,,2,0,0,2,4,2,5,1
apache-stringutils,apache-stringutils,,1,1,4,2,12,6,3,1
il2cpp,il2cpp,,5,7,7,12,7,19,8,40
livecycle,livecycle,,1,2,6,3,12,9,8,100
coin-flipping,coin-flipping,,0,3,7,3,14,10,0,200
graql,graql,,0,3,6,3,9,9,2,200
braille,braille,,0,0,5,0,1,5,13,1
taleo,taleo,,1,0,12,1,12,13,3,1
gob,gob,,2,3,8,5,15,13,6,50
go-toolchain,go-toolchain,,0,0,0,0,3,0,6,1
transactional-memory,transactional-memory,,0,0,0,0,3,0,2,1
visualstudio.testtools,visualstudio.testtools,,2,0,1,2,4,3,8,1
physics-engine,physics-engine,,11,6,5,17,14,22,8,1
azure-sdk-python,azure-sdk-python,,8,15,16,23,17,39,8,87.5
ifilter,ifilter,,2,1,5,3,2,8,4,1
cherry-pick,cherry-pick,,6,5,23,11,36,34,6,1
bssid,bssid,,0,1,2,1,7,3,3,1
inet-aton,inet-aton,,2,0,0,2,1,2,4,1
edb,edb,,2,3,3,5,6,8,4,50
updatable-views,updatable-views,,0,1,2,1,3,3,4,1
skphysicsworld,skphysicsworld,,0,0,1,0,10,1,13,1
suricata,suricata,,1,3,5,4,7,9,9,200
bringtofront,bringtofront,,1,0,4,1,10,5,8,1
nim-game,nim-game,,0,1,2,1,4,3,0,1
strophe,strophe,,7,6,13,13,22,26,3,1
skpaymenttransaction,skpaymenttransaction,,1,1,3,2,10,5,13,1
qt5.6,qt5.6,,1,4,3,5,12,8,9,300
saaj,saaj,,7,7,9,14,11,23,3,1
lua-telegram-bot,lua-telegram-bot,,0,0,1,0,3,1,0,1
devenv,devenv,,1,3,7,4,19,11,8,200
disambiguation,disambiguation,,2,1,3,3,3,6,9,1
spinnaker-halyard,spinnaker-halyard,,6,7,18,13,29,31,6,16.666667
lidgren,lidgren,,1,1,1,2,4,3,8,1
mojolicious-lite,mojolicious-lite,,5,1,6,6,13,12,9,1
publishsubject,publishsubject,,0,1,3,1,8,4,3,1
caf-receiver-sdk,caf-receiver-sdk,,2,0,1,2,11,3,13,1
parameterization,parameterization,,3,1,14,4,10,18,0,1
auraphp,auraphp,,0,0,1,0,3,1,4,1
pathos,pathos,,10,6,23,16,31,39,0,1
codewarrior,codewarrior,,1,4,2,5,3,7,9,300
desktop.ini,desktop.ini,,0,3,2,3,1,5,9,200
lua-5.2,lua-5.2,,0,1,1,1,4,2,9,1
heritrix,heritrix,,0,0,0,0,2,0,0,1
stormcrawler,stormcrawler,,10,9,32,19,50,51,0,1
jquery-query-builder,jquery-query-builder,,5,0,4,5,8,9,1,1
noncopyable,noncopyable,,0,0,4,0,3,4,9,1
quasar-framework,quasar-framework,,40,32,50,72,67,122,1,1
jersey-1.0,jersey-1.0,,3,5,10,8,15,18,3,66.666667
dbup,dbup,,0,0,7,0,8,7,8,1
combinelatest,combinelatest,,7,5,17,12,24,29,1,1
google-identity,google-identity,,10,12,14,22,44,36,5,20
cfloop,cfloop,,0,3,9,3,13,12,4,200
moby,moby,,0,5,8,5,6,13,6,400
multipartentity,multipartentity,,1,1,4,2,6,6,3,1
web-mining,web-mining,,2,1,0,3,4,3,0,1
line-spacing,line-spacing,,1,1,5,2,7,7,13,1
subresource-integrity,subresource-integrity,,3,2,9,5,11,14,1,1
g++4.9,g++4.9,,0,0,0,0,1,0,9,1
pydatalog,pydatalog,,0,1,2,1,7,3,0,1
pweave,pweave,,2,4,3,6,2,9,0,100
evaporate.js,evaporate.js,,1,1,2,2,2,4,6,1
shared-variable,shared-variable,,1,2,5,3,11,8,3,100
oxygenxml,oxygenxml,,5,4,6,9,18,15,3,1
yard,yard,,3,2,4,5,9,9,12,1
potrace,potrace,,1,0,1,1,2,2,1,1
cleaned-data,cleaned-data,,2,3,1,5,4,6,0,50
cygpath,cygpath,,0,0,0,0,1,0,9,1
hugsql,hugsql,,1,2,1,3,10,4,2,100
jvectormap,jvectormap,,16,7,14,23,20,37,1,1
catel,catel,,1,2,9,3,19,12,8,100
unicode-literals,unicode-literals,,1,2,2,3,10,5,0,100
boost-icl,boost-icl,,1,0,1,1,7,2,9,1
defaultproxy,defaultproxy,,0,1,0,1,2,1,8,1
shex,shex,,0,0,0,0,2,0,2,1
external-dependencies,external-dependencies,,4,0,2,4,7,6,9,1
mod-jk,mod-jk,,5,5,10,10,22,20,3,1
android-compound-view,android-compound-view,,1,0,2,1,3,3,3,1
ufs,ufs,,1,0,0,1,2,1,6,1
inches,inches,,0,0,2,0,4,2,5,1
centrify,centrify,,0,1,0,1,6,1,8,1
silktest,silktest,,1,0,3,1,6,4,3,1
xades4j,xades4j,,0,0,7,0,11,7,6,1
matlab-class,matlab-class,,0,2,2,2,7,4,0,100
shell-namespace-extension,shell-namespace-extension,,0,0,2,0,16,2,9,1
userdetailsservice,userdetailsservice,,0,2,3,2,8,5,3,100
view-helpers,view-helpers,,6,9,9,15,11,24,4,50
android-cookiemanager,android-cookiemanager,,2,1,2,3,8,5,3,1
com+,com+,,5,4,10,9,15,19,8,1
uifeedbackgenerator,uifeedbackgenerator,,0,0,1,0,2,1,13,1
shift-jis,shift-jis,,2,2,2,4,5,6,0,1
amp-access,amp-access,,3,1,2,4,1,6,1,1
abc,abc,,11,8,9,19,21,28,0,1
flask-cache,flask-cache,,1,1,3,2,10,5,0,1
italic,italic,,2,4,5,6,9,11,0,100
posthoc,posthoc,,7,7,11,14,21,25,0,1
pairwise,pairwise,,14,13,19,27,44,46,0,1
symfony-3.4,symfony-3.4,,99,84,199,183,388,382,4,1
symfony4,symfony4,,490,425,906,915,860,1821,4,1
cockroachdb,cockroachdb,,9,11,17,20,33,37,6,22.222222
ispc,ispc,,0,0,1,0,1,1,9,1
qscintilla,qscintilla,,5,5,8,10,9,18,0,1
ucs2,ucs2,,5,1,5,6,8,11,0,1
angular-ui-modal,angular-ui-modal,,5,0,1,5,6,6,1,1
jqxtree,jqxtree,,0,0,2,0,2,2,1,1
blit,blit,,3,4,16,7,16,23,0,33.333333
android-cast-api,android-cast-api,,0,0,1,0,3,1,3,1
trailing,trailing,,4,5,8,9,21,17,0,25
autocmd,autocmd,,2,0,2,2,5,4,9,1
skel,skel,,0,0,1,0,4,1,1,1
approximate,approximate,,1,2,4,3,2,7,0,100
swift-subscript,swift-subscript,,1,0,0,1,2,1,13,1
azure-ad-powershell-v2,azure-ad-powershell-v2,,4,4,6,8,11,14,8,1
2-3-4-tree,2-3-4-tree,,1,1,0,2,1,2,0,1
gradle-git,gradle-git,,0,0,0,0,1,0,3,1
zerofill,zerofill,,0,1,2,1,3,3,4,1
task-queue,task-queue,,14,11,29,25,43,54,6,1
adaptive-design,adaptive-design,,1,1,5,2,4,7,8,1
shtml,shtml,,3,1,1,4,5,5,4,1
nsbutton,nsbutton,,2,3,13,5,30,18,13,50
printing-web-page,printing-web-page,,5,1,7,6,15,13,1,1
code-maintainability,code-maintainability,,0,0,3,0,6,3,8,1
dig,dig,,3,0,12,3,20,15,4,1
dnssec,dnssec,,3,1,7,4,9,11,4,1
dane,dane,,0,0,0,0,3,0,4,1
pysvn,pysvn,,1,0,2,1,5,3,0,1
dotliquid,dotliquid,,8,9,7,17,13,24,8,12.5
near-real-time,near-real-time,,0,0,1,0,1,1,4,1
freelancer.com-api,freelancer.com-api,,0,0,1,0,2,1,4,1
hyperterminal,hyperterminal,,1,2,2,3,6,5,9,100
ansible-container,ansible-container,,1,0,1,1,11,2,6,1
openerp-6,openerp-6,,0,1,0,1,4,1,0,1
md5sum,md5sum,,5,5,12,10,18,22,9,1
sqlite-net-pcl,sqlite-net-pcl,,5,4,7,9,15,16,8,1
meter,meter,,0,1,4,1,6,5,0,1
koa.js,koa.js,,0,0,0,0,2,0,1,1
cross-posting,cross-posting,,0,0,0,0,1,0,13,1
vue-cli-3,vue-cli-3,,130,109,278,239,34,517,1,1
boost-process,boost-process,,6,4,8,10,19,18,9,1
sysex,sysex,,1,0,2,1,1,3,13,1
childwindow,childwindow,,1,1,3,2,4,5,8,1
openbravo,openbravo,,0,0,0,0,4,0,3,1
stereotype,stereotype,,3,0,0,3,1,3,3,1
use-case-diagram,use-case-diagram,,9,4,14,13,22,27,3,1
purescript-pux,purescript-pux,,0,4,0,4,1,4,2,300
android-mvvm,android-mvvm,,54,57,78,111,51,189,3,5.555556
exc-bad-instruction,exc-bad-instruction,,0,1,0,1,10,1,13,1
re-engineering,re-engineering,,1,0,0,1,4,1,9,1
rd,rd,,1,3,1,4,8,5,0,200
kendo-mvvm,kendo-mvvm,,2,1,4,3,10,7,1,1
ipad-mini,ipad-mini,,0,0,1,0,5,1,13,1
matcaffe,matcaffe,,1,1,5,2,17,7,0,1
spring-dsl,spring-dsl,,3,5,9,8,17,17,3,66.666667
tensor2tensor,tensor2tensor,,5,8,7,13,6,20,0,60
navicat,navicat,,13,11,18,24,23,42,4,1
activestate,activestate,,0,0,3,0,4,3,9,1
pandasql,pandasql,,14,16,13,30,30,43,0,14.285714
soci,soci,,3,1,5,4,4,9,9,1
eloqua-bulk-api,eloqua-bulk-api,,0,1,2,1,4,3,4,1
proficy,proficy,,2,1,0,3,4,3,5,1
ido,ido,,0,0,0,0,3,0,9,1
zynq,zynq,,9,14,13,23,38,36,9,55.555556
cyborg,cyborg,,0,0,0,0,1,0,3,1
cardreader,cardreader,,1,0,2,1,4,3,3,1
unimag,unimag,,0,0,1,0,1,1,3,1
typo3-7.x,typo3-7.x,,0,1,0,1,4,1,4,1
fluid-styled-content,fluid-styled-content,,1,1,8,2,11,10,4,1
rowtype,rowtype,,1,1,2,2,4,4,4,1
igrouping,igrouping,,1,1,2,2,5,4,8,1
tipsy,tipsy,,0,0,1,0,2,1,1,1
instant-messaging,instant-messaging,,0,6,13,6,17,19,3,500
nszombie,nszombie,,1,2,3,3,3,6,13,100
android-contextmenu,android-contextmenu,,0,2,3,2,9,5,3,100
uikit-state-preservation,uikit-state-preservation,,0,0,0,0,1,0,13,1
authenticationchallenge,authenticationchallenge,,3,0,0,3,3,3,13,1
memory-mapping,memory-mapping,,7,9,15,16,25,31,9,28.571429
browser-refresh,browser-refresh,,1,2,0,3,5,3,1,100
hdiutil,hdiutil,,3,0,2,3,2,5,13,1
illuminate-container,illuminate-container,,1,5,7,6,10,13,4,400
qtwebsockets,qtwebsockets,,1,2,1,3,2,4,9,100
referential-transparency,referential-transparency,,0,0,3,0,2,3,2,1
uiculture,uiculture,,1,1,1,2,4,3,8,1
imagettftext,imagettftext,,1,2,0,3,7,3,4,100
dbextensions,dbextensions,,0,0,0,0,1,0,4,1
jaxws-maven-plugin,jaxws-maven-plugin,,3,2,5,5,4,10,3,1
sp-msforeachdb,sp-msforeachdb,,1,0,0,1,1,1,4,1
cloud-platform,cloud-platform,,1,0,0,1,1,1,5,1
mkdir,mkdir,,21,15,33,36,64,69,9,1
essbase,essbase,,4,7,6,11,15,17,5,75
abbreviation,abbreviation,,5,1,5,6,13,11,0,1
nested-transactions,nested-transactions,,0,1,3,1,3,4,4,1
burp,burp,,7,9,19,16,28,35,4,28.571429
turbine,turbine,,4,1,5,5,8,10,3,1
anonymous-recursion,anonymous-recursion,,1,0,0,1,2,1,0,1
undocumented-behavior,undocumented-behavior,,4,4,10,8,8,18,0,1
.net-core-configuration,.net-core-configuration,,2,2,1,4,3,5,8,1
autonumber,autonumber,,3,3,8,6,11,14,5,1
sitecore7.2,sitecore7.2,,0,0,2,0,7,2,8,1
cumulative-line-chart,cumulative-line-chart,,0,0,1,0,4,1,5,1
asp.net-core-configuration,asp.net-core-configuration,,5,2,2,7,7,9,8,1
searchkit,searchkit,,2,1,4,3,16,7,1,1
temporal-difference,temporal-difference,,10,4,1,14,7,15,0,1
trustpilot,trustpilot,,1,1,4,2,8,6,1,1
carrot2,carrot2,,1,1,4,2,7,6,2,1
sitecore-workflow,sitecore-workflow,,0,1,0,1,4,1,8,1
transport-security,transport-security,,0,0,3,0,2,3,8,1
hosts-file,hosts-file,,2,1,7,3,6,10,4,1
bin-folder,bin-folder,,1,1,0,2,1,2,8,1
forums,forums,,0,0,0,0,3,0,0,1
enumerators,enumerators,,0,0,0,0,2,0,8,1
custom-directive,custom-directive,,3,3,7,6,13,13,1,1
emplace,emplace,,5,1,9,6,16,15,9,1
gams-math,gams-math,,10,7,15,17,27,32,0,1
simpowersystems,simpowersystems,,1,1,0,2,2,2,0,1
bond,bond,,0,0,1,0,11,1,9,1
memory-dump,memory-dump,,4,3,9,7,10,16,9,1
cgsize,cgsize,,2,2,3,4,7,7,13,1
webproject,webproject,,0,0,0,0,5,0,8,1
sql-server-ce-4,sql-server-ce-4,,0,0,1,0,4,1,4,1
keywordquery,keywordquery,,0,1,1,1,2,2,8,1
transactional-replication,transactional-replication,,10,6,17,16,18,33,4,1
layout-anchor,layout-anchor,,1,0,2,1,9,3,13,1
lemmatization,lemmatization,,15,16,20,31,50,51,0,6.666667
android-user-profile,android-user-profile,,1,0,2,1,1,3,3,1
nicedit,nicedit,,0,0,3,0,8,3,1,1
replication-factor,replication-factor,,0,0,2,0,4,2,2,1
app-secret,app-secret,,3,3,3,6,9,9,13,1
sql-server-2017-graph,sql-server-2017-graph,,0,1,3,1,3,4,4,1
gulp-header,gulp-header,,0,0,0,0,2,0,1,1
mysql-connect,mysql-connect,,0,1,7,1,10,8,4,1
cfquery,cfquery,,2,5,7,7,11,14,4,150
control-c,control-c,,2,1,0,3,3,3,0,1
xcode-workspace,xcode-workspace,,2,0,2,2,11,4,13,1
apache-commons-config,apache-commons-config,,1,3,7,4,11,11,3,200
nsvalue,nsvalue,,0,1,0,1,2,1,13,1
viewparams,viewparams,,1,0,0,1,4,1,3,1
ether,ether,,3,3,16,6,31,22,6,1
wordpress-json-api,wordpress-json-api,,2,3,1,5,3,6,4,50
magento-layout-xml,magento-layout-xml,,1,0,3,1,4,4,4,1
contactscontract,contactscontract,,2,0,25,2,37,27,3,1
qnamaker,qnamaker,,36,45,73,81,128,154,8,25
mkbundle,mkbundle,,2,2,1,4,6,5,8,1
swfobject,swfobject,,4,3,6,7,15,13,13,1
django-q,django-q,,2,1,7,3,14,10,0,1
kodein,kodein,,8,10,11,18,14,29,3,25
theano-cuda,theano-cuda,,2,3,10,5,14,15,0,50
r-factor,r-factor,,2,1,9,3,34,12,0,1
sbt-release,sbt-release,,0,1,3,1,5,4,2,1
github-mantle,github-mantle,,2,1,1,3,1,4,13,1
accumulo,accumulo,,5,5,7,10,14,17,2,1
gmisc,gmisc,,1,0,1,1,3,2,0,1
app-id,app-id,,3,4,9,7,21,16,13,33.333333
d3plus,d3plus,,5,1,6,6,9,12,1,1
tree-conflict,tree-conflict,,0,0,1,0,2,1,6,1
confd,confd,,5,3,1,8,3,9,6,1
apple-documentation,apple-documentation,,0,1,1,1,4,2,13,1
credits,credits,,3,0,2,3,4,5,4,1
cjk,cjk,,36,28,57,64,113,121,0,1
fo-dicom,fo-dicom,,3,4,8,7,12,15,8,33.333333
dedicated-server,dedicated-server,,5,3,10,8,10,18,4,1
cocoalumberjack,cocoalumberjack,,5,0,5,5,8,10,13,1
visual-studio-monaco,visual-studio-monaco,,3,3,9,6,15,15,1,1
set-based,set-based,,0,1,5,1,2,6,4,1
mcc,mcc,,1,2,5,3,5,8,0,100
pack-uri,pack-uri,,0,0,0,0,1,0,3,1
columnspan,columnspan,,0,0,0,0,4,0,8,1
detection-idiom,detection-idiom,,0,1,1,1,1,2,9,1
subitem,subitem,,2,0,2,2,7,4,3,1
batch-insert,batch-insert,,3,7,7,10,13,17,4,133.333333
inline-code,inline-code,,0,0,2,0,5,2,0,1
xrmquery,xrmquery,,1,0,0,1,2,1,8,1
servlet-2.5,servlet-2.5,,0,1,0,1,1,1,3,1
staticresource,staticresource,,4,1,8,5,17,13,8,1
intersystems,intersystems,,6,0,1,6,12,7,4,1
highgui,highgui,,0,2,2,2,5,4,0,100
mxmlc,mxmlc,,0,1,1,1,2,2,13,1
adobe-flash-cs3,adobe-flash-cs3,,0,0,1,0,1,1,13,1
jodd,jodd,,0,1,0,1,6,1,3,1
unicode-normalization,unicode-normalization,,1,5,6,6,14,12,0,400
mysql-error-1044,mysql-error-1044,,0,0,1,0,2,1,4,1
ibm-cloud-private,ibm-cloud-private,,4,3,28,7,56,35,6,1
audiotoolbox,audiotoolbox,,6,8,8,14,23,22,13,33.333333
minimesos,minimesos,,0,0,1,0,1,1,6,1
panoramas,panoramas,,5,7,12,12,23,24,0,40
antlr2,antlr2,,0,1,1,1,4,2,0,1
tween.js,tween.js,,1,1,8,2,16,10,1,1
aws-sts,aws-sts,,5,14,15,19,20,34,6,180
web-config-encryption,web-config-encryption,,0,0,0,0,1,0,3,1
inspectdb,inspectdb,,3,1,5,4,5,9,0,1
windows-server-2000,windows-server-2000,,0,0,0,0,1,0,3,1
laravel-elixir,laravel-elixir,,4,3,4,7,17,11,4,1
ctrl,ctrl,,0,4,7,4,18,11,9,300
localityofreference,localityofreference,,0,0,0,0,3,0,9,1
online-game,online-game,,2,2,2,4,5,6,8,1
iswix,iswix,,0,3,1,3,2,4,8,200
hiddenfield,hiddenfield,,0,0,0,0,4,0,8,1
mod-auth,mod-auth,,1,0,1,1,2,2,4,1
r6,r6,,5,10,9,15,21,24,0,100
gaps-in-data,gaps-in-data,,0,2,2,2,7,4,4,100
r-googlesheets,r-googlesheets,,4,0,8,4,19,12,0,1
mql5,mql5,,6,7,22,13,65,35,7,16.666667
downloadstring,downloadstring,,3,2,2,5,10,7,8,1
inputverifier,inputverifier,,0,0,0,0,2,0,3,1
z-order,z-order,,3,2,5,5,12,10,0,1
redux-persist,redux-persist,,30,29,58,59,87,117,1,1
erpnext,erpnext,,7,7,7,14,4,21,9,1
fastly,fastly,,2,1,7,3,6,10,4,1
fastly-vcl,fastly-vcl,,1,0,4,1,3,5,4,1
http-conduit,http-conduit,,2,0,1,2,6,3,2,1
websphere-mq-fte,websphere-mq-fte,,0,0,2,0,1,2,3,1
python-pdfkit,python-pdfkit,,9,6,8,15,16,23,0,1
msloadtest,msloadtest,,2,0,4,2,7,6,3,1
wavefront,wavefront,,10,3,14,13,36,27,9,1
prolog-dif,prolog-dif,,0,0,2,0,6,2,0,1
semantic-analysis,semantic-analysis,,6,0,1,6,9,7,9,1
dev-appserver,dev-appserver,,4,2,5,6,18,11,6,1
gmaps4rails2,gmaps4rails2,,0,0,0,0,1,0,12,1
tftp,tftp,,4,6,13,10,15,23,9,50
volusion,volusion,,0,2,0,2,2,2,1,100
yagmail,yagmail,,2,4,4,6,4,10,0,100
xquery-3.0,xquery-3.0,,0,2,18,2,23,20,3,100
fileparse,fileparse,,0,0,0,0,1,0,0,1
regional-settings,regional-settings,,2,2,7,4,19,11,5,1
machinekey,machinekey,,3,2,5,5,10,10,8,1
mediatemple,mediatemple,,0,1,2,1,3,3,4,1
multiview,multiview,,1,3,5,4,11,9,0,200
text-to-column,text-to-column,,4,2,3,6,11,9,5,1
git-alias,git-alias,,2,0,9,2,9,11,6,1
apache-chemistry,apache-chemistry,,1,1,3,2,3,5,3,1
fetched-property,fetched-property,,0,0,0,0,2,0,13,1
uiedgeinsets,uiedgeinsets,,1,1,10,2,20,12,13,1
isomorphism,isomorphism,,3,6,6,9,6,15,0,100
xmlslurper,xmlslurper,,5,4,5,9,26,14,3,1
iredmail,iredmail,,0,1,7,1,6,8,4,1
advantage-database-server,advantage-database-server,,7,5,16,12,26,28,4,1
mastercard,mastercard,,9,7,7,16,14,23,4,1
cookiecutter,cookiecutter,,4,1,6,5,17,11,0,1
simpy,simpy,,6,3,20,9,18,29,0,1
mri,mri,,5,3,3,8,8,11,0,1
angularfire5,angularfire5,,6,2,24,8,68,32,13,1
object-properties,object-properties,,2,1,2,3,12,5,1,1
photoswipe,photoswipe,,10,5,11,15,16,26,1,1
hardlink,hardlink,,5,3,6,8,11,14,9,1
fortrabbit,fortrabbit,,0,0,1,0,1,1,4,1
unbuffered-output,unbuffered-output,,0,0,0,0,1,0,9,1
specifier,specifier,,1,1,2,2,3,4,9,1
winhelp,winhelp,,0,0,2,0,2,2,8,1
visual-studio-exp-2013,visual-studio-exp-2013,,0,0,0,0,3,0,8,1
undertowjaxrsserver,undertowjaxrsserver,,0,0,0,0,3,0,3,1
line-segment,line-segment,,4,3,1,7,2,8,0,1
custom-binding,custom-binding,,0,0,4,0,3,4,8,1
selectpdf,selectpdf,,6,7,9,13,11,22,8,16.666667
dimensional-modeling,dimensional-modeling,,14,7,20,21,29,41,4,1
utest,utest,,0,0,2,0,1,2,1,1
rates,rates,,0,0,0,0,6,0,4,1
galleria,galleria,,1,0,2,1,6,3,1,1
deferred-execution,deferred-execution,,2,3,3,5,10,8,8,50
memory-footprint,memory-footprint,,0,1,3,1,5,4,3,1
ilmerge,ilmerge,,4,2,14,6,18,20,8,1
ranorex,ranorex,,2,7,9,9,20,18,8,250
rational-developer-for-i,rational-developer-for-i,,0,1,0,1,3,1,3,1
pyproj,pyproj,,9,12,10,21,16,31,0,33.333333
reduction,reduction,,10,6,22,16,28,38,0,1
google-inbox,google-inbox,,1,0,0,1,8,1,3,1
qurl,qurl,,2,1,0,3,12,3,9,1
sqlline,sqlline,,1,2,1,3,5,4,2,100
mapped-drive,mapped-drive,,2,2,8,4,10,12,8,1
dash-shell,dash-shell,,1,0,4,1,15,5,9,1
mysql-dependent-subquery,mysql-dependent-subquery,,0,0,3,0,1,3,4,1
mklocalsearchrequest,mklocalsearchrequest,,2,2,2,4,2,6,13,1
grip,grip,,0,0,0,0,2,0,0,1
code-editor,code-editor,,4,8,10,12,18,22,3,100
nsstream,nsstream,,1,0,4,1,6,5,13,1
nsinputstream,nsinputstream,,0,1,1,1,3,2,13,1
z-notation,z-notation,,0,2,2,2,1,4,0,100
gwtbootstrap3,gwtbootstrap3,,1,1,5,2,6,7,1,1
gal,gal,,1,1,1,2,8,3,5,1
zingchart,zingchart,,5,3,8,8,11,16,1,1
appboy,appboy,,0,0,1,0,1,1,13,1
cockpit,cockpit,,1,1,3,2,4,5,4,1
implementation-defined-behavior,implementation-defined-behavior,,0,0,3,0,3,3,9,1
libx264,libx264,,6,7,7,13,15,20,13,16.666667
dvb,dvb,,2,3,1,5,3,6,13,50
qcolor,qcolor,,1,0,1,1,10,2,9,1
qpen,qpen,,2,1,0,3,3,3,9,1
rightfax,rightfax,,0,0,2,0,3,2,8,1
linearization,linearization,,1,0,3,1,4,4,0,1
valueinjecter,valueinjecter,,2,1,1,3,4,4,8,1
challenge-response,challenge-response,,1,0,1,1,6,2,8,1
jvisualvm,jvisualvm,,7,6,12,13,23,25,3,1
j2v8,j2v8,,0,1,4,1,3,5,3,1
ora-06512,ora-06512,,0,0,0,0,1,0,4,1
ora-01843,ora-01843,,0,0,1,0,4,1,4,1
django-admin-filters,django-admin-filters,,5,4,10,9,14,19,0,1
google-publisher-tag,google-publisher-tag,,1,1,6,2,3,8,3,1
mediarecorder-api,mediarecorder-api,,2,2,5,4,11,9,1,1
msdtc,msdtc,,8,3,15,11,12,26,4,1
installaware,installaware,,1,0,0,1,3,1,8,1
shdocvw.internetexplorer,shdocvw.internetexplorer,,1,0,1,1,5,2,8,1
jquery-countdown,jquery-countdown,,2,0,1,2,7,3,1,1
compojure-api,compojure-api,,1,3,4,4,10,8,2,200
flotr2,flotr2,,0,0,1,0,1,1,1,1
nested-datalist,nested-datalist,,1,0,0,1,7,1,8,1
largenumber,largenumber,,6,11,19,17,26,36,0,83.333333
postgresql-bdr,postgresql-bdr,,0,0,1,0,4,1,4,1
xcelsius,xcelsius,,0,0,1,0,1,1,13,1
onfocuschangelistener,onfocuschangelistener,,0,0,2,0,5,2,3,1
ehcache-bigmemory,ehcache-bigmemory,,0,1,1,1,5,2,3,1
interactive-service-hub,interactive-service-hub,,0,0,0,0,5,0,8,1
risk-analysis,risk-analysis,,2,2,7,4,4,11,0,1
closesocket,closesocket,,0,0,0,0,2,0,9,1
nspopupbutton,nspopupbutton,,0,3,4,3,8,7,13,200
android-kernel,android-kernel,,7,14,11,21,18,32,3,100
remedy,remedy,,5,3,6,8,7,14,3,1
phpize,phpize,,1,2,3,3,3,6,4,100
24-bit,24-bit,,1,1,0,2,6,2,0,1
flow-control,flow-control,,5,4,8,9,18,17,3,1
sitecore6,sitecore6,,0,1,3,1,2,4,8,1
cordova-win10,cordova-win10,,0,2,0,2,4,2,1,100
amazon-quicksight,amazon-quicksight,,15,18,21,33,19,54,6,20
jqte,jqte,,0,2,0,2,2,2,1,100
taffydb,taffydb,,1,1,5,2,3,7,1,1
taffy,taffy,,1,0,1,1,5,2,4,1
sortcomparefunction,sortcomparefunction,,0,0,0,0,2,0,9,1
limiting,limiting,,0,0,1,0,4,1,3,1
oracle-fusion-apps,oracle-fusion-apps,,1,3,6,4,3,10,4,200
hwpf,hwpf,,1,0,2,1,4,3,3,1
windows-integrated-auth,windows-integrated-auth,,3,0,7,3,14,10,8,1
rowcommand,rowcommand,,3,0,3,3,9,6,8,1
elevated-privileges,elevated-privileges,,6,9,16,15,20,31,8,50
login-required,login-required,,3,1,5,4,4,9,0,1
mockjax,mockjax,,0,0,0,0,5,0,1,1
checkpoint,checkpoint,,13,7,18,20,36,38,0,1
phpcassa,phpcassa,,0,0,0,0,1,0,2,1
calendarkit,calendarkit,,0,0,2,0,2,2,13,1
usermanager,usermanager,,4,3,5,7,5,12,8,1
buildconfiguration,buildconfiguration,,3,3,6,6,18,12,9,1
ibm-cloud-applaunch,ibm-cloud-applaunch,,0,0,0,0,2,0,6,1
ocra,ocra,,1,1,2,2,5,4,12,1
output-caching,output-caching,,1,0,0,1,2,1,8,1
web-farm-framework,web-farm-framework,,0,0,4,0,2,4,8,1
viewwillappear,viewwillappear,,1,3,5,4,16,9,13,200
cheshire,cheshire,,2,0,1,2,1,3,2,1
textwriter,textwriter,,1,1,2,2,3,4,8,1
httpbrowsercapabilities,httpbrowsercapabilities,,0,0,2,0,4,2,8,1
aspx-user-control,aspx-user-control,,5,5,10,10,15,20,8,1
linqkit,linqkit,,2,3,4,5,13,9,8,50
qualys,qualys,,2,0,1,2,5,3,4,1
bluetooth-keyboard,bluetooth-keyboard,,1,2,0,3,3,3,3,100
packager,packager,,2,2,3,4,7,7,1,1
datatable-buttons,datatable-buttons,,1,2,4,3,3,7,1,100
ecmascript-harmony,ecmascript-harmony,,0,0,1,0,2,1,1,1
redmi-device,redmi-device,,4,2,7,6,13,13,3,1
wso2as,wso2as,,0,0,0,0,4,0,14,1
servercontrols,servercontrols,,0,0,0,0,3,0,8,1
adam,adam,,4,3,5,7,6,12,0,1
pathtoolongexception,pathtoolongexception,,0,2,2,2,4,4,8,100
composite-literals,composite-literals,,1,1,3,2,5,5,6,1
output-clause,output-clause,,1,0,1,1,4,2,4,1
happybase,happybase,,6,3,9,9,8,18,2,1
simplyscroll,simplyscroll,,0,0,0,0,1,0,1,1
maven-jetty-plugin,maven-jetty-plugin,,2,5,7,7,14,14,3,150
authenticode,authenticode,,1,2,6,3,16,9,8,100
mpmovieplayercontroller,mpmovieplayercontroller,,1,0,1,1,7,2,13,1
and-operator,and-operator,,1,1,4,2,4,6,0,1
webpack-dev-middleware,webpack-dev-middleware,,5,5,18,10,16,28,1,1
cascading,cascading,,2,5,9,7,17,16,8,150
strict,strict,,5,6,15,11,39,26,1,20
51degrees,51degrees,,0,0,1,0,2,1,8,1
docker-engine,docker-engine,,5,5,7,10,12,17,6,1
uitextviewdelegate,uitextviewdelegate,,3,5,5,8,17,13,13,66.666667
mysql-logic,mysql-logic,,0,0,1,0,3,1,4,1
unauthorized,unauthorized,,13,11,24,24,42,48,4,1
xna-4.0,xna-4.0,,2,1,10,3,6,13,8,1
typename,typename,,3,5,8,8,20,16,9,66.666667
localbroadcastmanager,localbroadcastmanager,,3,0,5,3,17,8,3,1
springmockito,springmockito,,2,3,4,5,12,9,3,50
left-to-right,left-to-right,,2,3,6,5,6,11,3,50
magento-1.9.2.4,magento-1.9.2.4,,1,1,0,2,1,2,4,1
documentum-dql,documentum-dql,,2,2,1,4,6,5,16,1
content-negotiation,content-negotiation,,4,5,3,9,10,12,3,25
matrix-decomposition,matrix-decomposition,,1,1,7,2,10,9,0,1
tclsh,tclsh,,1,2,3,3,5,6,0,100
spring-remoting,spring-remoting,,1,3,2,4,5,6,3,200
uilaunchimagefile,uilaunchimagefile,,0,0,0,0,1,0,13,1
polymer-1.x,polymer-1.x,,0,0,1,0,3,1,1,1
ms-access-2003,ms-access-2003,,0,4,7,4,10,11,5,300
blackfire,blackfire,,2,1,2,3,5,5,4,1
asgardcms,asgardcms,,2,0,2,2,2,4,4,1
glulookat,glulookat,,0,0,1,0,3,1,9,1
simpl-schema,simpl-schema,,0,1,2,1,7,3,1,1
birthday-paradox,birthday-paradox,,0,0,2,0,2,2,0,1
crypto-obfuscator,crypto-obfuscator,,0,1,3,1,2,4,8,1
replaceregexp,replaceregexp,,0,0,0,0,3,0,8,1
seqan,seqan,,0,0,1,0,1,1,9,1
onkeydown,onkeydown,,7,5,13,12,34,25,1,1
image-preloader,image-preloader,,2,1,1,3,5,4,1,1
axiom,axiom,,1,0,3,1,6,4,3,1
code-view,code-view,,1,0,0,1,2,1,9,1
mpeg-4,mpeg-4,,2,0,9,2,9,11,13,1
jcodec,jcodec,,3,2,3,5,8,8,13,1
convertapi,convertapi,,3,4,4,7,8,11,8,33.333333
surface-hub,surface-hub,,0,1,0,1,2,1,8,1
read-write,read-write,,20,11,25,31,60,56,0,1
tag-cloud,tag-cloud,,1,1,2,2,5,4,4,1
mutation-testing,mutation-testing,,5,6,7,11,10,18,3,20
squirrelmail,squirrelmail,,1,0,1,1,1,2,1,1
nodejs-jszip,nodejs-jszip,,0,1,1,1,3,2,1,1
graphdiff,graphdiff,,0,0,1,0,2,1,8,1
selectcheckboxmenu,selectcheckboxmenu,,1,1,1,2,4,3,3,1
cloudfoundry-uaa,cloudfoundry-uaa,,3,10,18,13,17,31,3,233.333333
sunspot-rails,sunspot-rails,,1,2,2,3,15,5,12,100
whois,whois,,6,5,13,11,28,24,12,1
whois-ruby,whois-ruby,,1,0,4,1,1,5,12,1
wmctrl,wmctrl,,3,2,3,5,6,8,9,1
frida,frida,,11,11,17,22,15,39,3,1
wcf-web-api,wcf-web-api,,0,0,1,0,4,1,8,1
odbcdatareader,odbcdatareader,,0,1,2,1,1,3,4,1
mobileiron,mobileiron,,5,3,5,8,4,13,13,1
calabash-ios,calabash-ios,,1,0,2,1,7,3,3,1
nurbs,nurbs,,6,1,8,7,6,15,0,1
imaging,imaging,,6,6,12,12,21,24,0,1
liipimaginebundle,liipimaginebundle,,4,5,11,9,7,20,4,25
ithit-webdav-server,ithit-webdav-server,,0,2,1,2,8,3,8,100
boofcv,boofcv,,4,1,6,5,4,11,3,1
fluent-nhibernate-mapping,fluent-nhibernate-mapping,,9,3,7,12,17,19,8,1
symfony-2.2,symfony-2.2,,0,0,0,0,2,0,4,1
perplexity,perplexity,,3,3,6,6,5,12,0,1
font-style,font-style,,2,2,3,4,9,7,8,1
merchant-account,merchant-account,,1,0,2,1,2,3,4,1
block-cipher,block-cipher,,6,5,12,11,17,23,6,1
gemset,gemset,,0,0,0,0,1,0,12,1
global.asa,global.asa,,0,1,1,1,3,2,8,1
qcolordialog,qcolordialog,,0,0,1,0,3,1,0,1
mailitem,mailitem,,2,3,12,5,19,17,5,50
decodeuricomponent,decodeuricomponent,,1,0,4,1,11,5,1,1
parsefloat,parsefloat,,5,1,9,6,14,15,1,1
file-moving,file-moving,,0,0,0,0,8,0,0,1
envoyproxy,envoyproxy,,36,32,57,68,35,125,6,1
stringification,stringification,,1,1,4,2,6,6,9,1
ocmock,ocmock,,1,0,4,1,14,5,13,1
cstringio,cstringio,,0,0,2,0,7,2,0,1
asciidoctor-pdf,asciidoctor-pdf,,0,2,7,2,6,9,3,100
robust,robust,,8,4,12,12,15,24,0,1
bonita,bonita,,10,2,9,12,13,21,3,1
site-prism,site-prism,,0,2,3,2,9,5,12,100
checkmark,checkmark,,6,0,3,6,12,9,13,1
nsenter,nsenter,,0,0,0,0,4,0,6,1
chessboard.js,chessboard.js,,2,2,3,4,6,7,0,1
hadoop-archive,hadoop-archive,,0,0,0,0,1,0,2,1
configurationelement,configurationelement,,0,0,0,0,3,0,8,1
google-latitude,google-latitude,,1,0,2,1,4,3,3,1
system.data,system.data,,1,5,8,6,7,14,8,400
rman,rman,,2,1,12,3,12,15,4,1
tracker,tracker,,9,5,19,14,16,33,8,1
replacewith,replacewith,,1,2,8,3,18,11,1,100
postgresql-copy,postgresql-copy,,6,4,6,10,9,16,4,1
mod-perl2,mod-perl2,,0,5,1,5,5,6,4,400
tiny-tds,tiny-tds,,4,3,3,7,7,10,12,1
typhoeus,typhoeus,,1,0,2,1,3,3,12,1
wns,wns,,3,3,2,6,12,8,8,1
truthiness,truthiness,,2,3,6,5,11,11,0,50
sniffer,sniffer,,5,2,12,7,11,19,9,1
teststand,teststand,,0,0,2,0,5,2,8,1
parallel-collections,parallel-collections,,1,1,0,2,2,2,2,1
openfst,openfst,,2,0,2,2,6,4,9,1
cpp-core-guidelines,cpp-core-guidelines,,1,3,8,4,13,12,9,200
heavy-computation,heavy-computation,,0,0,2,0,1,2,3,1
renderx,renderx,,2,0,1,2,2,3,3,1
mediawiki-extensions,mediawiki-extensions,,11,7,23,18,17,41,4,1
brat,brat,,1,1,1,2,4,3,0,1
shinyproxy,shinyproxy,,5,8,11,13,13,24,0,60
office-fabric,office-fabric,,10,8,11,18,17,29,1,1
public-key-pinning,public-key-pinning,,5,3,3,8,5,11,6,1
postgresql-initdb,postgresql-initdb,,1,1,1,2,2,3,4,1
profanity,profanity,,1,1,1,2,4,3,0,1
installshield-2016,installshield-2016,,1,1,3,2,4,5,8,1
aws-automation,aws-automation,,1,3,5,4,3,9,6,200
aws-ssm-document,aws-ssm-document,,3,1,3,4,4,7,6,1
google-deployment-manager,google-deployment-manager,,21,19,37,40,32,77,6,1
acronym,acronym,,2,1,2,3,7,5,0,1
transifex,transifex,,0,0,2,0,3,2,0,1
ocamllex,ocamllex,,1,0,3,1,5,4,0,1
reuters,reuters,,1,1,4,2,3,6,0,1
thomson-reuters-eikon,thomson-reuters-eikon,,5,0,2,5,3,7,0,1
table-relationships,table-relationships,,1,1,4,2,22,6,4,1
nested-sets,nested-sets,,3,7,7,10,12,17,4,133.333333
jqtree,jqtree,,1,2,2,3,2,5,1,100
f#-giraffe,f#-giraffe,,4,3,3,7,5,10,8,1
data-kinds,data-kinds,,2,10,9,12,15,21,2,400
program-flow,program-flow,,1,0,0,1,4,1,0,1
physical-design,physical-design,,2,1,1,3,4,4,4,1
fgsl,fgsl,,0,0,0,0,1,0,9,1
cmath,cmath,,4,6,12,10,11,22,9,50
paket,paket,,4,5,8,9,12,17,8,25
reasoner,reasoner,,3,2,5,5,13,10,2,1
rootviewcontroller,rootviewcontroller,,3,5,11,8,24,19,13,66.666667
reportserver,reportserver,,5,6,5,11,11,16,4,20
jfrog-xray,jfrog-xray,,6,5,7,11,7,18,6,1
ghostscript.net,ghostscript.net,,3,6,4,9,14,13,8,100
gtktreeview,gtktreeview,,6,0,2,6,10,8,9,1
reverse-lookup,reverse-lookup,,1,0,1,1,3,2,0,1
sublime-build,sublime-build,,1,1,3,2,5,5,0,1
invision-power-board,invision-power-board,,0,1,2,1,4,3,4,1
laravel-events,laravel-events,,7,4,12,11,12,23,4,1
lamemp3,lamemp3,,3,0,3,3,4,6,13,1
ezapi,ezapi,,0,2,0,2,1,2,4,100
sqlalchemy-utils,sqlalchemy-utils,,3,2,7,5,9,12,0,1
qtkit,qtkit,,0,0,1,0,1,1,13,1
refinerycms,refinerycms,,1,0,3,1,3,4,12,1
biomart,biomart,,3,0,4,3,21,7,0,1
wcm,wcm,,2,1,3,3,1,6,3,1
diagflow,diagflow,,0,1,1,1,5,2,13,1
ihaskell,ihaskell,,3,0,2,3,3,5,2,1
docker-in-docker,docker-in-docker,,7,5,9,12,31,21,6,1
rexx,rexx,,2,5,5,7,11,12,4,150
ispf,ispf,,2,0,2,2,5,4,4,1
awakefromnib,awakefromnib,,0,0,3,0,4,3,13,1
genson,genson,,4,1,2,5,7,7,3,1
gitstack,gitstack,,0,0,0,0,4,0,6,1
ctrlp,ctrlp,,0,2,1,2,5,3,9,100
validate-request,validate-request,,0,0,0,0,4,0,8,1
hyperterm,hyperterm,,0,1,1,1,2,2,9,1
datagridviewimagecolumn,datagridviewimagecolumn,,1,0,3,1,5,4,8,1
gpsbabel,gpsbabel,,0,0,0,0,1,0,1,1
aws-service-catalog,aws-service-catalog,,4,2,3,6,2,9,6,1
node-oracle,node-oracle,,2,1,0,3,7,3,1,1
twitch-api,twitch-api,,10,11,17,21,5,38,1,10
izip,izip,,0,0,1,0,1,1,0,1
cakephp-helper,cakephp-helper,,0,0,0,0,1,0,4,1
masonry-ios-osx,masonry-ios-osx,,2,0,1,2,3,3,13,1
conditional-aggregation,conditional-aggregation,,2,1,1,3,2,4,4,1
esri-maps,esri-maps,,1,3,9,4,15,13,1,200
video-toolbox,video-toolbox,,3,7,9,10,12,19,13,133.333333
oledbexception,oledbexception,,3,2,6,5,5,11,8,1
mapzen,mapzen,,0,1,0,1,3,1,1,1
tangram,tangram,,1,0,4,1,1,5,13,1
pci-compliance,pci-compliance,,8,3,11,11,25,22,4,1
classyshark,classyshark,,0,0,0,0,1,0,3,1
officedev,officedev,,1,4,3,5,10,8,5,300
perfect-numbers,perfect-numbers,,1,4,3,5,9,8,0,300
pts,pts,,3,2,7,5,6,12,13,1
insmod,insmod,,4,1,2,5,6,7,9,1
scotchbox,scotchbox,,0,1,3,1,4,4,4,1
spark-hive,spark-hive,,3,3,5,6,12,11,2,1
cts,cts,,1,3,9,4,14,13,3,200
moengage,moengage,,1,2,2,3,2,5,1,100
pluggable,pluggable,,3,1,0,4,4,4,4,1
gulp-livereload,gulp-livereload,,0,0,1,0,4,1,1,1
soot,soot,,0,5,11,5,15,16,3,400
subsonic3,subsonic3,,0,0,1,0,2,1,8,1
clockpicker,clockpicker,,0,2,4,2,6,6,1,100
workbench,workbench,,11,8,34,19,60,53,4,1
hiera,hiera,,9,9,16,18,22,34,6,1
uninstaller,uninstaller,,4,2,7,6,14,13,8,1
remote-file-inclusion,remote-file-inclusion,,0,0,2,0,1,2,12,1
filehelpers,filehelpers,,10,5,17,15,25,32,8,1
microsoft-sync-framework,microsoft-sync-framework,,3,3,6,6,11,12,8,1
pf-ring,pf-ring,,1,2,0,3,1,3,9,100
spnego,spnego,,8,6,14,14,25,28,2,1
kundera,kundera,,1,0,1,1,4,2,2,1
vcg,vcg,,0,0,2,0,7,2,0,1
ndepend,ndepend,,0,1,4,1,12,5,8,1
cqlinq,cqlinq,,0,1,2,1,2,3,8,1
django-jenkins,django-jenkins,,1,0,0,1,1,1,6,1
python-3.7,python-3.7,,532,625,477,1157,162,1634,0,17.481203
dvorak,dvorak,,1,1,3,2,1,5,13,1
auto-versioning,auto-versioning,,3,0,1,3,2,4,8,1
assembly-attributes,assembly-attributes,,0,0,0,0,2,0,8,1
subversion-edge,subversion-edge,,1,2,6,3,3,9,6,100
one2many,one2many,,3,4,3,7,13,10,0,33.333333
mfmessagecomposeview,mfmessagecomposeview,,0,3,4,3,9,7,13,200
rncryptor,rncryptor,,1,1,3,2,6,5,13,1
handles,handles,,0,0,0,0,7,0,9,1
ta-lib,ta-lib,,7,7,19,14,26,33,0,1
sendasynchronousrequest,sendasynchronousrequest,,2,1,2,3,5,5,14,1
ibm-rational,ibm-rational,,3,2,9,5,9,14,3,1
formatted,formatted,,1,2,0,3,3,3,9,100
security-warning,security-warning,,0,1,2,1,1,3,5,1
trending,trending,,0,2,1,2,4,3,0,100
cloud-security,cloud-security,,1,0,3,1,3,4,6,1
osrm,osrm,,9,11,16,20,27,36,1,22.222222
web-based,web-based,,1,2,0,3,5,3,8,100
partial-index,partial-index,,1,0,2,1,4,3,1,1
image-rendering,image-rendering,,2,2,4,4,10,8,1,1
registerhelper,registerhelper,,0,0,0,0,2,0,1,1
n,n,,1,1,3,2,8,5,1,1
libalsa,libalsa,,7,1,4,8,10,12,13,1
threadcontext,threadcontext,,1,1,1,2,6,3,3,1
isml,isml,,0,0,2,0,4,2,4,1
jboss-logging,jboss-logging,,2,2,3,4,9,7,3,1
openpose,openpose,,12,15,13,27,4,40,0,25
turtle-mock,turtle-mock,,0,0,0,0,2,0,9,1
audit-tables,audit-tables,,1,3,3,4,3,7,4,200
spring-junit,spring-junit,,2,1,3,3,9,6,3,1
sharepoint-addin,sharepoint-addin,,6,5,5,11,9,16,8,1
security-constraint,security-constraint,,1,0,1,1,6,2,3,1
oz,oz,,3,0,6,3,8,9,2,1
mozart,mozart,,3,0,6,3,7,9,2,1
deployit,deployit,,5,0,1,5,5,6,6,1
fasthttp,fasthttp,,2,2,3,4,6,7,6,1
docker-copy,docker-copy,,1,2,2,3,5,5,6,100
mysqladmin,mysqladmin,,2,2,1,4,7,5,4,1
bcrypt-ruby,bcrypt-ruby,,0,1,0,1,12,1,12,1
erubis,erubis,,0,0,1,0,3,1,12,1
twitter-finagle,twitter-finagle,,1,1,5,2,9,7,2,1
finatra,finatra,,0,1,2,1,5,3,2,1
webexception,webexception,,1,1,1,2,6,3,8,1
gridstack,gridstack,,6,7,8,13,20,21,1,16.666667
mathnet-filtering,mathnet-filtering,,0,0,0,0,3,0,8,1
graphene2,graphene2,,0,0,0,0,10,0,3,1
home-button,home-button,,0,2,6,2,6,8,3,100
pytest-html,pytest-html,,3,5,5,8,17,13,0,66.666667
nsattributedstringkey,nsattributedstringkey,,3,2,4,5,12,9,13,1
htmlspecialchars,htmlspecialchars,,6,2,11,8,26,19,4,1
lxml.html,lxml.html,,1,4,6,5,10,11,0,300
working-set,working-set,,0,3,3,3,2,6,3,200
form-parameter,form-parameter,,0,0,2,0,4,2,3,1
ios-universal-framework,ios-universal-framework,,2,0,2,2,3,4,13,1
azerty-keyboard,azerty-keyboard,,0,1,0,1,3,1,13,1
directinput,directinput,,3,5,4,8,9,12,8,66.666667
generative,generative,,1,3,3,4,5,7,0,200
android-for-work,android-for-work,,6,3,9,9,14,18,3,1
android-management-api,android-management-api,,21,12,14,33,10,47,3,1
tinc,tinc,,1,0,0,1,2,1,6,1
restforce,restforce,,0,0,0,0,5,0,12,1
plack,plack,,0,1,0,1,7,1,9,1
nspasteboard,nspasteboard,,7,2,6,9,11,15,13,1
tibco-ems,tibco-ems,,3,7,8,10,23,18,3,133.333333
initialization-vector,initialization-vector,,1,0,3,1,10,4,6,1
slab,slab,,1,0,0,1,1,1,9,1
gwt-material-design,gwt-material-design,,2,0,7,2,3,9,3,1
gritter,gritter,,0,0,0,0,2,0,3,1
zerobrane,zerobrane,,1,2,8,3,15,11,9,100
inputview,inputview,,4,2,2,6,6,8,13,1
startprocessinfo,startprocessinfo,,1,0,2,1,1,3,8,1
webtask,webtask,,0,0,1,0,9,1,1,1
dfm,dfm,,3,3,1,6,7,7,9,1
ifndef,ifndef,,0,0,4,0,8,4,9,1
ezplatform,ezplatform,,0,2,4,2,4,6,4,100
editorfor,editorfor,,0,2,2,2,19,4,8,100
accelerated-c++,accelerated-c++,,0,0,0,0,2,0,9,1
matlab-java,matlab-java,,1,0,0,1,4,1,3,1
side-by-side,side-by-side,,0,3,9,3,10,12,8,200
type-declaration,type-declaration,,8,6,15,14,12,29,1,1
freeimage,freeimage,,2,3,4,5,13,9,9,50
babel-core,babel-core,,3,0,8,3,10,11,1,1
metacharacters,metacharacters,,1,1,8,2,11,10,0,1
mobx-state-tree,mobx-state-tree,,14,13,30,27,28,57,1,1
django-shell,django-shell,,2,1,4,3,4,7,0,1
notificationservices,notificationservices,,1,2,1,3,4,4,3,100
kontakt.io,kontakt.io,,1,3,6,4,6,10,3,200
wordpress-hook,wordpress-hook,,4,3,15,7,25,22,4,1
rhadoop,rhadoop,,0,2,2,2,3,4,2,100
bucket-sort,bucket-sort,,3,0,8,3,6,11,0,1
node-soap,node-soap,,8,6,14,14,29,28,3,1
nsxmlparser,nsxmlparser,,3,5,4,8,7,12,13,66.666667
qtip,qtip,,0,2,4,2,6,6,1,100
http-request-parameters,http-request-parameters,,5,8,15,13,22,28,3,60
vmdk,vmdk,,1,1,7,2,8,9,6,1
skaudionode,skaudionode,,1,1,2,2,5,4,13,1
asp.net-mvc-areas,asp.net-mvc-areas,,1,6,17,7,19,24,8,500
eip,eip,,3,1,5,4,11,9,6,1
iphone-64bit,iphone-64bit,,0,0,0,0,1,0,13,1
nsapplescript,nsapplescript,,3,0,3,3,2,6,13,1
javaw,javaw,,3,0,2,3,3,5,3,1
call-user-func-array,call-user-func-array,,2,0,1,2,9,3,4,1
node-windows,node-windows,,3,2,4,5,6,9,1,1
cffunction,cffunction,,0,2,1,2,4,3,4,100
windows-vista,windows-vista,,1,2,4,3,11,7,9,100
degrees,degrees,,7,4,5,11,12,16,0,1
selecteditem,selecteditem,,15,6,20,21,48,41,8,1
boost-logging,boost-logging,,1,0,8,1,6,9,9,1
magic-square,magic-square,,1,1,8,2,11,10,0,1
objective-c-nullability,objective-c-nullability,,0,0,1,0,2,1,13,1
language-construct,language-construct,,0,0,1,0,2,1,9,1
viewdidappear,viewdidappear,,0,2,10,2,22,12,13,100
viewdidlayoutsubviews,viewdidlayoutsubviews,,0,3,2,3,9,5,13,200
xmobar,xmobar,,0,1,0,1,2,1,2,1
sharpziplib,sharpziplib,,1,3,9,4,15,13,8,200
android-async-http,android-async-http,,1,3,10,4,5,14,3,200
pantheon,pantheon,,3,2,7,5,9,12,4,1
xdgutils,xdgutils,,1,4,8,5,5,13,9,300
tunneling,tunneling,,1,9,19,10,12,29,9,800
folder-permissions,folder-permissions,,1,4,7,5,10,12,9,300
packagereference,packagereference,,7,7,11,14,16,25,8,1
tablename,tablename,,2,7,3,9,13,12,4,250
shared-secret,shared-secret,,3,1,2,4,4,6,6,1
printf-debugging,printf-debugging,,1,1,3,2,2,5,9,1
finalization,finalization,,0,1,2,1,4,3,3,1
java-console,java-console,,1,0,0,1,3,1,3,1
wait-free,wait-free,,1,0,0,1,4,1,9,1
to-timestamp,to-timestamp,,1,2,1,3,2,4,4,100
lc3,lc3,,10,0,10,10,41,20,9,1
variable-types,variable-types,,1,2,4,3,10,7,9,100
atomic-design,atomic-design,,6,1,4,7,4,11,1,1
domainservices,domainservices,,1,1,4,2,3,6,8,1
kendo-editor,kendo-editor,,1,3,3,4,6,7,1,200
cppdepend,cppdepend,,1,0,0,1,3,1,9,1
desktop-shortcut,desktop-shortcut,,4,5,14,9,17,23,9,25
dataimporthandler,dataimporthandler,,2,1,10,3,16,13,2,1
global-hotkey,global-hotkey,,1,1,4,2,3,6,8,1
activeview,activeview,,0,0,0,0,2,0,1,1
requestfactory,requestfactory,,0,0,0,0,3,0,3,1
k6,k6,,3,9,8,12,21,20,3,200
dacl,dacl,,2,3,3,5,3,8,9,50
controltemplates,controltemplates,,0,0,0,0,2,0,8,1
control-template,control-template,,0,0,0,0,1,0,8,1
protocol-relative,protocol-relative,,0,0,1,0,4,1,1,1
caldav,caldav,,6,11,19,17,25,36,4,83.333333
haxeflixel,haxeflixel,,0,0,1,0,17,1,9,1
slidingdrawer,slidingdrawer,,1,0,2,1,5,3,3,1
phase,phase,,3,6,8,9,18,17,0,100
celluloid,celluloid,,0,0,0,0,3,0,12,1
jboss-web,jboss-web,,0,0,2,0,3,2,3,1
redhat-bpm,redhat-bpm,,1,2,2,3,10,5,3,100
ahp,ahp,,1,0,1,1,4,2,0,1
hunchentoot,hunchentoot,,3,1,5,4,8,9,0,1
ar,ar,,3,7,4,10,10,14,9,133.333333
has-one-through,has-one-through,,1,0,1,1,2,2,12,1
inexact-arithmetic,inexact-arithmetic,,0,0,0,0,1,0,0,1
python-beautifultable,python-beautifultable,,3,0,4,3,5,7,0,1
angular2-resolve,angular2-resolve,,0,0,1,0,2,1,1,1
rustup,rustup,,1,1,2,2,6,4,9,1
accesscontrolservice,accesscontrolservice,,0,0,1,0,1,1,8,1
ou,ou,,0,2,10,2,11,12,8,100
organizational-unit,organizational-unit,,1,1,2,2,5,4,8,1
mouse-pointer,mouse-pointer,,2,0,3,2,6,5,8,1
negotiate,negotiate,,2,2,2,4,5,6,8,1
description-logic,description-logic,,3,4,12,7,8,19,2,33.333333
swiftydropbox,swiftydropbox,,1,2,4,3,10,7,13,100
bstr,bstr,,2,0,3,2,6,5,8,1
draft-js-plugins,draft-js-plugins,,3,6,13,9,25,22,1,100
pushd,pushd,,2,3,3,5,6,8,9,50
nested-properties,nested-properties,,3,2,3,5,7,8,3,1
cs193p,cs193p,,0,0,1,0,1,1,13,1
netmq,netmq,,6,4,13,10,9,23,8,1
ajaxsubmit,ajaxsubmit,,0,0,0,0,5,0,1,1
gnat-gps,gnat-gps,,3,1,4,4,11,8,9,1
on-location-changed,on-location-changed,,0,1,3,1,5,4,3,1
tooling,tooling,,3,2,3,5,6,8,8,1
apache-velocity,apache-velocity,,2,7,7,9,11,16,3,250
angstrom-linux,angstrom-linux,,0,1,0,1,6,1,9,1
fsck,fsck,,2,0,3,2,7,5,9,1
sstream,sstream,,1,0,3,1,11,4,9,1
procmon,procmon,,2,0,8,2,2,10,9,1
ion,ion,,3,5,12,8,21,20,3,66.666667
getimagedata,getimagedata,,3,2,6,5,12,11,1,1
laravel-translatable,laravel-translatable,,0,0,3,0,7,3,4,1
custom-build,custom-build,,0,1,2,1,2,3,8,1
was,was,,3,8,18,11,9,29,3,166.666667
touchesended,touchesended,,1,0,2,1,2,3,13,1
tizen-emulator,tizen-emulator,,5,3,8,8,13,16,13,1
elpy,elpy,,4,0,2,4,7,6,0,1
polyml,polyml,,1,2,1,3,3,4,2,100
knuth-morris-pratt,knuth-morris-pratt,,1,2,2,3,7,5,0,100
hashchange,hashchange,,0,1,5,1,6,6,1,1
popstate,popstate,,7,4,6,11,10,17,1,1
django-1.6,django-1.6,,1,0,3,1,4,4,0,1
laraadmin,laraadmin,,6,0,3,6,5,9,4,1
laravel-admin,laravel-admin,,5,1,8,6,2,14,4,1
relational-model,relational-model,,1,0,3,1,8,4,4,1
url-masking,url-masking,,6,3,9,9,6,18,4,1
purchase-order,purchase-order,,3,3,5,6,8,11,4,1
badsqlgrammarexception,badsqlgrammarexception,,1,0,2,1,3,3,3,1
amd-processor,amd-processor,,8,9,9,17,8,26,9,12.5
login-script,login-script,,10,7,9,17,28,26,4,1
convertall,convertall,,0,0,1,0,2,1,8,1
morgan,morgan,,5,15,20,20,19,40,1,200
chain-of-responsibility,chain-of-responsibility,,6,2,5,8,11,13,3,1
qcompleter,qcompleter,,5,6,9,11,16,20,0,20
azure-management,azure-management,,1,0,5,1,8,6,8,1
alloca,alloca,,3,0,3,3,6,6,9,1
getattribute,getattribute,,7,9,23,16,27,39,3,28.571429
serverxmlhttp,serverxmlhttp,,3,4,2,7,5,9,5,33.333333
const-reference,const-reference,,4,0,8,4,11,12,9,1
runbook,runbook,,3,5,7,8,18,15,8,66.666667
saltedhash,saltedhash,,0,1,0,1,2,1,4,1
readelf,readelf,,3,3,6,6,10,12,9,1
parse-framework,parse-framework,,0,0,0,0,1,0,1,1
password-storage,password-storage,,0,3,0,3,4,3,4,200
yii1.x,yii1.x,,12,8,20,20,36,40,4,1
messagecontract,messagecontract,,0,0,1,0,4,1,8,1
boost-mpl,boost-mpl,,0,0,3,0,11,3,9,1
io-buffering,io-buffering,,0,1,1,1,2,2,9,1
populus,populus,,0,0,0,0,1,0,6,1
deinit,deinit,,9,2,4,11,10,15,13,1
cloneable,cloneable,,0,2,8,2,9,10,3,100
texttemplate,texttemplate,,1,0,1,1,2,2,8,1
nstextstorage,nstextstorage,,4,2,5,6,6,11,13,1
openh264,openh264,,3,8,3,11,16,14,13,166.666667
asm.js,asm.js,,3,0,3,3,8,6,1,1
type-punning,type-punning,,8,3,9,11,13,20,9,1
radial,radial,,1,2,6,3,8,9,0,100
diffmerge,diffmerge,,0,0,3,0,3,3,6,1
get-winevent,get-winevent,,0,2,10,2,12,12,8,100
swiftsoup,swiftsoup,,3,4,8,7,12,15,13,33.333333
ice-cube,ice-cube,,0,0,2,0,4,2,12,1
gclient,gclient,,0,1,0,1,4,1,9,1
qstyleditemdelegate,qstyleditemdelegate,,3,4,6,7,19,13,9,33.333333
aabb,aabb,,4,4,5,8,11,13,0,1
dialect,dialect,,4,3,11,7,8,18,3,1
unpkg,unpkg,,3,0,4,3,5,7,1,1
podscms,podscms,,0,2,2,2,6,4,4,100
edsdk,edsdk,,1,3,3,4,11,7,8,200
mailboxprocessor,mailboxprocessor,,3,0,2,3,7,5,8,1
otapi,otapi,,0,0,1,0,7,1,9,1
motorengine,motorengine,,0,2,0,2,2,2,1,100
mongoose-im,mongoose-im,,2,1,18,3,12,21,3,1
desctools,desctools,,2,1,2,3,10,5,0,1
maxifs,maxifs,,2,1,2,3,3,5,5,1
project-hosting,project-hosting,,0,0,0,0,2,0,4,1
monkeyc,monkeyc,,0,0,2,0,3,2,3,1
on-the-fly,on-the-fly,,1,2,3,3,12,6,0,100
libpfm4,libpfm4,,0,0,0,0,1,0,9,1
stdasync,stdasync,,3,3,8,6,21,14,9,1
xinput,xinput,,2,5,5,7,10,12,9,150
ng-annotate,ng-annotate,,0,1,0,1,2,1,1,1
recycle-bin,recycle-bin,,4,5,13,9,15,22,9,25
ensembles,ensembles,,1,3,1,4,14,5,13,200
google-project-fi,google-project-fi,,0,0,0,0,2,0,3,1
mode-analytics,mode-analytics,,0,2,0,2,3,2,4,100
sharepointframework,sharepointframework,,3,3,13,6,24,19,8,1
mesi,mesi,,2,0,3,2,7,5,9,1
http-content-length,http-content-length,,5,1,8,6,7,14,4,1
snaplogic,snaplogic,,0,1,7,1,6,8,3,1
shadow-copy,shadow-copy,,1,1,0,2,7,2,8,1
d3-cloud,d3-cloud,,0,1,1,1,8,2,1,1
meteor-easy-search,meteor-easy-search,,1,0,0,1,6,1,1,1
sliding,sliding,,1,1,3,2,13,5,1,1
legacy-app,legacy-app,,0,0,2,0,5,2,3,1
azure-storage-queues,azure-storage-queues,,9,8,24,17,40,41,8,1
gota,gota,,0,4,1,4,3,5,6,300
cache-manifest,cache-manifest,,1,0,3,1,4,4,1,1
pscmdlet,pscmdlet,,0,0,4,0,6,4,8,1
remarks,remarks,,0,0,0,0,2,0,8,1
stdint,stdint,,5,3,2,8,12,10,9,1
node-ffi,node-ffi,,6,7,11,13,15,24,1,16.666667
cross-fade,cross-fade,,1,4,7,5,9,12,1,300
process-group,process-group,,0,2,2,2,2,4,9,100
notin,notin,,4,6,10,10,25,20,4,50
backing-field,backing-field,,0,3,1,3,3,4,8,200
newid,newid,,1,0,2,1,2,3,4,1
java-service-wrapper,java-service-wrapper,,0,1,4,1,8,5,3,1
mathprog,mathprog,,1,0,0,1,4,1,0,1
powerpoint-2010,powerpoint-2010,,2,2,1,4,6,5,5,1
attachmate-extra,attachmate-extra,,0,0,3,0,3,3,8,1
taps,taps,,0,0,0,0,1,0,12,1
scope-resolution,scope-resolution,,1,0,1,1,8,2,9,1
beast-websockets,beast-websockets,,4,3,6,7,4,13,9,1
utplsql,utplsql,,2,1,4,3,2,7,4,1
phrases,phrases,,0,0,0,0,6,0,0,1
requestdispatcher,requestdispatcher,,4,6,6,10,21,16,3,50
aasm,aasm,,2,2,11,4,13,15,12,1
overrun,overrun,,0,0,1,0,1,1,9,1
drf-queryset,drf-queryset,,4,2,5,6,11,11,0,1
ebextensions,ebextensions,,6,7,13,13,17,26,6,16.666667
ravendb-studio,ravendb-studio,,2,1,3,3,10,6,8,1
automatic-updates,automatic-updates,,2,0,5,2,12,7,5,1
gulp-less,gulp-less,,2,1,4,3,12,7,1,1
virtocommerce,virtocommerce,,2,1,1,3,5,4,8,1
zendesk-app,zendesk-app,,3,0,5,3,6,8,4,1
rgbcolor,rgbcolor,,0,0,1,0,6,1,0,1
setimmediate,setimmediate,,0,1,0,1,6,1,1,1
entryset,entryset,,1,0,3,1,5,4,3,1
mongodb-atlas,mongodb-atlas,,53,80,58,133,54,191,1,50.943396
table-statistics,table-statistics,,3,1,2,4,2,6,4,1
firefox-headless,firefox-headless,,4,2,7,6,9,13,3,1
lossless,lossless,,5,0,1,5,3,6,13,1
libxslt,libxslt,,0,2,5,2,3,7,3,100
elapsed,elapsed,,2,1,1,3,4,4,6,1
git-difftool,git-difftool,,1,3,9,4,12,13,6,200
androidimageslider,androidimageslider,,5,2,10,7,13,17,3,1
apache-commons-beanutils,apache-commons-beanutils,,4,7,5,11,15,16,3,75
scroll-snap-points,scroll-snap-points,,3,5,11,8,2,19,1,66.666667
key-formal-verification,key-formal-verification,,0,0,1,0,1,1,2,1
enterprisedb,enterprisedb,,3,3,3,6,12,9,4,1
shared-resource,shared-resource,,0,1,2,1,2,3,8,1
sieve,sieve,,5,2,11,7,11,18,0,1
xml-publisher,xml-publisher,,3,1,3,4,5,7,4,1
neighbours,neighbours,,7,2,6,9,11,15,0,1
conductor,conductor,,3,4,4,7,10,11,3,33.333333
social-network-friendship,social-network-friendship,,1,1,1,2,4,3,4,1
local-class,local-class,,1,1,0,2,9,2,9,1
android-googleapiclient,android-googleapiclient,,6,1,3,7,21,10,3,1
ruby-block,ruby-block,,1,0,2,1,6,3,12,1
codeeffects,codeeffects,,0,0,3,0,5,3,3,1
nrules,nrules,,2,2,4,4,1,8,8,1
viewexpiredexception,viewexpiredexception,,1,1,2,2,1,4,3,1
new-project,new-project,,4,1,2,5,7,7,3,1
phong,phong,,4,5,8,9,7,17,9,25
argc,argc,,2,1,7,3,16,10,9,1
ng-submit,ng-submit,,1,0,0,1,10,1,1,1
webvtt,webvtt,,7,5,18,12,16,30,1,1
njsonschema,njsonschema,,1,1,4,2,8,6,8,1
uncaught-exception,uncaught-exception,,2,6,6,8,17,14,4,200
stream-analytics,stream-analytics,,6,2,12,8,13,20,8,1
slate.js,slate.js,,0,0,3,0,5,3,1,1
xml-conduit,xml-conduit,,1,0,2,1,2,3,2,1
const-iterator,const-iterator,,1,7,3,8,15,11,9,600
contextmenustrip,contextmenustrip,,3,5,8,8,16,16,8,66.666667
getopenfilename,getopenfilename,,1,1,5,2,6,7,0,1
roaming-profile,roaming-profile,,0,0,3,0,4,3,8,1
cal,cal,,1,1,2,2,5,4,8,1
bsconfig,bsconfig,,0,0,0,0,3,0,9,1
uilayoutguide,uilayoutguide,,0,0,1,0,5,1,13,1
hierarchyviewer,hierarchyviewer,,0,0,0,0,3,0,3,1
cakephp-bake,cakephp-bake,,0,2,5,2,8,7,4,100
windows-live,windows-live,,0,0,1,0,3,1,4,1
fast-forward,fast-forward,,2,0,1,2,8,3,6,1
in-memory,in-memory,,10,11,21,21,35,42,3,10
global-state,global-state,,2,2,0,4,2,4,1,1
qmenubar,qmenubar,,0,2,2,2,7,4,0,100
content-assist,content-assist,,3,4,10,7,10,17,3,33.333333
react-instantsearch,react-instantsearch,,2,4,4,6,14,10,1,100
sails-skipper,sails-skipper,,1,2,0,3,4,3,1,100
rowdefinition,rowdefinition,,1,0,0,1,2,1,8,1
rs.exe,rs.exe,,2,0,1,2,4,3,4,1
autoresetevent,autoresetevent,,2,1,3,3,4,6,8,1
grunt-contrib-sass,grunt-contrib-sass,,1,1,5,2,5,7,1,1
rms,rms,,4,3,10,7,10,17,0,1
swift-structs,swift-structs,,2,3,5,5,10,10,13,50
qsub,qsub,,5,12,18,17,26,35,0,140
supercomputers,supercomputers,,1,2,4,3,12,7,0,100
hierarchical-bayesian,hierarchical-bayesian,,4,2,11,6,12,17,0,1
applicationwindow,applicationwindow,,2,0,1,2,6,3,9,1
java-package,java-package,,0,2,3,2,6,5,3,100
mkuserlocation,mkuserlocation,,0,0,3,0,3,3,13,1
run-app,run-app,,1,0,2,1,3,3,3,1
argmax,argmax,,10,6,12,16,22,28,0,1
get-event-store,get-event-store,,2,3,3,5,17,8,8,50
hopper,hopper,,0,0,2,0,2,2,9,1
django-1.1,django-1.1,,0,0,0,0,1,0,0,1
xstream-js,xstream-js,,0,1,2,1,4,3,1,1
toothpick-di,toothpick-di,,0,1,2,1,11,3,3,1
cac,cac,,3,2,8,5,6,13,6,1
tasker,tasker,,6,3,5,9,18,14,3,1
lsa,lsa,,1,2,7,3,10,10,0,100
django-manage.py,django-manage.py,,5,2,3,7,15,10,0,1
tla+,tla+,,1,1,6,2,5,8,0,1
tlc,tlc,,1,0,4,1,2,5,0,1
analytic-functions,analytic-functions,,3,9,8,12,8,20,4,200
associativity,associativity,,3,1,5,4,15,9,9,1
canonicalization,canonicalization,,4,3,9,7,11,16,4,1
jwt-auth,jwt-auth,,47,74,21,121,38,142,4,57.446809
stack-allocation,stack-allocation,,1,0,2,1,3,3,9,1
angular-cache,angular-cache,,0,1,1,1,2,2,1,1
document-oriented-db,document-oriented-db,,0,0,0,0,2,0,1,1
multiserver,multiserver,,3,0,3,3,2,6,3,1
updown,updown,,0,0,0,0,1,0,9,1
church-encoding,church-encoding,,7,1,2,8,10,10,2,1
phppowerpoint,phppowerpoint,,1,0,0,1,2,1,4,1
swfloader,swfloader,,2,0,0,2,3,2,13,1
lockless,lockless,,1,1,1,2,5,3,9,1
zend-filter,zend-filter,,1,0,1,1,1,2,4,1
system.net.mail,system.net.mail,,5,4,10,9,13,19,8,1
readerwriterlock,readerwriterlock,,2,4,3,6,4,9,3,100
argument-matching,argument-matching,,1,1,0,2,3,2,0,1
intrinsic-content-size,intrinsic-content-size,,1,4,11,5,11,16,13,300
ios-messages-extension,ios-messages-extension,,0,1,0,1,5,1,13,1
submission,submission,,7,5,15,12,23,27,13,1
debuggervisualizer,debuggervisualizer,,1,1,6,2,17,8,8,1
php-opencloud,php-opencloud,,0,0,0,0,2,0,4,1
mod-evasive,mod-evasive,,0,1,0,1,5,1,4,1
imp,imp,,2,1,4,3,9,7,4,1
cs3,cs3,,0,0,2,0,2,2,13,1
trezor,trezor,,1,0,2,1,7,3,6,1
sse4,sse4,,0,0,2,0,3,2,9,1
strongly-typed-dataset,strongly-typed-dataset,,2,1,1,3,11,4,8,1
kubernetes-python-client,kubernetes-python-client,,6,5,8,11,9,19,6,1
logstash-logback-encoder,logstash-logback-encoder,,0,2,7,2,11,9,3,100
mixed,mixed,,14,3,10,17,14,27,0,1
sbt-buildinfo,sbt-buildinfo,,1,0,0,1,2,1,2,1
methodhandle,methodhandle,,2,1,8,3,12,11,3,1
libgomp,libgomp,,0,1,3,1,3,4,9,1
custom-type,custom-type,,1,1,7,2,10,9,9,1
ondoubleclick,ondoubleclick,,1,0,1,1,3,2,1,1
tridion,tridion,,0,0,2,0,2,2,4,1
dd4t,dd4t,,0,0,0,0,1,0,4,1
tridion-deploy-extension,tridion-deploy-extension,,0,0,0,0,1,0,4,1
unreachable-statement,unreachable-statement,,1,0,3,1,6,4,3,1
netnamedpipebinding,netnamedpipebinding,,1,0,0,1,4,1,8,1
ec2-api-tools,ec2-api-tools,,0,0,5,0,5,5,6,1
fusefabric,fusefabric,,0,0,0,0,1,0,3,1
searchfiltercollection,searchfiltercollection,,1,0,1,1,5,2,8,1
robolectric-gradle-plugin,robolectric-gradle-plugin,,0,1,3,1,7,4,3,1
codeigniter-upload,codeigniter-upload,,0,1,1,1,12,2,4,1
kgdb,kgdb,,2,0,2,2,8,4,9,1
git-tf,git-tf,,3,0,1,3,4,4,8,1
oraoledb,oraoledb,,0,2,2,2,4,4,4,100
sketchapp,sketchapp,,5,0,18,5,30,23,1,1
pangram,pangram,,0,1,3,1,6,4,0,1
get-headers,get-headers,,0,1,3,1,7,4,4,1
persistent-data,persistent-data,,0,0,0,0,4,0,0,1
free-monad,free-monad,,3,1,4,4,15,8,2,1
backupexec,backupexec,,0,0,0,0,2,0,8,1
hiqpdf,hiqpdf,,2,1,3,3,5,6,8,1
tvos10,tvos10,,0,0,1,0,4,1,13,1
quantifiers,quantifiers,,6,2,5,8,18,13,0,1
clingo,clingo,,6,2,10,8,14,18,0,1
try-finally,try-finally,,1,3,4,4,12,8,3,200
hidapi,hidapi,,5,0,5,5,6,10,3,1
bug-tracker,bug-tracker,,1,0,0,1,1,1,8,1
mysql++,mysql++,,1,1,2,2,3,4,9,1
image-generation,image-generation,,10,5,5,15,7,20,0,1
braintree-rails,braintree-rails,,1,1,0,2,3,2,12,1
feedly,feedly,,0,3,1,3,4,4,4,200
refcounting,refcounting,,1,1,1,2,1,3,9,1
render-blocking,render-blocking,,0,2,3,2,9,5,1,100
nested-generics,nested-generics,,2,1,5,3,20,8,3,1
windows-hello,windows-hello,,3,1,3,4,3,7,8,1
doctrine-orm-filters,doctrine-orm-filters,,0,0,0,0,1,0,4,1
jspinclude,jspinclude,,0,1,1,1,6,2,3,1
dword,dword,,2,4,5,6,5,11,9,100
shapeshift,shapeshift,,0,1,0,1,2,1,1,1
jbake,jbake,,0,0,2,0,3,2,3,1
tabletools,tabletools,,0,0,1,0,2,1,1,1
zedgraph,zedgraph,,7,4,5,11,11,16,8,1
function-definition,function-definition,,1,4,7,5,13,12,9,300
gdlib,gdlib,,1,2,4,3,10,7,4,100
kendo-datetimepicker,kendo-datetimepicker,,1,1,4,2,4,6,1,1
set-difference,set-difference,,8,4,6,12,17,18,0,1
pdfnet,pdfnet,,0,1,2,1,10,3,8,1
rtsp-client,rtsp-client,,2,8,9,10,9,19,13,300
partialfunction,partialfunction,,3,1,3,4,4,7,2,1
apache-bahir,apache-bahir,,5,1,3,6,3,9,2,1
integerupdown,integerupdown,,0,0,1,0,2,1,8,1
docker-maven-plugin,docker-maven-plugin,,3,1,7,4,13,11,6,1
redlock.net,redlock.net,,1,1,1,2,2,3,3,1
swinject,swinject,,5,2,5,7,14,12,13,1
shopify-activemerchant,shopify-activemerchant,,6,0,3,6,7,9,1,1
crawler4j,crawler4j,,3,0,8,3,5,11,3,1
prooph,prooph,,1,0,1,1,7,2,8,1
libx265,libx265,,1,4,1,5,13,6,13,300
blockquote,blockquote,,4,5,3,9,9,12,1,25
aws-sdk-java-2.0,aws-sdk-java-2.0,,8,5,9,13,15,22,6,1
uti,uti,,6,2,2,8,16,10,13,1
angular-dragdrop,angular-dragdrop,,3,5,4,8,4,12,1,66.666667
redux-api-middleware,redux-api-middleware,,3,1,3,4,10,7,1,1
policy-based-design,policy-based-design,,0,1,1,1,6,2,9,1
activecollab,activecollab,,4,0,11,4,10,15,4,1
mockgoose,mockgoose,,1,0,1,1,7,2,1,1
abstract-methods,abstract-methods,,4,3,4,7,12,11,9,1
u2netdk,u2netdk,,0,1,0,1,3,1,9,1
rte,rte,,9,6,9,15,14,24,4,1
jenkins-mailer-plugin,jenkins-mailer-plugin,,0,1,2,1,4,3,6,1
oct2py,oct2py,,4,1,5,5,3,10,0,1
oppo,oppo,,3,5,8,8,13,16,3,66.666667
stomp.py,stomp.py,,0,0,0,0,3,0,3,1
dead-letter,dead-letter,,3,7,12,10,19,22,3,133.333333
printform,printform,,1,0,1,1,1,2,8,1
onkeypress,onkeypress,,6,7,16,13,23,29,1,16.666667
qabstractlistmodel,qabstractlistmodel,,2,2,3,4,11,7,9,1
dita,dita,,6,3,16,9,26,25,3,1
android-backup-service,android-backup-service,,2,5,3,7,11,10,3,150
rtx,rtx,,0,4,5,4,3,9,9,300
vagrant-aws,vagrant-aws,,0,0,0,0,1,0,6,1
s-function,s-function,,0,2,6,2,8,8,0,100
typesafe-config,typesafe-config,,3,7,17,10,25,27,2,133.333333
pureconfig,pureconfig,,5,1,7,6,8,13,2,1
ssms-2017,ssms-2017,,24,14,47,38,28,85,4,1
centos-web-panel,centos-web-panel,,6,3,8,9,6,17,4,1
content-pages,content-pages,,4,2,6,6,6,12,8,1
code-documentation,code-documentation,,18,11,26,29,32,55,0,1
android-dateutils,android-dateutils,,4,2,4,6,5,10,3,1
having-clause,having-clause,,5,6,9,11,23,20,4,20
ireport,ireport,,2,2,9,4,7,13,3,1
ibm-cloud-storage,ibm-cloud-storage,,5,8,6,13,27,19,6,60
razorpay,razorpay,,26,24,19,50,39,69,4,1
multiple-constructors,multiple-constructors,,1,2,1,3,5,4,9,100
iexpress,iexpress,,1,0,3,1,5,4,9,1
git-http-backend,git-http-backend,,0,0,4,0,5,4,6,1
antd-mobile,antd-mobile,,2,2,5,4,6,9,1,1
hmacsha1,hmacsha1,,4,11,13,15,21,28,6,175
protocol-buffers-3,protocol-buffers-3,,2,0,3,2,3,5,6,1
windows-identity,windows-identity,,5,4,4,9,11,13,8,1
oneplustwo,oneplustwo,,0,0,0,0,3,0,3,1
cancel-button,cancel-button,,2,3,3,5,13,8,13,50
gtkbuilder,gtkbuilder,,1,1,0,2,4,2,9,1
jquery-ui-selectmenu,jquery-ui-selectmenu,,3,1,7,4,17,11,1,1
unique-transaction-identifier,unique-transaction-identifier,,0,0,0,0,2,0,4,1
sage-erp,sage-erp,,4,3,4,7,12,11,8,1
echosign,echosign,,5,1,6,6,3,12,8,1
gcm-network-manager,gcm-network-manager,,0,1,1,1,5,2,3,1
sql-server-native-client,sql-server-native-client,,0,1,1,1,4,2,4,1
sonos,sonos,,1,7,9,8,8,17,4,600
precompiler,precompiler,,3,1,2,4,4,6,9,1
unity3d-cloud-build,unity3d-cloud-build,,2,0,2,2,3,4,8,1
context.xml,context.xml,,2,4,7,6,11,13,3,100
boost-unit-test-framework,boost-unit-test-framework,,0,1,2,1,1,3,9,1
django-taggit,django-taggit,,6,6,13,12,30,25,0,1
drives,drives,,0,0,0,0,5,0,9,1
android-lru-cache,android-lru-cache,,5,1,5,6,4,11,3,1
imageresizer-diskcache,imageresizer-diskcache,,1,0,2,1,2,3,8,1
diskcache,diskcache,,2,0,3,2,8,5,3,1
visual-studio-emulator,visual-studio-emulator,,1,1,4,2,12,6,3,1
uiautomatorviewer,uiautomatorviewer,,2,5,10,7,21,17,3,150
codekit,codekit,,1,0,6,1,12,7,1,1
aero,aero,,0,0,1,0,5,1,8,1
fancybox-2,fancybox-2,,6,2,2,8,18,10,1,1
translate-animation,translate-animation,,5,2,12,7,18,19,1,1
performancepoint,performancepoint,,0,0,0,0,3,0,4,1
testfx,testfx,,8,2,12,10,24,22,3,1
mcustomscrollbar,mcustomscrollbar,,3,3,10,6,8,16,1,1
dynamoose,dynamoose,,6,4,11,10,11,21,6,1
angularjs-ng-pattern,angularjs-ng-pattern,,0,1,3,1,2,4,1,1
relaxed-atomics,relaxed-atomics,,0,0,3,0,3,3,9,1
excel-2002,excel-2002,,0,0,0,0,1,0,5,1
construct,construct,,7,3,8,10,24,18,4,1
starkit,starkit,,0,0,0,0,2,0,0,1
generic-lambda,generic-lambda,,9,4,21,13,13,34,9,1
pygsheets,pygsheets,,8,11,20,19,22,39,0,37.5
wm-copydata,wm-copydata,,0,1,2,1,5,3,9,1
gcc-pedantic,gcc-pedantic,,1,0,1,1,4,2,9,1
shelly,shelly,,0,0,0,0,2,0,2,1
json2html,json2html,,0,2,3,2,3,5,1,100
momentics,momentics,,1,0,2,1,3,3,9,1
angular-material-stepper,angular-material-stepper,,13,12,18,25,21,43,1,1
infiniband,infiniband,,2,0,7,2,9,9,9,1
openvswitch,openvswitch,,7,9,33,16,36,49,9,28.571429
knockout-mapping-plugin,knockout-mapping-plugin,,3,3,5,6,20,11,1,1
cookielib,cookielib,,1,2,0,3,3,3,0,100
cookiejar,cookiejar,,1,2,4,3,6,7,0,100
unspecified-behavior,unspecified-behavior,,2,0,1,2,4,3,9,1
aliases,aliases,,4,3,10,7,10,17,9,1
l2tp,l2tp,,2,8,4,10,6,14,6,300
webobjects,webobjects,,0,0,0,0,4,0,3,1
sketch.js,sketch.js,,0,0,1,0,1,1,1,1
rust-crates,rust-crates,,3,9,4,12,13,16,9,200
docker-gen,docker-gen,,0,0,0,0,3,0,6,1
redhawksdr,redhawksdr,,1,2,3,3,8,6,9,100
na.rm,na.rm,,1,1,3,2,6,5,0,1
risc,risc,,11,3,10,14,15,24,9,1
shippable-ci,shippable-ci,,2,0,2,2,3,4,1,1
complement,complement,,2,1,5,3,6,8,0,1
nugetgallery,nugetgallery,,1,2,3,3,4,6,8,100
listbox-control,listbox-control,,3,0,3,3,5,6,5,1
pango,pango,,4,4,8,8,13,16,9,1
identity-experience-framework,identity-experience-framework,,4,8,7,12,64,19,8,100
invariantculture,invariantculture,,0,2,0,2,6,2,8,100
node-html-pdf,node-html-pdf,,4,3,7,7,8,14,1,1
aws-shell,aws-shell,,2,0,1,2,1,3,6,1
nstask,nstask,,6,6,9,12,12,21,13,1
nspipe,nspipe,,0,0,2,0,1,2,13,1
representable,representable,,0,0,1,0,6,1,2,1
nativewindow,nativewindow,,0,2,1,2,1,3,3,100
kernighan-and-ritchie,kernighan-and-ritchie,,3,3,11,6,20,17,9,1
max-flow,max-flow,,6,1,11,7,12,18,0,1
method-signature,method-signature,,3,5,4,8,15,12,9,66.666667
azure-elastic-scale,azure-elastic-scale,,0,1,2,1,6,3,8,1
azure-elastic-sharding,azure-elastic-sharding,,3,1,2,4,5,6,8,1
apache-spark-2.2,apache-spark-2.2,,1,0,14,1,18,15,2,1
erlang-supervisor,erlang-supervisor,,3,0,11,3,10,14,2,1
eclipse-collections,eclipse-collections,,1,0,2,1,5,3,3,1
gnu-apl,gnu-apl,,2,0,0,2,1,2,0,1
python-extensions,python-extensions,,8,14,15,22,31,37,0,75
ajaxuploader,ajaxuploader,,1,1,0,2,2,2,8,1
name-attribute,name-attribute,,0,1,1,1,2,2,1,1
docpad,docpad,,1,0,0,1,2,1,1,1
mclapply,mclapply,,1,4,10,5,15,15,0,300
autobahnws,autobahnws,,2,0,1,2,4,3,0,1
moltin,moltin,,1,1,5,2,6,7,13,1
negate,negate,,0,3,1,3,4,4,0,200
spotlight,spotlight,,4,2,7,6,10,13,13,1
xml-literals,xml-literals,,0,0,2,0,2,2,8,1
ggfortify,ggfortify,,2,2,6,4,15,10,0,1
rubber-band,rubber-band,,2,1,3,3,2,6,1,1
swxmlhash,swxmlhash,,0,0,1,0,11,1,13,1
mkcoordinateregion,mkcoordinateregion,,2,0,2,2,2,4,13,1
zcat,zcat,,3,0,3,3,5,6,9,1
slave,slave,,7,7,10,14,16,24,9,1
drop-duplicates,drop-duplicates,,11,3,5,14,6,19,0,1
key-pair,key-pair,,8,7,10,15,32,25,6,1
static-block,static-block,,3,1,13,4,13,17,3,1
edgecast,edgecast,,1,0,2,1,2,3,8,1
tumblr-html,tumblr-html,,3,0,11,3,6,14,1,1
azure-diagnostics,azure-diagnostics,,4,7,17,11,22,28,8,75
vp8,vp8,,3,1,5,4,4,9,13,1
scalapb,scalapb,,7,5,4,12,9,16,2,1
processing-instruction,processing-instruction,,0,2,1,2,4,3,3,100
sr-feuser-registration,sr-feuser-registration,,0,0,1,0,2,1,4,1
supplier,supplier,,3,6,7,9,12,16,3,100
camera-matrix,camera-matrix,,0,1,3,1,4,4,0,1
ncrunch,ncrunch,,1,0,6,1,8,7,8,1
fido-u2f,fido-u2f,,6,6,12,12,8,24,6,1
pyc,pyc,,1,4,8,5,20,13,0,300
setparent,setparent,,0,0,1,0,5,1,8,1
graalvm,graalvm,,28,19,29,47,15,76,3,1
pdfobject,pdfobject,,0,1,2,1,4,3,1,1
alfa,alfa,,3,2,4,5,14,9,4,1
clipper,clipper,,0,0,4,0,4,4,4,1
pyclipper,pyclipper,,0,0,1,0,1,1,0,1
uima,uima,,13,14,20,27,34,47,3,7.692308
ruta,ruta,,12,14,13,26,32,39,3,16.666667
jgrowl,jgrowl,,0,0,1,0,2,1,1,1
robustness,robustness,,1,5,5,6,5,11,0,400
fixed-header-tables,fixed-header-tables,,4,7,9,11,11,20,1,75
w3wp,w3wp,,3,2,9,5,7,14,8,1
image-scanner,image-scanner,,1,3,7,4,9,11,3,200
scaffold,scaffold,,4,6,12,10,17,22,13,50
delayed-execution,delayed-execution,,9,6,5,15,16,20,3,1
service-model,service-model,,0,1,2,1,2,3,8,1
servicemodelex,servicemodelex,,1,0,0,1,1,1,8,1
mvc-editor-templates,mvc-editor-templates,,4,4,10,8,14,18,8,1
restrict,restrict,,4,1,8,5,26,13,9,1
web-app-manifest,web-app-manifest,,1,1,0,2,9,2,1,1
preset,preset,,3,0,5,3,7,8,13,1
silverlight-4.0,silverlight-4.0,,2,4,5,6,7,11,8,100
windows-10-iot-enterprise,windows-10-iot-enterprise,,3,8,6,11,4,17,8,166.666667
pants,pants,,3,1,6,4,2,10,0,1
cfstream,cfstream,,1,1,1,2,2,3,13,1
cfreadstream,cfreadstream,,0,0,1,0,2,1,13,1
datagridviewcomboboxcolumn,datagridviewcomboboxcolumn,,1,2,2,3,9,5,8,100
jcmd,jcmd,,1,1,1,2,7,3,3,1
credential-manager,credential-manager,,3,5,16,8,14,24,8,66.666667
iccube-reporting,iccube-reporting,,3,4,6,7,14,13,4,33.333333
pkcs#8,pkcs#8,,3,1,11,4,13,15,6,1
slick-pg,slick-pg,,1,0,3,1,2,4,2,1
nsscrollview,nsscrollview,,8,4,19,12,20,31,13,1
key-events,key-events,,0,0,0,0,8,0,3,1
magento-1.9.3,magento-1.9.3,,2,1,6,3,12,9,4,1
position-independent-code,position-independent-code,,6,2,8,8,14,16,9,1
codesys,codesys,,4,5,5,9,11,14,9,25
jquery-steps,jquery-steps,,8,5,13,13,14,26,1,1
dbobject,dbobject,,2,0,1,2,3,3,1,1
desiredcapabilities,desiredcapabilities,,4,4,9,8,19,17,3,1
gpath,gpath,,0,4,6,4,8,10,3,300
helpfile,helpfile,,0,0,0,0,3,0,8,1
madcap,madcap,,2,1,2,3,2,5,1,1
laravel-paginate,laravel-paginate,,5,1,5,6,9,11,4,1
object-comparison,object-comparison,,2,0,1,2,2,3,1,1
best-in-place,best-in-place,,2,1,1,3,7,4,12,1
supercollider,supercollider,,3,1,9,4,4,13,0,1
jdk1.8.0,jdk1.8.0,,0,0,0,0,7,0,3,1
maximize,maximize,,4,3,9,7,24,16,0,1
url-action,url-action,,0,0,0,0,3,0,8,1
tls-psk,tls-psk,,1,4,1,5,2,6,6,300
tun,tun,,6,6,10,12,4,22,9,1
ora-00600,ora-00600,,0,2,1,2,3,3,4,100
zope,zope,,2,2,8,4,10,12,0,1
grafika,grafika,,0,0,8,0,5,8,3,1
visual-tree,visual-tree,,1,0,2,1,4,3,8,1
server-rendering,server-rendering,,2,3,2,5,15,7,1,50
google-plus-domains,google-plus-domains,,0,0,0,0,7,0,5,1
netoffice,netoffice,,5,3,2,8,2,10,8,1
android-chrome,android-chrome,,1,7,14,8,10,22,1,600
python-2to3,python-2to3,,4,7,5,11,26,16,0,75
pixel-density,pixel-density,,1,1,1,2,9,3,3,1
groupon,groupon,,0,1,0,1,1,1,4,1
ioports,ioports,,0,1,0,1,1,1,9,1
ngx-treeview,ngx-treeview,,6,1,5,7,1,12,1,1
null-conditional-operator,null-conditional-operator,,0,1,0,1,9,1,8,1
pressed,pressed,,0,2,1,2,10,3,3,100
interfacing,interfacing,,1,0,2,1,9,3,9,1
elaboration,elaboration,,1,1,1,2,2,3,9,1
scriptmanager,scriptmanager,,3,2,10,5,15,15,8,1
registerclientscriptblock,registerclientscriptblock,,0,0,1,0,3,1,8,1
fileupdate,fileupdate,,0,0,1,0,6,1,0,1
shape-context,shape-context,,0,0,0,0,3,0,0,1
custom-datetimepicker,custom-datetimepicker,,1,1,0,2,1,2,1,1
stardog,stardog,,0,0,3,0,9,3,2,1
address-bar,address-bar,,4,2,5,6,6,11,1,1
websocket4net,websocket4net,,2,2,1,4,5,5,8,1
altorouter,altorouter,,3,0,5,3,8,8,4,1
gtag.js,gtag.js,,12,18,24,30,46,54,5,50
ready,ready,,2,0,3,2,8,5,1,1
libgcrypt,libgcrypt,,2,2,5,4,6,9,6,1
rescue,rescue,,4,1,4,5,8,9,12,1
mdpi,mdpi,,0,1,1,1,1,2,3,1
onpaste,onpaste,,0,0,3,0,3,3,1,1
ng-paste,ng-paste,,0,0,0,0,3,0,1,1
oclint,oclint,,0,0,0,0,8,0,13,1
tdatetime,tdatetime,,0,0,0,0,2,0,9,1
c++builder-2009,c++builder-2009,,0,0,0,0,1,0,9,1
coreldraw,coreldraw,,3,2,12,5,4,17,5,1
gwt-rpc,gwt-rpc,,0,0,3,0,8,3,3,1
iconvertible,iconvertible,,0,0,2,0,2,2,8,1
pace,pace,,4,0,3,4,5,7,1,1
expandoobject,expandoobject,,8,5,10,13,18,23,8,1
consolidation,consolidation,,3,7,8,10,14,18,5,133.333333
react-native-native-module,react-native-native-module,,7,5,16,12,20,28,1,1
react-native-native-ui-component,react-native-native-ui-component,,0,1,1,1,9,2,1,1
dynamic-jasper,dynamic-jasper,,3,5,7,8,7,15,3,66.666667
webcenter,webcenter,,1,0,2,1,11,3,3,1
regex-alternation,regex-alternation,,3,2,0,5,6,5,0,1
mfcc,mfcc,,14,11,23,25,41,48,0,1
wso2-emm,wso2-emm,,0,2,4,2,8,6,14,100
wso2-appm,wso2-appm,,1,1,5,2,3,7,14,1
flask-testing,flask-testing,,3,1,3,4,10,7,0,1
re2,re2,,7,15,20,22,27,42,0,114.285714
spanning-tree,spanning-tree,,4,0,6,4,5,10,0,1
power-management,power-management,,3,7,7,10,13,17,3,133.333333
usb-hid,usb-hid,,4,2,1,6,6,7,3,1
testinfra,testinfra,,0,1,0,1,1,1,6,1
jquery-cycle2,jquery-cycle2,,0,0,7,0,3,7,1,1
reentrancy,reentrancy,,0,3,5,3,11,8,9,200
arcgis-runtime-net,arcgis-runtime-net,,5,1,4,6,16,10,8,1
hipi,hipi,,0,0,2,0,2,2,2,1
rosm,rosm,,0,0,0,0,1,0,0,1
ggspatial,ggspatial,,0,0,0,0,1,0,0,1
thunderforest,thunderforest,,0,0,0,0,1,0,0,1
fdfgen,fdfgen,,0,0,0,0,3,0,8,1
sonarqube5.3,sonarqube5.3,,0,0,0,0,1,0,3,1
kpi,kpi,,4,4,6,8,11,14,5,1
pafy,pafy,,5,9,9,14,6,23,0,80
t4mvc,t4mvc,,1,0,4,1,3,5,8,1
dexterity,dexterity,,0,0,1,0,5,1,0,1
plone-5.x,plone-5.x,,4,1,4,5,6,9,0,1
fedora-29,fedora-29,,7,1,9,8,1,17,9,1
array-difference,array-difference,,4,6,12,10,20,22,4,50
ucd,ucd,,3,5,4,8,3,12,6,66.666667
steady.js,steady.js,,0,0,0,0,1,0,0,1
pyarrow,pyarrow,,36,53,68,89,58,157,0,47.222222
ui-calendar,ui-calendar,,0,1,5,1,9,6,1,1
truthtable,truthtable,,6,2,16,8,12,24,0,1
web-publishing,web-publishing,,1,1,7,2,8,9,8,1
mu,mu,,1,1,3,2,5,5,0,1
test-results,test-results,,3,6,4,9,7,13,8,100
phppgadmin,phppgadmin,,2,2,12,4,5,16,4,1
human-readable,human-readable,,1,2,3,3,7,6,0,100
cocoalibspotify-2.0,cocoalibspotify-2.0,,0,0,2,0,2,2,13,1
maximo-anywhere,maximo-anywhere,,4,1,15,5,14,20,3,1
pydot,pydot,,9,4,9,13,22,22,0,1
asprepeater,asprepeater,,1,2,10,3,17,13,8,100
stripchart,stripchart,,1,1,2,2,3,4,0,1
parser-combinators,parser-combinators,,5,7,7,12,27,19,2,40
google-closure-templates,google-closure-templates,,5,2,0,7,3,7,1,1
soy-templates,soy-templates,,3,3,0,6,4,6,1,1
out-gridview,out-gridview,,0,0,1,0,4,1,8,1
pig-udf,pig-udf,,0,1,1,1,3,2,2,1
gemalto,gemalto,,2,2,2,4,4,6,3,1
outerwidth,outerwidth,,0,1,0,1,1,1,1,1
raddropdownbutton,raddropdownbutton,,0,1,0,1,3,1,8,1
arithmetic-overflow,arithmetic-overflow,,1,0,1,1,2,2,9,1
onepage-scroll,onepage-scroll,,5,0,6,5,7,11,1,1
textrange,textrange,,1,0,2,1,7,3,8,1
hugs,hugs,,0,0,0,0,4,0,2,1
class-hierarchy,class-hierarchy,,1,4,7,5,12,12,9,300
laravel-seeding,laravel-seeding,,10,5,20,15,51,35,4,1
uidocumentpickerviewcontroller,uidocumentpickerviewcontroller,,9,7,16,16,42,32,13,1
msbuild-projectreference,msbuild-projectreference,,0,0,1,0,3,1,8,1
async-hooks,async-hooks,,1,2,1,3,5,4,1,100
set-operations,set-operations,,1,1,1,2,6,3,0,1
bonsai-elasticsearch,bonsai-elasticsearch,,1,0,2,1,3,3,6,1
application-structure,application-structure,,1,1,0,2,1,2,4,1
redhat-brms,redhat-brms,,4,3,12,7,13,19,3,1
bapi,bapi,,2,5,5,7,6,12,5,150
hash-of-hashes,hash-of-hashes,,2,1,2,3,3,5,9,1
website-hosting,website-hosting,,3,1,2,4,4,6,4,1
notimplementedexception,notimplementedexception,,0,2,3,2,4,5,8,100
url-parsing,url-parsing,,3,3,4,6,11,10,0,1
kronos-workforce-central,kronos-workforce-central,,0,0,0,0,6,0,3,1
notifyjs,notifyjs,,0,0,0,0,4,0,1,1
plottable.js,plottable.js,,0,0,1,0,2,1,1,1
facebook-invite,facebook-invite,,1,1,0,2,2,2,13,1
django-guardian,django-guardian,,4,2,8,6,17,14,0,1
invokelater,invokelater,,1,1,1,2,4,3,3,1
ng-lightning,ng-lightning,,2,1,1,3,2,4,1,1
roboto,roboto,,0,2,6,2,9,8,1,100
stl-decomposition,stl-decomposition,,2,0,3,2,2,5,0,1
asp.net-roles,asp.net-roles,,6,1,9,7,8,16,8,1
git-stage,git-stage,,2,2,6,4,8,10,6,1
ko-custom-binding,ko-custom-binding,,0,0,2,0,1,2,1,1
sublimerepl,sublimerepl,,7,2,8,9,13,17,0,1
request-uri,request-uri,,4,3,5,7,9,12,4,1
lib.web.mvc,lib.web.mvc,,0,0,0,0,1,0,8,1
prebuild,prebuild,,1,2,2,3,7,5,8,100
turbolinks-android,turbolinks-android,,0,0,0,0,3,0,12,1
sunspot,sunspot,,3,4,3,7,20,10,12,33.333333
websolr,websolr,,0,0,0,0,3,0,12,1
dependencyobject,dependencyobject,,2,1,6,3,2,9,8,1
sonarqube-msbuild-runner,sonarqube-msbuild-runner,,2,0,3,2,22,5,3,1
document.evaluate,document.evaluate,,1,1,1,2,3,3,1,1
azure-autoscaling-block,azure-autoscaling-block,,1,1,2,2,3,4,8,1
postgraphql,postgraphql,,0,2,2,2,6,4,1,100
reactql,reactql,,1,0,0,1,3,1,1,1
swiftype,swiftype,,1,1,1,2,1,3,1,1
realm-browser,realm-browser,,0,0,0,0,2,0,13,1
borderless,borderless,,5,5,5,10,10,15,8,1
getschematable,getschematable,,0,0,0,0,2,0,8,1
opnet,opnet,,1,0,1,1,4,2,9,1
fso,fso,,4,1,4,5,11,9,5,1
qwizardpage,qwizardpage,,2,6,1,8,6,9,0,200
storable,storable,,0,1,1,1,4,2,2,1
skip-lists,skip-lists,,4,1,4,5,9,9,0,1
ion-scroll,ion-scroll,,1,1,3,2,7,5,1,1
screeps,screeps,,2,3,1,5,11,6,1,50
mpeg-2,mpeg-2,,0,1,0,1,4,1,13,1
srecord,srecord,,0,0,0,0,3,0,9,1
sourceanalyser,sourceanalyser,,1,1,2,2,6,4,3,1
railo,railo,,0,0,2,0,4,2,4,1
tabpage,tabpage,,5,3,11,8,20,19,8,1
camlp4,camlp4,,0,1,3,1,2,4,0,1
backbase,backbase,,0,0,1,0,5,1,13,1
touchpad,touchpad,,6,2,10,8,15,18,9,1
imagemin,imagemin,,4,6,6,10,9,16,1,50
textsum,textsum,,0,0,1,0,4,1,0,1
bluetooth-peripheral,bluetooth-peripheral,,1,1,5,2,11,7,3,1
computer-science-theory,computer-science-theory,,2,1,4,3,7,7,0,1
proofs,proofs,,4,8,7,12,6,19,0,100
pinax,pinax,,1,1,2,2,10,4,0,1
bindinglist,bindinglist,,7,4,4,11,15,15,8,1
fs-extra,fs-extra,,3,5,6,8,7,14,1,66.666667
myob,myob,,1,1,4,2,3,6,4,1
minhash,minhash,,11,2,6,13,15,19,2,1
dtw,dtw,,5,6,20,11,16,31,0,20
grub2,grub2,,6,8,6,14,10,20,9,33.333333
network-tools,network-tools,,0,0,1,0,2,1,9,1
neuroscience,neuroscience,,7,6,5,13,21,18,0,1
68hc12,68hc12,,1,1,0,2,3,2,9,1
inbound,inbound,,3,2,3,5,11,8,3,1
automaton,automaton,,1,3,7,4,9,11,0,200
embedxcode,embedxcode,,0,0,0,0,1,0,9,1
django-custom-manager,django-custom-manager,,1,0,3,1,3,4,0,1
direct3d12,direct3d12,,1,0,5,1,2,6,9,1
dirname,dirname,,5,2,2,7,7,9,9,1
vidyo,vidyo,,0,2,5,2,24,7,3,100
buildmaster,buildmaster,,1,0,0,1,2,1,8,1
symphony-cms,symphony-cms,,1,1,0,2,2,2,4,1
ruby-2.0,ruby-2.0,,0,1,1,1,4,2,12,1
visual-web-developer,visual-web-developer,,5,2,10,7,11,17,1,1
dyalog,dyalog,,4,2,7,6,17,13,0,1
almond,almond,,0,1,1,1,2,2,1,1
vue-ssr,vue-ssr,,2,7,7,9,10,16,1,250
unikernel,unikernel,,0,0,0,0,2,0,0,1
rivescript,rivescript,,0,1,3,1,3,4,1,1
brillo,brillo,,0,0,0,0,1,0,3,1
ssjs,ssjs,,3,3,16,6,16,22,5,1
nyquist,nyquist,,1,1,2,2,5,4,0,1
shadowbox,shadowbox,,0,0,4,0,4,4,1,1
xcos,xcos,,2,2,4,4,3,8,0,1
avrdude,avrdude,,9,4,7,13,9,20,9,1
lr1,lr1,,0,1,1,1,2,2,0,1
installutil,installutil,,3,1,3,4,6,7,8,1
applocker,applocker,,4,1,6,5,2,11,3,1
dash.js,dash.js,,3,3,5,6,21,11,13,1
r.java-file,r.java-file,,3,5,5,8,12,13,3,66.666667
envoyer.io,envoyer.io,,3,1,3,4,9,7,4,1
lr,lr,,0,1,3,1,7,4,0,1
bottom-up,bottom-up,,3,5,2,8,1,10,0,66.666667
jstree-search,jstree-search,,4,2,1,6,7,7,1,1
webusercontrols,webusercontrols,,0,0,0,0,2,0,8,1
jstl-functions,jstl-functions,,2,0,7,2,8,9,3,1
unordered-multiset,unordered-multiset,,0,0,1,0,2,1,9,1
django-parler,django-parler,,1,0,4,1,5,5,0,1
kemal,kemal,,0,0,5,0,10,5,9,1
sealed,sealed,,2,1,6,3,10,9,8,1
pluggableprotocol,pluggableprotocol,,0,0,1,0,3,1,9,1
video-card,video-card,,0,2,6,2,4,8,9,100
gpudirect,gpudirect,,1,0,0,1,1,1,0,1
noraui,noraui,,0,0,0,0,3,0,3,1
vspackage,vspackage,,2,3,5,5,10,10,8,50
cqengine,cqengine,,0,1,0,1,2,1,3,1
downloading-website-files,downloading-website-files,,3,1,0,4,6,4,0,1
teraterm,teraterm,,1,5,7,6,7,13,9,400
xmodem,xmodem,,1,0,1,1,2,2,9,1
multiple-repositories,multiple-repositories,,1,2,1,3,4,4,6,100
twitter-bootstrap-wizard,twitter-bootstrap-wizard,,1,5,1,6,7,7,1,400
quotas,quotas,,0,0,0,0,4,0,6,1
flex3,flex3,,0,1,3,1,5,4,13,1
thread-dump,thread-dump,,9,3,9,12,22,21,3,1
protocolexception,protocolexception,,3,0,0,3,3,3,3,1
imagesharp,imagesharp,,2,9,13,11,22,24,8,350
pyvirtualdisplay,pyvirtualdisplay,,0,3,1,3,10,4,3,200
runspace,runspace,,8,8,15,16,33,31,8,1
spamassassin,spamassassin,,5,4,8,9,12,17,4,1
underscores-wp,underscores-wp,,3,0,2,3,10,5,4,1
spring-jersey,spring-jersey,,4,4,8,8,16,16,3,1
android-selector,android-selector,,5,4,3,9,8,12,3,1
dns-get-record,dns-get-record,,0,3,0,3,2,3,4,200
android-dialer,android-dialer,,4,2,7,6,12,13,3,1
manifest-merging,manifest-merging,,0,4,2,4,8,6,3,300
harp,harp,,1,0,3,1,7,4,1,1
facebook-analytics-push,facebook-analytics-push,,0,0,0,0,4,0,13,1
viewmodellocator,viewmodellocator,,3,0,2,3,5,5,8,1
win32exception,win32exception,,0,2,3,2,4,5,8,100
mysql-backup,mysql-backup,,3,5,5,8,14,13,4,66.666667
denial-of-service,denial-of-service,,4,3,9,7,10,16,4,1
buttongroup,buttongroup,,4,2,6,6,11,12,1,1
synchronize,synchronize,,0,4,10,4,9,14,3,300
disjoint-union,disjoint-union,,1,0,2,1,3,3,0,1
ngdraggable,ngdraggable,,2,1,1,3,3,4,1,1
tls1.1,tls1.1,,0,2,2,2,11,4,6,100
authlogic,authlogic,,0,0,1,0,9,1,12,1
copy-database-wizard,copy-database-wizard,,1,2,1,3,2,4,4,100
r-plotly,r-plotly,,67,52,166,119,213,285,0,1
mips64,mips64,,2,1,11,3,10,14,9,1
carrier,carrier,,1,4,8,5,10,13,4,300
image-quality,image-quality,,5,3,3,8,4,11,1,1
flinkml,flinkml,,0,1,0,1,4,1,2,1
socialize-sdk,socialize-sdk,,0,0,0,0,1,0,3,1
mysql5,mysql5,,1,2,2,3,7,5,4,100
apfloat,apfloat,,0,0,1,0,2,1,3,1
spring-cloud-bus,spring-cloud-bus,,5,2,9,7,15,16,3,1
cannon.js,cannon.js,,3,1,12,4,11,16,1,1
object-destructuring,object-destructuring,,5,6,10,11,14,21,1,20
parrot,parrot,,0,3,1,3,3,4,0,200
azure-data-factory-2,azure-data-factory-2,,107,154,199,261,163,460,8,43.925234
dbconnection,dbconnection,,2,8,10,10,20,20,4,300
swift-custom-framework,swift-custom-framework,,3,0,4,3,3,7,13,1
rpython,rpython,,0,0,0,0,9,0,0,1
django-datatable,django-datatable,,7,3,6,10,1,16,0,1
mstsc,mstsc,,0,3,4,3,12,7,8,200
acralyzer,acralyzer,,0,0,0,0,1,0,1,1
restfixture,restfixture,,0,0,0,0,1,0,3,1
django-1.5,django-1.5,,1,0,4,1,6,5,0,1
devise-confirmable,devise-confirmable,,3,3,10,6,14,16,12,1
azure-gov,azure-gov,,6,3,8,9,19,17,8,1
spring-properties,spring-properties,,4,7,14,11,16,25,3,75
launcher,launcher,,12,14,20,26,46,46,3,16.666667
xtensa,xtensa,,0,3,5,3,3,8,9,200
program-files,program-files,,2,0,2,2,3,4,8,1
uclinux,uclinux,,0,0,3,0,4,3,9,1
gaufrette,gaufrette,,0,1,5,1,3,6,4,1
android-autofill-manager,android-autofill-manager,,5,4,7,9,12,16,3,1
jquery-on,jquery-on,,0,0,1,0,3,1,1,1
boringssl,boringssl,,12,5,9,17,23,26,6,1
ltree,ltree,,4,3,5,7,8,12,4,1
pgi-accelerator,pgi-accelerator,,1,1,2,2,7,4,0,1
iridium,iridium,,0,1,0,1,1,1,0,1
jpegoptim,jpegoptim,,3,0,2,3,4,5,9,1
aurora,aurora,,13,9,15,22,40,37,6,1
sidr,sidr,,0,1,5,1,2,6,1,1
mark-and-sweep,mark-and-sweep,,2,1,1,3,2,4,3,1
appdata,appdata,,1,4,12,5,21,17,8,300
facebook-litho,facebook-litho,,2,1,4,3,2,7,3,1
rubocop-rspec,rubocop-rspec,,0,0,2,0,5,2,12,1
elasticsearch-spark,elasticsearch-spark,,0,4,4,4,8,8,2,300
ilspy,ilspy,,2,1,0,3,2,3,8,1
itfoxtec-identity-saml2,itfoxtec-identity-saml2,,4,0,2,4,5,6,8,1
rvm-capistrano,rvm-capistrano,,1,1,4,2,5,6,12,1
spp,spp,,0,2,3,2,14,5,3,100
config-transformation,config-transformation,,2,0,1,2,10,3,8,1
r-car,r-car,,0,1,2,1,15,3,0,1
tying-the-knot,tying-the-knot,,0,0,2,0,1,2,2,1
openfx,openfx,,0,0,1,0,1,1,3,1
beta-distribution,beta-distribution,,2,2,4,4,10,8,0,1
reql,reql,,2,1,5,3,8,8,1,1
callouts,callouts,,0,2,5,2,3,7,14,100
csi,csi,,0,0,4,0,5,4,8,1
isolation,isolation,,2,3,14,5,14,19,6,50
dbaas,dbaas,,1,0,2,1,3,3,4,1
oracle-cloud-infrastructure,oracle-cloud-infrastructure,,21,15,28,36,27,64,4,1
counting-sort,counting-sort,,2,7,4,9,10,13,0,250
rootview,rootview,,0,0,3,0,5,3,3,1
sitecore-sxa,sitecore-sxa,,2,3,4,5,5,9,8,50
reactjs-flux,reactjs-flux,,4,3,4,7,25,11,1,1
outbound,outbound,,8,5,10,13,13,23,3,1
poedit,poedit,,0,1,8,1,13,9,4,1
networkmanager,networkmanager,,8,10,19,18,20,37,9,25
activerecord-import,activerecord-import,,2,4,5,6,5,11,12,100
pyjks,pyjks,,2,2,1,4,1,5,6,1
spring-security-acl,spring-security-acl,,3,1,3,4,9,7,3,1
custom-object,custom-object,,6,6,4,12,8,16,3,1
mybatis-cdi,mybatis-cdi,,0,0,0,0,2,0,3,1
metatable,metatable,,3,3,2,6,14,8,9,1
luaj,luaj,,2,0,1,2,4,3,9,1
implicit-methods,implicit-methods,,0,0,0,0,1,0,0,1
whitenoise,whitenoise,,5,3,10,8,20,18,0,1
searchqueryset,searchqueryset,,0,3,3,3,1,6,0,200
mojo-dom,mojo-dom,,0,1,1,1,1,2,9,1
doctrine-1.2,doctrine-1.2,,2,0,4,2,6,6,4,1
matlab-app-designer,matlab-app-designer,,14,7,13,21,27,34,0,1
runscope,runscope,,2,0,1,2,2,3,4,1
markup-extensions,markup-extensions,,3,1,5,4,10,9,8,1
spark-notebook,spark-notebook,,2,4,3,6,5,9,2,100
aurelia-navigation,aurelia-navigation,,0,0,0,0,2,0,1,1
setvalue,setvalue,,3,3,17,6,33,23,5,1
swift-dictionary,swift-dictionary,,0,2,3,2,7,5,13,100
inspec,inspec,,1,6,11,7,18,18,12,500
ccombobox,ccombobox,,0,1,2,1,2,3,9,1
angular-ngmodelchange,angular-ngmodelchange,,3,1,2,4,7,6,1,1
cusolver,cusolver,,1,2,0,3,4,3,0,100
rocket-chip,rocket-chip,,8,8,19,16,12,35,2,1
completion-service,completion-service,,0,1,0,1,2,1,3,1
sysprep,sysprep,,2,3,4,5,6,9,8,50
osx-lion,osx-lion,,0,0,3,0,6,3,13,1
listen,listen,,1,2,12,3,18,15,9,100
manova,manova,,3,3,7,6,11,13,0,1
reltool,reltool,,0,0,0,0,1,0,2,1
dcount,dcount,,1,4,1,5,5,6,5,300
omap,omap,,0,0,1,0,4,1,9,1
lf,lf,,3,3,3,6,5,9,6,1
cross-domain-policy,cross-domain-policy,,1,2,4,3,7,7,1,100
rangevalidator,rangevalidator,,3,0,1,3,4,4,8,1
azure-ddos,azure-ddos,,0,0,0,0,4,0,8,1
nstablecolumn,nstablecolumn,,0,0,0,0,2,0,13,1
nsindexset,nsindexset,,0,1,0,1,3,1,13,1
space-between,space-between,,2,1,2,3,4,5,1,1
sceneview,sceneview,,2,3,10,5,9,15,13,50
debug-build,debug-build,,0,0,2,0,4,2,9,1
multiple-select-query,multiple-select-query,,2,0,0,2,1,2,4,1
cxjs,cxjs,,0,0,3,0,4,3,1,1
property-based-testing,property-based-testing,,7,4,13,11,14,24,2,1
spreadjs,spreadjs,,8,0,1,8,6,9,1,1
sql.js,sql.js,,0,1,4,1,3,5,3,1
variable-expansion,variable-expansion,,8,7,12,15,25,27,9,1
timesten,timesten,,1,0,4,1,4,5,4,1
pgm-protocol,pgm-protocol,,0,0,0,0,1,0,9,1
trust-zone,trust-zone,,0,0,2,0,7,2,9,1
netflix-nebula-plugins,netflix-nebula-plugins,,2,1,0,3,4,3,3,1
r5rs,r5rs,,5,1,5,6,32,11,0,1
cloudscribe,cloudscribe,,0,0,0,0,4,0,8,1
banana-pi,banana-pi,,1,3,3,4,3,7,9,200
node-assert,node-assert,,0,0,1,0,1,1,1,1
xilinx-edk,xilinx-edk,,1,1,1,2,8,3,9,1
federated-queries,federated-queries,,1,1,5,2,15,7,2,1
cheat-engine,cheat-engine,,5,7,12,12,20,24,9,40
unresolved-external,unresolved-external,,8,3,8,11,41,19,9,1
deployment-target,deployment-target,,2,0,2,2,4,4,13,1
value-objects,value-objects,,3,6,11,9,24,20,8,100
watchconnectivity,watchconnectivity,,7,0,20,7,20,27,13,1
pagertabstrip,pagertabstrip,,0,1,0,1,4,1,3,1
c++builder-xe2,c++builder-xe2,,0,0,0,0,3,0,9,1
resource-timing-api,resource-timing-api,,1,1,2,2,4,4,1,1
bitconverter,bitconverter,,3,3,5,6,6,11,8,1
vsftpd,vsftpd,,2,4,13,6,15,19,9,100
runge-kutta,runge-kutta,,16,3,23,19,24,42,0,1
pudb,pudb,,2,0,4,2,5,6,0,1
pagerank,pagerank,,7,6,16,13,19,29,0,1
should.js,should.js,,2,2,4,4,7,8,1,1
ipb,ipb,,2,1,0,3,6,3,4,1
lambdify,lambdify,,2,2,6,4,7,10,0,1
currentculture,currentculture,,5,3,4,8,10,12,8,1
fontmetrics,fontmetrics,,1,1,1,2,9,3,3,1
exif-js,exif-js,,5,2,7,7,6,14,1,1
liquid-layout,liquid-layout,,2,1,4,3,15,7,1,1
facebook-live-api,facebook-live-api,,2,1,6,3,4,9,13,1
aws-billing,aws-billing,,9,3,11,12,8,23,6,1
pentaho-design-studio,pentaho-design-studio,,0,0,3,0,6,3,4,1
freegeoip,freegeoip,,0,0,0,0,4,0,4,1
luvit,luvit,,0,0,1,0,2,1,9,1
bijection,bijection,,1,0,2,1,4,3,0,1
runc,runc,,3,5,4,8,3,12,6,66.666667
android-parsequeryadapter,android-parsequeryadapter,,0,0,0,0,2,0,3,1
tinydb,tinydb,,2,5,11,7,10,18,0,150
hash-reference,hash-reference,,1,0,0,1,1,1,9,1
auto-populating,auto-populating,,1,0,1,1,3,2,5,1
http-kit,http-kit,,1,2,0,3,6,3,2,100
magick++,magick++,,1,3,3,4,12,7,12,200
file-comparison,file-comparison,,2,4,6,6,14,12,0,100
tpagecontrol,tpagecontrol,,0,0,1,0,3,1,9,1
cons,cons,,2,1,5,3,14,8,0,1
phpmd,phpmd,,1,1,3,2,4,5,4,1
google-cloud-source-repos,google-cloud-source-repos,,2,7,7,9,12,16,6,250
poll-syscall,poll-syscall,,0,0,1,0,2,1,9,1
angularjs-injector,angularjs-injector,,1,1,3,2,15,5,1,1
makeappx,makeappx,,1,0,4,1,12,5,8,1
hasownproperty,hasownproperty,,5,0,4,5,9,9,1,1
bootstrap-tokenfield,bootstrap-tokenfield,,2,2,1,4,7,5,1,1
l10n.js,l10n.js,,2,0,2,2,2,4,1,1
weak,weak,,0,3,8,3,8,11,13,200
pid-controller,pid-controller,,1,3,2,4,4,6,0,200
layoutsubviews,layoutsubviews,,2,1,2,3,12,5,13,1
traffic-measurement,traffic-measurement,,0,0,0,0,2,0,1,1
android-traceview,android-traceview,,2,0,1,2,1,3,3,1
unified-log,unified-log,,0,0,0,0,2,0,13,1
xar,xar,,1,0,0,1,2,1,1,1
r-environment,r-environment,,0,1,6,1,8,7,0,1
ndimage,ndimage,,4,6,7,10,14,17,0,50
device-detection,device-detection,,0,1,6,1,5,7,4,1
qooxdoo,qooxdoo,,0,0,4,0,10,4,1,1
process-monitoring,process-monitoring,,1,3,3,4,9,7,9,200
shared-file,shared-file,,0,1,1,1,3,2,5,1
name-clash,name-clash,,1,1,0,2,5,2,3,1
sqsh,sqsh,,1,0,0,1,4,1,4,1
phpgraphlib,phpgraphlib,,1,1,0,2,4,2,4,1
polyhedra,polyhedra,,5,1,14,6,7,20,0,1
folder-access,folder-access,,0,1,1,1,4,2,8,1
petapoco,petapoco,,7,5,7,12,22,19,8,1
nested-documents,nested-documents,,1,3,0,4,10,4,1,200
wfastcgi,wfastcgi,,2,3,9,5,10,14,8,50
codeigniter-datamapper,codeigniter-datamapper,,0,1,1,1,4,2,4,1
iphone-keypad,iphone-keypad,,0,0,0,0,3,0,13,1
automatic-migration,automatic-migration,,0,0,1,0,1,1,3,1
jenkins-pipeline-unit,jenkins-pipeline-unit,,1,3,4,4,4,8,6,200
webengine,webengine,,1,2,5,3,15,8,3,100
kubernetes-jobs,kubernetes-jobs,,3,7,8,10,2,18,6,133.333333
avm2,avm2,,0,0,0,0,1,0,13,1
galileo,galileo,,1,0,0,1,2,1,9,1
wse,wse,,1,0,4,1,7,5,8,1
build-triggers,build-triggers,,3,1,2,4,6,6,6,1
uipickerviewdelegate,uipickerviewdelegate,,0,1,3,1,4,4,13,1
visual-age,visual-age,,0,0,0,0,1,0,13,1
glassfish-4.1.1,glassfish-4.1.1,,0,0,1,0,1,1,3,1
nlb,nlb,,9,7,15,16,14,31,6,1
handbrakecli,handbrakecli,,0,1,4,1,2,5,13,1
first-class-functions,first-class-functions,,4,2,8,6,6,14,2,1
jsonfx,jsonfx,,0,0,1,0,1,1,8,1
megaparsec,megaparsec,,0,1,11,1,17,12,2,1
readkey,readkey,,0,1,5,1,2,6,8,1
armasm,armasm,,1,1,5,2,2,7,9,1
libjpeg-turbo,libjpeg-turbo,,2,2,6,4,10,10,9,1
jpegtran,jpegtran,,2,0,3,2,3,5,9,1
sunspot-solr,sunspot-solr,,0,3,2,3,15,5,12,200
google-email-audit-api,google-email-audit-api,,0,0,0,0,5,0,5,1
prototype-pattern,prototype-pattern,,2,0,1,2,3,3,3,1
gnuplot-iostream,gnuplot-iostream,,0,1,3,1,9,4,0,1
airtable,airtable,,12,10,21,22,19,43,4,1
winmd,winmd,,1,0,5,1,4,6,8,1
amazon-mobile-hub,amazon-mobile-hub,,1,0,2,1,16,3,6,1
inequality,inequality,,6,5,7,11,22,18,0,1
winhttp,winhttp,,10,13,25,23,29,48,9,30
simplecart,simplecart,,0,1,1,1,6,2,1,1
android-buildconfig,android-buildconfig,,3,4,6,7,8,13,3,33.333333
umfpack,umfpack,,0,0,0,0,6,0,9,1
maskformatter,maskformatter,,0,0,1,0,3,1,3,1
niftynet,niftynet,,10,3,9,13,15,22,0,1
rank-n-types,rank-n-types,,3,4,1,7,6,8,2,33.333333
manifoldcf,manifoldcf,,1,2,3,3,6,6,2,100
nhunspell,nhunspell,,0,0,1,0,1,1,8,1
caroufredsel,caroufredsel,,0,1,1,1,2,2,1,1
sammy.js,sammy.js,,0,1,3,1,4,4,1,1
ujs,ujs,,1,0,6,1,6,7,12,1
angular-testing,angular-testing,,30,21,50,51,18,101,1,1
sem,sem,,3,5,10,8,8,18,0,66.666667
or-operator,or-operator,,5,2,11,7,7,18,0,1
openmrs,openmrs,,1,0,0,1,3,1,3,1
odoo-website,odoo-website,,1,0,4,1,3,5,0,1
reproducible-research,reproducible-research,,5,4,10,9,28,19,0,1
enterprise-library-6,enterprise-library-6,,0,1,4,1,4,5,8,1
facebook4j,facebook4j,,2,0,2,2,4,4,13,1
vertical-scroll,vertical-scroll,,2,0,1,2,2,3,1,1
switchmap,switchmap,,15,14,15,29,25,44,1,1
yajl,yajl,,2,0,2,2,6,4,1,1
volume-rendering,volume-rendering,,3,4,6,7,6,13,0,33.333333
raymarching,raymarching,,1,0,1,1,1,2,0,1
patsy,patsy,,8,4,7,12,13,19,0,1
ramda-fantasy,ramda-fantasy,,0,0,1,0,2,1,2,1
msbuild-target,msbuild-target,,0,2,3,2,10,5,8,100
qgraphicspixmapitem,qgraphicspixmapitem,,5,1,2,6,8,8,9,1
articulate-storyline,articulate-storyline,,6,2,5,8,8,13,1,1
wix3.7,wix3.7,,3,2,12,5,15,17,8,1
laravel-snappy,laravel-snappy,,9,6,6,15,10,21,4,1
wii,wii,,1,0,0,1,2,1,3,1
.when,.when,,3,1,7,4,16,11,1,1
msbuildcommunitytasks,msbuildcommunitytasks,,0,0,2,0,3,2,8,1
multiautocompletetextview,multiautocompletetextview,,0,0,3,0,5,3,3,1
pomm,pomm,,0,0,0,0,4,0,4,1
vvv-wordpress,vvv-wordpress,,0,0,1,0,3,1,4,1
azure-scheduler,azure-scheduler,,2,1,1,3,18,4,8,1
ais,ais,,1,3,2,4,8,6,0,200
marko,marko,,6,3,6,9,7,15,1,1
eoferror,eoferror,,4,2,7,6,13,13,0,1
xpi,xpi,,2,0,1,2,2,3,1,1
jpm,jpm,,0,0,1,0,1,1,1,1
subsonic,subsonic,,0,1,2,1,1,3,8,1
sony-smarteyeglass,sony-smarteyeglass,,0,0,0,0,2,0,8,1
azure-tablequery,azure-tablequery,,2,4,9,6,16,15,8,100
pari-gp,pari-gp,,4,4,3,8,5,11,0,1
fluent-entity-framework,fluent-entity-framework,,0,0,0,0,3,0,8,1
directsound,directsound,,1,1,2,2,9,4,9,1
virtualscroll,virtualscroll,,9,7,36,16,16,52,1,1
concrete5-5.7,concrete5-5.7,,1,3,1,4,4,5,4,200
uiapplicationdelegate,uiapplicationdelegate,,4,5,6,9,12,15,13,25
slf4j-api,slf4j-api,,2,1,7,3,12,10,3,1
cikernel,cikernel,,0,4,2,4,11,6,13,300
ios9.3,ios9.3,,0,0,4,0,11,4,13,1
cloudberry,cloudberry,,0,0,3,0,6,3,6,1
qglwidget,qglwidget,,0,0,6,0,4,6,9,1
fitdistrplus,fitdistrplus,,5,4,12,9,10,21,0,1
reify,reify,,0,3,1,3,1,4,2,200
cabal-install,cabal-install,,6,1,9,7,15,16,2,1
local-system-account,local-system-account,,0,2,4,2,4,6,8,100
gnulib,gnulib,,0,0,0,0,3,0,9,1
playsound,playsound,,7,12,13,19,11,32,0,71.428571
tfs-process-template,tfs-process-template,,2,1,8,3,14,11,8,1
bulletedlist,bulletedlist,,1,2,2,3,14,5,1,100
dynamic-sizing,dynamic-sizing,,0,1,3,1,2,4,3,1
platypus-optimizer,platypus-optimizer,,3,1,1,4,2,5,0,1
eaglcontext,eaglcontext,,1,0,0,1,2,1,13,1
perltk,perltk,,0,0,2,0,1,2,9,1
rubiks-cube,rubiks-cube,,2,1,1,3,6,4,3,1
rubyzip,rubyzip,,0,0,8,0,6,8,12,1
formgroups,formgroups,,21,30,40,51,57,91,1,42.857143
dgraph,dgraph,,2,3,9,5,19,14,2,50
python-jedi,python-jedi,,2,3,2,5,1,7,0,50
javascript-marked,javascript-marked,,0,2,1,2,3,3,1,100
chakra,chakra,,3,0,0,3,1,3,1,1
threepenny-gui,threepenny-gui,,1,0,1,1,2,2,2,1
aurelia-fetch-client,aurelia-fetch-client,,0,1,5,1,4,6,1,1
samsung-edge,samsung-edge,,0,1,0,1,2,1,3,1
quosure,quosure,,5,6,11,11,23,22,0,20
ada-compliance,ada-compliance,,0,1,1,1,5,2,13,1
perl-data-structures,perl-data-structures,,1,0,1,1,2,2,9,1
jai,jai,,0,3,3,3,7,6,3,200
qbuffer,qbuffer,,2,2,0,4,4,4,9,1
angularjs-decorator,angularjs-decorator,,0,0,0,0,2,0,1,1
container-classes,container-classes,,0,0,1,0,1,1,9,1
xeon-phi,xeon-phi,,1,1,6,2,12,8,9,1
single-threaded,single-threaded,,1,7,9,8,12,17,1,600
android-identifiers,android-identifiers,,3,1,1,4,6,5,3,1
taskdialog,taskdialog,,5,2,1,7,4,8,9,1
dataminer,dataminer,,1,0,1,1,2,2,4,1
qpropertyanimation,qpropertyanimation,,4,4,5,8,10,13,0,1
right-justified,right-justified,,0,0,2,0,2,2,0,1
asp.net-web-api-helppages,asp.net-web-api-helppages,,1,1,0,2,2,2,8,1
knockout-mvc,knockout-mvc,,0,0,3,0,10,3,1,1
cellspacing,cellspacing,,1,1,1,2,2,3,13,1
pytest-django,pytest-django,,7,13,26,20,31,46,0,85.714286
marble,marble,,1,0,3,1,11,4,1,1
jasmine-marbles,jasmine-marbles,,14,9,11,23,13,34,1,1
biml,biml,,3,6,8,9,33,17,4,100
census,census,,5,8,13,13,34,26,0,60
tidycensus,tidycensus,,1,3,5,4,8,9,0,200
lemon,lemon,,3,2,3,5,2,8,0,1
nest-api,nest-api,,0,1,3,1,4,4,1,1
openthread,openthread,,5,1,6,6,4,12,9,1
kicad,kicad,,0,1,1,1,4,2,0,1
nslinguistictagger,nslinguistictagger,,3,0,3,3,6,6,13,1
ninject.web.mvc,ninject.web.mvc,,1,3,4,4,11,8,8,200
iplimage,iplimage,,2,0,1,2,2,3,0,1
msxsl,msxsl,,0,3,3,3,6,6,3,200
event-stream,event-stream,,6,3,8,9,12,17,1,1
opaleye,opaleye,,0,0,0,0,7,0,2,1
duckling,duckling,,1,3,2,4,6,6,0,200
externalizable,externalizable,,1,1,3,2,4,5,3,1
libxml-js,libxml-js,,4,3,1,7,3,8,1,1
cnc,cnc,,2,3,8,5,9,13,0,50
scriptcs,scriptcs,,1,0,1,1,6,2,8,1
nexosis,nexosis,,0,0,0,0,1,0,3,1
chromeless,chromeless,,1,1,4,2,20,6,1,1
salesforce-einstein,salesforce-einstein,,4,4,1,8,4,9,14,1
dispatchevent,dispatchevent,,1,0,2,1,9,3,1,1
nftw,nftw,,0,0,0,0,2,0,9,1
bids,bids,,1,1,9,2,14,11,4,1
apache-superset,apache-superset,,25,19,41,44,59,85,0,1
wolframalpha,wolframalpha,,5,2,4,7,17,11,0,1
appgroups,appgroups,,0,1,4,1,4,5,13,1
parallel-arrays,parallel-arrays,,2,0,2,2,5,4,3,1
rebus,rebus,,25,5,12,30,20,42,8,1
dynamic-image-generation,dynamic-image-generation,,1,3,3,4,6,7,1,200
multiple-definition-error,multiple-definition-error,,3,0,5,3,10,8,9,1
knuth,knuth,,2,1,5,3,2,8,0,1
taocp,taocp,,0,0,1,0,2,1,0,1
strtol,strtol,,0,5,7,5,8,12,9,400
redeclaration,redeclaration,,1,2,1,3,5,4,9,100
typesafe-stack,typesafe-stack,,0,0,0,0,2,0,2,1
documentsdirectory,documentsdirectory,,0,1,0,1,4,1,13,1
template-control,template-control,,0,0,0,0,2,0,8,1
od,od,,0,2,1,2,2,3,9,100
multiple-gpu,multiple-gpu,,0,4,1,4,4,5,0,300
matlab-gpu,matlab-gpu,,1,0,0,1,1,1,0,1
ckfinder,ckfinder,,18,16,19,34,35,53,1,1
glassfish-3,glassfish-3,,4,5,11,9,22,20,3,25
unexpected-token,unexpected-token,,8,11,18,19,29,37,1,37.5
linuxthreads,linuxthreads,,1,0,0,1,1,1,9,1
flash-cc,flash-cc,,0,1,2,1,5,3,13,1
lockscreenwidget,lockscreenwidget,,0,0,1,0,3,1,3,1
citrus-framework,citrus-framework,,12,10,19,22,52,41,3,1
laspy,laspy,,3,1,0,4,5,4,0,1
inflate,inflate,,3,4,5,7,10,12,0,33.333333
miniz,miniz,,0,0,0,0,2,0,0,1
digitization,digitization,,0,0,0,0,3,0,0,1
suhosin,suhosin,,0,0,1,0,1,1,4,1
ninject.web,ninject.web,,0,0,4,0,1,4,8,1
pymunk,pymunk,,6,1,8,7,15,15,0,1
cfengine,cfengine,,0,0,1,0,2,1,9,1
firebird1.5,firebird1.5,,0,0,1,0,2,1,4,1
nested-gridview,nested-gridview,,1,3,1,4,7,5,8,200
animatorset,animatorset,,3,0,2,3,5,5,3,1
navigationservice,navigationservice,,2,2,2,4,9,6,8,1
remote-control,remote-control,,2,3,7,5,13,12,3,50
prism.js,prism.js,,0,0,2,0,5,2,1,1
docsify,docsify,,1,0,1,1,2,2,0,1
microsoft-metro,microsoft-metro,,3,3,10,6,20,16,8,1
meteor-useraccounts,meteor-useraccounts,,0,0,2,0,3,2,1,1
fpic,fpic,,1,4,8,5,13,13,9,300
usebean,usebean,,0,0,1,0,2,1,3,1
editorconfig,editorconfig,,7,4,18,11,22,29,8,1
get-meta-tags,get-meta-tags,,0,0,1,0,5,1,4,1
c-str,c-str,,0,2,4,2,6,6,9,100
strstream,strstream,,0,0,0,0,1,0,9,1
singularity-container,singularity-container,,12,10,22,22,15,44,6,1
doctrine-collection,doctrine-collection,,1,1,1,2,1,3,4,1
distinguishedname,distinguishedname,,2,1,4,3,5,7,8,1
associated-domains,associated-domains,,3,0,2,3,7,5,13,1
line-numbers,line-numbers,,3,4,10,7,23,17,9,33.333333
activation-codes,activation-codes,,0,1,0,1,1,1,3,1
ansi-sql-92,ansi-sql-92,,3,0,1,3,1,4,4,1
pokemon-go,pokemon-go,,0,0,1,0,4,1,3,1
heroku-connect,heroku-connect,,0,0,5,0,5,5,1,1
graphicscontext,graphicscontext,,0,0,2,0,3,2,3,1
devexpress-gridcontrol,devexpress-gridcontrol,,5,2,11,7,18,18,8,1
struts-config,struts-config,,0,3,1,3,5,4,3,200
chef-zero,chef-zero,,0,1,0,1,1,1,12,1
gatttool,gatttool,,2,1,2,3,3,5,3,1
android-configchanges,android-configchanges,,4,3,3,7,14,10,3,1
jquery-upload-file-plugin,jquery-upload-file-plugin,,1,1,1,2,6,3,1,1
filter-var,filter-var,,1,1,4,2,6,6,4,1
favorite,favorite,,0,0,0,0,5,0,13,1
mson,mson,,0,0,4,0,4,4,4,1
xmldataprovider,xmldataprovider,,0,0,0,0,1,0,8,1
google-app-invites,google-app-invites,,0,0,1,0,2,1,13,1
chez-scheme,chez-scheme,,3,2,7,5,6,12,0,1
rendercontrol,rendercontrol,,0,0,0,0,1,0,8,1
nrwl,nrwl,,14,20,22,34,28,56,1,42.857143
powerview,powerview,,1,0,1,1,5,2,5,1
biginsights,biginsights,,0,0,1,0,1,1,2,1
pdf-manipulation,pdf-manipulation,,4,2,4,6,2,10,8,1
late-static-binding,late-static-binding,,2,0,2,2,5,4,9,1
websecurity,websecurity,,12,14,31,26,36,57,4,16.666667
webchartcontrol,webchartcontrol,,0,0,1,0,3,1,1,1
stetho,stetho,,5,3,5,8,8,13,3,1
giter8,giter8,,1,3,0,4,5,4,2,200
dealloc,dealloc,,3,0,5,3,4,8,13,1
gsubfn,gsubfn,,1,0,0,1,7,1,0,1
cold-start,cold-start,,6,3,9,9,10,18,6,1
ratchet-bootstrap,ratchet-bootstrap,,0,0,0,0,1,0,1,1
apache-commons-pool,apache-commons-pool,,0,1,2,1,5,3,3,1
camaleon,camaleon,,1,0,0,1,3,1,12,1
ioio,ioio,,0,0,0,0,4,0,3,1
servermanager,servermanager,,0,0,5,0,5,5,8,1
external-script,external-script,,4,2,0,6,6,6,1,1
webtop,webtop,,2,1,2,3,5,5,16,1
shadows,shadows,,0,0,0,0,14,0,9,1
ibm-content-collector,ibm-content-collector,,0,0,0,0,2,0,15,1
wm-flow,wm-flow,,0,0,0,0,2,0,3,1
ansi-colors,ansi-colors,,0,3,4,3,4,7,9,200
rprofile,rprofile,,2,0,1,2,6,3,0,1
osm2pgsql,osm2pgsql,,4,3,6,7,3,13,4,1
tsung,tsung,,1,6,5,7,1,12,3,500
qjsonobject,qjsonobject,,3,0,5,3,5,8,9,1
xscale,xscale,,1,0,2,1,3,3,0,1
multiparameter,multiparameter,,0,0,1,0,2,1,2,1
utm,utm,,13,7,26,20,18,46,0,1
toastr,toastr,,17,10,25,27,43,52,1,1
angular-toastr,angular-toastr,,2,2,12,4,14,16,1,1
antisamy,antisamy,,0,2,3,2,5,5,4,100
coala,coala,,0,0,0,0,2,0,0,1
login-with-amazon,login-with-amazon,,0,1,5,1,7,6,6,1
python-descriptors,python-descriptors,,2,3,5,5,16,10,0,50
ember-data-url-templates,ember-data-url-templates,,0,0,0,0,2,0,1,1
bump-mapping,bump-mapping,,0,0,1,0,5,1,9,1
paintevent,paintevent,,1,2,6,3,12,9,8,100
wmf,wmf,,0,3,6,3,8,9,8,200
filtered-index,filtered-index,,0,0,3,0,2,3,4,1
byte-shifting,byte-shifting,,1,1,2,2,6,4,9,1
facebook-prophet,facebook-prophet,,18,26,40,44,37,84,0,44.444444
fileset,fileset,,0,0,3,0,7,3,3,1
mpeg,mpeg,,9,12,18,21,18,39,13,33.333333
h.263,h.263,,0,0,0,0,1,0,13,1
sparc,sparc,,8,8,9,16,15,25,9,1
angular-ui-router-extras,angular-ui-router-extras,,0,0,1,0,9,1,1,1
pcap4j,pcap4j,,3,0,5,3,7,8,3,1
microsoft-dynamics-nav,microsoft-dynamics-nav,,5,8,8,13,18,21,8,60
importjson,importjson,,4,4,0,8,5,8,5,1
tell,tell,,2,0,0,2,3,2,0,1
acts-as-tenant,acts-as-tenant,,0,2,1,2,2,3,12,100
class-attributes,class-attributes,,6,3,4,9,16,13,0,1
netiq,netiq,,0,0,0,0,6,0,3,1
coin-or-cbc,coin-or-cbc,,6,3,6,9,13,15,0,1
coin-or-clp,coin-or-clp,,1,1,3,2,2,5,0,1
bonobo,bonobo,,3,2,4,5,13,9,6,1
raptor,raptor,,1,0,1,1,1,2,1,1
cloudamqp,cloudamqp,,7,1,5,8,4,13,3,1
somee,somee,,0,1,1,1,2,2,8,1
setjmp,setjmp,,0,1,2,1,11,3,9,1
execve,execve,,2,5,9,7,19,16,9,150
little-man-computer,little-man-computer,,4,0,3,4,5,7,9,1
code-hinting,code-hinting,,0,1,0,1,4,1,3,1
dlna,dlna,,0,0,6,0,5,6,3,1
ensime,ensime,,0,1,2,1,8,3,2,1
use-strict,use-strict,,0,0,3,0,6,3,1,1
pyfcm,pyfcm,,0,2,9,2,6,11,13,100
gff,gff,,3,0,1,3,5,4,0,1
inline-styles,inline-styles,,6,5,15,11,23,26,1,1
regl,regl,,3,0,3,3,5,6,1,1
wtforms-json,wtforms-json,,1,0,2,1,1,3,0,1
bootstrap-native,bootstrap-native,,1,0,3,1,1,4,1,1
serverless-plugins,serverless-plugins,,7,5,8,12,9,20,6,1
round-slider,round-slider,,0,1,2,1,2,3,1,1
telerik-combobox,telerik-combobox,,1,0,0,1,1,1,8,1
dhclient,dhclient,,1,0,1,1,3,2,9,1
lifetimes-python,lifetimes-python,,3,0,0,3,2,3,0,1
geographic-distance,geographic-distance,,2,1,3,3,9,6,0,1
moonlight,moonlight,,0,0,0,0,1,0,13,1
flasgger,flasgger,,1,5,1,6,6,7,0,400
bouncedemail,bouncedemail,,0,1,1,1,3,2,4,1
nsmenu,nsmenu,,4,2,6,6,16,12,13,1
bing-search,bing-search,,1,2,9,3,18,12,8,100
jeditable,jeditable,,1,0,1,1,5,2,1,1
sbt1.0,sbt1.0,,2,1,0,3,6,3,2,1
catch-block,catch-block,,3,3,9,6,5,15,1,1
bing-news-search-api,bing-news-search-api,,0,0,2,0,4,2,8,1
progid,progid,,0,0,1,0,2,1,8,1
fragment-animation,fragment-animation,,0,0,1,0,3,1,3,1
tfilestream,tfilestream,,1,1,1,2,4,3,9,1
python-magic,python-magic,,3,1,4,4,4,8,0,1
bigtop,bigtop,,0,0,0,0,1,0,2,1
friend-class,friend-class,,1,1,4,2,5,6,9,1
pdu,pdu,,2,2,5,4,9,9,3,1
erasure,erasure,,2,2,3,4,5,7,3,1
renderaction,renderaction,,0,0,2,0,2,2,8,1
pulsesecure,pulsesecure,,0,1,1,1,1,2,6,1
aggregator,aggregator,,3,1,7,4,6,11,3,1
dmd,dmd,,1,2,5,3,7,8,9,100
gdc,gdc,,0,0,2,0,1,2,9,1
ldc,ldc,,0,1,2,1,2,3,9,1
instantiation-error,instantiation-error,,1,0,5,1,14,6,0,1
aws-regions,aws-regions,,3,3,8,6,16,14,6,1
google-music,google-music,,1,0,1,1,4,2,3,1
makemessages,makemessages,,0,1,3,1,5,4,0,1
facebook-call-to-action,facebook-call-to-action,,0,0,0,0,2,0,13,1
nextion,nextion,,2,2,3,4,4,7,9,1
multiple-schema,multiple-schema,,2,0,2,2,2,4,3,1
extjs2,extjs2,,0,0,0,0,4,0,1,1
blink-developer-tools,blink-developer-tools,,0,0,0,0,2,0,1,1
react-starter-kit,react-starter-kit,,0,2,2,2,19,4,1,100
metainspector,metainspector,,0,0,0,0,1,0,12,1
qplaintextedit,qplaintextedit,,5,5,11,10,12,21,0,1
asyncappender,asyncappender,,0,1,2,1,1,3,3,1
successor-arithmetics,successor-arithmetics,,1,1,5,2,12,7,0,1
preference,preference,,5,3,11,8,13,19,3,1
amazon-ec2-spot-market,amazon-ec2-spot-market,,3,2,2,5,2,7,6,1
dob,dob,,1,1,3,2,4,5,4,1
jump-table,jump-table,,0,1,2,1,6,3,9,1
coda,coda,,2,1,6,3,8,9,1,1
faces-flow,faces-flow,,0,3,0,3,1,3,3,200
uic,uic,,1,2,4,3,6,7,9,100
react-native-fcm,react-native-fcm,,9,11,16,20,52,36,1,22.222222
python-keyring,python-keyring,,1,1,6,2,7,8,0,1
babun,babun,,1,0,8,1,6,9,9,1
sql-server-config-manager,sql-server-config-manager,,0,1,0,1,5,1,4,1
mkpolyline,mkpolyline,,7,4,7,11,11,18,13,1
man-in-the-middle,man-in-the-middle,,8,9,14,17,15,31,6,12.5
call-graph,call-graph,,6,4,14,10,6,24,9,1
ggally,ggally,,4,1,12,5,19,17,0,1
controller-action,controller-action,,2,1,0,3,3,3,8,1
visual-studio-designer,visual-studio-designer,,1,1,3,2,5,5,8,1
jslider,jslider,,4,4,4,8,28,12,3,1
bandit,bandit,,1,1,2,2,4,4,0,1
animatetransform,animatetransform,,2,0,1,2,5,3,1,1
srt,srt,,5,4,9,9,18,18,13,1
ion-menu,ion-menu,,2,3,5,5,5,10,1,50
android-orm,android-orm,,0,0,1,0,4,1,3,1
iterative-deepening,iterative-deepening,,0,0,2,0,4,2,0,1
knights-landing,knights-landing,,0,0,3,0,1,3,9,1
sdl-mixer,sdl-mixer,,3,6,7,9,10,16,9,100
pre-signed-url,pre-signed-url,,18,19,39,37,49,76,6,5.555556
lars,lars,,2,0,0,2,1,2,0,1
protobuf.js,protobuf.js,,2,5,9,7,14,16,6,150
protobufjs,protobufjs,,2,1,1,3,7,4,6,1
smali,smali,,12,12,20,24,13,44,3,1
locally-abstract-type,locally-abstract-type,,0,0,1,0,2,1,0,1
scribe-workbench,scribe-workbench,,0,0,1,0,2,1,8,1
aspnet-contrib,aspnet-contrib,,1,0,1,1,4,2,8,1
mixcloud,mixcloud,,0,3,2,3,3,5,1,200
mosaic-plot,mosaic-plot,,1,4,2,5,8,7,0,300
ng2-dragula,ng2-dragula,,7,9,31,16,41,47,1,28.571429
numba-pro,numba-pro,,4,1,3,5,7,8,0,1
pljson,pljson,,1,2,2,3,2,5,4,100
explicit-destructor-call,explicit-destructor-call,,0,1,3,1,4,4,9,1
pseudo-destructor,pseudo-destructor,,0,0,0,0,1,0,9,1
getlasterror,getlasterror,,1,0,1,1,2,2,9,1
javax.json,javax.json,,0,4,2,4,7,6,3,300
mule-cluster,mule-cluster,,1,0,4,1,2,5,14,1
powercommands,powercommands,,1,0,0,1,3,1,8,1
safari-content-blocker,safari-content-blocker,,1,2,7,3,4,10,13,100
minor-mode,minor-mode,,0,0,1,0,1,1,9,1
pax,pax,,2,1,1,3,3,4,3,1
wordnik,wordnik,,0,1,0,1,3,1,1,1
catkin,catkin,,14,12,16,26,31,42,9,1
two-step-verification,two-step-verification,,0,0,0,0,5,0,4,1
wai,wai,,1,0,1,1,4,2,13,1
background-attachment,background-attachment,,2,3,6,5,10,11,1,50
gazebo-simu,gazebo-simu,,5,7,0,12,1,12,9,40
topdown,topdown,,5,2,4,7,6,11,8,1
coremidi,coremidi,,6,4,5,10,12,15,13,1
do-catch,do-catch,,1,1,0,2,6,2,13,1
array-multisort,array-multisort,,1,1,2,2,12,4,4,1
reparsepoint,reparsepoint,,0,0,2,0,3,2,9,1
writable,writable,,1,0,1,1,11,2,2,1
hashref,hashref,,0,0,2,0,5,2,9,1
mayavi.mlab,mayavi.mlab,,9,20,10,29,15,39,0,122.222222
nph,nph,,0,0,0,0,1,0,9,1
timeval,timeval,,0,3,0,3,3,3,9,200
object-slicing,object-slicing,,4,7,9,11,21,20,9,75
reification,reification,,2,2,3,4,3,7,3,1
getasync,getasync,,0,4,2,4,6,6,8,300
reviver-function,reviver-function,,1,1,0,2,1,2,1,1
pysmartdl,pysmartdl,,0,0,0,0,1,0,0,1
xregexp,xregexp,,5,1,6,6,5,12,0,1
instantclient,instantclient,,5,6,7,11,14,18,4,20
craftyjs,craftyjs,,1,0,1,1,2,2,1,1
bootstrap-slider,bootstrap-slider,,7,7,3,14,14,17,1,1
client-side-scripting,client-side-scripting,,1,1,11,2,16,13,1,1
file-location,file-location,,1,3,4,4,7,8,5,200
sms-verification,sms-verification,,4,3,4,7,9,11,3,1
amazon-machine-learning,amazon-machine-learning,,1,0,5,1,6,6,6,1
dynamic-function,dynamic-function,,5,2,2,7,4,9,0,1
railstutorial.org,railstutorial.org,,1,3,6,4,31,10,12,200
request-response,request-response,,2,2,8,4,14,12,8,1
rqt,rqt,,0,3,0,3,7,3,9,200
linq2db,linq2db,,5,6,14,11,18,25,8,20
embedded-tomcat-7,embedded-tomcat-7,,4,2,2,6,7,8,3,1
metabase,metabase,,12,18,25,30,30,55,4,50
joomla-module,joomla-module,,0,0,1,0,5,1,4,1
getparameter,getparameter,,2,0,5,2,11,7,4,1
hibernate-statistics,hibernate-statistics,,0,0,0,0,1,0,3,1
nstitlebaraccessoryviewcontroller,nstitlebaraccessoryviewcontroller,,0,0,0,0,1,0,13,1
lpt,lpt,,0,0,2,0,2,2,9,1
perlbrew,perlbrew,,2,6,5,8,6,13,9,200
discriminator,discriminator,,4,4,13,8,13,21,1,1
openvz,openvz,,0,1,4,1,7,5,9,1
epp,epp,,1,1,2,2,3,4,4,1
caffe2,caffe2,,2,8,29,10,44,39,0,300
input-type-file,input-type-file,,1,3,7,4,14,11,1,200
https-proxy-agent,https-proxy-agent,,2,1,3,3,3,6,6,1
httplistenerrequest,httplistenerrequest,,0,0,1,0,3,1,8,1
validationrule,validationrule,,0,0,4,0,3,4,8,1
roadmap,roadmap,,2,1,3,3,2,6,1,1
java-3d,java-3d,,0,1,3,1,10,4,3,1
mobilefirst-studio,mobilefirst-studio,,1,1,6,2,11,8,13,1
gn,gn,,2,4,4,6,11,10,9,100
freebase,freebase,,1,0,2,1,10,3,2,1
.net-runtime,.net-runtime,,3,1,0,4,1,4,8,1
c++-amp,c++-amp,,0,0,4,0,5,4,9,1
mpir,mpir,,1,0,0,1,6,1,9,1
android-layout-editor,android-layout-editor,,3,5,10,8,18,18,3,66.666667
login-control,login-control,,8,0,9,8,27,17,4,1
que,que,,3,2,1,5,5,6,3,1
recharts,recharts,,41,26,45,67,41,112,1,1
options-resolver,options-resolver,,1,0,0,1,2,1,4,1
facebook-test-users,facebook-test-users,,1,0,1,1,6,2,13,1
movabletype,movabletype,,1,0,0,1,3,1,9,1
vote-up-buttons,vote-up-buttons,,0,1,1,1,1,2,0,1
selection-sort,selection-sort,,25,6,33,31,49,64,0,1
box2dlights,box2dlights,,1,2,3,3,8,6,3,100
click-through,click-through,,0,2,3,2,3,5,1,100
option-type,option-type,,1,0,2,1,3,3,8,1
triplet,triplet,,7,6,2,13,6,15,0,1
android-kenburnsview,android-kenburnsview,,0,0,0,0,1,0,3,1
ghc-mod,ghc-mod,,0,0,1,0,7,1,2,1
effective-java,effective-java,,0,1,5,1,14,6,3,1
static-factory,static-factory,,2,0,0,2,4,2,3,1
nom,nom,,5,7,8,12,13,20,9,40
nacl-cryptography,nacl-cryptography,,2,1,4,3,4,7,6,1
scintilla,scintilla,,6,1,9,7,8,16,0,1
double-buffering,double-buffering,,1,1,5,2,9,7,8,1
type-constructor,type-constructor,,1,0,4,1,5,5,2,1
identifying-relationship,identifying-relationship,,1,0,0,1,1,1,4,1
granularity,granularity,,0,3,0,3,4,3,4,200
mosel,mosel,,0,1,3,1,1,4,0,1
cache-locality,cache-locality,,2,0,1,2,7,3,9,1
ll,ll,,5,2,13,7,7,20,0,1
spatie,spatie,,23,27,49,50,41,99,4,17.391304
symfony-2.6,symfony-2.6,,0,0,1,0,9,1,4,1
phrase,phrase,,5,2,8,7,10,15,0,1
httpie,httpie,,4,4,10,8,9,18,4,1
graphical-logo,graphical-logo,,7,4,4,11,7,15,1,1
praat,praat,,2,4,5,6,7,11,0,100
on-demand-resources,on-demand-resources,,2,1,4,3,16,7,13,1
warden,warden,,4,4,5,8,9,13,12,1
faas,faas,,3,3,5,6,11,11,6,1
autokey,autokey,,3,3,5,6,12,11,9,1
core-api,core-api,,6,5,8,11,5,19,8,1
midl,midl,,1,7,11,8,12,19,8,600
shrinkresources,shrinkresources,,2,0,2,2,4,4,3,1
pgcrypto,pgcrypto,,4,1,5,5,8,10,4,1
libpq,libpq,,7,4,13,11,21,24,4,1
sktexture,sktexture,,0,1,4,1,9,5,13,1
glasspane,glasspane,,0,0,1,0,2,1,3,1
choroplethr,choroplethr,,3,3,7,6,12,13,0,1
caffeine,caffeine,,11,9,12,20,25,32,3,1
lpcwstr,lpcwstr,,0,0,2,0,3,2,9,1
lpbyte,lpbyte,,0,0,0,0,1,0,9,1
gksudo,gksudo,,1,0,1,1,4,2,9,1
cloth-simulation,cloth-simulation,,1,0,1,1,5,2,8,1
jxls,jxls,,5,1,10,6,14,16,3,1
jhipster-registry,jhipster-registry,,14,11,32,25,42,57,3,1
pkg-resources,pkg-resources,,7,0,2,7,10,9,0,1
powerbuilder-build-deploy,powerbuilder-build-deploy,,1,3,0,4,5,4,8,200
powerbuilder-pfc,powerbuilder-pfc,,0,0,1,0,4,1,8,1
openwhisk,openwhisk,,10,9,17,19,57,36,6,1
tree-search,tree-search,,0,1,2,1,2,3,0,1
multiprecision,multiprecision,,2,0,5,2,4,7,9,1
boost-multiprecision,boost-multiprecision,,7,3,8,10,8,18,9,1
class-template,class-template,,4,2,9,6,10,15,9,1
pushwoosh,pushwoosh,,1,3,5,4,13,9,13,200
adodbapi,adodbapi,,1,4,1,5,4,6,0,300
powerschool,powerschool,,0,0,1,0,6,1,13,1
context-free-language,context-free-language,,7,0,7,7,13,14,0,1
chomsky-normal-form,chomsky-normal-form,,1,1,0,2,3,2,0,1
squeak,squeak,,2,8,1,10,26,11,13,300
android-account,android-account,,2,4,4,6,4,10,3,100
livelock,livelock,,0,1,1,1,3,2,3,1
object-object-mapping,object-object-mapping,,2,2,1,4,14,5,3,1
dolibarr,dolibarr,,0,0,1,0,10,1,4,1
jsonframe-cheerio,jsonframe-cheerio,,0,0,1,0,1,1,1,1
errorprone,errorprone,,2,3,3,5,10,8,3,50
angular2-providers,angular2-providers,,1,0,1,1,6,2,1,1
extranet,extranet,,0,0,1,0,1,1,4,1
asp.net-3.5,asp.net-3.5,,0,4,2,4,6,6,8,300
object-composition,object-composition,,2,3,5,5,15,10,9,50
for-json,for-json,,0,4,6,4,3,10,4,300
argh,argh,,0,0,0,0,1,0,9,1
amazon-marketplace,amazon-marketplace,,3,1,2,4,6,6,6,1
pyes,pyes,,0,1,0,1,3,1,6,1
notifyicon,notifyicon,,3,2,9,5,15,14,8,1
minikanren,minikanren,,0,3,5,3,6,8,0,200
seasoned-schemer,seasoned-schemer,,0,0,1,0,1,1,0,1
web-console,web-console,,4,3,4,7,5,11,1,1
wrl,wrl,,1,1,1,2,5,3,9,1
data-execution-prevention,data-execution-prevention,,0,0,0,0,2,0,9,1
qtopengl,qtopengl,,4,5,4,9,9,13,9,25
textwrangler,textwrangler,,3,0,4,3,9,7,0,1
ijson,ijson,,1,2,3,3,5,6,0,100
icriteria,icriteria,,1,2,1,3,2,4,8,100
isodate,isodate,,8,3,7,11,18,18,1,1
antenna-house,antenna-house,,5,1,4,6,9,10,3,1
rate,rate,,14,9,21,23,31,44,4,1
platform-agnostic,platform-agnostic,,0,0,1,0,1,1,8,1
wildfly-9,wildfly-9,,9,1,12,10,32,22,3,1
vcd,vcd,,2,0,1,2,3,3,0,1
looper,looper,,0,3,8,3,9,11,3,200
rls,rls,,2,1,1,3,4,4,4,1
azure-iot-suite,azure-iot-suite,,7,1,0,8,8,8,8,1
executesqlserveragentjob,executesqlserveragentjob,,0,0,3,0,2,3,4,1
generic-constraints,generic-constraints,,2,2,5,4,7,9,8,1
code-navigation,code-navigation,,0,1,1,1,5,2,8,1
rasa-core,rasa-core,,43,40,79,83,46,162,0,1
nor,nor,,1,0,2,1,3,3,9,1
ibm-odm,ibm-odm,,2,6,5,8,6,13,3,200
responsecache,responsecache,,2,0,3,2,3,5,8,1
chaquopy,chaquopy,,6,7,9,13,6,22,3,16.666667
portaudio,portaudio,,18,12,18,30,36,48,9,1
concave-hull,concave-hull,,2,3,2,5,5,7,0,50
apipie,apipie,,0,1,2,1,1,3,12,1
classloading,classloading,,3,4,7,7,15,14,3,33.333333
parcel,parcel,,8,23,22,31,35,53,3,187.5
linux-scst,linux-scst,,0,0,0,0,1,0,9,1
converters,converters,,99,92,213,191,21,404,0,1
gcdasyncudpsocket,gcdasyncudpsocket,,0,0,2,0,3,2,13,1
cgcolor,cgcolor,,1,3,0,4,11,4,13,200
bgr,bgr,,3,2,1,5,11,6,0,1
medoo,medoo,,2,1,3,3,13,6,4,1
storyq,storyq,,0,1,1,1,3,2,8,1
function-fitting,function-fitting,,3,1,7,4,7,11,0,1
binomial-coefficients,binomial-coefficients,,3,1,9,4,14,13,0,1
command-window,command-window,,1,0,2,1,1,3,9,1
stream-operators,stream-operators,,0,0,0,0,3,0,9,1
rotatetransform,rotatetransform,,2,3,2,5,7,7,1,50
mdc-components,mdc-components,,19,16,24,35,37,59,3,1
virtex,virtex,,2,0,0,2,4,2,9,1
outerheight,outerheight,,1,0,1,1,4,2,1,1
iphone-standalone-web-app,iphone-standalone-web-app,,2,2,3,4,10,7,1,1
om,om,,0,1,1,1,3,2,2,1
rum,rum,,1,0,2,1,7,3,2,1
nexus-5x,nexus-5x,,1,1,2,2,5,4,3,1
typedescriptor,typedescriptor,,1,1,1,2,4,3,8,1
elm327,elm327,,2,1,5,3,7,8,3,1
instabug,instabug,,3,3,0,6,6,6,3,1
pagedown,pagedown,,2,1,1,3,4,4,0,1
stellar.js,stellar.js,,3,1,3,4,6,7,1,1
multiway-tree,multiway-tree,,3,2,0,5,3,5,0,1
inline-view,inline-view,,0,1,0,1,5,1,4,1
react-i18next,react-i18next,,26,23,33,49,13,82,1,1
svn-externals,svn-externals,,2,2,2,4,8,6,6,1
laravel-localization,laravel-localization,,5,2,12,7,12,19,4,1
simpletest,simpletest,,0,0,0,0,2,0,4,1
inputconnection,inputconnection,,1,3,2,4,6,6,3,200
blazeds,blazeds,,0,0,2,0,4,2,13,1
paravirtualization,paravirtualization,,1,0,2,1,2,3,6,1
xirsys,xirsys,,0,0,2,0,2,2,1,1
log4javascript,log4javascript,,0,0,2,0,3,2,3,1
lokijs,lokijs,,7,5,8,12,12,20,1,1
escapestring,escapestring,,0,0,4,0,4,4,0,1
appassembler,appassembler,,0,2,0,2,1,2,3,100
pyrevit,pyrevit,,8,6,12,14,8,26,8,1
linkageerror,linkageerror,,1,1,13,2,7,15,3,1
instantsearch,instantsearch,,9,7,12,16,10,28,4,1
instantsearch-android,instantsearch-android,,1,0,0,1,2,1,3,1
weblistener,weblistener,,1,0,0,1,3,1,8,1
sqr,sqr,,4,1,3,5,8,8,4,1
custom-tags,custom-tags,,4,2,5,6,9,11,3,1
dynamics-ax-2012-r2,dynamics-ax-2012-r2,,2,0,5,2,13,7,8,1
away3d,away3d,,1,0,0,1,1,1,13,1
azure-speech,azure-speech,,7,5,8,12,5,20,8,1
treepanel,treepanel,,2,4,0,6,2,6,1,100
msde,msde,,0,0,0,0,1,0,4,1
sgvizler,sgvizler,,0,0,0,0,3,0,1,1
tizen-studio,tizen-studio,,3,5,13,8,22,21,13,66.666667
genexus-sd,genexus-sd,,0,0,1,0,7,1,3,1
adobe-animate,adobe-animate,,13,10,21,23,32,44,13,1
diskimage,diskimage,,2,1,3,3,3,6,9,1
rickshaw,rickshaw,,2,0,1,2,1,3,1,1
sas-gtl,sas-gtl,,0,0,0,0,1,0,0,1
qwebenginepage,qwebenginepage,,7,4,7,11,13,18,0,1
rpm-maven-plugin,rpm-maven-plugin,,1,2,5,3,4,8,3,100
sql-data-warehouse,sql-data-warehouse,,11,3,12,14,28,26,8,1
virtual-disk,virtual-disk,,1,1,0,2,2,2,6,1
executionpolicy,executionpolicy,,0,4,4,4,11,8,8,300
django-simple-history,django-simple-history,,3,1,9,4,13,13,0,1
iso-8859-2,iso-8859-2,,1,1,1,2,3,3,0,1
object-expression,object-expression,,0,0,0,0,1,0,3,1
uivewcontroller,uivewcontroller,,0,0,1,0,3,1,13,1
dining-philosopher,dining-philosopher,,2,2,4,4,9,8,3,1
sqloledb,sqloledb,,0,1,3,1,6,4,4,1
interface-segregation-principle,interface-segregation-principle,,1,2,1,3,1,4,3,100
dbghelp,dbghelp,,2,0,3,2,6,5,9,1
ini4j,ini4j,,1,0,2,1,7,3,3,1
uipinchgesturerecognizer,uipinchgesturerecognizer,,6,0,6,6,15,12,13,1
push-queue,push-queue,,0,0,0,0,2,0,4,1
libgphoto2,libgphoto2,,0,3,9,3,8,12,0,200
openshift-online,openshift-online,,1,2,3,3,35,6,6,100
mysqljs,mysqljs,,7,8,6,15,19,21,1,14.285714
psr-6,psr-6,,0,0,0,0,1,0,4,1
modalpopup,modalpopup,,5,4,9,9,8,18,1,1
pacman,pacman,,2,3,11,5,16,16,0,50
uploadcare,uploadcare,,1,2,3,3,8,6,1,100
buildmanager,buildmanager,,0,0,0,0,3,0,8,1
static-polymorphism,static-polymorphism,,5,1,4,6,7,10,9,1
picking,picking,,0,1,1,1,7,2,9,1
transform-feedback,transform-feedback,,1,0,1,1,3,2,9,1
asprise-ocr-api,asprise-ocr-api,,0,2,0,2,1,2,0,100
input-filtering,input-filtering,,0,2,4,2,1,6,1,100
pdf-scraping,pdf-scraping,,4,9,12,13,15,25,0,125
qevent,qevent,,1,3,7,4,10,11,9,200
extrinsic-parameters,extrinsic-parameters,,0,1,1,1,1,2,0,1
sqlbrowser,sqlbrowser,,1,1,2,2,1,4,4,1
dex2jar,dex2jar,,2,0,2,2,9,4,3,1
twig-filter,twig-filter,,2,3,6,5,13,11,4,50
lexical,lexical,,2,4,5,6,13,11,0,100
postal,postal,,1,0,2,1,6,3,8,1
acrylic-material,acrylic-material,,0,2,0,2,5,2,8,100
jcc,jcc,,0,1,2,1,2,3,2,1
redigo,redigo,,4,1,5,5,11,10,6,1
android-appshortcut,android-appshortcut,,1,0,4,1,8,5,3,1
scalding,scalding,,0,1,1,1,7,2,2,1
uint32-t,uint32-t,,1,0,1,1,5,2,9,1
jexcelapi,jexcelapi,,3,6,11,9,9,20,3,100
sitecore7.1,sitecore7.1,,0,0,0,0,1,0,8,1
minix,minix,,3,0,3,3,17,6,9,1
knpmenu,knpmenu,,0,0,1,0,1,1,4,1
java-compiler-api,java-compiler-api,,3,1,8,4,7,12,3,1
webpack.config.js,webpack.config.js,,3,5,9,8,19,17,1,66.666667
octobercms-widgets,octobercms-widgets,,2,1,3,3,8,6,4,1
up-navigation,up-navigation,,0,2,0,2,3,2,3,100
juicy-pixels,juicy-pixels,,0,1,2,1,2,3,2,1
nhibernate-profiler,nhibernate-profiler,,0,0,0,0,1,0,8,1
find-util,find-util,,0,1,1,1,4,2,9,1
replay,replay,,3,5,3,8,7,11,8,66.666667
markov-random-fields,markov-random-fields,,0,0,0,0,3,0,0,1
verbatim-string,verbatim-string,,0,2,2,2,7,4,8,100
accelerate,accelerate,,2,1,2,3,7,5,13,1
prefixes,prefixes,,0,1,0,1,2,1,1,1
bravado,bravado,,1,0,2,1,4,3,0,1
dotpeek,dotpeek,,0,1,2,1,9,3,8,1
system-configuration,system-configuration,,1,0,0,1,4,1,13,1
migx,migx,,0,0,0,0,2,0,4,1
vaadin-spring-boot,vaadin-spring-boot,,0,1,0,1,4,1,3,1
ngx-bootstrap-modal,ngx-bootstrap-modal,,3,4,15,7,36,22,1,33.333333
django-managers,django-managers,,6,2,14,8,18,22,0,1
spotify-docker-client,spotify-docker-client,,7,2,7,9,6,16,6,1
scriptengine,scriptengine,,3,6,10,9,13,19,3,100
google-openid,google-openid,,6,2,11,8,10,19,5,1
berksfile,berksfile,,1,0,0,1,5,1,12,1
ctor-initializer,ctor-initializer,,1,2,2,3,5,5,9,100
htmltools,htmltools,,1,2,1,3,9,4,0,100
net.pipe,net.pipe,,0,1,2,1,1,3,8,1
outofrangeexception,outofrangeexception,,2,4,10,6,19,16,8,100
flow-scope,flow-scope,,2,4,1,6,1,7,3,100
genome,genome,,8,1,15,9,18,24,0,1
array-intersect,array-intersect,,2,2,3,4,8,7,4,1
whoosh,whoosh,,9,5,10,14,23,24,0,1
rewind,rewind,,0,1,1,1,6,2,13,1
spree-auth-devise,spree-auth-devise,,2,0,3,2,6,5,12,1
shogun,shogun,,3,1,2,4,14,6,0,1
surveyjs,surveyjs,,6,2,8,8,9,16,1,1
splash-js-render,splash-js-render,,7,7,8,14,14,22,0,1
microfocus,microfocus,,6,3,10,9,14,19,4,1
gnucobol,gnucobol,,3,7,9,10,10,19,4,133.333333
dongle,dongle,,0,3,6,3,7,9,3,200
iup,iup,,0,2,6,2,14,8,9,100
jquery-templates,jquery-templates,,0,0,3,0,9,3,1,1
pacemaker,pacemaker,,6,9,13,15,15,28,9,50
freecad,freecad,,9,9,3,18,6,21,0,1
database-abstraction,database-abstraction,,2,1,4,3,5,7,4,1
uglifyjs2,uglifyjs2,,2,0,5,2,11,7,1,1
discretization,discretization,,5,6,11,11,12,22,0,20
nested-query,nested-query,,5,2,8,7,15,15,4,1
apple-configurator,apple-configurator,,0,3,4,3,5,7,13,200
dired,dired,,1,0,3,1,3,4,9,1
mouse-coordinates,mouse-coordinates,,0,0,2,0,2,2,9,1
windows-8-mail-app,windows-8-mail-app,,0,0,0,0,1,0,4,1
libev,libev,,0,2,2,2,9,4,9,100
command-objects,command-objects,,1,0,3,1,5,4,3,1
windows-users,windows-users,,2,1,3,3,6,6,8,1
akeneo,akeneo,,8,5,12,13,33,25,4,1
pdf-rendering,pdf-rendering,,0,1,1,1,5,2,3,1
system-rules,system-rules,,0,0,1,0,1,1,3,1
deadline-timer,deadline-timer,,1,1,1,2,2,3,9,1
mscoco,mscoco,,5,4,4,9,10,13,0,1
kmz,kmz,,4,6,5,10,14,15,1,50
auth0-delegated-admin,auth0-delegated-admin,,1,1,4,2,9,6,4,1
appery.io,appery.io,,0,1,0,1,2,1,4,1
greendao3,greendao3,,1,2,1,3,4,4,3,100
tidb,tidb,,3,4,6,7,31,13,4,33.333333
unattended-processing,unattended-processing,,0,2,6,2,4,8,4,100
precompiled,precompiled,,1,2,0,3,8,3,8,100
ccache,ccache,,2,0,9,2,8,11,9,1
twitterizer,twitterizer,,0,0,0,0,1,0,8,1
azul-zing,azul-zing,,0,0,0,0,3,0,3,1
jqgrid-php,jqgrid-php,,2,1,2,3,7,5,1,1
subgrid,subgrid,,4,0,5,4,7,9,8,1
aws-sct,aws-sct,,0,0,6,0,3,6,6,1
winpe,winpe,,2,4,5,6,10,11,8,100
winsound,winsound,,6,3,10,9,8,19,0,1
uppaal,uppaal,,2,3,3,5,9,8,0,50
spine,spine,,4,7,2,11,2,13,1,75
mitmproxy,mitmproxy,,13,19,20,32,31,52,6,46.153846
amp-bind,amp-bind,,3,3,6,6,15,12,1,1
list-literal,list-literal,,0,0,0,0,1,0,0,1
window-object,window-object,,3,1,6,4,11,10,1,1
glove,glove,,15,13,26,28,8,54,0,1
datarelation,datarelation,,1,0,2,1,3,3,8,1
swiftyuserdefaults,swiftyuserdefaults,,0,1,1,1,6,2,13,1
kubernetes-play,kubernetes-play,,0,0,0,0,2,0,6,1
vary,vary,,1,0,0,1,6,1,4,1
teamsite,teamsite,,0,0,4,0,2,4,8,1
karma-systemjs,karma-systemjs,,0,0,0,0,2,0,1,1
crosswalk-runtime,crosswalk-runtime,,0,0,2,0,4,2,3,1
ioncube,ioncube,,2,3,10,5,16,15,4,50
spring-camel,spring-camel,,38,29,70,67,89,137,3,1
imeoptions,imeoptions,,2,3,3,5,6,8,3,50
comfortable-mexican-sofa,comfortable-mexican-sofa,,0,2,1,2,1,3,12,100
onpress,onpress,,8,9,10,17,22,27,1,12.5
nslock,nslock,,1,1,0,2,1,2,13,1
wsapi,wsapi,,1,1,3,2,5,5,3,1
git-subrepo,git-subrepo,,1,1,7,2,2,9,6,1
oscilloscope,oscilloscope,,2,1,4,3,6,7,0,1
lyft-api,lyft-api,,4,1,4,5,13,9,13,1
django-management-command,django-management-command,,3,1,6,4,11,10,0,1
simpleadapter,simpleadapter,,2,0,4,2,9,6,3,1
qpainterpath,qpainterpath,,4,2,5,6,11,11,9,1
react-router-component,react-router-component,,1,1,0,2,7,2,1,1
systemevent,systemevent,,1,0,1,1,6,2,8,1
cmsamplebufferref,cmsamplebufferref,,1,1,5,2,4,7,13,1
eclipse-sirius,eclipse-sirius,,1,0,4,1,9,5,3,1
nevpnmanager,nevpnmanager,,2,3,9,5,12,14,13,50
linux-toolchain,linux-toolchain,,3,1,2,4,5,6,9,1
kaazing,kaazing,,0,0,0,0,1,0,5,1
browser-based,browser-based,,0,0,0,0,3,0,5,1
xml-column,xml-column,,0,0,0,0,3,0,4,1
ios-enterprise,ios-enterprise,,3,2,4,5,11,9,13,1
focusmanager,focusmanager,,0,0,0,0,1,0,3,1
keyboardfocusmanager,keyboardfocusmanager,,0,0,0,0,3,0,3,1
against,against,,3,0,0,3,4,3,4,1
connect-direct,connect-direct,,0,0,1,0,3,1,9,1
react-props,react-props,,115,108,237,223,296,460,1,1
launch-configuration,launch-configuration,,2,0,3,2,7,5,6,1
jtag,jtag,,7,4,12,11,12,23,9,1
facebook-feed,facebook-feed,,0,1,1,1,5,2,13,1
string-metric,string-metric,,0,0,0,0,1,0,8,1
entityreference,entityreference,,2,3,3,5,5,8,4,50
nested-sortable,nested-sortable,,0,4,4,4,8,8,1,300
byebug,byebug,,8,2,2,10,9,12,12,1
access-keys,access-keys,,3,4,3,7,9,10,6,33.333333
weaviate,weaviate,,0,0,0,0,1,0,1,1
google-hangouts,google-hangouts,,3,3,12,6,8,18,5,1
hangouts-api,hangouts-api,,7,6,10,13,13,23,5,1
nsxmlelement,nsxmlelement,,1,0,1,1,3,2,13,1
update-attributes,update-attributes,,0,1,4,1,3,5,12,1
data-dumper,data-dumper,,0,1,1,1,11,2,9,1
bernoulli-numbers,bernoulli-numbers,,0,0,1,0,2,1,0,1
beep,beep,,0,2,10,2,9,12,9,100
release-candidate,release-candidate,,0,0,0,0,1,0,3,1
yii2-giiant,yii2-giiant,,0,1,1,1,1,2,4,1
rtlcss,rtlcss,,1,1,6,2,2,8,1,1
react-day-picker,react-day-picker,,6,5,12,11,33,23,1,1
snakeyaml,snakeyaml,,15,13,19,28,37,47,3,1
libnice,libnice,,1,0,2,1,2,3,1,1
roundedbitmapdrawable,roundedbitmapdrawable,,0,0,0,0,1,0,3,1
android-binder,android-binder,,7,11,8,18,20,26,3,57.142857
simultaneous-calls,simultaneous-calls,,0,1,1,1,4,2,13,1
swift-mt,swift-mt,,1,0,2,1,3,3,3,1
jdk6,jdk6,,2,1,1,3,5,4,3,1
python-2.4,python-2.4,,0,0,1,0,12,1,0,1
part-of-speech,part-of-speech,,2,5,12,7,17,19,0,150
android-pagetransformer,android-pagetransformer,,3,2,5,5,3,10,3,1
iif-function,iif-function,,3,1,5,4,6,9,5,1
rubular,rubular,,0,0,3,0,4,3,0,1
9-bit-serial,9-bit-serial,,0,1,1,1,2,2,9,1
jersey-test-framework,jersey-test-framework,,3,3,12,6,15,18,3,1
python-3.2,python-3.2,,1,2,0,3,9,3,0,100
d3pie.js,d3pie.js,,0,0,1,0,2,1,1,1
feature-branch,feature-branch,,3,1,6,4,9,10,6,1
azure-connect,azure-connect,,1,0,3,1,5,4,8,1
fido,fido,,9,13,7,22,3,29,6,44.444444
uaf,uaf,,0,2,1,2,1,3,6,100
depth-testing,depth-testing,,5,6,2,11,12,13,9,20
minor-upgrade,minor-upgrade,,0,0,1,0,5,1,8,1
import.io,import.io,,0,0,0,0,1,0,0,1
mtproto,mtproto,,0,4,3,4,2,7,0,300
hl7-v3,hl7-v3,,0,0,2,0,3,2,14,1
mailing-list,mailing-list,,3,0,6,3,5,9,4,1
pthreads-win32,pthreads-win32,,0,0,2,0,3,2,9,1
voxels,voxels,,0,0,0,0,6,0,0,1
amber-framework,amber-framework,,5,1,7,6,6,13,9,1
jzy3d,jzy3d,,0,2,2,2,4,4,3,100
spring-integration-aws,spring-integration-aws,,15,1,27,16,39,43,3,1
pathname,pathname,,3,2,8,5,9,13,0,1
html-post,html-post,,1,0,0,1,6,1,4,1
itoa,itoa,,3,0,0,3,3,3,9,1
gmail-addons,gmail-addons,,29,28,79,57,158,136,5,1
delegatinghandler,delegatinghandler,,2,1,3,3,9,6,8,1
fix8,fix8,,0,0,0,0,1,0,9,1
associative-table,associative-table,,0,0,1,0,2,1,4,1
wcf-ria-services,wcf-ria-services,,0,0,3,0,6,3,8,1
php-imagine,php-imagine,,0,0,3,0,6,3,4,1
cfspreadsheet,cfspreadsheet,,2,0,4,2,6,6,4,1
geocomplete,geocomplete,,1,3,1,4,4,5,1,200
bytearrayinputstream,bytearrayinputstream,,1,4,8,5,6,13,3,300
universal-hashing,universal-hashing,,0,0,4,0,2,4,12,1
environment-modules,environment-modules,,2,6,1,8,8,9,9,200
v4l,v4l,,2,1,3,3,3,6,13,1
runjags,runjags,,1,1,2,2,12,4,0,1
uiprintinteractioncntrler,uiprintinteractioncntrler,,2,1,7,3,5,10,13,1
uiprintformatter,uiprintformatter,,1,1,3,2,3,5,13,1
bag,bag,,7,2,3,9,14,12,0,1
pax-exam,pax-exam,,4,0,3,4,9,7,3,1
installshield-2014,installshield-2014,,1,0,0,1,3,1,8,1
gtk2hs,gtk2hs,,0,0,1,0,11,1,2,1
tensorlayer,tensorlayer,,3,1,2,4,4,6,0,1
groovydoc,groovydoc,,0,2,1,2,3,3,3,100
non-termination,non-termination,,2,0,0,2,2,2,0,1
finite-field,finite-field,,0,3,6,3,6,9,0,200
createbitmap,createbitmap,,2,0,0,2,4,2,3,1
jsnetworkx,jsnetworkx,,2,1,2,3,3,5,1,1
call-hierarchy,call-hierarchy,,2,1,2,3,2,5,3,1
grails-filters,grails-filters,,0,0,0,0,2,0,3,1
xquartz,xquartz,,3,5,10,8,9,18,9,66.666667
content-disposition,content-disposition,,4,12,16,16,24,32,4,200
xdist,xdist,,4,9,10,13,11,23,0,125
cgilua,cgilua,,0,0,0,0,1,0,9,1
jspinner,jspinner,,3,4,6,7,9,13,3,33.333333
bitbar,bitbar,,1,2,2,3,2,5,3,100
service-fabric-on-premises,service-fabric-on-premises,,4,3,12,7,32,19,8,1
parent-selector,parent-selector,,0,1,1,1,1,2,1,1
fusebox,fusebox,,3,0,0,3,6,3,1,1
stylish,stylish,,2,1,3,3,3,6,1,1
rawrabbit,rawrabbit,,3,6,0,9,5,9,8,100
boa,boa,,0,0,0,0,1,0,9,1
constantfolding,constantfolding,,2,1,0,3,4,3,9,1
mongoskin,mongoskin,,0,0,4,0,5,4,1,1
canary-deployment,canary-deployment,,1,2,7,3,12,10,6,100
mirage,mirage,,0,0,3,0,7,3,0,1
ohai-gem,ohai-gem,,1,0,1,1,6,2,12,1
eddystone-url,eddystone-url,,1,1,1,2,3,3,3,1
drive-letter,drive-letter,,0,0,2,0,2,2,9,1
non-member-functions,non-member-functions,,0,2,1,2,8,3,9,100
pytest-cov,pytest-cov,,5,4,6,9,12,15,0,1
aho-corasick,aho-corasick,,1,2,3,3,5,6,0,100
binascii,binascii,,3,1,2,4,8,6,0,1
powershellget,powershellget,,0,1,0,1,4,1,8,1
code-structure,code-structure,,8,3,8,11,9,19,9,1
addressof,addressof,,1,2,2,3,7,5,9,100
dda,dda,,1,0,0,1,2,1,9,1
yasm,yasm,,2,4,10,6,27,16,9,100
pipes-filters,pipes-filters,,2,0,4,2,11,6,1,1
cortana-invoke,cortana-invoke,,1,0,4,1,4,5,8,1
opserver,opserver,,0,0,0,0,1,0,4,1
unchecked-exception,unchecked-exception,,2,0,3,2,5,5,3,1
reportng,reportng,,0,0,1,0,5,1,3,1
firefox-developer-edition,firefox-developer-edition,,2,5,5,7,15,12,1,150
sap-data-dictionary,sap-data-dictionary,,0,1,3,1,8,4,5,1
service-pack,service-pack,,0,0,0,0,3,0,3,1
google-cloud-intellij,google-cloud-intellij,,0,1,0,1,4,1,6,1
dox,dox,,0,0,0,0,1,0,9,1
ejb-3.2,ejb-3.2,,7,2,8,9,9,17,3,1
arinc,arinc,,0,0,0,0,1,0,9,1
occlusion,occlusion,,4,2,3,6,7,9,0,1
jquery.repeater,jquery.repeater,,4,2,4,6,5,10,1,1
google-cdn,google-cdn,,0,3,5,3,3,8,6,200
localtunnel,localtunnel,,1,1,7,2,7,9,1,1
search-engine-api,search-engine-api,,0,0,0,0,1,0,1,1
tv4,tv4,,3,1,4,4,7,8,1,1
suid,suid,,0,1,1,1,4,2,9,1
caspol,caspol,,0,1,0,1,1,1,8,1
nothrow,nothrow,,0,1,1,1,2,2,9,1
mcl,mcl,,0,0,0,0,1,0,0,1
dynamic-pages,dynamic-pages,,2,1,2,3,6,5,1,1
anchor-view,anchor-view,,0,0,0,0,2,0,3,1
conio,conio,,1,1,3,2,4,5,9,1
petitparser,petitparser,,0,1,2,1,3,3,13,1
overlapped-io,overlapped-io,,2,1,3,3,13,6,9,1
roguelike,roguelike,,0,3,4,3,3,7,0,200
apr,apr,,1,5,7,6,12,13,3,400
resty,resty,,0,2,1,2,3,3,6,100
sqlstorage,sqlstorage,,0,0,0,0,1,0,4,1
gnip,gnip,,0,0,1,0,3,1,0,1
angularjs-config,angularjs-config,,1,0,1,1,3,2,1,1
tablet-pc,tablet-pc,,2,1,1,3,2,4,8,1
private-network,private-network,,2,2,6,4,7,10,6,1
dynamics365-app-outlook,dynamics365-app-outlook,,1,1,1,2,2,3,8,1
jdk1.4,jdk1.4,,0,0,0,0,3,0,3,1
react-stripe-elements,react-stripe-elements,,5,7,3,12,14,15,1,40
pleasewait,pleasewait,,1,0,0,1,2,1,1,1
database-versioning,database-versioning,,4,2,6,6,11,12,4,1
large-file-upload,large-file-upload,,4,4,3,8,5,11,8,1
commandfield,commandfield,,1,1,1,2,1,3,8,1
tweedie,tweedie,,0,1,5,1,5,6,0,1
devops-insights,devops-insights,,1,0,0,1,5,1,6,1
soomla,soomla,,0,0,0,0,3,0,13,1
instance-methods,instance-methods,,0,4,2,4,11,6,9,300
string-to-symbol,string-to-symbol,,0,0,1,0,1,1,9,1
android-include,android-include,,1,2,1,3,8,4,3,100
sizetofit,sizetofit,,2,1,3,3,6,6,13,1
dataflowtask,dataflowtask,,2,2,2,4,12,6,4,1
tabbed,tabbed,,0,6,7,6,5,13,3,500
virtual-ip-address,virtual-ip-address,,0,1,3,1,9,4,6,1
oracledb-npm,oracledb-npm,,3,2,10,5,20,15,1,1
activity-indicator,activity-indicator,,4,8,10,12,25,22,13,100
cblas,cblas,,7,1,8,8,9,16,9,1
filepicker.io,filepicker.io,,2,0,1,2,4,3,3,1
currentuiculture,currentuiculture,,0,1,1,1,3,2,8,1
android-palette,android-palette,,2,0,2,2,6,4,3,1
areas,areas,,0,0,0,0,8,0,8,1
section508,section508,,8,3,8,11,13,19,13,1
qtextcursor,qtextcursor,,0,1,3,1,6,4,9,1
transliteration,transliteration,,3,5,12,8,21,20,1,66.666667
tpkeyboardavoiding,tpkeyboardavoiding,,0,1,2,1,2,3,13,1
tyrus,tyrus,,0,1,6,1,7,7,3,1
settings.bundle,settings.bundle,,0,3,2,3,5,5,13,200
ambient,ambient,,1,0,6,1,9,7,3,1
simultaneous,simultaneous,,4,5,12,9,28,21,0,25
darkflow,darkflow,,15,8,15,23,30,38,0,1
or-tools,or-tools,,54,47,40,101,43,141,0,1
delete-method,delete-method,,1,2,1,3,5,4,5,100
event-dispatching,event-dispatching,,1,1,3,2,3,5,3,1
sitecore8.1,sitecore8.1,,1,0,4,1,7,5,8,1
json-c,json-c,,2,1,3,3,2,6,9,1
tagx,tagx,,0,0,0,0,1,0,3,1
page.js,page.js,,0,1,1,1,2,2,1,1
iron-pages,iron-pages,,1,0,3,1,5,4,1,1
mailboxer,mailboxer,,2,0,4,2,3,6,12,1
pega,pega,,6,6,11,12,13,23,3,1
pls-00103,pls-00103,,1,1,1,2,8,3,4,1
apollo-android,apollo-android,,3,5,7,8,12,15,1,66.666667
pbx,pbx,,3,6,6,9,15,15,13,100
associated-object,associated-object,,0,0,0,0,5,0,8,1
zenject,zenject,,2,1,7,3,12,10,8,1
teneo,teneo,,0,0,0,0,1,0,3,1
teamsql,teamsql,,0,0,2,0,2,2,3,1
google-qpx-express-api,google-qpx-express-api,,0,0,0,0,3,0,5,1
rndis,rndis,,0,1,2,1,3,3,9,1
shortest,shortest,,3,4,8,7,4,15,0,33.333333
policyfiles,policyfiles,,0,2,2,2,3,4,12,100
card.io,card.io,,4,1,2,5,8,7,3,1
android-4.1-jelly-bean,android-4.1-jelly-bean,,0,0,1,0,6,1,3,1
gwt-maven-plugin,gwt-maven-plugin,,0,0,4,0,2,4,3,1
canon-sdk,canon-sdk,,0,1,5,1,10,6,8,1
ptp,ptp,,0,0,7,0,4,7,3,1
teradata-sql-assistant,teradata-sql-assistant,,18,19,51,37,68,88,4,5.555556
caml,caml,,6,7,13,13,24,26,8,16.666667
django-markdown-deux,django-markdown-deux,,1,0,1,1,3,2,0,1
uickeychainstore,uickeychainstore,,0,0,0,0,1,0,13,1
objc-category,objc-category,,1,0,0,1,2,1,13,1
cryptotokenkit,cryptotokenkit,,0,1,0,1,2,1,13,1
clearcase-automation,clearcase-automation,,0,1,1,1,3,2,6,1
affix,affix,,1,0,3,1,12,4,1,1
pythonista,pythonista,,4,6,7,10,18,17,0,50
cyberduck,cyberduck,,1,1,4,2,7,6,6,1
setthreadaffinitymask,setthreadaffinitymask,,0,0,1,0,1,1,9,1
asf,asf,,2,0,2,2,4,4,13,1
image-extraction,image-extraction,,1,1,3,2,3,5,0,1
azimuth,azimuth,,3,1,3,4,2,7,0,1
sharpshell,sharpshell,,0,2,0,2,4,2,8,100
wildfly-11,wildfly-11,,8,7,22,15,56,37,3,1
preemption,preemption,,3,2,8,5,16,13,9,1
dom-if,dom-if,,2,1,0,3,5,3,1,1
ms-solver-foundation,ms-solver-foundation,,1,0,3,1,7,4,0,1
multiton,multiton,,0,0,0,0,2,0,3,1
rfe,rfe,,5,3,14,8,16,22,0,1
amazon-silk,amazon-silk,,0,0,2,0,2,2,1,1
type-narrowing,type-narrowing,,0,1,3,1,7,4,9,1
ef-power-tools,ef-power-tools,,0,1,1,1,1,2,8,1
facebook-rest-api,facebook-rest-api,,0,0,2,0,2,2,13,1
automatic-storage,automatic-storage,,0,0,4,0,3,4,9,1
unary-function,unary-function,,1,1,1,2,6,3,9,1
hpcc-ecl,hpcc-ecl,,1,0,2,1,1,3,0,1
watson-dialog,watson-dialog,,6,0,8,6,20,14,6,1
couchdb-2.x,couchdb-2.x,,0,2,1,2,3,3,1,100
nsbrowser,nsbrowser,,0,0,1,0,2,1,13,1
theforeman,theforeman,,2,2,4,4,4,8,12,1
ginkgo,ginkgo,,2,3,5,5,6,10,6,50
skyfloatinglabeltextfield,skyfloatinglabeltextfield,,0,0,2,0,2,2,13,1
offsetheight,offsetheight,,1,3,1,4,3,5,1,200
radare2,radare2,,2,2,15,4,4,19,9,1
curlpp,curlpp,,5,0,5,5,7,10,9,1
motion-detection,motion-detection,,5,6,13,11,23,24,0,20
constructor-chaining,constructor-chaining,,1,3,2,4,3,6,9,200
cognos-11,cognos-11,,14,10,8,24,1,32,4,1
tomcat5.5,tomcat5.5,,0,2,2,2,1,4,3,100
ios9-today-widget,ios9-today-widget,,0,0,0,0,1,0,13,1
zone,zone,,7,7,12,14,23,26,1,1
selenoid,selenoid,,6,2,3,8,14,11,3,1
hot-rod,hot-rod,,0,0,1,0,6,1,3,1
uicontrolevents,uicontrolevents,,2,0,3,2,6,5,13,1
virtus,virtus,,1,0,2,1,1,3,12,1
usrp,usrp,,3,3,7,6,11,13,0,1
ckmodifyrecordsoperation,ckmodifyrecordsoperation,,0,0,1,0,4,1,13,1
ckqueryoperation,ckqueryoperation,,1,1,3,2,5,5,13,1
parcelfiledescriptor,parcelfiledescriptor,,1,0,1,1,6,2,3,1
forestplot,forestplot,,14,12,14,26,21,40,0,1
slp,slp,,0,0,0,0,1,0,5,1
skeletal-mesh,skeletal-mesh,,0,2,3,2,3,5,9,100
amazon-dms,amazon-dms,,3,1,4,4,4,8,6,1
sas-stored-process,sas-stored-process,,0,0,0,0,6,0,0,1
google-colaboratory,google-colaboratory,,285,309,414,594,400,1008,0,8.421053
pandoc-citeproc,pandoc-citeproc,,4,3,4,7,6,11,0,1
strongly-connected-graph,strongly-connected-graph,,2,0,5,2,11,7,0,1
echo-server,echo-server,,0,1,2,1,3,3,9,1
acl2,acl2,,1,0,2,1,1,3,0,1
uniform,uniform,,6,2,6,8,6,14,0,1
reward,reward,,5,1,3,6,10,9,0,1
gaia,gaia,,0,1,1,1,1,2,4,1
xpathsapply,xpathsapply,,0,0,0,0,4,0,0,1
darcs,darcs,,0,2,1,2,1,3,6,100
invalidprogramexception,invalidprogramexception,,0,1,0,1,3,1,8,1
object-notation,object-notation,,2,1,1,3,4,4,1,1
rhodecode,rhodecode,,2,1,0,3,1,3,6,1
event-stream-processing,event-stream-processing,,4,3,2,7,6,9,14,1
jconfirm,jconfirm,,2,2,0,4,5,4,1,1
greenmail,greenmail,,0,3,1,3,5,4,3,200
test-framework,test-framework,,1,2,2,3,5,5,3,100
null-layout-manager,null-layout-manager,,3,2,3,5,8,8,3,1
big-ip,big-ip,,7,1,8,8,10,16,6,1
nhapi,nhapi,,0,1,1,1,7,2,8,1
asp.net-core-security,asp.net-core-security,,2,0,3,2,3,5,8,1
samtools,samtools,,2,2,4,4,7,8,9,1
picard,picard,,0,0,2,0,4,2,0,1
jaybird,jaybird,,0,1,5,1,23,6,4,1
ggvis,ggvis,,2,2,4,4,15,8,0,1
startupscript,startupscript,,9,2,7,11,7,18,6,1
clio-api,clio-api,,1,1,2,2,9,4,4,1
r.id,r.id,,0,0,0,0,1,0,3,1
jquery-svg,jquery-svg,,1,1,8,2,7,10,1,1
assistive-technology,assistive-technology,,0,0,3,0,4,3,1,1
scene-manager,scene-manager,,1,2,4,3,6,7,8,100
smartthings,smartthings,,0,3,2,3,7,5,3,200
acts-as-taggable-on,acts-as-taggable-on,,2,1,7,3,10,10,12,1
soti,soti,,0,0,5,0,5,5,3,1
maven-central,maven-central,,2,6,13,8,14,21,3,200
rayon,rayon,,4,3,4,7,8,11,9,1
concurrentdictionary,concurrentdictionary,,5,6,15,11,21,26,8,20
appindicator,appindicator,,2,0,0,2,3,2,9,1
reactfx,reactfx,,0,0,1,0,4,1,3,1
icon-fonts,icon-fonts,,0,7,8,7,12,15,1,600
gomock,gomock,,2,2,3,4,12,7,6,1
server-name,server-name,,1,5,4,6,4,10,6,400
screen-off,screen-off,,2,0,1,2,3,3,3,1
qsplitter,qsplitter,,2,3,4,5,9,9,0,50
lightning,lightning,,22,15,19,37,21,56,14,1
aura.js,aura.js,,1,1,2,2,3,4,14,1
compiler-services,compiler-services,,1,2,0,3,2,3,8,100
npm-liveserver,npm-liveserver,,3,9,6,12,7,18,1,200
jboss-4.2.x,jboss-4.2.x,,2,1,3,3,3,6,3,1
sensu,sensu,,1,3,9,4,15,13,6,200
microsoft-project-vba,microsoft-project-vba,,4,5,5,9,17,14,5,25
portia,portia,,0,3,3,3,6,6,0,200
jquery-forms-plugin,jquery-forms-plugin,,0,2,4,2,3,6,1,100
jquery-form-validator,jquery-form-validator,,2,3,3,5,12,8,1,50
rl78,rl78,,0,2,1,2,1,3,9,100
nsanimation,nsanimation,,0,0,1,0,2,1,13,1
shellsort,shellsort,,2,0,5,2,10,7,0,1
protein-database,protein-database,,3,3,3,6,16,9,0,1
perfect-notifications,perfect-notifications,,0,0,0,0,1,0,13,1
typo3-4.5,typo3-4.5,,1,0,0,1,5,1,4,1
baidu,baidu,,3,6,7,9,14,16,3,100
baidu-map,baidu-map,,2,2,5,4,7,9,3,1
uipopover,uipopover,,0,2,2,2,6,4,13,100
actionpack,actionpack,,3,0,0,3,6,3,12,1
rc,rc,,3,7,12,10,12,22,9,133.333333
screwdriver-cd,screwdriver-cd,,0,2,0,2,1,2,6,100
brep,brep,,0,0,0,0,2,0,0,1
mozjpeg,mozjpeg,,2,0,1,2,4,3,9,1
vim-macros,vim-macros,,1,1,0,2,1,2,9,1
failure-slice,failure-slice,,6,0,0,6,6,6,0,1
telegraf-inputs-plugin,telegraf-inputs-plugin,,9,5,5,14,9,19,6,1
telegraf-plugins,telegraf-plugins,,8,3,4,11,3,15,6,1
clock-synchronization,clock-synchronization,,0,1,1,1,3,2,9,1
pdh,pdh,,0,0,0,0,1,0,9,1
jquery-mobile-listview,jquery-mobile-listview,,0,0,0,0,2,0,1,1
xmlspy,xmlspy,,0,1,2,1,4,3,3,1
intel-media-sdk,intel-media-sdk,,1,1,0,2,2,2,9,1
for-xml-explicit,for-xml-explicit,,0,0,0,0,2,0,4,1
omeka,omeka,,0,1,1,1,3,2,1,1
culling,culling,,1,3,7,4,5,11,9,200
proxy-protocol,proxy-protocol,,1,0,2,1,9,3,6,1
ocs,ocs,,0,0,0,0,2,0,4,1
infosphere-spl,infosphere-spl,,1,0,1,1,5,2,4,1
ibm-streams,ibm-streams,,0,0,1,0,5,1,4,1
jquery-ui-accordion,jquery-ui-accordion,,3,4,5,7,15,12,1,33.333333
getprocaddress,getprocaddress,,2,1,4,3,10,7,9,1
server-response,server-response,,1,1,4,2,5,6,4,1
lua-c++-connection,lua-c++-connection,,0,0,1,0,3,1,9,1
jose4j,jose4j,,1,5,6,6,5,12,4,400
onem2m,onem2m,,5,2,2,7,6,9,8,1
dsx-local,dsx-local,,0,1,1,1,2,2,0,1
acts-as-audited,acts-as-audited,,1,2,5,3,7,8,12,100
eclipse-gef,eclipse-gef,,1,0,0,1,10,1,3,1
diamond-operator,diamond-operator,,1,1,2,2,2,4,3,1
service-reference,service-reference,,5,7,11,12,24,23,8,40
anonymous-inner-class,anonymous-inner-class,,2,2,12,4,29,16,3,1
multiple-models,multiple-models,,2,1,6,3,9,9,12,1
gringo,gringo,,1,0,1,1,3,2,0,1
rfc3339,rfc3339,,3,2,2,5,5,7,0,1
findersync,findersync,,1,1,11,2,4,13,13,1
maven-changes-plugin,maven-changes-plugin,,0,1,0,1,1,1,6,1
mbr2gpt,mbr2gpt,,0,0,0,0,1,0,9,1
rdma,rdma,,0,1,8,1,11,9,9,1
file-find,file-find,,0,0,1,0,2,1,9,1
aries,aries,,2,0,6,2,10,8,3,1
rsh,rsh,,0,3,3,3,3,6,9,200
first-chance-exception,first-chance-exception,,0,0,0,0,4,0,8,1
transitive-dependency,transitive-dependency,,6,7,12,13,26,25,3,16.666667
kendo-sortable,kendo-sortable,,2,0,3,2,2,5,1,1
ibm-ifs,ibm-ifs,,0,0,0,0,3,0,4,1
abcustomuinavcontroller,abcustomuinavcontroller,,0,1,0,1,1,1,13,1
acts-as-votable,acts-as-votable,,3,2,7,5,11,12,12,1
ion-infinite-scroll,ion-infinite-scroll,,0,0,2,0,3,2,1,1
random-data,random-data,,0,1,2,1,6,3,0,1
horizontal-accordion,horizontal-accordion,,0,0,0,0,2,0,1,1
scrolledcomposite,scrolledcomposite,,1,0,2,1,1,3,3,1
magento-1.9.1,magento-1.9.1,,0,1,1,1,5,2,4,1
nsbitmapimagerep,nsbitmapimagerep,,0,2,2,2,2,4,13,100
ssas-2016,ssas-2016,,3,0,3,3,6,6,4,1
suptitle,suptitle,,0,0,1,0,2,1,0,1
android-device-explorer,android-device-explorer,,0,0,0,0,3,0,3,1
jsonml,jsonml,,0,0,0,0,2,0,3,1
getenv,getenv,,2,3,5,5,10,10,9,50
system-stored-procedures,system-stored-procedures,,0,0,0,0,1,0,4,1
prefix-sum,prefix-sum,,0,2,0,2,3,2,0,100
angular2-docheck,angular2-docheck,,0,0,0,0,1,0,1,1
rubyinstaller,rubyinstaller,,1,0,2,1,4,3,12,1
cleanse,cleanse,,0,0,0,0,1,0,13,1
warm-up,warm-up,,1,0,3,1,6,4,8,1
r-haven,r-haven,,5,5,11,10,20,21,0,1
french,french,,4,6,15,10,28,25,0,50
mft,mft,,2,1,0,3,2,3,9,1
facebook-graph-api-v2.8,facebook-graph-api-v2.8,,0,0,0,0,4,0,13,1
ptree,ptree,,5,1,7,6,7,13,9,1
perlop,perlop,,0,0,1,0,1,1,9,1
struts-validation,struts-validation,,0,0,0,0,3,0,3,1
insecure-connection,insecure-connection,,2,2,4,4,6,8,4,1
eyeql,eyeql,,0,0,0,0,2,0,6,1
idea-plugin,idea-plugin,,2,1,0,3,3,3,3,1
debconf,debconf,,0,2,2,2,4,4,9,100
mime-message,mime-message,,10,5,17,15,19,32,3,1
qstandarditem,qstandarditem,,1,1,2,2,7,4,9,1
boost-system,boost-system,,2,0,2,2,3,4,9,1
php-webdriver,php-webdriver,,2,1,2,3,2,5,3,1
android-apt,android-apt,,0,0,0,0,5,0,3,1
fst,fst,,1,1,2,2,3,4,0,1
zerorpc,zerorpc,,6,3,5,9,8,14,0,1
countable,countable,,0,1,2,1,4,3,4,1
rootfs,rootfs,,3,3,8,6,16,14,9,1
class-instance-variables,class-instance-variables,,1,0,3,1,7,4,12,1
java-ws,java-ws,,3,0,6,3,9,9,3,1
flightpath,flightpath,,0,0,0,0,2,0,3,1
nsmetadataquery,nsmetadataquery,,0,1,1,1,3,2,13,1
color-profile,color-profile,,0,2,4,2,11,6,0,100
color-management,color-management,,0,2,4,2,4,6,0,100
sapui5-theming,sapui5-theming,,5,3,3,8,7,11,1,1
smartview,smartview,,1,1,4,2,3,6,5,1
angular2-styleguide,angular2-styleguide,,0,0,0,0,7,0,1,1
gradle-android-test-plugi,gradle-android-test-plugi,,2,3,1,5,4,6,3,50
system.io.fileinfo,system.io.fileinfo,,1,0,3,1,6,4,8,1
nailgun,nailgun,,0,0,1,0,2,1,3,1
lld,lld,,6,2,6,8,12,14,9,1
jodconverter,jodconverter,,2,0,3,2,4,5,5,1
sonar-maven-plugin,sonar-maven-plugin,,0,0,1,0,5,1,3,1
bitstream,bitstream,,1,3,5,4,9,9,0,200
rmo,rmo,,0,0,1,0,2,1,4,1
capacity,capacity,,8,8,5,16,18,21,6,1
message-authentication-code,message-authentication-code,,0,0,2,0,2,2,6,1
.profile,.profile,,0,2,4,2,6,6,9,100
hazard,hazard,,4,4,6,8,9,14,0,1
cox,cox,,4,4,6,8,13,14,0,1
callcc,callcc,,1,6,2,7,5,9,0,500
json-simple,json-simple,,9,2,2,11,19,13,3,1
sdl-net,sdl-net,,0,0,2,0,4,2,9,1
googleio,googleio,,1,1,1,2,4,3,3,1
validationattribute,validationattribute,,2,4,4,6,12,10,8,100
ply-file-format,ply-file-format,,3,0,7,3,6,10,0,1
edgejs,edgejs,,2,1,7,3,10,10,1,1
magnetic-cards,magnetic-cards,,1,3,3,4,7,7,3,200
pywinusb,pywinusb,,1,0,0,1,2,1,0,1
predestroy,predestroy,,0,0,5,0,3,5,3,1
ghost.py,ghost.py,,0,0,0,0,5,0,0,1
rollover,rollover,,2,2,4,4,6,8,1,1
excel-charts,excel-charts,,9,17,25,26,28,51,5,88.888889
imagemapster,imagemapster,,0,2,4,2,4,6,1,100
class-constants,class-constants,,2,1,5,3,10,8,9,1
probe,probe,,1,7,3,8,5,11,6,600
whisper,whisper,,1,1,3,2,4,5,6,1
odesk,odesk,,0,0,0,0,2,0,4,1
pyuno,pyuno,,0,0,3,0,1,3,0,1
adobe-dps,adobe-dps,,0,0,0,0,1,0,3,1
cuda-streams,cuda-streams,,1,4,3,5,8,8,0,300
google-voice,google-voice,,4,1,11,5,16,16,3,1
gopacket,gopacket,,1,1,4,2,5,6,6,1
columnmappings,columnmappings,,0,0,0,0,3,0,8,1
border-color,border-color,,1,2,2,3,8,5,1,100
ranged-loops,ranged-loops,,0,2,2,2,13,4,9,100
hid-device,hid-device,,0,0,0,0,1,0,13,1
d2rq,d2rq,,0,0,1,0,4,1,2,1
logistics,logistics,,0,1,2,1,8,3,0,1
npp,npp,,0,3,3,3,5,6,0,200
nscharacterset,nscharacterset,,2,2,2,4,2,6,13,1
cgeventtap,cgeventtap,,5,3,2,8,9,10,13,1
dropdownchoice,dropdownchoice,,3,0,4,3,9,7,3,1
cvc4,cvc4,,1,0,5,1,8,6,0,1
deployd,deployd,,1,1,1,2,3,3,1,1
coinbase-php,coinbase-php,,2,3,6,5,12,11,4,50
ngrep,ngrep,,0,2,0,2,2,2,9,100
storyboard-reference,storyboard-reference,,0,0,1,0,1,1,13,1
xamarin.forms-layout,xamarin.forms-layout,,0,0,3,0,3,3,8,1
mixture-model,mixture-model,,8,7,10,15,16,25,0,1
fuzzing,fuzzing,,5,9,16,14,16,30,9,80
camera-roll,camera-roll,,5,9,7,14,29,21,1,80
rdfstore,rdfstore,,2,0,1,2,1,3,2,1
applepayjs,applepayjs,,1,4,3,5,9,8,13,300
switch-user,switch-user,,1,1,2,2,5,4,6,1
parsehub,parsehub,,2,0,1,2,3,3,0,1
transferable,transferable,,1,0,3,1,5,4,1,1
mfc-feature-pack,mfc-feature-pack,,0,0,5,0,10,5,9,1
tmp,tmp,,6,8,11,14,14,25,9,33.333333
mom,mom,,1,0,0,1,5,1,3,1
elephantbird,elephantbird,,0,0,2,0,3,2,2,1
concrete,concrete,,1,0,3,1,4,4,4,1
pcap-ng,pcap-ng,,0,1,4,1,2,5,9,1
cssom,cssom,,4,0,5,4,6,9,1,1
django-rest-framework-gis,django-rest-framework-gis,,1,1,0,2,4,2,0,1
universal-binary,universal-binary,,0,0,1,0,1,1,13,1
fat-binaries,fat-binaries,,0,0,2,0,1,2,13,1
symbolicatecrash,symbolicatecrash,,3,2,4,5,10,9,13,1
ios-sharesheet,ios-sharesheet,,1,0,3,1,7,4,13,1
snpe,snpe,,0,1,5,1,8,6,0,1
trigram,trigram,,3,3,9,6,13,15,0,1
if-none-match,if-none-match,,1,1,1,2,4,3,4,1
imagebrush,imagebrush,,0,0,4,0,3,4,8,1
jsonmodel,jsonmodel,,3,4,5,7,7,12,13,33.333333
classtag,classtag,,1,1,4,2,8,6,2,1
termios,termios,,11,9,11,20,23,31,9,1
vue-filter,vue-filter,,1,0,4,1,10,5,1,1
frozen,frozen,,4,4,9,8,11,17,0,1
npm-init,npm-init,,2,3,0,5,4,5,1,50
pg-hba.conf,pg-hba.conf,,6,1,4,7,14,11,4,1
forward-reference,forward-reference,,1,1,3,2,5,5,1,1
navigator-ios,navigator-ios,,0,0,1,0,4,1,1,1
mdht,mdht,,0,0,0,0,2,0,14,1
data-scrubbing,data-scrubbing,,1,1,1,2,4,3,0,1
pspdfkit,pspdfkit,,1,1,3,2,12,5,13,1
catalina.out,catalina.out,,5,0,8,5,6,13,3,1
ionic-keyboard,ionic-keyboard,,0,1,5,1,6,6,1,1
mixitup,mixitup,,2,5,6,7,4,13,1,150
valuechangelistener,valuechangelistener,,1,0,3,1,7,4,1,1
transport-stream,transport-stream,,1,2,6,3,6,9,13,100
matroska,matroska,,1,1,3,2,4,5,13,1
winginx,winginx,,2,0,0,2,6,2,4,1
saaskit,saaskit,,1,0,0,1,3,1,8,1
parental-control,parental-control,,2,1,1,3,7,4,13,1
spc,spc,,1,2,1,3,2,4,0,100
mobile-country-code,mobile-country-code,,0,2,1,2,6,3,3,100
android-messaging,android-messaging,,0,2,1,2,6,3,3,100
mmx,mmx,,1,1,4,2,6,6,9,1
cloudify,cloudify,,0,0,3,0,3,3,6,1
jquery-validation-engine,jquery-validation-engine,,1,0,7,1,14,8,1,1
xacml3,xacml3,,2,2,2,4,9,6,4,1
path-combine,path-combine,,0,0,1,0,4,1,8,1
image-reader,image-reader,,5,2,8,7,7,15,3,1
django-nose,django-nose,,1,1,5,2,10,7,0,1
photosphere,photosphere,,2,3,0,5,2,5,1,50
fieldofview,fieldofview,,1,4,3,5,5,8,8,300
clojure-core.logic,clojure-core.logic,,1,4,2,5,7,7,2,300
code-comments,code-comments,,0,1,0,1,5,1,6,1
hmail-server,hmail-server,,1,3,3,4,6,7,4,200
ng-component-outlet,ng-component-outlet,,1,1,1,2,3,3,1,1
salesforce-chatter,salesforce-chatter,,4,3,5,7,6,12,14,1
jsonlint,jsonlint,,0,1,0,1,4,1,1,1
runonce,runonce,,2,0,2,2,2,4,8,1
angularjs-ng-transclude,angularjs-ng-transclude,,1,4,4,5,8,9,1,300
html5-import,html5-import,,0,0,1,0,1,1,1,1
angular2-webpack-starter,angular2-webpack-starter,,0,0,0,0,1,0,1,1
theta360,theta360,,4,4,2,8,2,10,13,1
bing-translator-api,bing-translator-api,,3,0,2,3,3,5,8,1
android-studio-3.1,android-studio-3.1,,1,0,8,1,158,9,3,1
limma,limma,,3,2,6,5,11,11,0,1
acts-as-paranoid,acts-as-paranoid,,3,0,3,3,5,6,12,1
kendo-map,kendo-map,,0,0,2,0,1,2,1,1
multipartconfig,multipartconfig,,1,1,0,2,3,2,3,1
attunity,attunity,,4,3,6,7,8,13,4,1
networkit,networkit,,2,0,1,2,7,3,0,1
perforce-integrate,perforce-integrate,,1,1,2,2,5,4,6,1
heterogeneous-services,heterogeneous-services,,0,0,1,0,3,1,4,1
google-reseller-api,google-reseller-api,,0,1,5,1,6,6,5,1
r-neo4j,r-neo4j,,1,0,2,1,2,3,2,1
textnode,textnode,,2,1,5,3,8,8,1,1
mindmap,mindmap,,0,1,2,1,2,3,0,1
fileshare,fileshare,,5,8,11,13,13,24,8,60
scd,scd,,4,6,7,10,10,17,4,50
scd2,scd2,,4,1,3,5,5,8,4,1
pdcurses,pdcurses,,1,5,3,6,9,9,9,400
nested-views,nested-views,,1,0,1,1,6,2,1,1
opengl-1.x,opengl-1.x,,1,0,3,1,2,4,9,1
kendo-droptarget,kendo-droptarget,,0,0,0,0,2,0,1,1
maven-ant-tasks,maven-ant-tasks,,1,0,0,1,3,1,3,1
nameko,nameko,,5,3,8,8,9,16,0,1
watson-assistant,watson-assistant,,52,66,0,118,50,118,6,26.923077
ecgi,ecgi,,0,0,0,0,2,0,3,1
gcc4.8,gcc4.8,,3,0,7,3,6,10,9,1
zephyr-rtos,zephyr-rtos,,5,3,2,8,1,10,9,1
memory-fences,memory-fences,,0,0,0,0,11,0,9,1
delphi-2009,delphi-2009,,2,2,11,4,19,15,9,1
symfony-cmf,symfony-cmf,,1,0,1,1,4,2,4,1
beforeupdate,beforeupdate,,1,2,2,3,7,5,4,100
xfs,xfs,,3,1,7,4,9,11,9,1
textedit,textedit,,1,5,7,6,9,13,3,400
non-alphanumeric,non-alphanumeric,,1,1,2,2,7,4,0,1
gradle-shadow-plugin,gradle-shadow-plugin,,2,1,3,3,2,6,3,1
ooad,ooad,,3,0,9,3,10,12,9,1
dicttoxml,dicttoxml,,0,2,3,2,1,5,0,100
skeffectnode,skeffectnode,,2,0,0,2,2,2,13,1
duplicity,duplicity,,2,0,3,2,4,5,6,1
duplicity-backup,duplicity-backup,,1,0,1,1,3,2,6,1
website-monitoring,website-monitoring,,0,0,1,0,1,1,6,1
ruffus,ruffus,,0,0,0,0,1,0,0,1
tpot,tpot,,3,6,3,9,10,12,0,100
angular-webpack-starter,angular-webpack-starter,,0,0,1,0,5,1,1,1
boolean-search,boolean-search,,0,0,1,0,4,1,4,1
gc-roots,gc-roots,,0,0,1,0,1,1,3,1
winlogon,winlogon,,2,1,10,3,18,13,9,1
react-native-push,react-native-push,,0,0,0,0,2,0,1,1
react-native-push-notification,react-native-push-notification,,21,14,23,35,29,58,1,1
asp.net-core-localization,asp.net-core-localization,,3,5,14,8,23,22,8,66.666667
debian-based,debian-based,,5,9,26,14,22,40,9,80
telerik-appbuilder,telerik-appbuilder,,0,0,0,0,1,0,1,1
wagtail-snippet,wagtail-snippet,,3,1,3,4,14,7,0,1
preempt-rt,preempt-rt,,0,1,1,1,3,2,9,1
wack,wack,,2,1,2,3,7,5,8,1
ecma262,ecma262,,1,1,0,2,2,2,1,1
dbd-mysql,dbd-mysql,,0,1,2,1,1,3,9,1
dbix-connector,dbix-connector,,0,0,0,0,1,0,9,1
ionicons,ionicons,,5,5,10,10,19,20,1,1
flashvars,flashvars,,0,0,1,0,1,1,1,1
isolated-scope,isolated-scope,,0,1,2,1,8,3,1,1
apache-storm-topology,apache-storm-topology,,6,5,8,11,29,19,2,1
meteor-orion,meteor-orion,,0,0,0,0,1,0,1,1
wal,wal,,5,9,13,14,21,27,4,80
abaddressbook,abaddressbook,,0,1,2,1,11,3,13,1
azure-webjobs-triggered,azure-webjobs-triggered,,4,7,12,11,15,23,8,75
azure-webjobs-continuous,azure-webjobs-continuous,,4,4,8,8,15,16,8,1
csvde,csvde,,1,0,1,1,1,2,8,1
user.config,user.config,,1,0,1,1,3,2,8,1
deis,deis,,0,0,0,0,3,0,6,1
helmet.js,helmet.js,,4,3,3,7,5,10,1,1
tweetsharp,tweetsharp,,0,2,1,2,5,3,8,100
white,white,,8,1,10,9,23,19,8,1
transparentproxy,transparentproxy,,1,3,3,4,6,7,9,200
silent-post,silent-post,,0,0,1,0,1,1,4,1
laravel-envoy,laravel-envoy,,7,1,6,8,8,14,4,1
directcast,directcast,,0,0,0,0,2,0,8,1
flashair,flashair,,2,2,0,4,5,4,13,1
seam,seam,,1,2,3,3,8,6,3,100
rational-rose,rational-rose,,0,0,0,0,2,0,3,1
textutils,textutils,,3,0,1,3,2,4,3,1
event-hooking,event-hooking,,0,1,2,1,1,3,8,1
f#-compiler-services,f#-compiler-services,,1,1,1,2,1,3,8,1
viewport3d,viewport3d,,0,0,3,0,8,3,8,1
ancestry,ancestry,,1,2,2,3,12,5,12,100
binary-matrix,binary-matrix,,3,2,3,5,9,8,0,1
gambit,gambit,,0,0,1,0,2,1,13,1
application-xml,application-xml,,1,0,0,1,1,1,1,1
database-installation,database-installation,,1,1,0,2,1,2,4,1
cloudhub,cloudhub,,5,4,3,9,12,12,14,1
agile-crm,agile-crm,,0,1,1,1,3,2,4,1
session-affinity,session-affinity,,2,1,4,3,3,7,8,1
permute,permute,,3,2,8,5,6,13,0,1
strong-references,strong-references,,1,1,1,2,5,3,13,1
lasso.js,lasso.js,,2,1,0,3,1,3,1,1
matlab-engine,matlab-engine,,0,4,5,4,9,9,0,300
malformedurlexception,malformedurlexception,,1,0,3,1,4,4,4,1
oneget,oneget,,0,1,1,1,1,2,8,1
ng2-bootstrap,ng2-bootstrap,,3,1,4,4,14,8,1,1
simulate,simulate,,12,6,11,18,23,29,1,1
mysql-routines,mysql-routines,,0,0,0,0,1,0,4,1
spring-android,spring-android,,1,1,3,2,4,5,3,1
boundcolumn,boundcolumn,,0,0,0,0,1,0,8,1
capture-output,capture-output,,1,1,2,2,2,4,13,1
jline3,jline3,,1,1,3,2,9,5,3,1
targets,targets,,0,0,0,0,13,0,8,1
clientid,clientid,,7,7,7,14,10,21,4,1
agda-mode,agda-mode,,2,1,1,3,4,4,2,1
doevents,doevents,,4,0,2,4,7,6,5,1
playframework-evolutions,playframework-evolutions,,1,2,6,3,6,9,2,100
dotween,dotween,,2,2,4,4,4,8,8,1
xcode-project,xcode-project,,3,3,4,6,8,10,13,1
jnr,jnr,,3,0,6,3,4,9,3,1
remodal,remodal,,2,0,0,2,1,2,1,1
isuserinteractionenabled,isuserinteractionenabled,,0,2,4,2,4,6,13,100
isearch,isearch,,0,0,0,0,2,0,9,1
c-api,c-api,,11,4,12,15,16,27,0,1
apache-commons-csv,apache-commons-csv,,5,3,8,8,18,16,3,1
ibm-cloud-functions,ibm-cloud-functions,,17,13,27,30,36,57,6,1
azure-web-app-for-containers,azure-web-app-for-containers,,2,2,15,4,10,19,8,1
wamp64,wamp64,,3,5,4,8,5,12,4,66.666667
cyclic-dependency,cyclic-dependency,,5,8,6,13,14,19,1,60
gvariant,gvariant,,1,1,1,2,3,3,9,1
clipbucket,clipbucket,,0,1,0,1,2,1,4,1
oracle8i,oracle8i,,2,3,4,5,9,9,4,50
product-quantity,product-quantity,,11,3,16,14,29,30,4,1
nam,nam,,0,0,0,0,3,0,9,1
dbca,dbca,,3,0,1,3,4,4,4,1
oracle-net-services,oracle-net-services,,1,0,0,1,1,1,4,1
gradientdrawable,gradientdrawable,,2,1,7,3,1,10,3,1
lzo,lzo,,1,2,1,3,9,4,0,100
applitools,applitools,,1,2,1,3,4,4,3,100
pykafka,pykafka,,2,5,6,7,17,13,2,150
uicontrolview,uicontrolview,,0,0,0,0,1,0,3,1
carbonkit,carbonkit,,1,0,2,1,6,3,13,1
lynx,lynx,,2,2,1,4,6,5,9,1
hdbc,hdbc,,1,1,1,2,10,3,2,1
blotter,blotter,,1,1,1,2,11,3,0,1
dwoo,dwoo,,1,0,0,1,1,1,4,1
cocotb,cocotb,,1,4,4,5,2,9,9,300
vetur,vetur,,3,4,10,7,6,17,1,33.333333
mediamuxer,mediamuxer,,1,6,16,7,12,23,3,500
gpuimagestillcamera,gpuimagestillcamera,,0,0,1,0,2,1,13,1
container-view,container-view,,2,1,1,3,5,4,13,1
expression-encoder,expression-encoder,,1,3,1,4,1,5,3,200
windows-media-encoder,windows-media-encoder,,1,0,0,1,1,1,9,1
input-parameters,input-parameters,,1,2,1,3,4,4,4,100
pygsl,pygsl,,0,0,0,0,2,0,0,1
wicked-gem,wicked-gem,,6,1,4,7,7,11,12,1
cudd,cudd,,4,0,1,4,5,5,9,1
superpixels,superpixels,,3,3,8,6,10,14,0,1
xxd,xxd,,4,2,7,6,5,13,9,1
gloss,gloss,,2,2,11,4,8,15,2,1
goji,goji,,1,0,0,1,1,1,6,1
sift-tool,sift-tool,,0,0,0,0,1,0,9,1
snakeviz,snakeviz,,0,2,1,2,3,3,0,100
codebird,codebird,,1,0,3,1,3,4,4,1
jsoniq,jsoniq,,2,0,1,2,5,3,3,1
cocos2d-python,cocos2d-python,,0,0,0,0,2,0,0,1
invariance,invariance,,0,0,3,0,8,3,8,1
serviceloader,serviceloader,,2,0,6,2,13,8,3,1
background-foreground,background-foreground,,4,1,3,5,11,8,3,1
handlebars.net,handlebars.net,,1,0,2,1,4,3,1,1
economics,economics,,22,9,18,31,30,49,0,1
php-gd,php-gd,,7,10,14,17,21,31,4,42.857143
maven-clean-plugin,maven-clean-plugin,,2,1,0,3,5,3,3,1
npm-version,npm-version,,3,1,3,4,3,7,1,1
lammps,lammps,,1,1,1,2,3,3,0,1
soft-real-time,soft-real-time,,0,0,0,0,1,0,9,1
heterogeneous,heterogeneous,,2,0,1,2,9,3,3,1
android-8.1-oreo,android-8.1-oreo,,22,12,56,34,140,90,3,1
git-sparse-checkout,git-sparse-checkout,,1,1,1,2,2,3,6,1
return-by-value,return-by-value,,0,0,0,0,5,0,9,1
provisioned-iops,provisioned-iops,,3,1,0,4,2,4,6,1
webpack-watch,webpack-watch,,1,0,1,1,2,2,1,1
ibm-soliddb,ibm-soliddb,,0,1,3,1,1,4,3,1
wexitstatus,wexitstatus,,0,0,0,0,1,0,9,1
xming,xming,,3,0,8,3,10,11,9,1
mach,mach,,4,4,5,8,13,13,13,1
jxmapviewer,jxmapviewer,,0,0,0,0,2,0,3,1
jxmaps,jxmaps,,1,0,2,1,4,3,3,1
node-telegram-bot-api,node-telegram-bot-api,,11,6,3,17,3,20,0,1
uitypeeditor,uitypeeditor,,3,0,0,3,4,3,8,1
color-detection,color-detection,,0,2,6,2,14,8,0,100
plates,plates,,0,1,1,1,4,2,4,1
alphabetical-sort,alphabetical-sort,,7,3,8,10,15,18,0,1
johnny-five,johnny-five,,4,6,5,10,13,15,9,50
massive,massive,,0,2,0,2,9,2,1,100
stage3d,stage3d,,1,0,2,1,4,3,13,1
update-in,update-in,,0,0,0,0,1,0,2,1
webtorrent,webtorrent,,4,4,8,8,4,16,1,1
select-for-update,select-for-update,,4,1,4,5,3,9,4,1
set-comprehension,set-comprehension,,2,1,3,3,10,6,0,1
prolog-toplevel,prolog-toplevel,,4,2,9,6,11,15,0,1
prerenderview,prerenderview,,1,0,0,1,1,1,1,1
opera-mini,opera-mini,,1,2,1,3,5,4,1,100
normalize-css,normalize-css,,0,1,1,1,4,2,1,1
magic-numbers,magic-numbers,,5,3,3,8,7,11,3,1
phlivephoto,phlivephoto,,3,0,2,3,3,5,13,1
feedback-loop,feedback-loop,,0,1,3,1,1,4,4,1
spring-aspects,spring-aspects,,7,0,8,7,9,15,3,1
modx-templates,modx-templates,,0,0,0,0,2,0,4,1
xml-dsig,xml-dsig,,4,3,0,7,9,7,6,1
acoustics,acoustics,,1,2,1,3,7,4,0,100
rascal,rascal,,2,4,10,6,15,16,0,100
trailsjs,trailsjs,,0,0,0,0,4,0,1,1
cgcolorspace,cgcolorspace,,1,1,0,2,3,2,13,1
httptransportse,httptransportse,,0,0,1,0,1,1,3,1
groupname,groupname,,0,0,0,0,2,0,9,1
jquery-ui-touch-punch,jquery-ui-touch-punch,,0,4,6,4,6,10,1,300
prefix-operator,prefix-operator,,1,0,1,1,4,2,9,1
coldfusionbuilder,coldfusionbuilder,,1,0,2,1,2,3,4,1
component-based,component-based,,0,0,1,0,1,1,1,1
aurelia-auth,aurelia-auth,,0,0,0,0,1,0,1,1
call-by-need,call-by-need,,0,0,1,0,1,1,2,1
selectedvalue,selectedvalue,,12,6,12,18,15,30,8,1
create-function,create-function,,2,1,3,3,7,6,4,1
mosh,mosh,,0,1,2,1,3,3,6,1
windows-share,windows-share,,1,0,1,1,8,2,9,1
devanagari,devanagari,,1,1,0,2,6,2,0,1
amfphp,amfphp,,0,1,0,1,2,1,4,1
jet-sql,jet-sql,,0,3,5,3,9,8,5,200
packed-decimal,packed-decimal,,1,0,1,1,3,2,4,1
prototype-programming,prototype-programming,,2,1,5,3,8,8,1,1
econnrefused,econnrefused,,1,4,7,5,7,12,1,300
fluent-interface,fluent-interface,,4,2,4,6,8,10,8,1
vfio,vfio,,0,1,0,1,5,1,9,1
calloutview,calloutview,,2,3,2,5,3,7,13,50
smooks,smooks,,3,2,13,5,11,18,3,1
tcltk,tcltk,,5,3,9,8,12,17,0,1
tcltk2,tcltk2,,0,1,2,1,4,3,0,1
gitpitch,gitpitch,,0,0,2,0,1,2,6,1
odatacontroller,odatacontroller,,1,0,2,1,5,3,8,1
iterpc,iterpc,,0,0,0,0,2,0,0,1
glium,glium,,0,0,0,0,5,0,9,1
mpu,mpu,,0,2,2,2,5,4,9,100
gm-xmlhttprequest,gm-xmlhttprequest,,2,0,1,2,5,3,1,1
jama,jama,,0,0,2,0,11,2,3,1
visualize,visualize,,3,5,6,8,11,14,0,66.666667
mklink,mklink,,1,1,3,2,6,5,9,1
android-maven-plugin,android-maven-plugin,,1,0,2,1,3,3,3,1
ntfs-3g,ntfs-3g,,1,1,1,2,2,3,9,1
identityserver2,identityserver2,,2,0,1,2,2,3,8,1
exiv2,exiv2,,1,0,2,1,5,3,9,1
inria-spoon,inria-spoon,,0,2,5,2,7,7,3,100
e4x,e4x,,0,0,1,0,3,1,1,1
zero-padding,zero-padding,,5,3,10,8,15,18,0,1
angularjs-watch,angularjs-watch,,1,1,2,2,6,4,1,1
react-grid-layout,react-grid-layout,,4,4,12,8,22,20,1,1
awstats,awstats,,2,0,3,2,5,5,4,1
website-admin,website-admin,,0,0,0,0,1,0,4,1
outlook-calendar,outlook-calendar,,2,7,11,9,31,20,8,250
requirejs-define,requirejs-define,,1,0,1,1,3,2,1,1
string-decoding,string-decoding,,3,3,3,6,14,9,0,1
google-nexus,google-nexus,,0,0,0,0,2,0,3,1
registerclass,registerclass,,0,0,1,0,1,1,9,1
hadoop3,hadoop3,,3,9,24,12,23,36,2,200
firemonkey-fm3,firemonkey-fm3,,0,0,1,0,1,1,9,1
two-column-layout,two-column-layout,,0,1,0,1,2,1,1,1
opentripplanner,opentripplanner,,2,2,5,4,5,9,0,1
forced-unwrapping,forced-unwrapping,,1,0,8,1,13,9,13,1
protocol-handler,protocol-handler,,1,0,3,1,4,4,9,1
faye,faye,,1,2,0,3,8,3,12,100
cstdint,cstdint,,0,1,2,1,4,3,9,1
wkinterfaceimage,wkinterfaceimage,,0,0,0,0,2,0,13,1
barbecue,barbecue,,1,0,4,1,2,5,3,1
plex,plex,,3,2,10,5,10,15,6,1
ssh-keygen,ssh-keygen,,7,6,12,13,14,25,9,1
pagerslidingtabstrip,pagerslidingtabstrip,,2,0,1,2,1,3,3,1
libzip,libzip,,5,4,3,9,13,12,9,1
rt.jar,rt.jar,,0,0,5,0,3,5,3,1
template-variables,template-variables,,2,7,4,9,8,13,9,250
modx-getresources,modx-getresources,,0,0,0,0,2,0,4,1
restler,restler,,0,0,2,0,5,2,4,1
uimodalpresentationstyle,uimodalpresentationstyle,,1,3,4,4,12,8,13,200
jflex,jflex,,1,5,9,6,16,15,3,400
cup,cup,,1,2,7,3,10,10,3,100
riot,riot,,3,7,2,10,12,12,1,133.333333
hlint,hlint,,0,0,0,0,5,0,2,1
bindata,bindata,,0,0,0,0,4,0,0,1
my.settings,my.settings,,1,1,4,2,3,6,8,1
fastlane-gym,fastlane-gym,,1,2,7,3,8,10,13,100
find-by-sql,find-by-sql,,0,1,1,1,2,2,12,1
set-returning-functions,set-returning-functions,,4,5,2,9,8,11,4,25
camtasia,camtasia,,1,1,1,2,1,3,13,1
anaglyph-3d,anaglyph-3d,,0,0,1,0,1,1,0,1
passport-google-oauth,passport-google-oauth,,8,3,11,11,25,22,1,1
numeric-ranges,numeric-ranges,,1,0,1,1,3,2,0,1
tokenize2,tokenize2,,0,1,2,1,3,3,1,1
jstat,jstat,,3,1,1,4,2,5,3,1
der,der,,9,4,12,13,18,25,6,1
roundup,roundup,,0,0,2,0,5,2,0,1
abstractset,abstractset,,0,0,0,0,1,0,3,1
ng-controller,ng-controller,,4,1,2,5,13,7,1,1
boost-foreach,boost-foreach,,0,1,0,1,1,1,9,1
azure-vpn,azure-vpn,,13,8,11,21,21,32,8,1
j2objc,j2objc,,0,3,1,3,13,4,13,200
busyindicator,busyindicator,,3,2,7,5,8,12,8,1
the-amazing-audio-engine,the-amazing-audio-engine,,0,0,1,0,2,1,13,1
er-diagram,er-diagram,,0,0,0,0,5,0,4,1
bfo,bfo,,2,0,5,2,7,7,14,1
mp4parser,mp4parser,,0,5,4,5,14,9,13,400
asp.net-docker-extensions,asp.net-docker-extensions,,2,0,1,2,1,3,6,1
jzmq,jzmq,,1,2,2,3,6,5,3,100
numactl,numactl,,2,2,4,4,2,8,9,1
activereports,activereports,,5,2,9,7,6,16,8,1
infovis,infovis,,0,1,2,1,1,3,1,1
gwidgets,gwidgets,,3,1,4,4,13,8,0,1
keen-io,keen-io,,2,2,1,4,15,5,4,1
gyp,gyp,,6,3,6,9,7,15,1,1
stringescapeutils,stringescapeutils,,0,1,3,1,7,4,3,1
cscope,cscope,,5,1,7,6,11,13,9,1
addin-express,addin-express,,7,2,12,9,6,21,8,1
mongodate,mongodate,,0,0,1,0,3,1,1,1
git-index,git-index,,2,2,4,4,4,8,6,1
visual-studio-power-tools,visual-studio-power-tools,,0,0,0,0,2,0,8,1
caching-application-block,caching-application-block,,0,0,0,0,1,0,8,1
unity-application-block,unity-application-block,,0,0,0,0,1,0,8,1
swd,swd,,2,1,2,3,2,5,9,1
mongodb-compass,mongodb-compass,,15,13,20,28,21,48,1,1
nawk,nawk,,2,0,1,2,7,3,9,1
longtext,longtext,,2,2,4,4,11,8,4,1
to-json,to-json,,0,5,2,5,9,7,0,400
android-min-sdk,android-min-sdk,,2,6,6,8,4,14,3,200
administrative,administrative,,0,0,0,0,2,0,12,1
paxos,paxos,,3,2,2,5,11,7,6,1
scep,scep,,0,5,4,5,4,9,6,400
simd-library,simd-library,,0,1,1,1,5,2,9,1
libmosquitto,libmosquitto,,5,0,1,5,7,6,6,1
avcomposition,avcomposition,,0,1,4,1,10,5,13,1
boost-parameter,boost-parameter,,0,0,2,0,1,2,9,1
ansi-term,ansi-term,,1,0,1,1,1,2,9,1
qtoolbutton,qtoolbutton,,2,4,4,6,8,10,9,100
dijit.tree,dijit.tree,,1,0,0,1,2,1,1,1
materialized,materialized,,1,1,1,2,10,3,4,1
socketcluster,socketcluster,,4,2,8,6,10,14,1,1
static-if,static-if,,0,0,0,0,1,0,9,1
watson-virtual-agent,watson-virtual-agent,,0,1,0,1,2,1,6,1
listboxitems,listboxitems,,0,0,0,0,9,0,8,1
spoon,spoon,,1,1,13,2,26,15,4,1
bias-neuron,bias-neuron,,1,2,7,3,9,10,0,100
avassetdownloadtask,avassetdownloadtask,,4,0,1,4,7,5,13,1
nvme,nvme,,3,3,6,6,14,12,9,1
auto-rotation,auto-rotation,,0,0,2,0,3,2,13,1
callbackurl,callbackurl,,4,1,1,5,10,6,4,1
k2,k2,,4,4,3,8,12,11,4,1
k2-blackpearl,k2-blackpearl,,0,2,0,2,3,2,4,100
bde,bde,,3,2,3,5,13,8,9,1
orson-charts,orson-charts,,0,0,0,0,2,0,3,1
mouse-cursor,mouse-cursor,,5,0,5,5,11,10,8,1
liferay-6.2,liferay-6.2,,1,1,7,2,12,9,3,1
mono-embedding,mono-embedding,,1,0,0,1,2,1,8,1
maven-mirroring,maven-mirroring,,0,0,0,0,2,0,3,1
addressable-gem,addressable-gem,,0,0,1,0,1,1,12,1
epsg,epsg,,4,2,5,6,8,11,0,1
sendto,sendto,,3,1,9,4,19,13,9,1
sockaddr-in,sockaddr-in,,0,0,2,0,3,2,9,1
autorotate,autorotate,,3,0,4,3,6,7,13,1
overpass-api,overpass-api,,12,12,17,24,24,41,1,1
orientdb-2.1,orientdb-2.1,,0,0,2,0,12,2,2,1
onactionexecuted,onactionexecuted,,1,2,1,3,2,4,8,100
array-population,array-population,,0,0,1,0,1,1,8,1
nested-urls,nested-urls,,0,0,0,0,2,0,0,1
eshell,eshell,,1,0,3,1,6,4,9,1
required-field,required-field,,3,2,4,5,5,9,1,1
lmertest,lmertest,,4,1,0,5,11,5,0,1
wise,wise,,0,0,0,0,3,0,8,1
nscopying,nscopying,,0,0,5,0,4,5,13,1
toll-free-bridging,toll-free-bridging,,0,0,0,0,3,0,13,1
zend-controller,zend-controller,,0,0,0,0,2,0,4,1
croogo,croogo,,0,0,2,0,3,2,4,1
iprincipal,iprincipal,,0,2,1,2,5,3,8,100
roxy,roxy,,1,0,0,1,5,1,3,1
perl-exporter,perl-exporter,,0,0,0,0,2,0,9,1
glfrustum,glfrustum,,0,1,0,1,2,1,9,1
del,del,,5,3,19,8,30,27,0,1
swagger-node,swagger-node,,0,0,1,0,4,1,3,1
intersystems-cache,intersystems-cache,,2,0,9,2,27,11,4,1
utl-mail,utl-mail,,0,0,1,0,3,1,4,1
unique-values,unique-values,,1,0,13,1,11,14,5,1
scripting.dictionary,scripting.dictionary,,1,1,2,2,4,4,5,1
leantween,leantween,,0,0,0,0,3,0,8,1
wp-editor,wp-editor,,1,2,3,3,8,6,4,100
runlevel,runlevel,,3,0,0,3,1,3,9,1
operand,operand,,0,0,0,0,19,0,0,1
cfthread,cfthread,,0,0,0,0,2,0,4,1
ebpf,ebpf,,20,29,11,49,20,60,9,45
passive-mode,passive-mode,,2,2,0,4,4,4,4,1
workmanagers,workmanagers,,3,4,5,7,6,12,3,33.333333
word-2010,word-2010,,2,0,2,2,6,4,5,1
set-theory,set-theory,,4,7,6,11,15,17,0,75
dynamic-usercontrols,dynamic-usercontrols,,3,1,3,4,8,7,8,1
android-6.0.1-marshmallow,android-6.0.1-marshmallow,,2,5,5,7,6,12,3,150
docx-mailmerge,docx-mailmerge,,2,3,4,5,9,9,5,50
tray,tray,,5,1,2,6,8,8,1,1
spreadsheetlight,spreadsheetlight,,1,5,11,6,6,17,8,400
gtid,gtid,,1,1,1,2,5,3,4,1
shlex,shlex,,2,2,6,4,8,10,0,1
initializecomponent,initializecomponent,,0,0,1,0,5,1,8,1
minim,minim,,2,0,3,2,7,5,3,1
geokettle,geokettle,,0,0,0,0,6,0,4,1
google-php-sdk,google-php-sdk,,1,1,11,2,7,13,5,1
google-health,google-health,,3,0,1,3,1,4,6,1
schemaexport,schemaexport,,0,0,2,0,1,2,3,1
helpermethods,helpermethods,,0,1,4,1,2,5,12,1
psychtoolbox,psychtoolbox,,4,7,15,11,12,26,0,75
document-based,document-based,,0,0,5,0,5,5,13,1
look-and-feel,look-and-feel,,6,10,10,16,32,26,3,66.666667
vitess,vitess,,2,0,3,2,3,5,6,1
magiczoomplus,magiczoomplus,,0,0,0,0,2,0,1,1
multiprocessor,multiprocessor,,1,1,0,2,4,2,0,1
stty,stty,,3,2,1,5,5,6,9,1
em-websocket-client,em-websocket-client,,0,0,0,0,2,0,3,1
yowsup,yowsup,,1,0,3,1,4,4,0,1
google-apps-script-editor,google-apps-script-editor,,17,13,24,30,50,54,5,1
lazybones,lazybones,,1,0,1,1,3,2,3,1
firefox-browser-api,firefox-browser-api,,0,0,1,0,1,1,1,1
wpf-positioning,wpf-positioning,,0,0,0,0,1,0,8,1
sdf,sdf,,3,2,4,5,4,9,14,1
wab,wab,,0,0,0,0,2,0,3,1
sortedcontainers,sortedcontainers,,0,0,0,0,4,0,0,1
pls,pls,,9,8,10,17,11,27,0,1
jquery-address,jquery-address,,0,0,0,0,1,0,1,1
xcode9.2,xcode9.2,,3,1,12,4,189,16,13,1
ios11.2,ios11.2,,0,0,1,0,47,1,13,1
dynamic-content,dynamic-content,,5,1,12,6,22,18,1,1
haskell-hedgehog,haskell-hedgehog,,2,4,3,6,4,9,2,100
sitemap-generator-gem,sitemap-generator-gem,,1,1,4,2,1,6,12,1
elgamal,elgamal,,3,0,3,3,6,6,6,1
javascript-audio-api,javascript-audio-api,,2,1,6,3,6,9,1,1
spm,spm,,2,1,4,3,5,7,0,1
local-datastore,local-datastore,,0,1,0,1,1,1,6,1
inputformatter,inputformatter,,1,1,0,2,6,2,8,1
wallaby,wallaby,,0,1,2,1,4,3,2,1
icarus,icarus,,1,0,0,1,9,1,9,1
role-based-access-control,role-based-access-control,,6,9,10,15,9,25,4,50
zorba,zorba,,0,0,1,0,3,1,3,1
moq-3,moq-3,,0,0,0,0,3,0,8,1
unfold,unfold,,2,0,1,2,3,3,2,1
ref-cursor,ref-cursor,,3,1,1,4,10,5,4,1
dotty,dotty,,2,3,2,5,10,7,2,50
ovirt,ovirt,,1,8,4,9,9,13,6,700
jqpagination,jqpagination,,1,0,0,1,1,1,4,1
null-string,null-string,,0,0,0,0,4,0,4,1
ccd,ccd,,0,0,2,0,5,2,14,1
wcf-4,wcf-4,,0,0,0,0,1,0,8,1
wcf-data-services-client,wcf-data-services-client,,2,1,0,3,1,3,8,1
internet-explorer-6,internet-explorer-6,,0,1,2,1,6,3,1,1
angular2-custom-component,angular2-custom-component,,0,2,0,2,1,2,1,100
saxparseexception,saxparseexception,,1,2,6,3,9,9,3,100
isort,isort,,0,0,1,0,1,1,0,1
timesheet.js,timesheet.js,,0,0,0,0,2,0,0,1
espeak,espeak,,3,1,3,4,25,7,9,1
docplexcloud,docplexcloud,,0,1,5,1,2,6,0,1
highlight.js,highlight.js,,4,6,14,10,14,24,1,50
n-triples,n-triples,,1,5,2,6,8,8,2,400
charbuffer,charbuffer,,1,0,2,1,1,3,3,1
memcmp,memcmp,,1,1,1,2,5,3,9,1
sdi,sdi,,1,1,2,2,3,4,9,1
low-level-io,low-level-io,,3,1,1,4,7,5,9,1
information-gain,information-gain,,1,2,2,3,8,5,0,100
wmv,wmv,,2,2,5,4,8,9,13,1
jquery-easing,jquery-easing,,0,3,4,3,5,7,1,200
c-standard-library,c-standard-library,,2,1,6,3,9,9,9,1
componentkit,componentkit,,0,0,0,0,1,0,13,1
devtoolset,devtoolset,,3,2,6,5,10,11,9,1
fedora-23,fedora-23,,0,0,0,0,3,0,9,1
contactus,contactus,,0,2,2,2,7,4,4,100
jacc,jacc,,0,0,1,0,3,1,3,1
distro,distro,,1,1,1,2,1,3,9,1
wordprocessingml,wordprocessingml,,1,2,9,3,4,12,8,100
facebook-app-settings,facebook-app-settings,,3,1,2,4,7,6,13,1
license-maven-plugin,license-maven-plugin,,0,0,2,0,2,2,3,1
pagingtoolbar,pagingtoolbar,,1,0,0,1,2,1,3,1
copyonwritearraylist,copyonwritearraylist,,1,2,3,3,2,6,3,100
clp,clp,,5,2,3,7,9,10,0,1
clpb,clpb,,0,0,0,0,1,0,0,1
asyncore,asyncore,,1,1,0,2,8,2,0,1
spdy,spdy,,2,1,6,3,13,9,1,1
fileapi,fileapi,,7,3,6,10,17,16,1,1
flask-httpauth,flask-httpauth,,2,2,3,4,4,7,0,1
selectnodes,selectnodes,,5,0,2,5,7,7,8,1
the-little-schemer,the-little-schemer,,0,0,1,0,6,1,0,1
compound-drawables,compound-drawables,,0,0,6,0,3,6,3,1
android-wrap-content,android-wrap-content,,9,3,5,12,8,17,3,1
ckeditor.net,ckeditor.net,,0,0,6,0,3,6,1,1
tinder,tinder,,5,5,4,10,7,14,3,1
quartz-core,quartz-core,,4,2,6,6,7,12,13,1
core-services,core-services,,1,1,1,2,3,3,13,1
apptentive,apptentive,,0,0,0,0,1,0,13,1
gmpy,gmpy,,4,2,1,6,5,7,0,1
griffon,griffon,,1,0,2,1,3,3,3,1
geany-plugin,geany-plugin,,0,0,1,0,2,1,0,1
awaitility,awaitility,,1,0,1,1,2,2,3,1
snappydb,snappydb,,0,0,0,0,1,0,2,1
leex,leex,,0,1,0,1,1,1,2,1
share-open-graph,share-open-graph,,2,2,4,4,6,8,13,1
jquery-webcam-plugin,jquery-webcam-plugin,,0,0,0,0,4,0,8,1
tor-browser-bundle,tor-browser-bundle,,1,1,1,2,3,3,3,1
neo4j-java-api,neo4j-java-api,,1,1,0,2,13,2,2,1
neo4j-bolt,neo4j-bolt,,1,5,2,6,10,8,2,400
moonmail,moonmail,,0,0,1,0,4,1,6,1
handlebars.java,handlebars.java,,1,5,6,6,9,12,3,400
dynamic-data-display,dynamic-data-display,,0,3,1,3,6,4,8,200
access-specifier,access-specifier,,0,3,3,3,9,6,9,200
fsync,fsync,,2,4,7,6,6,13,9,100
openscript,openscript,,1,1,1,2,2,3,4,1
bilinear-interpolation,bilinear-interpolation,,3,1,8,4,16,12,0,1
ospf,ospf,,2,2,3,4,2,7,9,1
winappdriver,winappdriver,,18,22,16,40,7,56,3,22.222222
android-filterable,android-filterable,,3,2,12,5,17,17,3,1
vcalendar,vcalendar,,2,2,5,4,6,9,4,1
ert,ert,,0,0,0,0,1,0,9,1
mysqladministrator,mysqladministrator,,0,1,2,1,4,3,4,1
usermode,usermode,,1,0,2,1,7,3,9,1
dopostback,dopostback,,4,6,5,10,11,15,8,50
quality-gate,quality-gate,,0,2,1,2,5,3,3,100
editcontrol,editcontrol,,2,2,0,4,8,4,9,1
qchar,qchar,,1,0,0,1,3,1,9,1
sqlmetal,sqlmetal,,1,0,0,1,1,1,8,1
linqer,linqer,,0,0,0,0,3,0,8,1
kademlia,kademlia,,2,3,9,5,14,14,9,50
nssound,nssound,,0,1,1,1,1,2,13,1
android-sound,android-sound,,3,1,3,4,4,7,3,1
apple-news,apple-news,,1,2,1,3,10,4,4,100
deco,deco,,1,0,0,1,1,1,1,1
ws-addressing,ws-addressing,,0,0,2,0,1,2,3,1
ora-06550,ora-06550,,0,0,2,0,5,2,4,1
tampering,tampering,,2,0,2,2,6,4,3,1
msflexgrid,msflexgrid,,1,0,1,1,3,2,8,1
zoneinfo,zoneinfo,,2,0,3,2,2,5,0,1
mysql-error-2013,mysql-error-2013,,2,1,3,3,2,6,4,1
logz.io,logz.io,,1,3,4,4,3,8,6,200
rapache,rapache,,0,2,2,2,2,4,0,100
cbir,cbir,,0,0,1,0,7,1,0,1
lire,lire,,1,0,0,1,1,1,2,1
application.cfc,application.cfc,,4,0,0,4,7,4,4,1
application.cfm,application.cfm,,1,1,0,2,3,2,4,1
build-pipeline-plugin,build-pipeline-plugin,,0,0,3,0,6,3,6,1
ipconfig,ipconfig,,1,2,1,3,10,4,9,100
rubber,rubber,,0,0,0,0,1,0,12,1
data-comparison,data-comparison,,1,0,3,1,5,4,4,1
cbitmap,cbitmap,,0,0,0,0,3,0,9,1
named-instance,named-instance,,0,1,0,1,3,1,8,1
kaspersky,kaspersky,,1,0,3,1,8,4,8,1
monotorrent,monotorrent,,1,0,0,1,3,1,8,1
doclet,doclet,,5,1,5,6,7,11,3,1
extended-choice-parameter,extended-choice-parameter,,3,2,5,5,5,10,6,1
moment-recur,moment-recur,,0,0,1,0,3,1,1,1
schemagen,schemagen,,1,0,1,1,3,2,3,1
unbounded-wildcard,unbounded-wildcard,,0,2,3,2,7,5,3,100
dia-sdk,dia-sdk,,0,0,2,0,2,2,9,1
resharper-8.0,resharper-8.0,,1,0,0,1,2,1,8,1
infopath2010,infopath2010,,0,2,7,2,4,9,8,100
spring-ide,spring-ide,,0,1,0,1,2,1,3,1
vertex-array-object,vertex-array-object,,0,1,4,1,3,5,9,1
imageprocessor,imageprocessor,,1,1,4,2,5,6,8,1
gts,gts,,1,0,0,1,2,1,1,1
docblocks,docblocks,,1,2,1,3,6,4,4,100
object-destruction,object-destruction,,1,0,5,1,2,6,9,1
monoids,monoids,,10,5,10,15,23,25,2,1
rails-activestorage,rails-activestorage,,107,84,184,191,191,375,12,1
bass,bass,,1,1,3,2,8,5,13,1
medium.com,medium.com,,5,7,10,12,12,22,1,40
field-names,field-names,,0,1,0,1,5,1,0,1
gnu-prolog,gnu-prolog,,1,1,3,2,6,5,0,1
dct,dct,,7,2,19,9,15,28,0,1
rospy,rospy,,6,3,7,9,19,16,0,1
sinatra-activerecord,sinatra-activerecord,,2,1,4,3,13,7,12,1
lychrel-numbers,lychrel-numbers,,0,0,0,0,1,0,6,1
mapster,mapster,,2,0,2,2,7,4,8,1
cross-database,cross-database,,0,1,4,1,9,5,4,1
cross-server,cross-server,,0,3,1,3,1,4,4,200
external-data-source,external-data-source,,3,1,4,4,5,8,4,1
python-cloudant,python-cloudant,,1,0,2,1,7,3,1,1
mssticker,mssticker,,1,0,2,1,5,3,13,1
lumen-5.3,lumen-5.3,,1,1,0,2,2,2,4,1
unix-head,unix-head,,1,0,5,1,5,6,9,1
zend-view,zend-view,,5,2,2,7,9,9,4,1
nsdatepicker,nsdatepicker,,3,1,1,4,4,5,13,1
lostfocus,lostfocus,,0,0,0,0,3,0,3,1
fdt,fdt,,0,0,1,0,1,1,9,1
stm32l152,stm32l152,,0,1,0,1,6,1,9,1
ibpy,ibpy,,2,1,4,3,10,7,0,1
chrome-gcm,chrome-gcm,,1,0,0,1,3,1,13,1
morphic,morphic,,1,2,0,3,1,3,13,100
ms-mpi,ms-mpi,,0,2,3,2,7,5,9,100
dn,dn,,0,0,0,0,1,0,8,1
acm-java-libraries,acm-java-libraries,,2,0,2,2,1,4,3,1
processlist,processlist,,0,0,0,0,3,0,9,1
isspace,isspace,,0,0,0,0,1,0,0,1
sgen,sgen,,0,1,2,1,5,3,8,1
sthttprequest,sthttprequest,,0,1,0,1,1,1,13,1
mysql-json,mysql-json,,8,7,15,15,30,30,4,1
knowledge-management,knowledge-management,,0,1,1,1,8,2,0,1
soa-suite,soa-suite,,2,3,5,5,8,10,3,50
ora-01000,ora-01000,,0,1,0,1,3,1,3,1
sapjco3,sapjco3,,1,2,9,3,11,12,5,100
hyperscript,hyperscript,,2,0,0,2,1,2,1,1
jcarousellite,jcarousellite,,0,0,0,0,1,0,1,1
blindness,blindness,,0,0,0,0,2,0,9,1
youtube-channels,youtube-channels,,2,0,4,2,2,6,5,1
gulp-imagemin,gulp-imagemin,,3,1,4,4,7,8,1,1
clojure-java-interop,clojure-java-interop,,5,0,20,5,19,25,2,1
mysql-variables,mysql-variables,,2,3,5,5,15,10,4,50
vowpalwabbit,vowpalwabbit,,6,2,7,8,12,15,0,1
ordinals,ordinals,,4,0,2,4,4,6,0,1
csl,csl,,6,3,4,9,6,13,0,1
kbhit,kbhit,,0,1,6,1,5,7,9,1
azure-hybrid-connections,azure-hybrid-connections,,7,8,13,15,17,28,8,14.285714
pardot,pardot,,7,3,9,10,19,19,1,1
dynogels,dynogels,,0,0,2,0,6,2,6,1
cxml,cxml,,2,2,4,4,6,8,3,1
mapping-by-code,mapping-by-code,,2,1,5,3,4,8,8,1
shred,shred,,0,0,1,0,1,1,3,1
gzipfile,gzipfile,,2,0,2,2,2,4,0,1
xrmtoolbox,xrmtoolbox,,0,0,6,0,2,6,8,1
mtlbuffer,mtlbuffer,,4,2,1,6,11,7,13,1
perl-xs,perl-xs,,0,0,3,0,9,3,9,1
data-presentation,data-presentation,,2,0,1,2,2,3,0,1
cuvid,cuvid,,0,1,3,1,4,4,13,1
driverless-ai,driverless-ai,,7,2,7,9,8,16,0,1
object-initialization,object-initialization,,0,1,2,1,11,3,9,1
object-state,object-state,,1,0,0,1,1,1,3,1
sequence-generators,sequence-generators,,3,3,4,6,9,10,3,1
commandbox,commandbox,,1,1,1,2,5,3,4,1
ie8-compatibility-mode,ie8-compatibility-mode,,2,1,2,3,4,5,1,1
generic-interface,generic-interface,,1,0,4,1,3,5,3,1
tpngimagelist,tpngimagelist,,0,0,0,0,1,0,9,1
bleno,bleno,,3,1,4,4,5,8,3,1
mod-python,mod-python,,0,1,2,1,5,3,4,1
zikula,zikula,,0,4,1,4,5,5,4,300
platform-tools,platform-tools,,1,1,4,2,8,6,3,1
qstatusbar,qstatusbar,,0,2,0,2,7,2,0,100
cvblobslib,cvblobslib,,0,0,0,0,1,0,0,1
windowsformhost,windowsformhost,,0,0,0,0,6,0,8,1
off-heap,off-heap,,1,0,1,1,4,2,3,1
soapfault,soapfault,,4,6,6,10,4,16,3,50
web-garden,web-garden,,4,2,1,6,4,7,8,1
libs,libs,,3,1,3,4,14,7,3,1
scroll-position,scroll-position,,6,1,4,7,10,11,1,1
cdk,cdk,,5,8,11,13,1,24,1,60
onrowclick,onrowclick,,0,0,3,0,3,3,1,1
futex,futex,,1,0,2,1,9,3,9,1
table-locking,table-locking,,0,5,4,5,6,9,4,400
drupal-fivestar,drupal-fivestar,,0,0,0,0,1,0,4,1
gemfile.lock,gemfile.lock,,1,0,4,1,8,5,12,1
mvxspinner,mvxspinner,,0,0,1,0,5,1,8,1
integrated-pipeline-mode,integrated-pipeline-mode,,0,0,1,0,3,1,8,1
getproperties,getproperties,,0,0,3,0,2,3,8,1
icustomtypedescriptor,icustomtypedescriptor,,0,0,1,0,1,1,8,1
ravendb4,ravendb4,,4,1,9,5,27,14,8,1
checkinstall,checkinstall,,0,0,1,0,1,1,9,1
jmf,jmf,,3,2,4,5,5,9,3,1
twincat-ads,twincat-ads,,2,1,1,3,2,4,9,1
bisonc++,bisonc++,,1,2,1,3,4,4,9,100
ata,ata,,0,1,3,1,1,4,9,1
abnf,abnf,,2,2,0,4,4,4,9,1
base32,base32,,0,2,4,2,5,6,0,100
3scale,3scale,,2,2,0,4,1,4,3,1
similarweb,similarweb,,0,0,0,0,1,0,0,1
git-cherry,git-cherry,,0,0,1,0,2,1,6,1
milter,milter,,0,0,1,0,3,1,4,1
lockbits,lockbits,,1,1,4,2,7,6,8,1
checkboxfor,checkboxfor,,2,0,3,2,9,5,8,1
radiobuttonfor,radiobuttonfor,,1,1,0,2,7,2,8,1
wpf-animation,wpf-animation,,3,1,7,4,9,11,8,1
kohana-3.3,kohana-3.3,,1,1,1,2,3,3,4,1
datapoint,datapoint,,3,0,1,3,7,4,8,1
petrel,petrel,,0,2,3,2,4,5,6,100
ui.bootstrap,ui.bootstrap,,0,1,5,1,8,6,1,1
gcc4.4,gcc4.4,,1,3,0,4,2,4,9,200
taleo-connect-client,taleo-connect-client,,1,0,8,1,7,9,3,1
table-rename,table-rename,,0,1,0,1,3,1,4,1
javascript-namespaces,javascript-namespaces,,3,1,5,4,8,9,1,1
table-splitting,table-splitting,,0,1,0,1,2,1,8,1
runsettings,runsettings,,7,7,3,14,5,17,8,1
avaudiopcmbuffer,avaudiopcmbuffer,,0,1,4,1,6,5,13,1
qf-test,qf-test,,1,0,2,1,2,3,3,1
google-cloud-nl,google-cloud-nl,,8,2,6,10,20,16,6,1
modelbinder,modelbinder,,0,0,0,0,4,0,8,1
xcode4,xcode4,,1,3,1,4,5,5,13,200
carchive,carchive,,0,1,0,1,1,1,9,1
greenhills,greenhills,,4,1,3,5,5,8,9,1
puts,puts,,2,1,7,3,7,10,9,1
anonymity,anonymity,,2,1,0,3,1,3,4,1
fusionreactor,fusionreactor,,0,0,0,0,1,0,4,1
dup2,dup2,,17,2,17,19,26,36,9,1
vfork,vfork,,1,0,0,1,3,1,9,1
imsl,imsl,,0,0,0,0,1,0,9,1
n-layer,n-layer,,0,0,3,0,5,3,8,1
json-lib,json-lib,,0,1,1,1,3,2,1,1
clearcase-remote-client,clearcase-remote-client,,0,4,3,4,2,7,6,300
maven-install,maven-install,,1,0,1,1,4,2,3,1
openx,openx,,0,1,1,1,3,2,4,1
glreadpixels,glreadpixels,,3,4,3,7,7,10,9,33.333333
lexicographic-ordering,lexicographic-ordering,,1,1,3,2,9,5,0,1
multipoint,multipoint,,0,1,4,1,4,5,0,1
title-case,title-case,,0,2,2,2,14,4,0,100
pretty-urls,pretty-urls,,1,4,8,5,5,13,4,300
array-initialization,array-initialization,,0,2,3,2,8,5,9,100
cpio,cpio,,0,0,1,0,4,1,9,1
appv,appv,,1,0,3,1,4,4,8,1
relevanssi,relevanssi,,1,0,2,1,5,3,4,1
sphero-api,sphero-api,,0,0,0,0,1,0,6,1
sphero,sphero,,1,0,3,1,1,4,6,1
character-replacement,character-replacement,,1,0,3,1,4,4,0,1
multiple-forms,multiple-forms,,0,1,4,1,13,5,0,1
routelocalization-mvc,routelocalization-mvc,,0,0,1,0,1,1,8,1
gnumeric,gnumeric,,3,0,1,3,4,4,5,1
bare,bare,,0,1,3,1,3,4,6,1
retransmit-timeout,retransmit-timeout,,0,0,0,0,2,0,9,1
tcp-keepalive,tcp-keepalive,,5,4,4,9,9,13,9,1
snoop,snoop,,3,0,2,3,2,5,8,1
panda3d,panda3d,,6,5,7,11,6,18,0,1
cppcms,cppcms,,0,0,5,0,3,5,9,1
qopenglfunctions,qopenglfunctions,,3,0,1,3,4,4,9,1
corresponding-records,corresponding-records,,0,0,0,0,1,0,4,1
intellij-scala,intellij-scala,,1,0,1,1,6,2,2,1
digraphs,digraphs,,4,4,4,8,14,12,0,1
duktape,duktape,,1,2,3,3,9,6,3,100
domc,domc,,1,1,0,2,7,2,0,1
ccm,ccm,,5,2,3,7,4,10,2,1
webinar,webinar,,0,0,1,0,1,1,13,1
color-thief,color-thief,,1,0,1,1,2,2,1,1
fsharp.data.typeproviders,fsharp.data.typeproviders,,2,3,7,5,5,12,8,50
android-filter,android-filter,,2,2,2,4,6,6,3,1
qsplashscreen,qsplashscreen,,0,1,2,1,3,3,9,1
vcxproj,vcxproj,,0,2,2,2,12,4,8,100
datazen-server,datazen-server,,0,0,1,0,1,1,4,1
pyftpdlib,pyftpdlib,,2,1,0,3,2,3,0,1
ibm-sterling,ibm-sterling,,1,3,4,4,2,8,13,200
flask-cors,flask-cors,,5,9,10,14,8,24,0,80
ss,ss,,1,3,4,4,5,8,9,200
dbmail,dbmail,,1,1,3,2,5,5,4,1
log4cxx,log4cxx,,3,3,5,6,5,11,9,1
macrodef,macrodef,,1,0,1,1,3,2,3,1
pygraphviz,pygraphviz,,14,7,21,21,18,42,0,1
angular2-meteor,angular2-meteor,,0,0,1,0,4,1,1,1
pyffmpeg,pyffmpeg,,4,2,2,6,5,8,13,1
shady-dom,shady-dom,,0,0,2,0,3,2,1,1
mxml,mxml,,6,1,3,7,7,10,13,1
anonymous-struct,anonymous-struct,,1,2,3,3,2,6,9,100
local-security-authority,local-security-authority,,0,0,0,0,5,0,9,1
boost-fusion,boost-fusion,,1,2,2,3,9,5,9,100
minmax-heap,minmax-heap,,0,1,1,1,3,2,0,1
name-binding,name-binding,,0,1,1,1,3,2,3,1
sqlcompare,sqlcompare,,0,1,1,1,4,2,4,1
online-radio,online-radio,,0,0,0,0,5,0,3,1
sortedcollection,sortedcollection,,0,0,0,0,1,0,9,1
debugview,debugview,,1,0,0,1,4,1,9,1
redcarpet,redcarpet,,0,2,2,2,4,4,12,100
business-objects-sdk,business-objects-sdk,,0,1,2,1,9,3,5,1
smartsheet-c#-sdk-v1,smartsheet-c#-sdk-v1,,0,0,0,0,1,0,8,1
drillthrough,drillthrough,,2,1,6,3,12,9,4,1
tlv,tlv,,2,2,7,4,8,11,3,1
zope.interface,zope.interface,,0,0,1,0,1,1,0,1
hxcpp,hxcpp,,2,0,2,2,1,4,9,1
webrick,webrick,,5,2,6,7,10,13,12,1
sfx,sfx,,3,1,2,4,5,6,9,1
git-plumbing,git-plumbing,,1,1,2,2,4,4,6,1
wikia,wikia,,1,0,0,1,1,1,4,1
3g-network,3g-network,,0,0,2,0,2,2,9,1
stateless-state-machine,stateless-state-machine,,1,1,0,2,4,2,8,1
playscalajs,playscalajs,,1,0,0,1,2,1,2,1
mutagen,mutagen,,6,3,10,9,12,19,0,1
lwuit,lwuit,,0,0,0,0,1,0,3,1
java-wireless-toolkit,java-wireless-toolkit,,0,0,0,0,1,0,3,1
non-uniform-distribution,non-uniform-distribution,,0,1,0,1,1,1,0,1
perfect-hash,perfect-hash,,3,0,4,3,4,7,12,1
yii-booster,yii-booster,,0,0,0,0,1,0,4,1
y86,y86,,4,0,8,4,10,12,9,1
likert,likert,,7,3,10,10,13,20,0,1
clients,clients,,0,0,0,0,5,0,3,1
currentlocation,currentlocation,,5,4,5,9,17,14,3,1
editcap,editcap,,0,3,1,3,1,4,9,200
moea-framework,moea-framework,,0,0,2,0,1,2,0,1
mobx-utils,mobx-utils,,1,0,0,1,2,1,1,1
git-daemon,git-daemon,,2,0,0,2,2,2,6,1
ldapconnection,ldapconnection,,3,4,0,7,2,7,8,33.333333
stackexchange,stackexchange,,4,6,4,10,7,14,4,50
sql-server-openxml,sql-server-openxml,,0,3,2,3,4,5,4,200
scala-option,scala-option,,1,1,4,2,10,6,2,1
bochs,bochs,,2,1,5,3,7,8,9,1
inmobi,inmobi,,1,2,3,3,9,6,3,100
apache-ranger,apache-ranger,,9,22,13,31,16,44,2,144.444444
wcsession,wcsession,,1,2,10,3,15,13,13,100
ecmascript-2016,ecmascript-2016,,0,1,2,1,4,3,1,1
adb-drivers,adb-drivers,,0,0,1,0,1,1,3,1
node-orm2,node-orm2,,0,0,1,0,1,1,1,1
fairplay,fairplay,,7,4,9,11,13,20,13,1
chef-provisioning,chef-provisioning,,0,0,2,0,1,2,12,1
bsp,bsp,,3,1,4,4,18,8,9,1
rtems,rtems,,2,1,5,3,3,8,9,1
mo-cap,mo-cap,,0,3,2,3,1,5,0,200
selectboxit,selectboxit,,0,2,2,2,3,4,1,100
geocoder,geocoder,,10,9,23,19,38,42,12,1
volt,volt,,4,0,4,4,7,8,4,1
function-module,function-module,,0,1,2,1,7,3,5,1
laravel-pagination,laravel-pagination,,13,6,19,19,15,38,4,1
dynamics365-app-mobile,dynamics365-app-mobile,,0,3,1,3,6,4,8,200
elasticsearch-1.6.0,elasticsearch-1.6.0,,3,0,0,3,1,3,6,1
binary-indexed-tree,binary-indexed-tree,,0,2,2,2,5,4,0,100
request-object,request-object,,0,0,1,0,1,1,9,1
kaitai-struct,kaitai-struct,,4,0,1,4,8,5,0,1
blacs,blacs,,0,0,0,0,1,0,9,1
arm7,arm7,,5,0,1,5,2,6,9,1
jira-xray,jira-xray,,1,7,5,8,4,13,3,600
typolink,typolink,,2,2,1,4,3,5,4,1
jomsocial,jomsocial,,0,0,0,0,1,0,4,1
mockstatic,mockstatic,,1,0,0,1,5,1,3,1
documentfilter,documentfilter,,1,0,0,1,4,1,3,1
ksql,ksql,,32,51,80,83,77,163,2,59.375
fastlane-match,fastlane-match,,6,1,8,7,13,15,13,1
scntext,scntext,,1,2,1,3,9,4,13,100
zumo,zumo,,0,1,0,1,5,1,8,1
cropit,cropit,,1,0,1,1,7,2,1,1
firstdata,firstdata,,1,0,2,1,2,3,4,1
payeezy,payeezy,,0,0,2,0,2,2,4,1
varnish-3,varnish-3,,0,0,0,0,3,0,4,1
transitive-closure-table,transitive-closure-table,,1,1,0,2,5,2,4,1
ionic-serve,ionic-serve,,3,0,0,3,9,3,1,1
ionic-devapp,ionic-devapp,,1,4,8,5,7,13,1,300
discogs-api,discogs-api,,1,2,2,3,7,5,0,100
css-hyphens,css-hyphens,,0,1,2,1,3,3,1,1
rhomobile,rhomobile,,0,1,2,1,4,3,12,1
rhodes,rhodes,,0,1,3,1,4,4,12,1
rhoconnect,rhoconnect,,0,0,0,0,1,0,12,1
keyguard,keyguard,,5,1,7,6,12,13,3,1
django-polymorphic,django-polymorphic,,3,6,6,9,8,15,0,100
circleci-workflows,circleci-workflows,,13,3,9,16,14,25,6,1
sbt-proguard,sbt-proguard,,1,0,0,1,1,1,3,1
jsprettier,jsprettier,,1,1,5,2,3,7,9,1
python-dedupe,python-dedupe,,1,5,5,6,11,11,0,400
general-network-error,general-network-error,,3,1,4,4,6,8,3,1
cfoutput,cfoutput,,0,1,0,1,2,1,4,1
cfdump,cfdump,,0,0,1,0,2,1,4,1
heat,heat,,1,5,9,6,18,15,8,400
hiccup,hiccup,,0,1,2,1,10,3,2,1
hyphenator,hyphenator,,0,0,0,0,2,0,1,1
visual-studio-gallery,visual-studio-gallery,,0,0,0,0,1,0,9,1
pixel-perfect,pixel-perfect,,0,0,5,0,5,5,1,1
uipresentingcontroller,uipresentingcontroller,,0,0,1,0,2,1,13,1
uploadify,uploadify,,0,0,1,0,4,1,1,1
nscolorpanel,nscolorpanel,,0,0,1,0,3,1,13,1
nscolorwell,nscolorwell,,0,0,0,0,3,0,13,1
mapnik,mapnik,,7,2,6,9,13,15,0,1
buildkite,buildkite,,2,3,3,5,2,8,9,50
type-members,type-members,,0,1,2,1,5,3,2,1
oauth2resttemplate,oauth2resttemplate,,3,2,3,5,4,8,3,1
yandex-api,yandex-api,,4,3,6,7,12,13,3,1
cfreport,cfreport,,0,0,1,0,1,1,4,1
openstack-python-api,openstack-python-api,,1,0,3,1,1,4,0,1
cfs,cfs,,1,1,8,2,5,10,9,1
referer,referer,,2,4,4,6,14,10,4,100
gml-geographic-markup-lan,gml-geographic-markup-lan,,5,0,1,5,2,6,0,1
cloud-integration,cloud-integration,,0,0,0,0,1,0,5,1
sp-msforeachtable,sp-msforeachtable,,0,1,1,1,3,2,4,1
ladda,ladda,,1,1,0,2,4,2,1,1
elasticsearch-indices,elasticsearch-indices,,3,1,4,4,6,8,6,1
headertext,headertext,,1,0,1,1,3,2,8,1
uiapplicationshortcutitem,uiapplicationshortcutitem,,1,1,2,2,6,4,13,1
dosgi,dosgi,,0,0,1,0,2,1,3,1
atsam3x,atsam3x,,0,0,2,0,3,2,9,1
cjuidialog,cjuidialog,,0,0,0,0,2,0,4,1
webinvoke,webinvoke,,0,0,1,0,3,1,8,1
user-stories,user-stories,,2,3,3,5,9,8,8,50
dulwich,dulwich,,0,0,1,0,8,1,6,1
word-sense-disambiguation,word-sense-disambiguation,,0,1,2,1,8,3,0,1
pre-compilation,pre-compilation,,0,1,1,1,9,2,8,1
imapx,imapx,,0,0,2,0,6,2,8,1
formsauthenticationticket,formsauthenticationticket,,1,0,2,1,1,3,8,1
episerver-7,episerver-7,,0,1,1,1,9,2,8,1
mersenne-twister,mersenne-twister,,1,2,6,3,8,9,0,100
keyref,keyref,,0,1,0,1,2,1,3,1
geminabox,geminabox,,0,0,0,0,1,0,12,1
skphysicsjoint,skphysicsjoint,,0,1,3,1,3,4,13,1
sysdatabases,sysdatabases,,0,0,0,0,1,0,1,1
virtual-member-manager,virtual-member-manager,,0,0,0,0,1,0,3,1
nuget-cli,nuget-cli,,2,0,3,2,5,5,8,1
android-vpn-service,android-vpn-service,,5,16,9,21,21,30,3,220
cni,cni,,11,9,13,20,2,33,6,1
displayformat,displayformat,,0,0,0,0,3,0,0,1
pellet,pellet,,3,1,1,4,13,5,2,1
justgage,justgage,,2,1,0,3,6,3,1,1
jackson-dataformat-avro,jackson-dataformat-avro,,0,2,0,2,3,2,2,100
visio-vba,visio-vba,,4,1,5,5,10,10,5,1
setattr,setattr,,2,3,9,5,12,14,0,50
qjson,qjson,,3,0,3,3,12,6,9,1
blueprint-css,blueprint-css,,0,0,1,0,3,1,3,1
dotconnect,dotconnect,,1,3,2,4,7,6,8,200
class-names,class-names,,3,3,4,6,6,10,1,1
asp.net-core-testhost,asp.net-core-testhost,,1,2,2,3,10,5,8,100
yahoo-weather-api,yahoo-weather-api,,3,0,9,3,7,12,4,1
orbit,orbit,,5,1,5,6,9,11,0,1
installshield-le,installshield-le,,0,0,5,0,9,5,8,1
clicktag,clicktag,,0,0,1,0,1,1,1,1
cgimageref,cgimageref,,2,2,2,4,3,6,13,1
csvkit,csvkit,,0,1,4,1,8,5,0,1
system.web,system.web,,1,3,4,4,11,8,8,200
memmove,memmove,,0,2,3,2,10,5,9,100
hippomocks,hippomocks,,1,1,2,2,3,4,9,1
proto.actor,proto.actor,,0,1,1,1,2,2,2,1
regexp-grammars,regexp-grammars,,1,0,1,1,4,2,0,1
truedepth-camera,truedepth-camera,,5,3,5,8,12,13,13,1
jgrapht,jgrapht,,11,5,4,16,17,20,3,1
elasticsearch-curator,elasticsearch-curator,,1,4,10,5,19,15,6,300
petl,petl,,1,5,4,6,9,10,0,400
tx-indexed-search,tx-indexed-search,,1,2,3,3,11,6,4,100
web-config-transform,web-config-transform,,1,2,4,3,13,7,8,100
qc,qc,,3,1,6,4,18,10,5,1
stem,stem,,0,3,5,3,16,8,0,200
webkit-sharp,webkit-sharp,,0,0,0,0,1,0,8,1
less-unix,less-unix,,2,1,7,3,13,10,9,1
saiy,saiy,,0,0,1,0,1,1,3,1
emboss,emboss,,1,0,0,1,1,1,3,1
jeromq,jeromq,,5,2,5,7,12,12,3,1
timsort,timsort,,3,1,5,4,8,9,0,1
date-histogram,date-histogram,,4,3,2,7,2,9,6,1
microstation,microstation,,0,2,1,2,1,3,5,100
stunnel,stunnel,,3,4,8,7,6,15,6,33.333333
urlscan,urlscan,,0,0,0,0,1,0,4,1
stalled,stalled,,0,0,1,0,3,1,4,1
pkcs#1,pkcs#1,,3,2,8,5,15,13,6,1
procmail,procmail,,0,3,5,3,6,8,4,200
bspline,bspline,,13,11,12,24,15,36,0,1
active-window,active-window,,0,1,2,1,6,3,9,1
urn,urn,,3,0,5,3,4,8,4,1
code-size,code-size,,0,4,1,4,7,5,9,300
hypernym,hypernym,,0,0,1,0,3,1,0,1
soundjs,soundjs,,0,2,1,2,6,3,1,100
system.security,system.security,,0,2,4,2,7,6,8,100
msstickerview,msstickerview,,1,0,0,1,3,1,13,1
flowpane,flowpane,,0,2,0,2,2,2,3,100
wrds,wrds,,4,0,1,4,8,5,0,1
assemblybinding,assemblybinding,,0,2,3,2,8,5,8,100
pgmpy,pgmpy,,0,0,0,0,2,0,0,1
gulp-task,gulp-task,,4,2,2,6,7,8,1,1
coqide,coqide,,6,2,16,8,10,24,2,1
resource-disposal,resource-disposal,,0,0,0,0,1,0,6,1
hal-json,hal-json,,0,1,3,1,6,4,3,1
automoq,automoq,,4,4,3,8,6,11,8,1
pure-css,pure-css,,2,2,2,4,8,6,1,1
google-cloud-billing,google-cloud-billing,,5,4,9,9,11,18,6,1
ngx-admin,ngx-admin,,26,12,21,38,4,59,1,1
go-reflect,go-reflect,,1,0,4,1,13,5,6,1
htmlgenericcontrol,htmlgenericcontrol,,2,1,0,3,2,3,8,1
europepmc,europepmc,,0,0,0,0,3,0,4,1
ssis-data-types,ssis-data-types,,2,0,2,2,2,4,4,1
uipath-robot,uipath-robot,,5,4,0,9,1,9,5,1
bltoolkit,bltoolkit,,0,0,0,0,1,0,8,1
anytree,anytree,,6,4,7,10,9,17,0,1
paytm,paytm,,19,24,35,43,47,78,4,26.315789
google-cloud-node,google-cloud-node,,0,1,2,1,4,3,6,1
maf,maf,,1,1,3,2,4,5,8,1
convenience-methods,convenience-methods,,1,0,0,1,4,1,13,1
smartgit,smartgit,,4,3,13,7,18,20,6,1
jquery-3,jquery-3,,3,3,9,6,14,15,1,1
spire,spire,,2,2,8,4,7,12,8,1
taco,taco,,0,1,4,1,9,5,1,1
tools-for-apache-cordova,tools-for-apache-cordova,,0,1,0,1,9,1,1,1
jyni,jyni,,0,0,1,0,5,1,0,1
simple-openni,simple-openni,,0,0,1,0,2,1,8,1
eml,eml,,10,11,18,21,16,39,4,10
ssis-connection-manager,ssis-connection-manager,,0,3,5,3,3,8,4,200
cryptarithmetic-puzzle,cryptarithmetic-puzzle,,2,0,0,2,4,2,0,1
connectionexception,connectionexception,,3,0,5,3,4,8,3,1
executequery,executequery,,0,2,9,2,7,11,3,100
google-app-engine-go,google-app-engine-go,,2,5,8,7,13,15,6,150
gui-designer,gui-designer,,1,0,0,1,1,1,8,1
design-surface,design-surface,,0,0,0,0,1,0,8,1
phpeclipse,phpeclipse,,0,0,0,0,1,0,8,1
showmodaldialog,showmodaldialog,,1,0,4,1,7,5,1,1
quick-nimble,quick-nimble,,0,3,4,3,11,7,13,200
ldapjs,ldapjs,,5,11,11,16,14,27,1,120
intellitest,intellitest,,0,1,1,1,3,2,8,1
nolock,nolock,,0,2,1,2,4,3,4,100
netty-socketio,netty-socketio,,4,5,7,9,6,16,3,25
janitor,janitor,,2,3,6,5,3,11,0,50
jahia,jahia,,0,0,3,0,3,3,3,1
jquery-datatables-editor,jquery-datatables-editor,,2,7,9,9,11,18,1,250
bin2hex,bin2hex,,1,3,1,4,1,5,4,200
symbolic-references,symbolic-references,,0,0,1,0,2,1,6,1
primeng-dialog,primeng-dialog,,2,1,3,3,11,6,1,1
content-delivery-network,content-delivery-network,,3,0,0,3,5,3,1,1
ios-vision,ios-vision,,0,0,2,0,3,2,13,1
arraydeque,arraydeque,,2,3,3,5,9,8,3,50
owner,owner,,5,6,5,11,7,16,4,20
logentries,logentries,,1,2,6,3,5,9,1,100
specification-pattern,specification-pattern,,2,2,3,4,8,7,3,1
web-feature-service,web-feature-service,,1,1,2,2,6,4,1,1
minimized,minimized,,0,1,3,1,8,4,8,1
servletexception,servletexception,,2,3,0,5,2,5,3,50
nsurlcomponents,nsurlcomponents,,1,3,4,4,4,8,13,200
nmea2000,nmea2000,,0,1,1,1,2,2,9,1
java-libpst,java-libpst,,0,1,0,1,1,1,5,1
launch-services,launch-services,,1,1,4,2,1,6,13,1
fingerprintjs2,fingerprintjs2,,1,1,4,2,6,6,1,1
django-subquery,django-subquery,,1,1,2,2,5,4,0,1
queuetrigger,queuetrigger,,0,8,5,8,3,13,8,700
remove-method,remove-method,,2,0,2,2,4,4,0,1
systray,systray,,3,3,3,6,5,9,0,1
pixmap,pixmap,,0,1,6,1,3,7,9,1
angular2-localstorage,angular2-localstorage,,0,0,1,0,3,1,1,1
sqlite-browser,sqlite-browser,,2,0,0,2,4,2,3,1
iodbc,iodbc,,0,0,1,0,3,1,4,1
windows-firewall-api,windows-firewall-api,,0,0,2,0,4,2,8,1
tone-generator,tone-generator,,0,0,1,0,3,1,3,1
coin3d,coin3d,,0,0,0,0,3,0,6,1
automatonymous,automatonymous,,6,3,3,9,12,12,8,1
msi-patch,msi-patch,,0,2,5,2,9,7,8,100
value-initialization,value-initialization,,1,1,1,2,3,3,9,1
lastinsertid,lastinsertid,,0,0,0,0,5,0,4,1
webkit2-webextension,webkit2-webextension,,1,0,2,1,2,3,9,1
keyword-expansion,keyword-expansion,,0,0,0,0,2,0,6,1
zebble,zebble,,0,0,0,0,4,0,8,1
evalf,evalf,,0,0,1,0,2,1,0,1
cimage,cimage,,0,0,1,0,3,1,9,1
onclientclick,onclientclick,,2,1,1,3,2,4,1,1
authority,authority,,3,2,2,5,4,7,6,1
odoo-enterprise,odoo-enterprise,,3,1,4,4,5,8,0,1
outlook-2007,outlook-2007,,1,0,4,1,7,5,5,1
install-requires,install-requires,,1,0,1,1,2,2,0,1
zxingobjc,zxingobjc,,0,0,1,0,1,1,13,1
objectlistview-python,objectlistview-python,,1,0,0,1,3,1,0,1
method-interception,method-interception,,1,1,0,2,2,2,3,1
bioperl,bioperl,,2,0,2,2,3,4,9,1
path-dependent-type,path-dependent-type,,3,2,6,5,11,11,2,1
clregion,clregion,,0,0,1,0,3,1,13,1
hsqml,hsqml,,0,0,0,0,1,0,9,1
rinside,rinside,,1,1,4,2,9,6,0,1
hoops,hoops,,0,1,0,1,1,1,9,1
custom-domain,custom-domain,,10,6,11,16,18,27,4,1
easy-digital-downloads,easy-digital-downloads,,7,5,2,12,4,14,4,1
pystache,pystache,,1,0,0,1,2,1,0,1
mpmath,mpmath,,6,5,3,11,11,14,0,1
react-universal,react-universal,,0,0,2,0,4,2,1,1
ulong,ulong,,1,0,2,1,6,3,8,1
list-manipulation,list-manipulation,,2,1,4,3,12,7,0,1
firebug-lite,firebug-lite,,0,0,0,0,2,0,1,1
autovivification,autovivification,,0,0,4,0,4,4,9,1
opsview,opsview,,1,0,0,1,1,1,6,1
wbxml,wbxml,,0,0,0,0,1,0,3,1
invalidargumentexception,invalidargumentexception,,1,2,7,3,4,10,4,100
rsa-key-fingerprint,rsa-key-fingerprint,,1,1,0,2,5,2,3,1
uiactivitytypeairdrop,uiactivitytypeairdrop,,0,0,0,0,2,0,13,1
javap,javap,,0,1,7,1,7,8,3,1
argouml,argouml,,0,0,1,0,2,1,3,1
jt400,jt400,,2,1,8,3,11,11,4,1
soundeffect,soundeffect,,2,1,3,3,1,6,13,1
video-effects,video-effects,,0,0,2,0,1,2,13,1
angular-auxiliary-routes,angular-auxiliary-routes,,7,2,3,9,4,12,1,1
cobertura,cobertura,,6,5,23,11,20,34,3,1
server.mappath,server.mappath,,2,0,2,2,6,4,8,1
swift-keyboard,swift-keyboard,,1,1,1,2,5,3,3,1
sql-variant,sql-variant,,0,1,2,1,6,3,4,1
multicastsocket,multicastsocket,,4,1,9,5,8,14,9,1
dashicons,dashicons,,0,0,0,0,3,0,4,1
androidplot,androidplot,,3,7,7,10,19,17,3,133.333333
sizing,sizing,,8,3,4,11,12,15,1,1
asn1,asn1,,2,3,16,5,13,21,6,50
sqlitemanager,sqlitemanager,,0,0,0,0,4,0,3,1
avcam,avcam,,2,0,0,2,6,2,13,1
smartxls,smartxls,,0,0,0,0,1,0,3,1
httponly,httponly,,2,6,9,8,10,17,4,200
aura-framework,aura-framework,,3,7,0,10,2,10,14,133.333333
proget,proget,,1,1,2,2,5,4,8,1
geometric-mean,geometric-mean,,3,0,0,3,6,3,0,1
sitecore-analytics,sitecore-analytics,,0,0,2,0,6,2,8,1
unboundid,unboundid,,0,0,1,0,3,1,8,1
webmatrix,webmatrix,,1,2,2,3,4,5,8,100
subviews,subviews,,0,0,0,0,13,0,13,1
fat16,fat16,,0,1,0,1,2,1,9,1
qbwc,qbwc,,1,0,2,1,7,3,4,1
assembly-references,assembly-references,,2,4,3,6,9,9,8,100
django-flatpages,django-flatpages,,0,0,1,0,3,1,0,1
spl-autoloader,spl-autoloader,,0,0,0,0,4,0,4,1
pycallgraph,pycallgraph,,2,0,0,2,5,2,0,1
elasticsearch.js,elasticsearch.js,,0,1,1,1,4,2,6,1
test-class,test-class,,2,2,3,4,7,7,14,1
microblink,microblink,,0,2,1,2,1,3,13,100
registration-free-com,registration-free-com,,1,0,1,1,3,2,8,1
convolutional-neural-network,convolutional-neural-network,,0,0,0,0,262,0,0,1
easyapache-4,easyapache-4,,4,4,7,8,6,15,4,1
js-joda,js-joda,,0,0,0,0,2,0,1,1
embarrassingly-parallel,embarrassingly-parallel,,0,0,0,0,2,0,0,1
dotnetnuke-7,dotnetnuke-7,,0,5,3,5,4,8,8,400
gulp-rename,gulp-rename,,0,0,2,0,5,2,1,1
failing-tests,failing-tests,,0,0,0,0,2,0,3,1
strconv,strconv,,0,2,1,2,4,3,6,100
easy68k,easy68k,,1,3,1,4,7,5,9,200
app-signing,app-signing,,0,1,1,1,4,2,3,1
python-db-api,python-db-api,,2,2,8,4,8,12,4,1
audio-source,audio-source,,4,1,7,5,13,12,8,1
facebook-events,facebook-events,,3,2,7,5,15,12,13,1
object-create,object-create,,1,0,1,1,4,2,1,1
halogen,halogen,,1,1,0,2,8,2,2,1
luabridge,luabridge,,2,4,2,6,5,8,9,100
gridviewheader,gridviewheader,,0,0,0,0,1,0,8,1
passwordbox,passwordbox,,0,1,4,1,10,5,8,1
sails-postgresql,sails-postgresql,,8,2,8,10,9,18,1,1
sigchld,sigchld,,2,1,0,3,2,3,9,1
hbox,hbox,,5,4,4,9,19,13,3,1
android-handlerthread,android-handlerthread,,0,3,7,3,4,10,3,200
htmltextwriter,htmltextwriter,,0,1,0,1,3,1,8,1
amibroker,amibroker,,0,1,2,1,4,3,0,1
wheelnav.js,wheelnav.js,,0,3,3,3,3,6,1,200
method-group,method-group,,0,0,1,0,3,1,8,1
resolutions,resolutions,,0,0,0,0,1,0,8,1
facebook-account-kit,facebook-account-kit,,0,0,0,0,5,0,3,1
azure-service-plan,azure-service-plan,,0,0,3,0,3,3,8,1
django-angular,django-angular,,2,1,0,3,3,3,0,1
solidus,solidus,,2,5,8,7,15,15,12,150
akka.net-cluster,akka.net-cluster,,0,1,7,1,10,8,8,1
first-class,first-class,,0,0,1,0,5,1,0,1
htc-android,htc-android,,0,0,0,0,1,0,1,1
activescaffold,activescaffold,,1,1,2,2,4,4,12,1
filecompare,filecompare,,0,1,2,1,3,3,5,1
richtextfx,richtextfx,,3,1,4,4,5,8,3,1
meeting-request,meeting-request,,0,0,3,0,3,3,5,1
grako,grako,,0,0,0,0,3,0,0,1
zend-config,zend-config,,0,0,1,0,1,1,4,1
raid,raid,,3,2,13,5,12,18,9,1
literate-programming,literate-programming,,4,2,6,6,6,12,0,1
owlready,owlready,,4,5,3,9,9,12,2,25
gae-eclipse-plugin,gae-eclipse-plugin,,0,0,1,0,3,1,6,1
red-zone,red-zone,,2,3,2,5,3,7,9,50
wkextension,wkextension,,0,0,1,0,1,1,13,1
data-transfer-objects,data-transfer-objects,,2,0,1,2,10,3,8,1
javacpp,javacpp,,4,2,13,6,13,19,3,1
stickyrecycleview,stickyrecycleview,,3,9,1,12,7,13,3,200
undeploy,undeploy,,1,0,0,1,2,1,3,1
carbon-copy,carbon-copy,,0,0,1,0,2,1,5,1
nebular,nebular,,16,14,33,30,2,63,1,1
wxtextctrl,wxtextctrl,,4,3,2,7,8,9,0,1
gretl,gretl,,0,0,3,0,4,3,0,1
audio-converter,audio-converter,,2,2,2,4,6,6,13,1
immediate-operand,immediate-operand,,0,0,2,0,1,2,9,1
range-tree,range-tree,,0,1,1,1,1,2,0,1
magento-2.0.7,magento-2.0.7,,0,0,3,0,5,3,4,1
swing-app-framework,swing-app-framework,,0,0,0,0,1,0,3,1
mda,mda,,2,1,0,3,3,3,3,1
metawidget,metawidget,,0,0,1,0,1,1,3,1
nothing,nothing,,3,3,4,6,7,10,8,1
parity-io,parity-io,,2,8,5,10,9,15,6,300
jekyll-bootstrap,jekyll-bootstrap,,0,2,0,2,4,2,1,100
sine-wave,sine-wave,,3,2,1,5,1,6,13,1
mysql-connector-c,mysql-connector-c,,1,1,7,2,7,9,4,1
cross-build,cross-build,,1,0,3,1,5,4,9,1
prolog-findall,prolog-findall,,5,1,2,6,4,8,0,1
enzyme-to-snapshot,enzyme-to-snapshot,,1,1,0,2,6,2,1,1
gulp-zip,gulp-zip,,0,0,3,0,4,3,1,1
vaadin-themes,vaadin-themes,,0,0,1,0,1,1,3,1
latin,latin,,4,3,4,7,8,11,0,1
instasharp,instasharp,,3,5,0,8,2,8,8,66.666667
semantic-segmentation,semantic-segmentation,,17,19,40,36,36,76,0,11.764706
console-input,console-input,,1,1,2,2,4,4,3,1
tgifimage,tgifimage,,0,0,0,0,2,0,13,1
pycparser,pycparser,,0,4,9,4,5,13,0,300
language-detection,language-detection,,8,4,3,12,8,15,0,1
cscore,cscore,,2,1,3,3,12,6,8,1
uievent,uievent,,2,1,1,3,3,4,13,1
availability-monitoring,availability-monitoring,,0,0,0,0,4,0,6,1
rust-compiler-plugin,rust-compiler-plugin,,0,1,2,1,1,3,9,1
android-screen-pinning,android-screen-pinning,,2,0,3,2,7,5,3,1
dft,dft,,10,8,31,18,26,49,0,1
hslogger,hslogger,,0,0,0,0,2,0,2,1
dxribbonwindow,dxribbonwindow,,1,0,0,1,1,1,8,1
react-native-drawer,react-native-drawer,,0,6,10,6,5,16,1,500
reportportal,reportportal,,3,3,6,6,6,12,3,1
scala-native,scala-native,,3,0,2,3,2,5,2,1
higher-order-types,higher-order-types,,0,0,0,0,2,0,2,1
macports,macports,,3,4,20,7,18,27,13,33.333333
dnode,dnode,,0,0,0,0,1,0,1,1
contentpane,contentpane,,1,1,1,2,4,3,3,1
anthill,anthill,,0,0,0,0,2,0,6,1
gray-code,gray-code,,1,1,2,2,9,4,0,1
jsvalidation,jsvalidation,,0,0,0,0,3,0,1,1
semigroup,semigroup,,3,0,4,3,3,7,2,1
rest-security,rest-security,,2,2,4,4,6,8,4,1
vignette,vignette,,2,1,8,3,7,11,0,1
strict-weak-ordering,strict-weak-ordering,,0,0,3,0,3,3,9,1
visual-prolog,visual-prolog,,3,0,3,3,3,6,0,1
shoutcast,shoutcast,,3,3,8,6,15,14,13,1
shadowjar,shadowjar,,10,0,13,10,14,23,3,1
android-customtabs,android-customtabs,,3,1,8,4,15,12,3,1
angular-masonry,angular-masonry,,0,1,0,1,7,1,1,1
compiler-version,compiler-version,,3,0,1,3,2,4,9,1
grun,grun,,0,0,0,0,3,0,0,1
accesscontrolexception,accesscontrolexception,,1,0,2,1,3,3,3,1
guid-partition-table,guid-partition-table,,0,0,1,0,2,1,6,1
sysobjects,sysobjects,,0,0,2,0,1,2,4,1
onpaint,onpaint,,3,1,5,4,9,9,8,1
topmost,topmost,,1,0,5,1,6,6,8,1
slugify,slugify,,3,0,8,3,6,11,4,1
intellij-lombok-plugin,intellij-lombok-plugin,,10,6,13,16,24,29,3,1
ada2012,ada2012,,0,1,3,1,6,4,9,1
spark-2014,spark-2014,,2,0,2,2,7,4,9,1
.net-micro-framework,.net-micro-framework,,0,1,0,1,2,1,8,1
opengl-compat,opengl-compat,,50,62,9,112,10,121,9,24
ngzone,ngzone,,1,5,10,6,27,16,1,400
x-http-method-override,x-http-method-override,,0,0,1,0,2,1,1,1
rx-scala,rx-scala,,1,0,1,1,12,2,3,1
zeos,zeos,,2,2,5,4,9,9,9,1
maphilight,maphilight,,1,2,4,3,2,7,1,100
aws-sdk-mock,aws-sdk-mock,,4,2,4,6,5,10,6,1
rewriting,rewriting,,2,2,7,4,11,11,4,1
clustering-key,clustering-key,,0,1,2,1,9,3,2,1
pgi-visual-fortran,pgi-visual-fortran,,0,0,1,0,1,1,9,1
twitter-r,twitter-r,,1,1,0,2,3,2,0,1
vim-airline,vim-airline,,1,0,1,1,7,2,9,1
binary-semaphore,binary-semaphore,,2,0,1,2,5,3,9,1
mod-mono,mod-mono,,2,1,3,3,2,6,8,1
multibyte-characters,multibyte-characters,,1,2,6,3,7,9,9,100
mlton,mlton,,1,0,2,1,4,3,2,1
sharetribe,sharetribe,,1,1,2,2,6,4,12,1
treetagger,treetagger,,2,3,3,5,7,8,0,50
korpus,korpus,,0,1,0,1,1,1,0,1
trampolines,trampolines,,3,3,1,6,4,7,9,1
mapsforge,mapsforge,,3,0,5,3,5,8,3,1
executable-path,executable-path,,2,1,0,3,5,3,0,1
xamarin-live-player,xamarin-live-player,,2,0,5,2,33,7,8,1
dbo,dbo,,0,2,4,2,6,6,4,100
sunrpc,sunrpc,,0,1,0,1,1,1,9,1
hashcat,hashcat,,2,1,2,3,9,5,9,1
domo,domo,,1,5,2,6,6,8,4,400
cvx,cvx,,8,2,6,10,7,16,0,1
lisp-2,lisp-2,,0,0,0,0,1,0,0,1
kotlin-native,kotlin-native,,13,34,40,47,32,87,3,161.538462
taskdef,taskdef,,0,0,0,0,1,0,6,1
json-view,json-view,,3,3,8,6,9,14,3,1
om-next,om-next,,0,2,0,2,3,2,2,100
instant,instant,,2,4,16,6,14,22,13,100
healthvault,healthvault,,0,0,0,0,1,0,8,1
gwt-jsinterop,gwt-jsinterop,,1,1,6,2,8,8,3,1
multiple-matches,multiple-matches,,0,2,1,2,7,3,0,100
inquirer,inquirer,,4,3,8,7,8,15,1,1
vorpal,vorpal,,0,0,1,0,2,1,1,1
grape-entity,grape-entity,,1,2,2,3,9,5,12,100
icloud-api,icloud-api,,0,1,5,1,7,6,13,1
wordbreaker,wordbreaker,,0,0,1,0,1,1,4,1
vote,vote,,2,0,5,2,7,7,4,1
xml-visualizer,xml-visualizer,,0,0,0,0,2,0,8,1
ora-12514,ora-12514,,1,0,0,1,2,1,4,1
html-templates,html-templates,,9,5,17,14,13,31,1,1
rich-comm-service,rich-comm-service,,0,0,0,0,3,0,3,1
wistia,wistia,,3,2,3,5,10,8,1,1
avassetreader,avassetreader,,1,3,8,4,10,12,13,200
httpforbiddenhandler,httpforbiddenhandler,,0,1,3,1,7,4,4,1
bookblock,bookblock,,0,0,0,0,2,0,1,1
textkit,textkit,,4,2,12,6,12,18,13,1
rolap,rolap,,1,0,2,1,3,3,4,1
apm,apm,,9,11,21,20,9,41,6,22.222222
parted,parted,,0,3,3,3,3,6,9,200
visual-studio-automation,visual-studio-automation,,0,0,0,0,3,0,8,1
script-debugging,script-debugging,,0,0,2,0,2,2,3,1
cobra,cobra,,1,2,0,3,5,3,6,100
minimalmodbus,minimalmodbus,,2,3,6,5,7,11,0,50
word-processor,word-processor,,0,0,1,0,5,1,0,1
suite,suite,,3,3,3,6,11,9,3,1
openbabel,openbabel,,5,1,1,6,3,7,0,1
pybel,pybel,,2,0,1,2,4,3,0,1
molecule,molecule,,8,7,13,15,6,28,6,1
reduce-reduce-conflict,reduce-reduce-conflict,,0,1,3,1,3,4,9,1
fastfile,fastfile,,2,1,0,3,3,3,13,1
deselect,deselect,,4,1,1,5,5,6,1,1
data-handling,data-handling,,6,3,1,9,6,10,0,1
inquirerjs,inquirerjs,,3,0,7,3,9,10,1,1
ca2202,ca2202,,0,0,2,0,1,2,8,1
ng-image-compress,ng-image-compress,,0,0,0,0,3,0,1,1
android-video-record,android-video-record,,3,3,4,6,16,10,3,1
gogo-shell,gogo-shell,,6,2,1,8,1,9,3,1
release-mode,release-mode,,0,1,4,1,4,5,3,1
debug-mode,debug-mode,,4,1,4,5,9,9,3,1
maven-cobertura-plugin,maven-cobertura-plugin,,0,1,5,1,6,6,3,1
scoverage,scoverage,,2,2,9,4,5,13,2,1
long-double,long-double,,3,2,5,5,5,10,9,1
blink,blink,,5,4,11,9,9,20,1,1
apache2-module,apache2-module,,1,1,0,2,6,2,4,1
neo4j-python-driver,neo4j-python-driver,,1,0,2,1,6,3,2,1
handheld,handheld,,1,0,3,1,2,4,3,1
prerequisites,prerequisites,,2,2,4,4,11,8,8,1
custom-events,custom-events,,5,3,12,8,21,20,1,1
certificate-transparency,certificate-transparency,,0,2,3,2,4,5,6,100
kruskals-algorithm,kruskals-algorithm,,7,3,12,10,14,22,0,1
django-fsm,django-fsm,,0,1,0,1,5,1,0,1
ssid,ssid,,2,4,13,6,15,19,3,100
conditional-regex,conditional-regex,,1,1,1,2,1,3,0,1
web-storage,web-storage,,6,4,10,10,20,20,1,1
discover,discover,,2,1,0,3,5,3,3,1
vue-server-renderer,vue-server-renderer,,1,0,1,1,4,2,1,1
rails-flash,rails-flash,,0,0,0,0,2,0,12,1
wisper,wisper,,0,0,0,0,1,0,12,1
chromium-os,chromium-os,,2,2,0,4,5,4,3,1
splitbrain,splitbrain,,0,0,1,0,3,1,6,1
datastore-admin,datastore-admin,,0,0,0,0,3,0,6,1
etags,etags,,3,0,0,3,6,3,3,1
tttattributedlabel,tttattributedlabel,,0,0,0,0,7,0,13,1
twitter-util,twitter-util,,0,0,2,0,2,2,2,1
dlib-python,dlib-python,,0,0,0,0,1,0,0,1
titanium-web-proxy,titanium-web-proxy,,3,1,3,4,4,7,8,1
alexacrm-toolkit,alexacrm-toolkit,,0,4,0,4,2,4,8,300
metering,metering,,0,1,3,1,2,4,9,1
v-play,v-play,,3,2,9,5,4,14,9,1
fully-qualified-naming,fully-qualified-naming,,0,1,1,1,2,2,9,1
kosaraju-algorithm,kosaraju-algorithm,,1,0,3,1,2,4,0,1
infinispan-8,infinispan-8,,0,1,3,1,6,4,3,1
wampsharp,wampsharp,,1,0,1,1,1,2,8,1
autocompletefilter,autocompletefilter,,0,1,1,1,2,2,3,1
ml-studio,ml-studio,,2,3,8,5,12,13,8,50
onscrollchanged,onscrollchanged,,1,1,1,2,4,3,3,1
com-object,com-object,,0,0,0,0,2,0,8,1
resumablejs,resumablejs,,1,1,1,2,3,3,1,1
rails-ujs,rails-ujs,,6,2,7,8,12,15,12,1
npapi,npapi,,0,2,1,2,6,3,1,100
monomac,monomac,,0,0,0,0,3,0,8,1
nspredicateeditor,nspredicateeditor,,0,0,3,0,5,3,13,1
memory-editing,memory-editing,,0,0,0,0,1,0,9,1
wkinterfacecontroller,wkinterfacecontroller,,3,1,1,4,10,5,13,1
job-queue,job-queue,,3,0,4,3,9,7,3,1
tagged-pdf,tagged-pdf,,1,0,0,1,3,1,8,1
junction-table,junction-table,,5,4,7,9,20,16,4,1
promql,promql,,22,20,21,42,23,63,6,1
groupwise,groupwise,,1,1,0,2,1,2,0,1
bnfc,bnfc,,4,0,0,4,1,4,0,1
google-translator-toolkit,google-translator-toolkit,,4,2,6,6,12,12,1,1
cewp,cewp,,1,1,5,2,4,7,8,1
facebook-graph-api-v2.1,facebook-graph-api-v2.1,,0,0,1,0,4,1,13,1
name-resolution,name-resolution,,1,1,1,2,2,3,9,1
pre-authentication,pre-authentication,,0,3,8,3,4,11,3,200
ueberauth,ueberauth,,1,0,0,1,3,1,2,1
ekeventkit,ekeventkit,,0,1,0,1,6,1,13,1
redisearch,redisearch,,6,7,13,13,5,26,3,16.666667
inno-download-plugin,inno-download-plugin,,1,4,0,5,3,5,8,300
compose,compose,,5,7,19,12,24,31,6,40
gcc-plugins,gcc-plugins,,1,2,0,3,2,3,9,100
imanage,imanage,,1,0,4,1,6,5,5,1
document-library,document-library,,0,1,3,1,6,4,8,1
xceed-plus-edition,xceed-plus-edition,,2,0,0,2,2,2,8,1
stratum,stratum,,0,0,0,0,6,0,0,1
css-counter,css-counter,,3,3,5,6,21,11,1,1
django-storage,django-storage,,3,9,14,12,16,26,0,200
prefixfree,prefixfree,,0,0,0,0,1,0,1,1
clutter,clutter,,0,0,1,0,5,1,9,1
value-class,value-class,,0,2,2,2,5,4,2,100
universal-trait,universal-trait,,0,0,0,0,2,0,2,1
uioutput,uioutput,,2,1,0,3,8,3,0,1
proxyselector,proxyselector,,0,0,1,0,2,1,6,1
gcloud-python,gcloud-python,,0,0,0,0,5,0,6,1
unescapestring,unescapestring,,2,2,2,4,6,6,0,1
silk-central,silk-central,,3,0,0,3,2,3,5,1
webgl-earth,webgl-earth,,2,1,3,3,2,6,1,1
mclust,mclust,,1,1,6,2,6,8,0,1
amazon-s3-infrequent,amazon-s3-infrequent,,0,0,0,0,2,0,6,1
rainbowtable,rainbowtable,,2,2,3,4,2,7,0,1
svg-react-loader,svg-react-loader,,0,0,1,0,2,1,1,1
ogc,ogc,,1,1,4,2,3,6,4,1
outlook-filter,outlook-filter,,1,1,5,2,10,7,5,1
pykinect,pykinect,,2,2,5,4,4,9,0,1
logitech-gaming-software,logitech-gaming-software,,7,4,10,11,5,21,9,1
n2cms,n2cms,,0,0,1,0,1,1,4,1
n2,n2,,0,0,0,0,1,0,4,1
checkedtextview,checkedtextview,,3,1,4,4,3,8,3,1
python-server-pages,python-server-pages,,1,0,1,1,3,2,0,1
window-style,window-style,,2,1,0,3,3,3,8,1
enchant,enchant,,1,0,1,1,5,2,0,1
predictive,predictive,,5,1,11,6,17,17,0,1
wiktionary,wiktionary,,0,1,1,1,5,2,4,1
ruby-csv,ruby-csv,,1,0,1,1,6,2,12,1
alice-fixtures,alice-fixtures,,1,1,4,2,4,6,4,1
scancodes,scancodes,,4,1,4,5,5,9,13,1
chrome-remote-debugging,chrome-remote-debugging,,0,3,7,3,9,10,1,200
gcmtaskservice,gcmtaskservice,,0,0,1,0,5,1,3,1
chefdk,chefdk,,1,3,5,4,3,9,12,200
symfony-recipe,symfony-recipe,,0,0,0,0,2,0,4,1
excel-indirect,excel-indirect,,7,4,18,11,34,29,5,1
geometry-surface,geometry-surface,,3,9,9,12,13,21,0,200
pitch-shifting,pitch-shifting,,2,3,6,5,6,11,13,50
qos,qos,,8,5,13,13,12,26,9,1
edmx-designer,edmx-designer,,0,0,7,0,5,7,8,1
timespec,timespec,,0,0,0,0,7,0,9,1
common-library,common-library,,1,0,0,1,1,1,0,1
boost-any,boost-any,,0,0,0,0,11,0,9,1
boost-type-erasure,boost-type-erasure,,0,0,0,0,4,0,9,1
pins,pins,,4,1,5,5,4,10,0,1
arduino-uno-wifi,arduino-uno-wifi,,1,1,1,2,3,3,9,1
custom-functions-excel,custom-functions-excel,,2,12,10,14,22,24,5,500
chrome-ux-report,chrome-ux-report,,0,1,1,1,3,2,4,1
system.json,system.json,,0,2,0,2,1,2,8,100
bitcoinlib,bitcoinlib,,1,1,2,2,4,4,6,1
gridsplitter,gridsplitter,,4,1,5,5,9,10,8,1
fibonacci-heap,fibonacci-heap,,1,3,2,4,2,6,0,200
oracle-sql-data-modeler,oracle-sql-data-modeler,,4,2,5,6,4,11,4,1
laravel-authentication,laravel-authentication,,39,26,47,65,24,112,4,1
clndr.js,clndr.js,,1,0,2,1,6,3,1,1
httprouter,httprouter,,1,0,1,1,5,2,6,1
harbor,harbor,,6,3,2,9,8,11,6,1
optional-values,optional-values,,4,0,1,4,10,5,13,1
mappedsuperclass,mappedsuperclass,,2,3,4,5,6,9,3,50
table-per-class,table-per-class,,0,1,0,1,4,1,3,1
m4,m4,,1,6,8,7,9,15,9,500
restkit-0.20,restkit-0.20,,1,0,0,1,3,1,13,1
mysql-error-1264,mysql-error-1264,,0,0,0,0,1,0,4,1
greendroid,greendroid,,0,0,0,0,2,0,3,1
cassandra-stress-tool,cassandra-stress-tool,,1,0,0,1,4,1,2,1
red-black-tree-insertion,red-black-tree-insertion,,3,1,2,4,5,6,0,1
jsmockito,jsmockito,,1,0,0,1,1,1,1,1
systemtime,systemtime,,6,1,6,7,10,13,8,1
oneway,oneway,,2,3,1,5,6,6,8,50
android-spellcheck,android-spellcheck,,0,0,1,0,1,1,3,1
nsuseractivity,nsuseractivity,,3,3,7,6,5,13,13,1
perlscript,perlscript,,1,0,3,1,2,4,9,1
binary-log,binary-log,,1,0,4,1,4,5,4,1
load-time-weaving,load-time-weaving,,1,2,6,3,7,9,3,100
mdxstudio,mdxstudio,,0,0,1,0,4,1,4,1
endpoints-proto-datastore,endpoints-proto-datastore,,0,0,0,0,7,0,6,1
protorpc,protorpc,,0,0,0,0,5,0,6,1
yii2-grid,yii2-grid,,1,0,3,1,5,4,4,1
pitr,pitr,,2,0,1,2,4,3,4,1
winmain,winmain,,0,1,4,1,4,5,9,1
pprof,pprof,,4,1,9,5,11,14,6,1
dependent-destroy,dependent-destroy,,0,1,0,1,2,1,12,1
aspose-slides,aspose-slides,,3,1,3,4,2,7,8,1
fling,fling,,0,0,2,0,3,2,3,1
hit-count,hit-count,,0,0,0,0,1,0,3,1
qdap,qdap,,5,4,10,9,11,19,0,1
odometer,odometer,,1,3,4,4,5,8,1,200
remote-management,remote-management,,2,0,2,2,1,4,8,1
self-host-webapi,self-host-webapi,,4,4,10,8,11,18,8,1
tensorrt,tensorrt,,22,34,24,56,26,80,0,54.545455
loadnibnamed,loadnibnamed,,0,0,0,0,1,0,13,1
happstack,happstack,,2,0,1,2,9,3,2,1
stringtemplate,stringtemplate,,3,2,8,5,4,13,3,1
rtm,rtm,,0,0,2,0,5,2,9,1
django-scheduler,django-scheduler,,1,2,3,3,3,6,0,100
anonymous-pipes,anonymous-pipes,,1,0,1,1,4,2,9,1
shell-icons,shell-icons,,0,0,0,0,2,0,9,1
magento2.2,magento2.2,,30,12,82,42,102,124,4,1
hwndhost,hwndhost,,0,0,2,0,1,2,8,1
embedded-video,embedded-video,,3,2,1,5,5,6,1,1
word-template,word-template,,0,0,2,0,5,2,5,1
xtrf,xtrf,,1,1,0,2,2,2,4,1
stackunderflow,stackunderflow,,2,0,1,2,2,3,9,1
goimports,goimports,,0,0,1,0,3,1,6,1
index-signature,index-signature,,3,2,6,5,7,11,1,1
parsepy,parsepy,,0,1,0,1,1,1,0,1
sqlncli,sqlncli,,0,0,0,0,3,0,4,1
gitlab-wiki,gitlab-wiki,,0,0,0,0,4,0,6,1
oledragdrop,oledragdrop,,0,0,1,0,3,1,8,1
string-evaluation,string-evaluation,,0,0,0,0,2,0,9,1
sahi,sahi,,0,2,1,2,5,3,1,100
touchswipe,touchswipe,,0,0,1,0,2,1,1,1
tomcat-jdbc,tomcat-jdbc,,2,3,4,5,5,9,3,50
scrollableresults,scrollableresults,,0,0,2,0,2,2,3,1
thin-client,thin-client,,0,6,1,6,3,7,3,500
vdi,vdi,,2,2,9,4,6,13,8,1
apple-reporter,apple-reporter,,0,0,0,0,1,0,13,1
managed-c++,managed-c++,,6,1,4,7,11,11,8,1
railsinstaller,railsinstaller,,4,0,0,4,2,4,12,1
static-compilation,static-compilation,,0,0,1,0,2,1,9,1
pahocpp,pahocpp,,1,2,0,3,3,3,9,100
angular-hotkeys,angular-hotkeys,,0,0,0,0,2,0,1,1
enumerated,enumerated,,0,2,0,2,2,2,3,100
uiviewcontentmode,uiviewcontentmode,,0,0,3,0,3,3,13,1
webresponse,webresponse,,3,3,4,6,4,10,8,1
azul-zulu,azul-zulu,,4,3,5,7,1,12,3,1
autodiff,autodiff,,4,3,8,7,10,15,0,1
rubberduck,rubberduck,,3,0,2,3,6,5,5,1
eula,eula,,0,0,0,0,3,0,9,1
message-map,message-map,,0,0,0,0,1,0,9,1
control-library,control-library,,0,1,0,1,1,1,8,1
typemock,typemock,,2,0,1,2,5,3,8,1
typemock-isolator,typemock-isolator,,2,0,1,2,3,3,8,1
sapscript,sapscript,,4,3,7,7,11,14,5,1
scalac,scalac,,4,5,3,9,16,12,2,25
system-profiler,system-profiler,,0,0,1,0,2,1,13,1
stepper,stepper,,19,10,32,29,31,61,1,1
django-mssql,django-mssql,,0,0,2,0,3,2,0,1
resulttype,resulttype,,0,1,0,1,2,1,2,1
xap,xap,,0,0,0,0,2,0,8,1
graphenedb,graphenedb,,1,0,1,1,8,2,2,1
sqlcommandbuilder,sqlcommandbuilder,,3,0,2,3,3,5,8,1
sqlcedatareader,sqlcedatareader,,0,0,0,0,2,0,8,1
windows-scheduler,windows-scheduler,,3,1,4,4,7,8,8,1
flipkart-api,flipkart-api,,3,2,0,5,2,5,4,1
open-graph-protocol,open-graph-protocol,,7,8,19,15,17,34,13,14.285714
openmaptiles,openmaptiles,,3,12,22,15,23,37,1,300
s4sdk,s4sdk,,28,3,24,31,19,55,3,1
office-web-components,office-web-components,,0,0,0,0,1,0,1,1
shared-config,shared-config,,0,1,0,1,1,1,8,1
xattribute,xattribute,,1,3,0,4,1,4,8,200
jtableheader,jtableheader,,3,0,2,3,6,5,3,1
dokuwiki,dokuwiki,,4,3,3,7,6,10,4,1
coolstorage,coolstorage,,1,0,0,1,1,1,13,1
adler32,adler32,,1,0,1,1,1,2,0,1
richtextarea,richtextarea,,3,1,3,4,2,7,1,1
session-fixation,session-fixation,,1,3,3,4,5,7,4,200
movefileex,movefileex,,0,0,2,0,2,2,9,1
sp-rename,sp-rename,,0,0,1,0,3,1,4,1
bmi,bmi,,0,0,2,0,3,2,9,1
libssl,libssl,,7,4,12,11,9,23,6,1
.net-3.0,.net-3.0,,0,0,0,0,4,0,8,1
ion-content,ion-content,,1,3,1,4,3,5,1,200
unbuffered,unbuffered,,1,0,2,1,3,3,9,1
binary-xml,binary-xml,,0,0,1,0,4,1,3,1
gulp-load-plugins,gulp-load-plugins,,0,0,1,0,1,1,1,1
apprtcdemo,apprtcdemo,,1,1,2,2,7,4,1,1
adomd.net,adomd.net,,1,3,8,4,8,12,8,200
m2crypto,m2crypto,,4,3,6,7,11,13,0,1
neo4j-cql,neo4j-cql,,1,0,0,1,3,1,2,1
containstable,containstable,,2,4,2,6,6,8,4,100
google-reflections,google-reflections,,1,0,1,1,2,2,3,1
account-management,account-management,,1,0,2,1,3,3,8,1
infinispan-9,infinispan-9,,4,3,7,7,7,14,3,1
asus,asus,,1,1,6,2,7,8,3,1
journaling,journaling,,4,1,3,5,3,8,9,1
resumable,resumable,,0,0,0,0,4,0,5,1
tfs-power-tools,tfs-power-tools,,1,0,0,1,8,1,8,1
system-testing,system-testing,,3,3,8,6,15,14,12,1
gba,gba,,1,0,2,1,2,3,9,1
hamming-window,hamming-window,,0,0,0,0,5,0,0,1
uss,uss,,0,0,0,0,2,0,0,1
jison,jison,,0,1,7,1,7,8,9,1
rkt,rkt,,1,1,0,2,5,2,6,1
stm,stm,,4,5,5,9,6,14,2,25
openstack-cinder,openstack-cinder,,2,2,11,4,5,15,6,1
dotnetcharting,dotnetcharting,,0,1,1,1,1,2,8,1
libstreaming,libstreaming,,1,0,1,1,3,2,3,1
galaxy-apps,galaxy-apps,,0,0,0,0,2,0,3,1
gem5,gem5,,9,13,20,22,30,42,9,44.444444
credible-interval,credible-interval,,0,0,2,0,4,2,0,1
tx-mask,tx-mask,,0,1,2,1,6,3,4,1
sql-server-profiler,sql-server-profiler,,3,3,10,6,25,16,4,1
slather,slather,,3,0,0,3,6,3,13,1
chomp,chomp,,0,0,0,0,3,0,9,1
errordocument,errordocument,,6,2,5,8,10,13,4,1
document-storage,document-storage,,0,0,1,0,3,1,4,1
uiimageasset,uiimageasset,,1,1,5,2,5,7,13,1
http-status,http-status,,3,4,3,7,4,10,4,33.333333
json-spirit,json-spirit,,0,0,0,0,2,0,9,1
subfigure,subfigure,,1,0,4,1,3,5,0,1
opencascade,opencascade,,4,4,9,8,6,17,0,1
jasmine-reporters,jasmine-reporters,,2,0,2,2,7,4,1,1
suitesparse,suitesparse,,1,3,2,4,6,6,9,200
visited,visited,,5,0,1,5,3,6,1,1
dism,dism,,4,3,5,7,12,12,8,1
zend-form-element,zend-form-element,,0,0,3,0,2,3,4,1
django-context,django-context,,4,0,1,4,8,5,0,1
interpretation,interpretation,,6,5,7,11,11,18,0,1
viewstub,viewstub,,2,2,4,4,8,8,3,1
btrace,btrace,,1,0,1,1,6,2,3,1
ed,ed,,0,2,1,2,5,3,9,100
file-length,file-length,,0,0,0,0,2,0,8,1
angular-webpack,angular-webpack,,0,2,4,2,7,6,1,100
nstimeinterval,nstimeinterval,,2,4,7,6,13,13,13,100
checkboxpreference,checkboxpreference,,1,1,1,2,2,3,3,1
reverse-iterator,reverse-iterator,,2,2,3,4,4,7,9,1
samsung-gear,samsung-gear,,2,0,1,2,4,3,13,1
real-ip,real-ip,,1,1,0,2,4,2,6,1
searchactivity,searchactivity,,0,0,1,0,1,1,3,1
lablgtk,lablgtk,,0,0,1,0,1,1,0,1
model-driven,model-driven,,0,1,3,1,8,4,3,1
mapactivity,mapactivity,,0,3,7,3,3,10,3,200
snow,snow,,5,8,6,13,11,19,0,60
data-generation,data-generation,,13,9,14,22,13,36,0,1
neutrino,neutrino,,0,0,6,0,8,6,1,1
third-normal-form,third-normal-form,,0,0,3,0,4,3,4,1
spooler,spooler,,0,2,1,2,7,3,9,100
conque,conque,,0,0,1,0,1,1,9,1
l-systems,l-systems,,3,3,3,6,4,9,0,1
tesla,tesla,,6,3,6,9,7,15,0,1
android-titlebar,android-titlebar,,1,1,7,2,7,9,3,1
nvvp,nvvp,,1,0,4,1,4,5,0,1
tachyons-css,tachyons-css,,4,1,6,5,5,11,1,1
environments,environments,,2,0,1,2,17,3,6,1
bcc-compiler,bcc-compiler,,1,0,1,1,2,2,9,1
colon-equals,colon-equals,,1,0,0,1,3,1,0,1
nginx-status,nginx-status,,0,0,0,0,10,0,6,1
tab-size,tab-size,,1,0,1,1,3,2,3,1
ntext,ntext,,1,0,2,1,2,3,4,1
cuda-events,cuda-events,,0,0,0,0,2,0,0,1
loop-invariant,loop-invariant,,4,4,6,8,11,14,0,1
rdfa,rdfa,,3,0,4,3,9,7,4,1
uiaccessoryview,uiaccessoryview,,0,0,0,0,2,0,13,1
controlleras,controlleras,,0,0,0,0,2,0,1,1
paypal-buttons,paypal-buttons,,1,1,4,2,6,6,4,1
strophe.js,strophe.js,,2,2,12,4,11,16,3,1
tup,tup,,1,0,1,1,1,2,3,1
build-target,build-target,,0,1,0,1,1,1,3,1
system32,system32,,2,2,4,4,7,8,9,1
circle-pack,circle-pack,,3,1,5,4,12,9,1,1
has-many-polymorphs,has-many-polymorphs,,1,0,1,1,4,2,4,1
geth,geth,,17,20,48,37,100,85,6,17.647059
fileopenpicker,fileopenpicker,,0,1,1,1,5,2,8,1
uribuilder,uribuilder,,0,3,7,3,8,10,3,200
enclave,enclave,,4,1,5,5,13,10,9,1
lxml.objectify,lxml.objectify,,1,2,7,3,6,10,0,100
cookiemanager,cookiemanager,,2,1,1,3,4,4,3,1
dalli,dalli,,0,1,2,1,5,3,12,1
jquery-fileupload-rails,jquery-fileupload-rails,,0,0,0,0,2,0,12,1
xsbt-web-plugin,xsbt-web-plugin,,1,0,0,1,5,1,2,1
coreos-ignition,coreos-ignition,,0,0,1,0,5,1,6,1
phpstorm-10,phpstorm-10,,0,0,0,0,2,0,1,1
csstidy,csstidy,,1,0,1,1,1,2,4,1
peakutils,peakutils,,1,0,3,1,4,4,0,1
playing,playing,,1,1,3,2,3,5,13,1
pyasn1,pyasn1,,2,2,5,4,9,9,0,1
breakout,breakout,,2,1,2,3,10,5,0,1
attiny,attiny,,9,4,10,13,14,23,9,1
qnap,qnap,,2,4,12,6,11,18,9,100
cubic-bezier,cubic-bezier,,1,0,6,1,8,7,0,1
jira-zephyr,jira-zephyr,,6,2,6,8,9,14,6,1
rad-controls,rad-controls,,0,0,3,0,1,3,8,1
celery-canvas,celery-canvas,,0,3,2,3,2,5,0,200
multisampling,multisampling,,1,2,6,3,8,9,9,100
telerik-reporting,telerik-reporting,,5,13,22,18,26,40,8,160
mbf,mbf,,1,0,0,1,2,1,8,1
timed,timed,,0,2,4,2,9,6,3,100
muenchian-grouping,muenchian-grouping,,0,2,7,2,9,9,3,100
pingback,pingback,,0,0,0,0,1,0,4,1
ros2,ros2,,6,8,8,14,15,22,9,33.333333
vin,vin,,2,0,1,2,4,3,0,1
quic,quic,,2,2,4,4,7,8,1,1
python-daemon,python-daemon,,2,1,8,3,15,11,0,1
hackintosh,hackintosh,,2,0,1,2,3,3,13,1
straight-line-detection,straight-line-detection,,0,4,7,4,6,11,0,300
android-studio-2.2.3,android-studio-2.2.3,,0,0,0,0,2,0,3,1
oboe.js,oboe.js,,0,0,6,0,3,6,1,1
google-api-v4,google-api-v4,,0,0,4,0,1,4,5,1
groovyscriptengine,groovyscriptengine,,2,3,3,5,6,8,3,50
ca-lisa,ca-lisa,,0,0,1,0,1,1,3,1
miracast,miracast,,3,2,5,5,11,10,3,1
nunit-gui,nunit-gui,,0,0,1,0,2,1,8,1
jdbc-odbc,jdbc-odbc,,4,6,5,10,8,15,3,50
guice-persist,guice-persist,,1,1,2,2,2,4,3,1
windows-7-embedded,windows-7-embedded,,1,1,2,2,4,4,8,1
yii-modules,yii-modules,,0,0,2,0,3,2,4,1
multiple-users,multiple-users,,11,3,12,14,23,26,4,1
cdatabase,cdatabase,,1,0,0,1,2,1,9,1
graphedit,graphedit,,3,0,0,3,2,3,13,1
non-interactive,non-interactive,,2,1,0,3,6,3,9,1
cbo,cbo,,1,0,0,1,2,1,2,1
connect-flash,connect-flash,,7,5,14,12,20,26,1,1
oai,oai,,2,2,3,4,6,7,3,1
officewriter,officewriter,,1,0,3,1,3,4,5,1
gulp-eslint,gulp-eslint,,2,0,3,2,3,5,1,1
commercetools,commercetools,,4,2,3,6,6,9,3,1
sphere.io,sphere.io,,1,0,3,1,4,4,3,1
geostatistics,geostatistics,,0,0,2,0,7,2,0,1
wps,wps,,1,1,3,2,7,5,3,1
ws-reliablemessaging,ws-reliablemessaging,,0,1,1,1,4,2,8,1
msbuild-propertygroup,msbuild-propertygroup,,0,1,0,1,2,1,8,1
system-alert-window,system-alert-window,,0,1,9,1,3,10,3,1
mongoid5,mongoid5,,0,1,0,1,1,1,12,1
kint,kint,,0,0,0,0,4,0,4,1
jackcess,jackcess,,0,1,5,1,6,6,3,1
databound,databound,,1,0,1,1,4,2,8,1
doobie,doobie,,6,5,5,11,11,16,2,1
database-server,database-server,,1,1,1,2,6,3,4,1
queuing,queuing,,4,2,7,6,9,13,4,1
last.fm,last.fm,,4,5,7,9,6,16,1,25
custom-attribute,custom-attribute,,2,3,4,5,8,9,1,50
coupa,coupa,,0,0,1,0,2,1,4,1
phplint,phplint,,0,1,0,1,4,1,4,1
laravel-upgrade,laravel-upgrade,,1,0,5,1,6,6,4,1
backport,backport,,2,1,0,3,4,3,0,1
google-maps-embed,google-maps-embed,,0,1,3,1,3,4,1,1
bigdl,bigdl,,1,3,0,4,4,4,2,200
rdfs+,rdfs+,,0,0,0,0,3,0,2,1
azure-rbac,azure-rbac,,8,8,8,16,14,24,8,1
webbroker,webbroker,,1,0,1,1,4,2,9,1
vlc-android,vlc-android,,3,1,7,4,10,11,13,1
sikuli-ide,sikuli-ide,,3,4,9,7,16,16,3,33.333333
nsscanner,nsscanner,,1,0,0,1,5,1,13,1
cpputest,cpputest,,5,3,4,8,3,12,9,1
projective-geometry,projective-geometry,,0,4,4,4,5,8,0,300
uxtheme,uxtheme,,1,0,1,1,2,2,9,1
ordered-set,ordered-set,,0,0,2,0,3,2,0,1
akka-remote-actor,akka-remote-actor,,0,1,4,1,13,5,2,1
createprocesswithlogonw,createprocesswithlogonw,,0,0,1,0,1,1,3,1
android-open-accessory,android-open-accessory,,0,1,1,1,2,2,3,1
flannbasedmatcher,flannbasedmatcher,,2,1,2,3,3,5,0,1
xamarin-android-player,xamarin-android-player,,0,1,3,1,4,4,3,1
reporting-services-2016,reporting-services-2016,,3,6,1,9,9,10,4,100
ibatis.net,ibatis.net,,0,0,1,0,2,1,8,1
bankid,bankid,,4,0,0,4,1,4,6,1
viewwilldisappear,viewwilldisappear,,0,2,1,2,6,3,13,100
komodo,komodo,,0,0,8,0,7,8,0,1
jgitver,jgitver,,0,1,1,1,3,2,6,1
hwndsource,hwndsource,,0,0,1,0,1,1,8,1
joincolumn,joincolumn,,2,2,5,4,7,9,3,1
finite-state-automaton,finite-state-automaton,,5,1,2,6,2,8,0,1
app-service-environment,app-service-environment,,2,1,3,3,5,6,8,1
magento-1.5,magento-1.5,,1,0,1,1,1,2,4,1
directfb,directfb,,1,0,2,1,1,3,9,1
jasmine-matchers,jasmine-matchers,,0,0,2,0,5,2,1,1
iri,iri,,2,1,3,3,4,6,2,1
pushy,pushy,,0,3,5,3,5,8,13,200
simple.odata.client,simple.odata.client,,4,2,3,6,5,9,8,1
python-2.2,python-2.2,,1,0,0,1,2,1,0,1
image-literals,image-literals,,0,0,2,0,4,2,13,1
java-ee-5,java-ee-5,,0,0,6,0,3,6,3,1
ruby-jmeter,ruby-jmeter,,0,0,2,0,3,2,3,1
jing,jing,,0,0,0,0,1,0,9,1
aws-elasticsearch,aws-elasticsearch,,26,36,49,62,52,111,6,38.461538
quadratic-curve,quadratic-curve,,1,1,2,2,3,4,0,1
android-sinch-api,android-sinch-api,,2,1,5,3,8,8,13,1
adodb-php,adodb-php,,0,1,1,1,3,2,4,1
deeplearn.js,deeplearn.js,,0,0,0,0,7,0,1,1
gridlength,gridlength,,0,0,1,0,1,1,8,1
htmldecode,htmldecode,,1,2,2,3,5,5,8,100
static-order-fiasco,static-order-fiasco,,0,0,2,0,4,2,9,1
redirecttoaction,redirecttoaction,,1,4,2,5,6,7,8,300
uitextborderstyle,uitextborderstyle,,0,0,1,0,1,1,13,1
flwor,flwor,,2,3,4,5,7,9,3,50
extended-precision,extended-precision,,2,1,3,3,3,6,9,1
procdump,procdump,,1,4,4,5,6,9,9,300
uifocusguide,uifocusguide,,0,0,2,0,2,2,13,1
android-resolution,android-resolution,,1,1,0,2,3,2,3,1
attrs.xml,attrs.xml,,1,0,4,1,1,5,3,1
nofollow,nofollow,,3,0,8,3,12,11,4,1
gcmlistenerservice,gcmlistenerservice,,0,0,1,0,5,1,3,1
google-diff-match-patch,google-diff-match-patch,,2,2,7,4,5,11,1,1
text-mask,text-mask,,1,0,4,1,5,5,1,1
mumps,mumps,,0,0,2,0,6,2,4,1
lita,lita,,0,0,1,0,1,1,6,1
xmlgregoriancalendar,xmlgregoriancalendar,,3,5,6,8,17,14,3,66.666667
aspchart,aspchart,,0,0,0,0,2,0,8,1
rxjs-lettable-operators,rxjs-lettable-operators,,0,0,3,0,18,3,1,1
version-numbering,version-numbering,,3,3,5,6,3,11,8,1
anonymous-objects,anonymous-objects,,1,0,3,1,5,4,9,1
ziggeo-sdk,ziggeo-sdk,,2,1,0,3,1,3,1,1
brace-expansion,brace-expansion,,3,6,7,9,11,16,9,100
gen-tcp,gen-tcp,,1,1,4,2,4,6,2,1
saiku,saiku,,6,2,6,8,10,14,4,1
interpreted-language,interpreted-language,,3,2,2,5,3,7,9,1
datastax-python-driver,datastax-python-driver,,0,3,2,3,5,5,2,200
atg-dynamo,atg-dynamo,,2,1,7,3,5,10,3,1
spack,spack,,1,1,2,2,1,4,13,1
ms-publisher,ms-publisher,,2,0,2,2,4,4,5,1
boost-spirit-lex,boost-spirit-lex,,0,0,0,0,5,0,9,1
dynamic-queries,dynamic-queries,,2,1,6,3,11,9,4,1
generic-variance,generic-variance,,2,0,7,2,2,9,8,1
bellman-ford,bellman-ford,,5,5,13,10,23,23,0,1
802.11p,802.11p,,0,1,1,1,6,2,9,1
updatepanel-progressbar,updatepanel-progressbar,,0,0,0,0,2,0,8,1
parsley,parsley,,2,3,11,5,11,16,1,50
isalpha,isalpha,,2,3,1,5,9,6,0,50
assemble,assemble,,0,1,7,1,5,8,1,1
fromcharcode,fromcharcode,,1,2,4,3,3,7,1,100
nuclide-editor,nuclide-editor,,1,0,3,1,17,4,0,1
jupyter-scala,jupyter-scala,,1,0,1,1,2,2,2,1
custom-operator,custom-operator,,2,1,2,3,3,5,0,1
sketchup,sketchup,,3,4,13,7,12,20,12,33.333333
tradeoff,tradeoff,,1,0,1,1,2,2,0,1
quickfixj,quickfixj,,7,9,5,16,27,21,14,28.571429
andengine,andengine,,2,3,2,5,7,7,3,50
angular-chosen,angular-chosen,,1,1,1,2,8,3,1,1
redux-immutable,redux-immutable,,1,1,3,2,7,5,1,1
jolokia,jolokia,,7,9,7,16,12,23,3,28.571429
bluetooth-socket,bluetooth-socket,,3,2,6,5,6,11,3,1
zentyal,zentyal,,1,0,0,1,1,1,9,1
whiteboard,whiteboard,,1,1,1,2,6,3,3,1
sdcalertview,sdcalertview,,0,0,0,0,1,0,13,1
bytesio,bytesio,,10,4,25,14,17,39,0,1
static-import,static-import,,0,0,1,0,7,1,3,1
resharper-9.0,resharper-9.0,,0,0,0,0,2,0,8,1
kmip,kmip,,0,0,2,0,3,2,6,1
nobackend,nobackend,,0,0,0,0,1,0,1,1
marker-interfaces,marker-interfaces,,0,2,2,2,4,4,3,100
orchardcms-1.6,orchardcms-1.6,,0,0,0,0,3,0,8,1
grxml,grxml,,0,2,0,2,2,2,6,100
terminal-services,terminal-services,,5,1,9,6,11,15,8,1
wxhaskell,wxhaskell,,0,0,0,0,3,0,2,1
inline-variable,inline-variable,,0,2,0,2,8,2,9,100
invitation,invitation,,2,1,2,3,7,5,13,1
read-uncommitted,read-uncommitted,,1,1,3,2,3,5,4,1
word-2016,word-2016,,2,0,7,2,17,9,5,1
microsoft-ink,microsoft-ink,,0,0,0,0,1,0,5,1
labwindows,labwindows,,0,2,2,2,1,4,9,100
heroku-pipelines,heroku-pipelines,,1,2,6,3,7,9,1,100
utm-tracking,utm-tracking,,4,1,0,5,7,5,5,1
itemssource,itemssource,,9,3,6,12,8,18,8,1
maven-jarsigner-plugin,maven-jarsigner-plugin,,0,0,1,0,5,1,3,1
hortonworks-sam,hortonworks-sam,,0,1,1,1,2,2,2,1
git-gui,git-gui,,1,2,4,3,8,7,6,100
error-suppression,error-suppression,,1,0,3,1,7,4,4,1
sutime,sutime,,1,1,5,2,6,7,0,1
extract-method,extract-method,,0,0,0,0,1,0,3,1
kite,kite,,0,1,1,1,2,2,4,1
avsc,avsc,,0,2,1,2,4,3,2,100
bindvalue,bindvalue,,0,1,3,1,2,4,4,1
bizspark,bizspark,,0,0,0,0,2,0,8,1
mixture,mixture,,1,1,1,2,14,3,0,1
stack-unwinding,stack-unwinding,,5,2,4,7,12,11,9,1
structured-exception,structured-exception,,0,0,1,0,3,1,9,1
shake-build-system,shake-build-system,,1,0,5,1,5,6,2,1
systemcolors,systemcolors,,0,2,0,2,2,2,8,100
bootstrap-file-upload,bootstrap-file-upload,,0,0,2,0,5,2,4,1
visual-styles,visual-styles,,4,1,2,5,2,7,8,1
itemspresenter,itemspresenter,,0,1,2,1,2,3,8,1
ruby-1.8.7,ruby-1.8.7,,0,1,3,1,9,4,12,1
in-memory-tables,in-memory-tables,,3,1,2,4,6,6,4,1
in-memory-oltp,in-memory-oltp,,1,0,4,1,3,5,4,1
solr-schema,solr-schema,,1,2,0,3,10,3,2,100
compiled,compiled,,4,2,3,6,9,9,8,1
facebook-permissions,facebook-permissions,,2,1,5,3,17,8,13,1
sitecore-commerce-server,sitecore-commerce-server,,0,0,2,0,4,2,8,1
sitecore-ecommerce,sitecore-ecommerce,,0,0,0,0,1,0,8,1
prado,prado,,0,1,0,1,2,1,4,1
displayfield,displayfield,,0,0,0,0,1,0,1,1
rack-rewrite,rack-rewrite,,0,0,0,0,1,0,12,1
fyber,fyber,,0,2,0,2,1,2,3,100
object-persistence,object-persistence,,0,0,1,0,3,1,3,1
polykinds,polykinds,,0,0,3,0,1,3,2,1
xquery-update,xquery-update,,0,1,0,1,2,1,4,1
react-native-tab-view,react-native-tab-view,,7,4,7,11,13,18,1,1
gpu-shared-memory,gpu-shared-memory,,1,1,3,2,4,5,0,1
gtksourceview,gtksourceview,,3,3,2,6,4,8,9,1
ibm-case-manager,ibm-case-manager,,0,2,4,2,4,6,15,100
japplet,japplet,,6,4,8,10,15,18,3,1
propertypath,propertypath,,2,1,1,3,2,4,2,1
jenkins-job-builder,jenkins-job-builder,,1,4,6,5,18,11,6,300
functools,functools,,5,13,23,18,24,41,0,160
commandbinding,commandbinding,,1,1,4,2,5,6,8,1
mfmailcomposer,mfmailcomposer,,1,1,2,2,9,4,13,1
smidge,smidge,,0,0,0,0,3,0,8,1
ntlmv2,ntlmv2,,0,1,2,1,5,3,8,1
featuretoggle,featuretoggle,,1,1,5,2,7,7,3,1
kubernetes-cronjob,kubernetes-cronjob,,11,10,14,21,9,35,6,1
tui,tui,,3,2,8,5,9,13,9,1
web.api,web.api,,2,1,10,3,9,13,8,1
pgdb,pgdb,,1,2,0,3,3,3,4,100
iterparse,iterparse,,2,1,4,3,4,7,0,1
suppression,suppression,,1,0,1,1,4,2,8,1
nelmio-alice,nelmio-alice,,1,1,3,2,10,5,4,1
clr-hosting,clr-hosting,,0,0,0,0,1,0,8,1
google-ios-vision,google-ios-vision,,0,0,1,0,7,1,13,1
multistore,multistore,,5,2,5,7,8,12,4,1
http-auth,http-auth,,0,0,4,0,2,4,1,1
group-summaries,group-summaries,,0,3,4,3,5,7,0,200
load-time,load-time,,1,0,3,1,10,4,3,1
mathtype,mathtype,,0,0,1,0,5,1,0,1
kotlin-lateinit,kotlin-lateinit,,3,2,2,5,14,7,3,1
specialized-annotation,specialized-annotation,,0,0,0,0,1,0,2,1
eager,eager,,6,4,10,10,19,20,0,1
dllplugin,dllplugin,,0,0,3,0,9,3,1,1
glcm,glcm,,7,2,5,9,14,14,0,1
xsql,xsql,,0,0,0,0,1,0,3,1
launch-agent,launch-agent,,2,4,2,6,6,8,13,100
react-redux-firebase,react-redux-firebase,,24,14,29,38,19,67,1,1
melt-framework,melt-framework,,0,1,2,1,4,3,13,1
packages.json,packages.json,,1,1,2,2,2,4,1,1
version-editor,version-editor,,0,0,0,0,1,0,6,1
aria-live,aria-live,,1,4,1,5,3,6,13,300
naudio-framework,naudio-framework,,2,1,8,3,1,11,8,1
multibyte-functions,multibyte-functions,,0,0,0,0,4,0,0,1
turbo-pascal,turbo-pascal,,3,1,5,4,5,9,9,1
nrql,nrql,,1,3,0,4,1,4,6,200
circleci-2.0,circleci-2.0,,22,21,49,43,92,92,6,1
picocontainer,picocontainer,,3,3,8,6,7,14,3,1
eclipse-photon,eclipse-photon,,1,1,33,2,34,35,3,1
wowslider,wowslider,,0,0,1,0,3,1,1,1
websauna,websauna,,0,0,0,0,1,0,0,1
new-item,new-item,,0,0,4,0,7,4,8,1
mobilefirst-appcenter,mobilefirst-appcenter,,1,2,1,3,3,4,13,100
predicatebuilder,predicatebuilder,,2,6,5,8,11,13,8,200
centos6.8,centos6.8,,0,3,0,3,3,3,9,200
placeholder-control,placeholder-control,,0,0,0,0,2,0,8,1
asp.net-core-2.1,asp.net-core-2.1,,171,139,833,310,343,1143,8,1
date-of-birth,date-of-birth,,1,1,3,2,7,5,4,1
hessian-matrix,hessian-matrix,,5,2,7,7,14,14,0,1
sector,sector,,0,0,3,0,4,3,9,1
google-cloud-repository,google-cloud-repository,,3,3,7,6,5,13,6,1
revoscaler,revoscaler,,2,1,11,3,9,14,0,1
rxkmeans,rxkmeans,,0,0,1,0,1,1,0,1
perl-hash,perl-hash,,2,0,1,2,8,3,9,1
cache2k,cache2k,,0,2,6,2,2,8,3,100
mailaddress,mailaddress,,0,1,2,1,2,3,8,1
verot-upload-class,verot-upload-class,,0,0,0,0,3,0,4,1
anti-join,anti-join,,2,4,2,6,9,8,0,100
streamparse,streamparse,,0,1,1,1,2,2,2,1
jhtmlarea,jhtmlarea,,0,0,0,0,2,0,1,1
bulk-rename-utility,bulk-rename-utility,,0,0,0,0,1,0,8,1
twitter-follow,twitter-follow,,0,1,2,1,5,3,0,1
klarna,klarna,,7,3,4,10,3,14,4,1
nrf52,nrf52,,8,8,17,16,23,33,9,1
spring-mvc-initbinders,spring-mvc-initbinders,,1,2,3,3,5,6,3,100
rcw,rcw,,2,0,0,2,3,2,8,1
popularity,popularity,,1,2,0,3,2,3,0,100
font-smoothing,font-smoothing,,0,0,1,0,2,1,1,1
routelink,routelink,,0,2,0,2,3,2,1,100
getopt-long,getopt-long,,2,0,3,2,8,5,9,1
pysdl2,pysdl2,,5,0,1,5,4,6,0,1
openrdf,openrdf,,0,0,1,0,2,1,2,1
asqueryable,asqueryable,,1,0,1,1,6,2,8,1
polymorphic-variants,polymorphic-variants,,0,0,5,0,3,5,9,1
nstimezone,nstimezone,,2,2,1,4,8,5,13,1
php-parser,php-parser,,1,2,1,3,2,4,4,100
www-authenticate,www-authenticate,,0,1,4,1,7,5,4,1
phpstorm-2016.1,phpstorm-2016.1,,0,0,0,0,1,0,1,1
app-transfer,app-transfer,,1,1,2,2,7,4,13,1
system-identification,system-identification,,2,1,0,3,5,3,0,1
fuzzy-c-means,fuzzy-c-means,,1,1,1,2,3,3,0,1
equalsverifier,equalsverifier,,0,0,0,0,1,0,3,1
chord,chord,,1,3,4,4,10,8,0,200
chord-diagram,chord-diagram,,5,3,12,8,9,20,0,1
jscrollbar,jscrollbar,,1,5,6,6,8,12,3,400
google-notebook,google-notebook,,0,1,1,1,2,2,0,1
totp,totp,,7,6,11,13,13,24,3,1
packet-loss,packet-loss,,1,5,9,6,14,15,9,400
patternfly,patternfly,,1,1,2,2,2,4,1,1
publickeytoken,publickeytoken,,0,2,1,2,2,3,8,100
parse-url,parse-url,,3,3,2,6,4,8,4,1
teamcity-9.1,teamcity-9.1,,2,2,0,4,5,4,8,1
teamcity-rest-api,teamcity-rest-api,,0,2,0,2,1,2,8,100
wasabi,wasabi,,0,0,1,0,2,1,6,1
pushdown-automaton,pushdown-automaton,,5,4,7,9,9,16,0,1
durandal-2.0,durandal-2.0,,0,1,0,1,7,1,1,1
slurp,slurp,,1,1,1,2,4,3,6,1
data-masking,data-masking,,3,4,11,7,17,18,4,33.333333
switchers,switchers,,0,1,0,1,2,1,0,1
winnovative,winnovative,,0,0,1,0,3,1,8,1
shrinkwrap,shrinkwrap,,2,2,3,4,7,7,3,1
web-application-firewall,web-application-firewall,,11,13,25,24,20,49,6,18.181818
safety-critical,safety-critical,,3,1,4,4,6,8,9,1
xamdatagrid,xamdatagrid,,3,1,6,4,10,10,8,1
parameterized-tests,parameterized-tests,,2,1,7,3,7,10,3,1
1wire,1wire,,0,1,2,1,2,3,0,1
birt-emitter,birt-emitter,,0,0,1,0,5,1,3,1
birt-deapi,birt-deapi,,0,0,1,0,4,1,3,1
ghost-inspector,ghost-inspector,,1,0,0,1,2,1,3,1
giphy-api,giphy-api,,5,5,4,10,12,14,1,1
icap,icap,,1,1,4,2,1,6,6,1
kotlin-delegate,kotlin-delegate,,2,0,1,2,5,3,3,1
powermanager,powermanager,,2,4,4,6,7,10,3,100
cookie-matching,cookie-matching,,0,0,0,0,1,0,4,1
creation-pattern,creation-pattern,,0,0,2,0,1,2,3,1
sprof,sprof,,0,0,0,0,1,0,9,1
apache-camel-cdi,apache-camel-cdi,,2,2,1,4,4,5,3,1
neo4j-ogm-bolt-driver,neo4j-ogm-bolt-driver,,0,0,2,0,2,2,2,1
rebar,rebar,,1,2,5,3,3,8,2,100
relx,relx,,0,0,0,0,2,0,2,1
snowflake,snowflake,,46,45,63,91,31,154,4,1
dx-data-grid,dx-data-grid,,2,4,9,6,12,15,1,100
vinyl-ftp,vinyl-ftp,,0,0,6,0,6,6,1,1
jcanvascript,jcanvascript,,0,0,0,0,1,0,1,1
cacheprofile,cacheprofile,,0,0,1,0,1,1,8,1
crossbar,crossbar,,4,4,5,8,13,13,0,1
opencv-ml,opencv-ml,,0,0,1,0,1,1,0,1
angular-ui-sortable,angular-ui-sortable,,1,0,2,1,5,3,1,1
terminal-server,terminal-server,,1,2,3,3,5,6,8,100
event-dispatch-thread,event-dispatch-thread,,2,6,22,8,19,30,3,200
gridview-sorting,gridview-sorting,,0,0,2,0,5,2,8,1
imenu,imenu,,0,1,0,1,1,1,9,1
otroslogviewer,otroslogviewer,,0,1,0,1,1,1,3,1
metalc,metalc,,0,0,0,0,1,0,9,1
biztalk-bam,biztalk-bam,,0,0,0,0,2,0,8,1
google-sheets-importxml,google-sheets-importxml,,41,35,17,76,5,93,5,1
localytics,localytics,,0,0,3,0,2,3,3,1
gerrithub.io,gerrithub.io,,0,0,0,0,3,0,6,1
fontastic,fontastic,,0,1,1,1,2,2,1,1
gamesparks,gamesparks,,3,3,10,6,9,16,8,1
achievements,achievements,,0,1,3,1,7,4,3,1
abbyy,abbyy,,5,8,5,13,8,18,0,60
tire,tire,,0,0,0,0,4,0,12,1
activecampaign,activecampaign,,3,2,2,5,1,7,4,1
ptpd,ptpd,,0,1,1,1,1,2,9,1
symfony-1.2,symfony-1.2,,0,1,3,1,11,4,4,1
symbol-not-found,symbol-not-found,,1,0,1,1,2,2,3,1
crystal-reports-2011,crystal-reports-2011,,0,0,1,0,3,1,8,1
mongorito,mongorito,,1,0,0,1,1,1,1,1
java-10,java-10,,12,12,102,24,263,126,3,1
expires-header,expires-header,,1,0,8,1,6,9,4,1
iso-prolog,iso-prolog,,2,2,4,4,4,8,0,1
advanced-search,advanced-search,,1,4,9,5,10,14,4,300
http-protocols,http-protocols,,3,2,2,5,2,7,4,1
setrlimit,setrlimit,,0,0,1,0,4,1,9,1
bit-packing,bit-packing,,3,2,1,5,2,6,9,1
netflix-archaius,netflix-archaius,,2,0,0,2,6,2,3,1
eclipse-wtp,eclipse-wtp,,2,0,7,2,5,9,3,1
d3.geo,d3.geo,,1,3,3,4,4,7,1,200
restxq,restxq,,0,0,0,0,3,0,3,1
adoconnection,adoconnection,,1,0,0,1,4,1,9,1
axi4-stream,axi4-stream,,0,0,0,0,1,0,9,1
material-components-ios,material-components-ios,,4,6,14,10,17,24,13,50
installscript-msi,installscript-msi,,5,1,3,6,12,9,8,1
drawnow,drawnow,,1,2,2,3,2,5,0,100
interception,interception,,2,0,4,2,10,6,3,1
inappsettingskit,inappsettingskit,,0,0,1,0,5,1,13,1
unbuffered-queries,unbuffered-queries,,0,1,0,1,1,1,4,1
showcaseview,showcaseview,,1,1,1,2,9,3,3,1
inputsimulator,inputsimulator,,1,1,2,2,4,4,8,1
azure-caching,azure-caching,,2,2,1,4,6,5,8,1
scrollmonitorjs,scrollmonitorjs,,0,0,0,0,1,0,1,1
numerical-recipes,numerical-recipes,,0,0,1,0,1,1,9,1
conversation-scope,conversation-scope,,0,1,1,1,4,2,3,1
javapos,javapos,,0,0,4,0,16,4,3,1
fields-for,fields-for,,0,1,9,1,6,10,12,1
ftp4j,ftp4j,,0,1,1,1,2,2,4,1
smooth-streaming,smooth-streaming,,0,0,3,0,2,3,13,1
android-authenticator,android-authenticator,,3,8,8,11,4,19,3,166.666667
psgi,psgi,,0,0,0,0,6,0,9,1
angularjs-google-maps,angularjs-google-maps,,0,0,1,0,1,1,1,1
laravel-session,laravel-session,,8,3,14,11,13,25,4,1
nelmiocorsbundle,nelmiocorsbundle,,1,2,2,3,6,5,4,100
attask,attask,,0,0,6,0,7,6,4,1
workfront-api,workfront-api,,0,5,8,5,12,13,4,400
popt,popt,,0,0,0,0,1,0,4,1
optimus,optimus,,0,0,2,0,3,2,8,1
pbm,pbm,,1,0,1,1,2,2,0,1
otter-script,otter-script,,0,0,0,0,1,0,8,1
dbdatareader,dbdatareader,,1,1,0,2,7,2,8,1
sharpsvn,sharpsvn,,3,1,5,4,10,9,6,1
jceks,jceks,,2,3,2,5,4,7,6,50
excel-online,excel-online,,2,5,5,7,7,12,5,150
tvar,tvar,,0,0,1,0,2,1,0,1
nsepy,nsepy,,0,2,7,2,6,9,0,100
port80,port80,,3,5,6,8,10,14,4,66.666667
tfs2010,tfs2010,,2,6,11,8,26,19,8,200
xtk,xtk,,0,1,1,1,8,2,1,1
ami.js,ami.js,,3,1,1,4,5,5,1,1
jedit,jedit,,1,1,4,2,2,6,2,1
audio-fingerprinting,audio-fingerprinting,,2,3,1,5,9,6,13,50
dmesg,dmesg,,1,2,4,3,5,7,9,100
qcad,qcad,,0,0,0,0,1,0,9,1
uvloop,uvloop,,1,2,2,3,3,5,0,100
lambda-prolog,lambda-prolog,,0,0,0,0,1,0,0,1
run-configuration,run-configuration,,2,2,5,4,12,9,3,1
pyml,pyml,,0,1,0,1,1,1,0,1
stack-size,stack-size,,3,5,2,8,7,10,9,66.666667
build-pipeline,build-pipeline,,12,11,22,23,15,45,8,1
streamingmarkupbuilder,streamingmarkupbuilder,,0,0,0,0,1,0,3,1
base-address,base-address,,0,2,2,2,3,4,9,100
jquery-collision,jquery-collision,,0,0,0,0,2,0,1,1
updatebatchsize,updatebatchsize,,0,0,2,0,6,2,0,1
ion-select,ion-select,,5,1,12,6,17,18,1,1
iceweasel,iceweasel,,0,0,1,0,2,1,3,1
non-repetitive,non-repetitive,,1,1,3,2,4,5,0,1
convex-polygon,convex-polygon,,0,3,5,3,6,8,0,200
play-authenticate,play-authenticate,,0,0,1,0,1,1,2,1
proxyquire,proxyquire,,4,2,14,6,13,20,1,1
oracle-cloud-infrastructure-classic,oracle-cloud-infrastructure-classic,,4,2,5,6,6,11,4,1
actionsheetpicker,actionsheetpicker,,0,1,0,1,1,1,8,1
dat.gui,dat.gui,,2,5,6,7,13,13,1,150
typeform,typeform,,9,8,12,17,15,29,1,1
selectedindex,selectedindex,,5,4,6,9,19,15,8,1
resource-file,resource-file,,0,0,0,0,2,0,8,1
gwt-platform,gwt-platform,,1,0,0,1,2,1,3,1
mail-form,mail-form,,0,0,2,0,8,2,4,1
minimum-spanning-forest,minimum-spanning-forest,,0,0,0,0,1,0,0,1
flowdock,flowdock,,0,0,1,0,1,1,1,1
threadstatic,threadstatic,,1,2,1,3,2,4,8,100
platform-server,platform-server,,0,0,0,0,1,0,1,1
vespa,vespa,,1,2,13,3,7,16,2,100
slapper.automapper,slapper.automapper,,1,0,2,1,2,3,8,1
multi-model-database,multi-model-database,,1,0,4,1,3,5,4,1
2d-3d-conversion,2d-3d-conversion,,0,1,0,1,1,1,0,1
moqui,moqui,,4,3,2,7,6,9,3,1
hivemind,hivemind,,0,1,0,1,1,1,12,1
phpws,phpws,,0,0,0,0,2,0,6,1
ssms-addin,ssms-addin,,1,1,1,2,5,3,4,1
xtensor,xtensor,,3,6,3,9,11,12,9,100
clientside-caching,clientside-caching,,0,1,0,1,1,1,4,1
google-code-prettify,google-code-prettify,,3,0,5,3,5,8,1,1
passwd,passwd,,4,1,5,5,10,10,9,1
javafx-css,javafx-css,,4,1,13,5,18,18,3,1
parallax.js,parallax.js,,6,3,5,9,7,14,1,1
builtwith,builtwith,,0,0,1,0,2,1,0,1
borland-c,borland-c,,2,0,0,2,1,2,9,1
avgrund,avgrund,,0,0,0,0,1,0,1,1
display-templates,display-templates,,4,2,1,6,6,7,8,1
validating-event,validating-event,,0,0,0,0,4,0,8,1
jmenuitem,jmenuitem,,4,3,5,7,12,12,3,1
boost-serialization,boost-serialization,,4,8,6,12,17,18,9,100
opendir,opendir,,3,3,5,6,10,11,4,1
gradle.properties,gradle.properties,,2,0,2,2,4,4,3,1
facebook-graph-api-v2.0,facebook-graph-api-v2.0,,1,2,5,3,13,8,13,100
z80,z80,,6,3,7,9,9,16,9,1
uivideoeditorcontroller,uivideoeditorcontroller,,0,0,1,0,3,1,13,1
rocket-u2,rocket-u2,,0,0,1,0,2,1,9,1
continued-fractions,continued-fractions,,0,1,2,1,6,3,0,1
canonical-form,canonical-form,,1,0,1,1,4,2,9,1
traffic-simulation,traffic-simulation,,5,8,5,13,8,18,0,60
click-tracking,click-tracking,,0,1,2,1,3,3,1,1
ibm-cloud-plugin,ibm-cloud-plugin,,1,0,5,1,5,6,6,1
crosstool-ng,crosstool-ng,,2,4,3,6,10,9,9,100
ipxe,ipxe,,1,3,4,4,6,8,9,200
czml,czml,,0,1,2,1,5,3,1,1
jfugue,jfugue,,2,1,5,3,2,8,3,1
imageswitcher,imageswitcher,,1,0,2,1,7,3,3,1
database-cleaner,database-cleaner,,0,2,6,2,11,8,12,100
financialinstrument,financialinstrument,,0,0,0,0,3,0,0,1
django-wiki,django-wiki,,0,0,1,0,3,1,0,1
turbo-c,turbo-c,,6,1,8,7,18,15,9,1
hive-metastore,hive-metastore,,12,14,24,26,39,50,2,16.666667
nspanel,nspanel,,2,0,1,2,3,3,13,1
catransaction,catransaction,,1,3,3,4,6,7,13,200
python-mode,python-mode,,0,0,2,0,11,2,9,1
javascript-1.7,javascript-1.7,,0,0,0,0,1,0,1,1
travis-ci-cli,travis-ci-cli,,3,0,8,3,16,11,6,1
djgpp,djgpp,,0,0,0,0,1,0,9,1
bluehost,bluehost,,6,8,12,14,23,26,4,33.333333
system.io.directory,system.io.directory,,3,0,3,3,8,6,8,1
android-studio-3.3,android-studio-3.3,,25,3,61,28,2,89,3,1
scikit-multilearn,scikit-multilearn,,3,3,6,6,4,12,0,1
window-decoration,window-decoration,,0,0,1,0,2,1,0,1
qtgui,qtgui,,1,7,8,8,14,16,0,600
build-time,build-time,,2,2,2,4,6,6,3,1
primefaces-dialog-framework,primefaces-dialog-framework,,1,0,1,1,3,2,3,1
fdroid,fdroid,,0,1,1,1,3,2,3,1
qubes-os,qubes-os,,0,2,2,2,2,4,9,100
scrollwheel,scrollwheel,,0,0,0,0,2,0,1,1
slsvcutil,slsvcutil,,0,0,0,0,1,0,8,1
react-masonry,react-masonry,,0,1,1,1,1,2,1,1
http-status-code-409,http-status-code-409,,1,1,2,2,4,4,4,1
xlm,xlm,,0,4,0,4,2,4,3,300
api-hook,api-hook,,0,1,8,1,2,9,9,1
view-scope,view-scope,,2,0,5,2,8,7,3,1
modelvisual3d,modelvisual3d,,0,0,1,0,1,1,8,1
qtwebchannel,qtwebchannel,,0,1,5,1,8,6,0,1
accessible,accessible,,4,1,3,5,6,8,1,1
jwebbrowser,jwebbrowser,,0,0,1,0,1,1,3,1
mouse-position,mouse-position,,3,7,2,10,14,12,8,133.333333
g729,g729,,0,1,0,1,5,1,13,1
completion-block,completion-block,,0,1,1,1,6,2,13,1
contextual-action-bar,contextual-action-bar,,2,0,1,2,6,3,3,1
strtr,strtr,,0,0,0,0,3,0,4,1
stringtemplate-4,stringtemplate-4,,0,0,2,0,4,2,3,1
raiseerror,raiseerror,,0,0,6,0,1,6,4,1
meta-method,meta-method,,1,1,0,2,3,2,9,1
lua-5.3,lua-5.3,,2,3,1,5,6,6,9,50
listview-filter,listview-filter,,0,0,0,0,3,0,3,1
nsbasic,nsbasic,,0,0,0,0,1,0,1,1
flask-peewee,flask-peewee,,3,5,4,8,11,12,0,66.666667
webviewchromium,webviewchromium,,2,0,4,2,6,6,3,1
geotrellis,geotrellis,,5,2,3,7,5,10,2,1
breezingforms,breezingforms,,1,0,2,1,3,3,4,1
mass-assignment,mass-assignment,,3,1,3,4,9,7,4,1
upvalue,upvalue,,0,0,1,0,1,1,9,1
jets3t,jets3t,,0,0,0,0,2,0,6,1
winbgi,winbgi,,0,4,2,4,1,6,9,300
guided-access,guided-access,,2,0,4,2,7,6,13,1
aspects,aspects,,0,0,0,0,6,0,3,1
intellitrace,intellitrace,,0,1,4,1,5,5,8,1
jbehave-plugin,jbehave-plugin,,0,0,0,0,3,0,3,1
systemml,systemml,,0,2,2,2,4,4,2,100
apache-pivot,apache-pivot,,0,0,0,0,2,0,3,1
session-store,session-store,,1,2,1,3,6,4,1,100
nsblockoperation,nsblockoperation,,1,1,1,2,3,3,13,1
impact-analysis,impact-analysis,,2,2,3,4,7,7,8,1
xrdp,xrdp,,3,1,8,4,10,12,9,1
shape-recognition,shape-recognition,,0,1,2,1,3,3,0,1
vm-implementation,vm-implementation,,1,1,1,2,6,3,9,1
ember-drag-sort,ember-drag-sort,,0,0,2,0,5,2,1,1
visual-programming,visual-programming,,0,0,2,0,2,2,8,1
plasma,plasma,,2,0,2,2,4,4,9,1
r7rs,r7rs,,1,0,1,1,4,2,0,1
chibi-scheme,chibi-scheme,,1,0,0,1,1,1,0,1
jtreetable,jtreetable,,1,0,1,1,2,2,3,1
removable-drive,removable-drive,,0,1,1,1,2,2,9,1
marc,marc,,2,1,2,3,4,5,3,1
ng2-datetime,ng2-datetime,,0,0,0,0,3,0,1,1
web-traffic,web-traffic,,3,3,10,6,12,16,5,1
dojox.charting,dojox.charting,,1,1,1,2,4,3,1,1
sles,sles,,3,6,8,9,24,17,9,100
popviewcontrolleranimated,popviewcontrolleranimated,,0,0,0,0,1,0,13,1
angularjs-events,angularjs-events,,2,0,1,2,2,3,1,1
ripemd,ripemd,,1,0,1,1,1,2,0,1
ajax-upload,ajax-upload,,1,1,0,2,6,2,4,1
enyo,enyo,,1,0,0,1,2,1,1,1
psake,psake,,0,0,1,0,2,1,6,1
visual-studio-2017-build-tools,visual-studio-2017-build-tools,,21,15,48,36,4,84,8,1
cvs2svn,cvs2svn,,0,1,0,1,1,1,6,1
elasticsearch-2.4,elasticsearch-2.4,,0,0,4,0,10,4,6,1
indieweb,indieweb,,0,0,0,0,1,0,8,1
skcropnode,skcropnode,,0,2,0,2,5,2,13,100
text-rotating,text-rotating,,0,0,2,0,2,2,1,1
sweethome3d,sweethome3d,,0,0,0,0,1,0,9,1
zipoutputstream,zipoutputstream,,9,8,7,17,8,24,3,1
angularjs-compile,angularjs-compile,,1,2,4,3,7,7,1,100
ssconvert,ssconvert,,2,1,1,3,4,4,5,1
alipay,alipay,,1,3,4,4,3,8,4,200
playframework-1.x,playframework-1.x,,3,1,4,4,12,8,3,1
mx-record,mx-record,,3,2,8,5,18,13,4,1
qtbluetooth,qtbluetooth,,1,1,6,2,4,8,9,1
syntax-checking,syntax-checking,,1,0,4,1,4,5,9,1
janino,janino,,2,1,5,3,5,8,3,1
rhino-security,rhino-security,,0,0,0,0,1,0,3,1
do-not-track,do-not-track,,0,0,1,0,3,1,1,1
soundcard,soundcard,,1,3,5,4,10,9,13,200
dub,dub,,0,0,2,0,4,2,9,1
bs-webapi,bs-webapi,,0,0,1,0,3,1,9,1
nsdatecomponentsformatter,nsdatecomponentsformatter,,1,1,2,2,5,4,13,1
facebook-app-requests,facebook-app-requests,,2,3,2,5,8,7,13,50
dotnetbar,dotnetbar,,1,0,4,1,4,5,8,1
c-cda,c-cda,,0,1,2,1,3,3,14,1
cvsimport,cvsimport,,0,2,0,2,1,2,6,100
double-checked-locking,double-checked-locking,,1,0,3,1,9,4,3,1
llvm-gcc,llvm-gcc,,1,1,1,2,11,3,9,1
k2-smartobjects,k2-smartobjects,,0,0,0,0,2,0,4,1
pg-query,pg-query,,1,1,3,2,6,5,4,1
quickreports,quickreports,,2,0,3,2,2,5,9,1
tquery,tquery,,0,0,0,0,2,0,9,1
data-formatters,data-formatters,,0,0,1,0,4,1,3,1
insert-select,insert-select,,4,1,8,5,8,13,4,1
watchify,watchify,,2,1,0,3,6,3,1,1
otl,otl,,0,1,1,1,2,2,9,1
fig,fig,,1,1,2,2,4,4,1,1
password-less,password-less,,1,6,4,7,6,11,9,500
wix3.5,wix3.5,,7,7,16,14,19,30,8,1
turn-by-turn,turn-by-turn,,0,0,1,0,4,1,13,1
ua-parser,ua-parser,,0,0,2,0,2,2,2,1
civicrm,civicrm,,1,3,10,4,7,14,4,200
incremental-search,incremental-search,,0,0,1,0,7,1,0,1
dumpsys,dumpsys,,4,1,6,5,4,11,3,1
simba,simba,,3,2,5,5,9,10,4,1
getsockopt,getsockopt,,3,0,1,3,1,4,9,1
canvas-lms,canvas-lms,,4,4,9,8,11,17,12,1
tizen-tv,tizen-tv,,0,0,2,0,4,2,13,1
composite-controls,composite-controls,,1,0,0,1,2,1,8,1
siteorigin,siteorigin,,1,2,3,3,6,6,4,100
scalatest-maven-plugin,scalatest-maven-plugin,,0,2,2,2,2,4,2,100
crystal-reports-7,crystal-reports-7,,0,0,2,0,1,2,8,1
window.crypto,window.crypto,,0,0,1,0,2,1,1,1
vfw,vfw,,1,0,1,1,3,2,13,1
chardev,chardev,,1,0,0,1,2,1,9,1
vogels,vogels,,0,0,2,0,1,2,1,1
camel-jms,camel-jms,,1,0,5,1,16,6,3,1
color-key,color-key,,4,0,2,4,3,6,13,1
css-contain,css-contain,,0,0,1,0,1,1,1,1
spring-filter,spring-filter,,4,5,7,9,12,16,3,25
safe-mode,safe-mode,,2,1,2,3,7,5,2,1
p4eclipse,p4eclipse,,0,0,1,0,2,1,3,1
passphrase,passphrase,,2,0,5,2,16,7,6,1
blockstack,blockstack,,2,2,1,4,1,5,1,1
tvos9.1,tvos9.1,,0,0,0,0,1,0,13,1
python-plyplus,python-plyplus,,0,0,0,0,1,0,0,1
installshield-2013,installshield-2013,,0,0,0,0,4,0,8,1
opaque-pointers,opaque-pointers,,5,3,5,8,3,13,9,1
before-filter,before-filter,,2,0,2,2,7,4,12,1
erasure-code,erasure-code,,1,1,5,2,6,7,2,1
agsxmpp,agsxmpp,,0,0,0,0,2,0,8,1
sharp.xmpp,sharp.xmpp,,0,0,0,0,3,0,8,1
actionlink,actionlink,,3,5,8,8,19,16,8,66.666667
microsoft-query,microsoft-query,,3,3,2,6,13,8,5,1
uc4,uc4,,0,0,0,0,1,0,9,1
has-scope,has-scope,,0,1,0,1,3,1,12,1
fsshttp,fsshttp,,0,0,0,0,2,0,8,1
imgkit,imgkit,,4,2,3,6,5,9,12,1
babel-plugin-transform-import,babel-plugin-transform-import,,0,0,0,0,1,0,1,1
undefined-function,undefined-function,,3,2,7,5,10,12,0,1
linq-to-nhibernate,linq-to-nhibernate,,2,2,2,4,6,6,8,1
keyboard-hook,keyboard-hook,,5,2,4,7,9,11,8,1
ezsql,ezsql,,0,2,1,2,2,3,4,100
festival,festival,,2,0,3,2,5,5,3,1
either,either,,6,13,22,19,26,41,2,116.666667
google-eclipse-plugin,google-eclipse-plugin,,0,0,0,0,7,0,6,1
com-interface,com-interface,,1,0,0,1,2,1,8,1
dictview,dictview,,1,2,1,3,1,4,0,100
redland,redland,,1,0,0,1,5,1,2,1
apache-ode,apache-ode,,0,0,0,0,5,0,3,1
copy-assignment,copy-assignment,,6,2,7,8,9,15,9,1
nfsclient,nfsclient,,4,1,10,5,3,15,9,1
magento-2.2.1,magento-2.2.1,,0,0,0,0,5,0,4,1
dweet.io,dweet.io,,0,0,1,0,2,1,1,1
scikit-survival,scikit-survival,,1,1,1,2,3,3,0,1
vocore,vocore,,0,0,0,0,1,0,9,1
dynamic-values,dynamic-values,,1,3,0,4,4,4,3,200
gettype,gettype,,1,3,5,4,8,9,8,200
dinamico,dinamico,,0,0,0,0,1,0,5,1
shoes-4,shoes-4,,0,0,1,0,3,1,12,1
google-chrome-webview,google-chrome-webview,,1,0,4,1,4,5,3,1
digital-analog-converter,digital-analog-converter,,0,2,2,2,4,4,13,100
n3,n3,,0,0,2,0,1,2,2,1
ekeventstore,ekeventstore,,0,2,9,2,9,11,13,100
jtopen,jtopen,,1,1,3,2,2,5,4,1
coursera-api,coursera-api,,2,3,5,5,3,10,0,50
icu4c,icu4c,,2,6,3,8,2,11,9,200
gamesalad,gamesalad,,0,0,0,0,1,0,3,1
non-volatile,non-volatile,,2,0,4,2,6,6,9,1
office-js-helpers,office-js-helpers,,10,10,28,20,15,48,5,1
lfe,lfe,,0,0,0,0,5,0,0,1
flexigrid,flexigrid,,0,1,0,1,1,1,4,1
gkturnbasedmatch,gkturnbasedmatch,,1,0,5,1,3,6,13,1
abstract-base-class,abstract-base-class,,2,3,5,5,9,10,9,50
ng-dropdown-multiselect,ng-dropdown-multiselect,,1,0,0,1,3,1,1,1
office-2013,office-2013,,2,2,2,4,7,6,5,1
entity-system,entity-system,,0,0,1,0,3,1,9,1
google-patent-search,google-patent-search,,0,0,9,0,1,9,4,1
bdc,bdc,,0,0,1,0,1,1,5,1
watson-personality-insights,watson-personality-insights,,1,1,2,2,4,4,6,1
facebook-invite-friends,facebook-invite-friends,,0,0,0,0,5,0,13,1
twaindotnet,twaindotnet,,1,2,2,3,3,5,8,100
spring-form,spring-form,,3,7,8,10,15,18,3,133.333333
kernlab,kernlab,,3,2,2,5,6,7,0,1
text-indent,text-indent,,3,3,3,6,8,9,1,1
wercker,wercker,,0,1,3,1,6,4,6,1
multi-table-inheritance,multi-table-inheritance,,1,1,1,2,4,3,0,1
r-lemon,r-lemon,,0,0,0,0,3,0,0,1
pisa,pisa,,0,0,2,0,2,2,0,1
ansible-awx,ansible-awx,,24,24,24,48,8,72,6,1
pagecontrol,pagecontrol,,2,3,2,5,8,7,13,50
websphere-commerce,websphere-commerce,,0,1,3,1,5,4,2,1
wcs,wcs,,7,2,5,9,6,14,2,1
libwcs,libwcs,,0,0,0,0,1,0,2,1
link-time-optimization,link-time-optimization,,1,2,0,3,10,3,9,100
bluetooth-lowenergy-4.2,bluetooth-lowenergy-4.2,,0,1,0,1,3,1,3,1
rebol2,rebol2,,0,1,0,1,4,1,0,1
aruba,aruba,,2,1,5,3,5,8,12,1
autotest,autotest,,1,1,5,2,6,7,3,1
jpeg-xr,jpeg-xr,,1,0,2,1,2,3,0,1
inspect-element,inspect-element,,3,2,9,5,10,14,1,1
rauth,rauth,,0,0,1,0,2,1,0,1
logical-tree,logical-tree,,0,1,1,1,1,2,8,1
virtualfilesystem,virtualfilesystem,,1,1,1,2,5,3,9,1
svnignore,svnignore,,0,1,0,1,5,1,6,1
false-sharing,false-sharing,,1,2,6,3,7,9,9,100
ihtmlstring,ihtmlstring,,0,0,0,0,2,0,8,1
pabx,pabx,,0,0,0,0,1,0,8,1
vuejs-datepicker,vuejs-datepicker,,3,0,4,3,4,7,1,1
zopfli,zopfli,,0,2,0,2,3,2,1,100
polymer-elements,polymer-elements,,0,0,2,0,9,2,1,1
sha-3,sha-3,,3,3,6,6,11,12,6,1
swing-highlighter,swing-highlighter,,0,0,0,0,1,0,3,1
jgitflow-maven-plugin,jgitflow-maven-plugin,,5,2,4,7,9,11,6,1
turnkeylinux.org,turnkeylinux.org,,1,0,0,1,2,1,6,1
django-extensions,django-extensions,,1,2,3,3,11,6,0,100
scriptdom,scriptdom,,0,1,2,1,1,3,4,1
python-applymap,python-applymap,,2,2,2,4,7,6,0,1
linaro,linaro,,4,1,3,5,8,8,9,1
multi-catch,multi-catch,,0,1,0,1,3,1,3,1
react-native-windows,react-native-windows,,3,1,4,4,6,8,1,1
lesscss-resources,lesscss-resources,,0,1,0,1,1,1,1,1
security-framework,security-framework,,3,3,1,6,3,7,13,1
hacker-news,hacker-news,,3,2,3,5,7,8,4,1
appengine-maven-plugin,appengine-maven-plugin,,2,1,1,3,1,4,6,1
itween,itween,,1,0,1,1,3,2,8,1
torcs,torcs,,0,1,1,1,1,2,9,1
pulse,pulse,,5,3,7,8,9,15,9,1
nsanimationcontext,nsanimationcontext,,0,0,1,0,3,1,13,1
trigger.io,trigger.io,,1,0,1,1,5,2,1,1
winhttprequest,winhttprequest,,4,6,7,10,17,17,5,50
boost.test,boost.test,,0,0,4,0,1,4,9,1
difference-lists,difference-lists,,0,1,4,1,3,5,0,1
burndowncharts,burndowncharts,,1,2,3,3,6,6,8,100
paredit,paredit,,0,0,3,0,2,3,9,1
ora-00904,ora-00904,,2,0,3,2,16,5,4,1
view-templates,view-templates,,0,0,1,0,2,1,1,1
exception-specification,exception-specification,,0,0,1,0,1,1,9,1
go-server,go-server,,0,1,2,1,1,3,6,1
x-robots-tag,x-robots-tag,,2,2,2,4,1,6,4,1
polymer-2.0,polymer-2.0,,3,1,5,4,13,9,1,1
config-files,config-files,,2,2,5,4,5,9,0,1
federated-storage-engine,federated-storage-engine,,0,3,0,3,5,3,4,200
lexical-closures,lexical-closures,,0,1,0,1,3,1,1,1
haskell-lucid,haskell-lucid,,2,1,1,3,1,4,2,1
global-object,global-object,,1,0,1,1,1,2,0,1
googlesigninaccount,googlesigninaccount,,6,6,9,12,10,21,3,1
symmetry,symmetry,,2,1,1,3,7,4,0,1
text-capture,text-capture,,0,1,0,1,1,1,13,1
content-tag,content-tag,,0,0,0,0,3,0,12,1
lyx,lyx,,3,3,4,6,6,10,0,1
help-files,help-files,,0,0,0,0,1,0,4,1
gnucash,gnucash,,0,0,0,0,2,0,9,1
solr5,solr5,,1,1,8,2,10,10,2,1
papi,papi,,2,3,7,5,7,12,9,50
contextclassloader,contextclassloader,,1,0,1,1,3,2,3,1
mutability,mutability,,11,8,17,19,31,36,9,1
readxml,readxml,,3,2,3,5,8,8,8,1
progressive-enhancement,progressive-enhancement,,0,1,2,1,6,3,1,1
jflap,jflap,,0,0,0,0,3,0,0,1
youtracksharp,youtracksharp,,0,1,0,1,1,1,6,1
global-filter,global-filter,,3,1,2,4,5,6,8,1
solus,solus,,2,2,5,4,3,9,9,1
ntl,ntl,,1,0,2,1,8,3,9,1
mathematical-lattices,mathematical-lattices,,3,1,2,4,6,6,0,1
proc-format,proc-format,,0,0,0,0,2,0,0,1
dojo.gridx,dojo.gridx,,3,0,7,3,5,10,1,1
npoco,npoco,,6,3,5,9,5,14,8,1
.net-1.1,.net-1.1,,1,0,0,1,10,1,8,1
typescript1.7,typescript1.7,,0,0,0,0,3,0,1,1
gui-editor,gui-editor,,0,0,0,0,1,0,5,1
error-console,error-console,,0,0,0,0,1,0,1,1
initrd,initrd,,0,1,4,1,5,5,9,1
writeonly,writeonly,,2,0,1,2,2,3,0,1
nsformatter,nsformatter,,1,0,2,1,3,3,13,1
teaspoon,teaspoon,,1,5,2,6,6,8,1,400
mason,mason,,0,1,2,1,6,3,9,1
node-supervisor,node-supervisor,,0,0,0,0,1,0,1,1
freedesktop.org,freedesktop.org,,0,1,4,1,1,5,9,1
akka-typed,akka-typed,,5,18,7,23,9,30,2,260
californium,californium,,0,1,2,1,1,3,9,1
microsoft.codeanalysis,microsoft.codeanalysis,,2,2,6,4,6,10,8,1
roslynpad,roslynpad,,0,1,0,1,4,1,8,1
primefaces-gmap,primefaces-gmap,,0,0,1,0,4,1,3,1
trellis,trellis,,1,3,5,4,6,9,0,200
ms-access-97,ms-access-97,,1,0,4,1,3,5,5,1
codio,codio,,3,0,7,3,5,10,0,1
rx-javafx,rx-javafx,,1,0,5,1,5,6,3,1
splistitem,splistitem,,1,1,2,2,7,4,8,1
ios11.1.1,ios11.1.1,,0,0,0,0,6,0,13,1
pyro4,pyro4,,5,2,8,7,4,15,0,1
zenbot,zenbot,,0,0,0,0,6,0,1,1
enaml,enaml,,0,0,2,0,5,2,0,1
perlmagick,perlmagick,,0,3,0,3,1,3,12,200
intellij-17,intellij-17,,0,0,1,0,6,1,3,1
python-3.1,python-3.1,,0,0,0,0,3,0,0,1
firefox-quantum,firefox-quantum,,1,2,10,3,53,13,1,100
testem,testem,,0,1,1,1,5,2,1,1
npm-outdated,npm-outdated,,0,0,1,0,1,1,1,1
sasl,sasl,,14,11,31,25,28,56,2,1
flutter-test,flutter-test,,51,50,54,101,44,155,13,1
mysqldbcompare,mysqldbcompare,,0,3,1,3,5,4,4,200
quill.io,quill.io,,1,5,5,6,12,11,2,400
greasemonkey-4,greasemonkey-4,,4,8,17,12,31,29,1,100
firefox-57+,firefox-57+,,0,1,0,1,14,1,1,1
sitemap.xml,sitemap.xml,,0,1,2,1,4,3,4,1
procfs,procfs,,2,0,4,2,5,6,9,1
setbounds,setbounds,,1,0,0,1,2,1,3,1
grafana-api,grafana-api,,10,11,10,21,14,31,6,10
uuencode,uuencode,,0,3,4,3,4,7,9,200
windowlistener,windowlistener,,1,4,3,5,3,8,3,300
penn-treebank,penn-treebank,,0,1,1,1,2,2,0,1
stacked,stacked,,6,8,17,14,23,31,0,33.333333
match-phrase,match-phrase,,3,0,4,3,5,7,6,1
paypal-vault,paypal-vault,,0,1,0,1,3,1,4,1
wwwroot,wwwroot,,7,1,7,8,9,15,8,1
sass-brunch,sass-brunch,,0,1,1,1,1,2,1,1
pattern-synonyms,pattern-synonyms,,0,1,4,1,4,5,0,1
yad,yad,,3,0,0,3,5,3,9,1
xposed,xposed,,6,4,12,10,10,22,3,1
xposed-framework,xposed-framework,,1,2,4,3,3,7,3,100
ionic-webview,ionic-webview,,1,3,12,4,2,16,1,200
dispatch-table,dispatch-table,,0,0,0,0,2,0,9,1
uc-browser,uc-browser,,1,1,6,2,6,8,1,1
react-ssr,react-ssr,,2,6,12,8,9,20,1,200
elm-port,elm-port,,0,0,1,0,2,1,1,1
todo,todo,,1,4,1,5,9,6,1,300
updatemodel,updatemodel,,0,0,1,0,3,1,8,1
django-model-utils,django-model-utils,,1,1,4,2,7,6,0,1
jquery-queue,jquery-queue,,1,0,0,1,2,1,1,1
nimrod,nimrod,,0,0,0,0,1,0,9,1
css3pie,css3pie,,0,0,1,0,2,1,1,1
eaaccessory,eaaccessory,,0,1,6,1,4,7,13,1
http-trace,http-trace,,0,0,3,0,4,3,3,1
caf,caf,,2,0,3,2,1,5,13,1
string-pool,string-pool,,2,2,7,4,17,11,3,1
string-constant,string-constant,,3,2,3,5,4,8,4,1
extjs-stores,extjs-stores,,0,0,2,0,3,2,1,1
log4view,log4view,,0,0,2,0,1,2,8,1
multiple-apk,multiple-apk,,0,0,0,0,2,0,3,1
google-goggles,google-goggles,,0,0,0,0,1,0,2,1
multipart-alternative,multipart-alternative,,1,1,1,2,1,3,1,1
pipelined-function,pipelined-function,,1,3,0,4,5,4,4,200
rave-reports,rave-reports,,1,0,1,1,1,2,9,1
httpuv,httpuv,,0,3,3,3,1,6,0,200
scala-2.10,scala-2.10,,1,0,0,1,8,1,2,1
custom-scope,custom-scope,,1,0,1,1,6,2,3,1
rails-administrate,rails-administrate,,0,1,2,1,5,3,12,1
markdowndeep,markdowndeep,,0,0,0,0,2,0,8,1
node-amqp,node-amqp,,4,1,3,5,8,8,3,1
gocardless,gocardless,,2,0,4,2,5,6,4,1
androidviewclient,androidviewclient,,0,1,4,1,14,5,3,1
android-chips,android-chips,,15,13,22,28,17,50,3,1
ecmascript-2018,ecmascript-2018,,3,3,8,6,3,14,1,1
wro4j,wro4j,,0,1,0,1,4,1,3,1
built.io,built.io,,0,1,0,1,2,1,3,1
getsystemmetrics,getsystemmetrics,,0,0,0,0,1,0,9,1
ordered-map,ordered-map,,1,0,1,1,3,2,4,1
rome,rome,,2,0,4,2,6,6,4,1
ember-i18n,ember-i18n,,0,1,0,1,5,1,1,1
ftok,ftok,,0,0,1,0,1,1,9,1
msgsend,msgsend,,1,0,1,1,1,2,9,1
ninjaframework,ninjaframework,,0,3,2,3,5,5,3,200
substance,substance,,2,1,2,3,3,5,3,1
path-separator,path-separator,,1,0,2,1,5,3,8,1
linq-group,linq-group,,1,0,2,1,5,3,8,1
erl,erl,,0,2,16,2,11,18,2,100
filechannel,filechannel,,1,2,10,3,10,13,3,100
public-activity,public-activity,,1,0,1,1,4,2,12,1
java2wsdl,java2wsdl,,2,0,0,2,3,2,3,1
git-detached-head,git-detached-head,,1,2,8,3,8,11,6,100
mongo-jackson-mapper,mongo-jackson-mapper,,0,1,3,1,1,4,3,1
oauth2-toolkit,oauth2-toolkit,,0,1,0,1,5,1,0,1
service-not-available,service-not-available,,1,0,0,1,2,1,1,1
descendant,descendant,,2,1,0,3,9,3,3,1
vue-mixin,vue-mixin,,4,7,4,11,5,15,1,75
october-partial,october-partial,,1,0,4,1,7,5,4,1
dotmemory,dotmemory,,3,2,5,5,7,10,8,1
android-mipmap,android-mipmap,,0,1,1,1,6,2,3,1
ipcs,ipcs,,0,1,0,1,2,1,9,1
.net-4.7.1,.net-4.7.1,,4,4,12,8,24,20,8,1
rich-media,rich-media,,2,0,2,2,2,4,4,1
rackattack,rackattack,,0,3,1,3,2,4,12,200
metaphone,metaphone,,2,1,0,3,3,3,0,1
negroni,negroni,,0,0,1,0,2,1,6,1
component-diagram,component-diagram,,1,1,3,2,4,5,3,1
gulp-typescript,gulp-typescript,,0,1,3,1,2,4,1,1
imageloader,imageloader,,2,1,2,3,5,5,3,1
rethinkdb-python,rethinkdb-python,,2,3,5,5,7,10,1,50
google-api-webmasters,google-api-webmasters,,3,0,4,3,5,7,5,1
single-abstract-method,single-abstract-method,,0,1,1,1,3,2,2,1
nconf,nconf,,0,1,0,1,2,1,1,1
special-folders,special-folders,,0,2,3,2,5,5,8,100
tripadvisor,tripadvisor,,4,1,6,5,7,11,0,1
prtg,prtg,,3,0,2,3,5,5,6,1
solarwindslem,solarwindslem,,0,0,0,0,1,0,6,1
dotfiles,dotfiles,,4,4,12,8,6,20,9,1
pytumblr,pytumblr,,0,0,3,0,5,3,0,1
coldfusion-administrator,coldfusion-administrator,,0,0,1,0,3,1,4,1
directdraw,directdraw,,0,0,0,0,2,0,0,1
contextroot,contextroot,,0,1,4,1,5,5,3,1
windows-server-container,windows-server-container,,2,0,0,2,2,2,6,1
google-admin-settings-api,google-admin-settings-api,,2,0,2,2,2,4,5,1
gorm-mongodb,gorm-mongodb,,1,2,5,3,4,8,3,100
positional-parameter,positional-parameter,,2,5,4,7,7,11,9,150
texel,texel,,0,1,1,1,4,2,9,1
schemaless,schemaless,,2,0,1,2,5,3,1,1
splobjectstorage,splobjectstorage,,0,0,1,0,2,1,4,1
jinput,jinput,,1,0,1,1,6,2,3,1
casyncsocket,casyncsocket,,0,1,0,1,1,1,9,1
vptr,vptr,,3,5,4,8,6,12,9,66.666667
runtime-environment,runtime-environment,,0,0,0,0,1,0,5,1
nsmeasurementformatter,nsmeasurementformatter,,1,0,0,1,1,1,13,1
parallel-ssh,parallel-ssh,,1,1,1,2,4,3,9,1
ncdf4,ncdf4,,6,4,11,10,17,21,0,1
mysql-helper,mysql-helper,,0,0,0,0,1,0,8,1
bitronix,bitronix,,1,2,4,3,6,7,3,100
trackpy,trackpy,,1,0,1,1,2,2,0,1
graphql-dotnet,graphql-dotnet,,7,5,23,12,12,35,8,1
libressl,libressl,,2,2,6,4,9,10,6,1
bionic,bionic,,2,0,2,2,4,4,3,1
coredns,coredns,,13,24,28,37,6,65,6,84.615385
magellan-nightwatch,magellan-nightwatch,,1,0,2,1,1,3,3,1
sitecore-fxm,sitecore-fxm,,1,0,1,1,2,2,8,1
spaceship-operator,spaceship-operator,,1,0,4,1,13,5,9,1
global-methods,global-methods,,0,0,0,0,1,0,8,1
tlbimp,tlbimp,,1,0,0,1,4,1,8,1
cs-script,cs-script,,1,3,0,4,3,4,8,200
photoshop-cs4,photoshop-cs4,,0,0,0,0,1,0,1,1
wunderlist,wunderlist,,0,0,1,0,4,1,4,1
ibm-jdk,ibm-jdk,,3,3,3,6,6,9,3,1
flexpaper,flexpaper,,0,2,0,2,1,2,1,100
user-presence,user-presence,,3,1,2,4,7,6,13,1
browser-action,browser-action,,1,1,3,2,4,5,1,1
outlook-for-mac,outlook-for-mac,,5,2,10,7,24,17,5,1
dm,dm,,1,2,3,3,3,6,0,100
simplecv,simplecv,,1,0,1,1,4,2,0,1
skylink,skylink,,0,0,0,0,2,0,1,1
temasys,temasys,,0,0,1,0,3,1,1,1
igcombo,igcombo,,0,1,2,1,2,3,8,1
rust-result,rust-result,,0,0,0,0,3,0,9,1
ftputil,ftputil,,2,1,1,3,2,4,0,1
pgo,pgo,,0,0,4,0,1,4,9,1
clos,clos,,1,4,6,5,11,11,0,300
nettle,nettle,,1,2,3,3,1,6,9,100
dragenter,dragenter,,0,1,0,1,1,1,1,1
ffbase,ffbase,,1,1,1,2,3,3,0,1
wirebox,wirebox,,0,0,1,0,1,1,4,1
testbox,testbox,,0,0,2,0,2,2,4,1
lazyeval,lazyeval,,0,0,0,0,2,0,0,1
tr1,tr1,,0,1,0,1,2,1,9,1
tables-package,tables-package,,0,0,0,0,1,0,0,1
sitecore-xdb,sitecore-xdb,,0,2,0,2,6,2,8,100
uiswipeactionsconfiguration,uiswipeactionsconfiguration,,3,6,7,9,8,16,13,100
uicontextualaction,uicontextualaction,,4,2,10,6,11,16,13,1
camera-projection,camera-projection,,1,1,0,2,5,2,0,1
waze,waze,,3,5,14,8,22,22,3,66.666667
server-administration,server-administration,,1,1,4,2,9,6,4,1
toolz,toolz,,1,2,1,3,5,4,0,100
datastax-node-driver,datastax-node-driver,,1,0,0,1,6,1,2,1
smf,smf,,1,1,3,2,2,5,4,1
datastax-search,datastax-search,,0,0,0,0,2,0,2,1
jquery-filter,jquery-filter,,0,0,0,0,5,0,1,1
c#-7.2,c#-7.2,,3,3,14,6,56,20,8,1
system.memory,system.memory,,1,2,4,3,12,7,8,100
data.stackexchange.com,data.stackexchange.com,,1,0,1,1,3,2,4,1
tensorflow-lite,tensorflow-lite,,116,141,156,257,137,413,0,21.551724
filter-driver,filter-driver,,1,0,1,1,8,2,9,1
spring-social-linkedin,spring-social-linkedin,,3,1,3,4,4,7,4,1
neura,neura,,1,0,0,1,1,1,0,1
layered,layered,,4,2,3,6,4,9,8,1
printjs,printjs,,7,1,5,8,9,13,1,1
dunit,dunit,,0,0,0,0,6,0,9,1
dunitx,dunitx,,0,1,4,1,3,5,9,1
sql-server-2012-localdb,sql-server-2012-localdb,,0,0,1,0,2,1,4,1
file-uri,file-uri,,0,0,7,0,3,7,3,1
xdomainrequest,xdomainrequest,,0,0,0,0,3,0,1,1
missing-template,missing-template,,0,1,0,1,1,1,8,1
wikimapia,wikimapia,,0,1,0,1,3,1,0,1
twitter-timeline,twitter-timeline,,1,0,1,1,3,2,3,1
dexmaker,dexmaker,,0,0,0,0,1,0,3,1
machine.config,machine.config,,2,4,1,6,4,7,8,100
finch,finch,,1,1,3,2,4,5,2,1
libjingle,libjingle,,2,3,5,5,5,10,3,50
peer-connection,peer-connection,,1,1,2,2,11,4,1,1
aspbutton,aspbutton,,0,0,4,0,4,4,8,1
caveman2,caveman2,,0,0,0,0,1,0,0,1
marimekko-chart,marimekko-chart,,0,0,1,0,2,1,1,1
schema.rb,schema.rb,,0,1,1,1,1,2,12,1
alloc,alloc,,0,1,3,1,7,4,9,1
pastebin,pastebin,,3,1,3,4,7,7,4,1
uiimagejpegrepresentation,uiimagejpegrepresentation,,1,1,2,2,6,4,13,1
secure-transport,secure-transport,,0,0,0,0,2,0,6,1
mollie,mollie,,2,2,8,4,6,12,4,1
ierrorhandler,ierrorhandler,,0,0,1,0,3,1,8,1
aglio,aglio,,1,1,3,2,2,5,4,1
crush,crush,,1,1,2,2,3,4,3,1
sp-who2,sp-who2,,0,1,2,1,2,3,4,1
radtreeview,radtreeview,,3,0,3,3,1,6,8,1
excel-import,excel-import,,8,2,3,10,6,13,5,1
yapdatabase,yapdatabase,,0,0,1,0,2,1,13,1
office-2007,office-2007,,1,1,0,2,3,2,5,1
no-cache,no-cache,,0,1,5,1,9,6,4,1
rails-assets,rails-assets,,1,1,2,2,3,4,12,1
plv8,plv8,,0,0,1,0,7,1,4,1
gradle-3.0,gradle-3.0,,0,0,0,0,3,0,3,1
webkitspeechrecognition,webkitspeechrecognition,,2,4,5,6,5,11,1,100
placeautocompletefragment,placeautocompletefragment,,1,2,8,3,24,11,3,100
project-settings,project-settings,,0,1,3,1,4,4,8,1
writeablebitmap,writeablebitmap,,2,0,5,2,9,7,8,1
usernotificationsui,usernotificationsui,,0,0,1,0,1,1,13,1
unity-test-tools,unity-test-tools,,0,0,0,0,2,0,8,1
react-map-gl,react-map-gl,,3,17,16,20,15,36,1,466.666667
yield-from,yield-from,,2,2,3,4,6,7,0,1
c++-ts,c++-ts,,0,0,0,0,3,0,9,1
uncheck,uncheck,,2,3,3,5,4,8,1,50
phplist,phplist,,1,0,2,1,4,3,4,1
rbvmomi,rbvmomi,,1,0,2,1,2,3,6,1
async-workflow,async-workflow,,1,0,0,1,1,1,8,1
openzeppelyn,openzeppelyn,,0,0,0,0,3,0,6,1
sanity,sanity,,8,3,5,11,8,16,1,1
iphone-sdk-3.0,iphone-sdk-3.0,,1,0,0,1,1,1,13,1
specular,specular,,2,0,0,2,2,2,9,1
no-framework,no-framework,,0,3,1,3,2,4,1,200
oggvorbis,oggvorbis,,2,0,4,2,7,6,9,1
visual-studio-2003,visual-studio-2003,,0,1,10,1,3,11,8,1
iextenderprovider,iextenderprovider,,0,0,0,0,2,0,8,1
offloading,offloading,,0,4,5,4,14,9,9,300
utf-16le,utf-16le,,1,1,5,2,8,7,0,1
express-router,express-router,,13,16,18,29,36,47,1,23.076923
aws-redshift,aws-redshift,,0,0,0,0,7,0,6,1
ccxt,ccxt,,2,1,11,3,10,14,0,1
adgroup,adgroup,,2,3,2,5,6,7,8,50
stochastic-process,stochastic-process,,7,4,8,11,15,19,0,1
markov-decision-process,markov-decision-process,,12,8,16,20,10,36,0,1
messagingcenter,messagingcenter,,0,3,7,3,7,10,8,200
binlog,binlog,,3,1,0,4,4,4,4,1
carryflag,carryflag,,2,1,8,3,2,11,9,1
tms570,tms570,,0,0,0,0,2,0,9,1
varbinarymax,varbinarymax,,2,2,6,4,18,10,4,1
bug-reporting,bug-reporting,,0,3,2,3,9,5,3,200
cdb,cdb,,1,1,3,2,3,5,9,1
commonj,commonj,,1,1,1,2,1,3,3,1
schannel,schannel,,4,4,1,8,10,9,6,1
tomcat-manager,tomcat-manager,,0,0,2,0,3,2,3,1
practical-common-lisp,practical-common-lisp,,1,1,2,2,1,4,0,1
quickselect,quickselect,,4,1,5,5,4,10,0,1
ddmathparser,ddmathparser,,0,0,0,0,3,0,13,1
ucontext,ucontext,,2,0,5,2,3,7,9,1
control-state,control-state,,0,0,1,0,1,1,1,1
system.web.optimization,system.web.optimization,,0,0,2,0,2,2,1,1
dirtyread,dirtyread,,0,1,4,1,4,5,3,1
ruby-prof,ruby-prof,,0,0,0,0,2,0,12,1
union-types,union-types,,13,23,27,36,33,63,1,76.923077
tinyos,tinyos,,5,2,6,7,5,13,9,1
nesc,nesc,,2,1,1,3,3,4,9,1
end-of-life,end-of-life,,2,1,8,3,3,11,3,1
racsignal,racsignal,,0,0,0,0,1,0,13,1
racsequence,racsequence,,0,0,0,0,1,0,13,1
region-monitoring,region-monitoring,,1,2,1,3,4,4,13,100
volttron,volttron,,0,1,2,1,11,3,0,1
datetime-select,datetime-select,,0,0,1,0,2,1,8,1
foldable,foldable,,4,4,5,8,8,13,2,1
di-containers,di-containers,,1,0,0,1,3,1,8,1
neupy,neupy,,1,0,4,1,8,5,0,1
word-vba-mac,word-vba-mac,,3,7,5,10,5,15,5,133.333333
objectscript,objectscript,,2,0,3,2,3,5,4,1
insert-image,insert-image,,1,1,3,2,5,5,3,1
entitygraph,entitygraph,,4,1,8,5,11,13,3,1
pbxproj,pbxproj,,1,0,0,1,2,1,13,1
altair,altair,,54,31,52,85,33,137,0,1
django-inheritance,django-inheritance,,1,2,3,3,5,6,0,100
aidl,aidl,,14,7,26,21,38,47,3,1
session-bean,session-bean,,1,1,2,2,3,4,3,1
pyxll,pyxll,,1,1,2,2,2,4,0,1
diawi,diawi,,1,1,1,2,4,3,13,1
find-all-references,find-all-references,,1,0,1,1,2,2,8,1
catransform3d,catransform3d,,3,1,1,4,9,5,13,1
uiactivity,uiactivity,,1,0,4,1,8,5,13,1
gwt-compiler,gwt-compiler,,1,0,0,1,1,1,3,1
wink,wink,,0,0,1,0,2,1,4,1
panning,panning,,4,1,8,5,13,13,1,1
xbind,xbind,,1,1,5,2,6,7,8,1
winstone,winstone,,1,2,0,3,2,3,1,100
reactive-property,reactive-property,,0,0,2,0,3,2,8,1
nskeyvaluecoding,nskeyvaluecoding,,0,0,0,0,1,0,13,1
reorganize,reorganize,,3,2,3,5,7,8,0,1
dsa,dsa,,3,5,10,8,13,18,6,66.666667
sas-ds2,sas-ds2,,0,0,0,0,4,0,0,1
imetadataimport,imetadataimport,,0,0,0,0,2,0,8,1
mediarouter,mediarouter,,1,1,1,2,4,3,3,1
file-monitoring,file-monitoring,,3,1,5,4,4,9,8,1
findwindowex,findwindowex,,1,0,1,1,3,2,8,1
edititemtemplate,edititemtemplate,,2,0,2,2,4,4,8,1
http-status-code-204,http-status-code-204,,3,3,4,6,8,10,4,1
ui-ace,ui-ace,,0,0,0,0,2,0,1,1
popviewcontroller,popviewcontroller,,1,0,3,1,5,4,13,1
unchecked-cast,unchecked-cast,,2,0,2,2,6,4,3,1
fromfile,fromfile,,1,1,2,2,7,4,0,1
geoswift,geoswift,,2,1,2,3,3,5,13,1
fxcopcmd,fxcopcmd,,1,0,1,1,1,2,8,1
typescript2.2,typescript2.2,,0,0,1,0,6,1,1,1
vector-clock,vector-clock,,2,0,0,2,3,2,3,1
mappedby,mappedby,,0,0,5,0,2,5,3,1
object-relationships,object-relationships,,0,0,2,0,2,2,4,1
intel-ipp,intel-ipp,,4,3,8,7,10,15,9,1
crx,crx,,1,4,3,5,9,8,3,300
ncover,ncover,,0,1,0,1,1,1,3,1
input-split,input-split,,0,0,0,0,3,0,2,1
gnu-smalltalk,gnu-smalltalk,,14,1,4,15,8,19,13,1
parallel.invoke,parallel.invoke,,0,0,0,0,2,0,8,1
a2dp,a2dp,,6,1,8,7,8,15,3,1
badimageformatexception,badimageformatexception,,2,6,4,8,7,12,8,200
underscore.js-templating,underscore.js-templating,,2,2,2,4,5,6,1,1
angularjs-ng-include,angularjs-ng-include,,1,3,7,4,18,11,1,200
multi-stage-programming,multi-stage-programming,,0,0,0,0,1,0,0,1
admin-rights,admin-rights,,4,0,4,4,7,8,8,1
uikeycommand,uikeycommand,,0,4,1,4,6,5,13,300
mongodb-stitch,mongodb-stitch,,25,16,26,41,27,67,1,1
staleelementreferenceexception,staleelementreferenceexception,,4,5,16,9,32,25,3,25
server.xml,server.xml,,2,10,8,12,13,20,3,400
knockout-2.0,knockout-2.0,,1,3,10,4,23,14,1,200
pact-net,pact-net,,0,0,4,0,4,4,3,1
page-flipping,page-flipping,,0,0,1,0,2,1,1,1
script-element,script-element,,0,0,1,0,2,1,1,1
power-saving,power-saving,,3,1,3,4,5,7,3,1
spagobi,spagobi,,2,1,4,3,9,7,4,1
mysql-error-1241,mysql-error-1241,,1,0,2,1,4,3,4,1
xlsread,xlsread,,1,1,5,2,5,7,0,1
pikaday,pikaday,,2,2,5,4,10,9,1,1
tinterfacedobject,tinterfacedobject,,0,0,0,0,1,0,9,1
scxml,scxml,,0,2,4,2,6,6,9,100
torq,torq,,0,0,0,0,4,0,0,1
spark-webui,spark-webui,,0,0,2,0,4,2,2,1
zebra-puzzle,zebra-puzzle,,4,2,0,6,5,6,0,1
messageformat.js,messageformat.js,,1,0,0,1,2,1,1,1
playframework-2.1,playframework-2.1,,0,0,0,0,3,0,3,1
google-feed-api,google-feed-api,,2,0,1,2,1,3,4,1
jinfo,jinfo,,1,0,0,1,1,1,3,1
bsod,bsod,,2,1,4,3,5,7,9,1
wumpus-world,wumpus-world,,1,0,2,1,3,3,0,1
http-status-code-410,http-status-code-410,,0,0,3,0,11,3,4,1
dojo-build,dojo-build,,0,0,0,0,1,0,1,1
networkimageview,networkimageview,,1,0,3,1,1,4,3,1
image-replacement,image-replacement,,1,0,3,1,2,4,0,1
start-stop-daemon,start-stop-daemon,,2,0,7,2,6,9,9,1
nopcommerce-4.0,nopcommerce-4.0,,2,1,5,3,18,8,8,1
windowstate,windowstate,,0,0,1,0,4,1,8,1
coordinator-pattern,coordinator-pattern,,5,9,8,14,4,22,13,80
node-nan,node-nan,,1,0,2,1,5,3,1,1
cab,cab,,3,0,3,3,8,6,8,1
r.net,r.net,,3,2,12,5,19,17,8,1
chronicle-bytes,chronicle-bytes,,1,0,4,1,3,5,3,1
broadcasting,broadcasting,,4,13,23,17,22,40,0,225
spying,spying,,0,0,2,0,2,2,5,1
kairosdb,kairosdb,,4,0,5,4,7,9,2,1
javascript.net,javascript.net,,0,0,0,0,2,0,8,1
datasheet,datasheet,,4,0,3,4,11,7,5,1
cxf-xjc-plugin,cxf-xjc-plugin,,2,0,2,2,3,4,3,1
collator,collator,,1,2,4,3,9,7,3,100
inlines,inlines,,1,0,6,1,2,7,0,1
multiprogramming,multiprogramming,,0,1,0,1,3,1,9,1
ss7,ss7,,0,4,7,4,5,11,3,300
adox,adox,,0,0,1,0,6,1,8,1
oauth2-playground,oauth2-playground,,2,1,4,3,8,7,5,1
gemini,gemini,,0,0,2,0,4,2,3,1
max-execution-timeout,max-execution-timeout,,1,1,4,2,3,6,4,1
backbone-stickit,backbone-stickit,,1,0,0,1,3,1,1,1
server-side-sync,server-side-sync,,0,0,3,0,3,3,8,1
loopback-address,loopback-address,,0,0,0,0,4,0,1,1
dynamic-web-twain,dynamic-web-twain,,1,0,2,1,3,3,8,1
gpib,gpib,,1,5,4,6,10,10,0,400
doctrine-mongodb,doctrine-mongodb,,2,0,5,2,5,7,4,1
datatable.select,datatable.select,,0,0,0,0,1,0,8,1
declared-property,declared-property,,0,0,0,0,3,0,9,1
jena-querybuilder,jena-querybuilder,,0,0,0,0,1,0,2,1
django-bootstrap3,django-bootstrap3,,2,3,4,5,11,9,0,50
table-index,table-index,,1,0,3,1,3,4,4,1
android-2.3-gingerbread,android-2.3-gingerbread,,1,0,0,1,3,1,3,1
sorl-thumbnail,sorl-thumbnail,,3,1,7,4,4,11,0,1
why3,why3,,0,0,3,0,5,3,2,1
why3ml,why3ml,,0,0,2,0,2,2,2,1
yield-keyword,yield-keyword,,0,0,4,0,11,4,0,1
phpldapadmin,phpldapadmin,,1,2,8,3,3,11,8,100
azure-backup-vault,azure-backup-vault,,2,2,9,4,14,13,8,1
aws-ecs,aws-ecs,,0,0,4,0,89,4,6,1
ckasset,ckasset,,0,1,1,1,2,2,13,1
event-simulation,event-simulation,,5,4,5,9,6,14,0,1
dynamics-gp,dynamics-gp,,2,2,4,4,6,8,8,1
revisions,revisions,,0,0,0,0,5,0,4,1
luks,luks,,3,2,0,5,7,5,9,1
elasticity,elasticity,,1,0,4,1,3,5,0,1
hg-log,hg-log,,0,0,0,0,2,0,6,1
oas,oas,,1,0,4,1,1,5,3,1
resonance-audio,resonance-audio,,2,0,4,2,15,6,8,1
django-request,django-request,,3,3,6,6,13,12,0,1
icefaces-3,icefaces-3,,2,0,2,2,5,4,3,1
jung,jung,,3,1,6,4,15,10,3,1
varchar2,varchar2,,5,4,14,9,9,23,4,1
wdproj,wdproj,,0,0,0,0,1,0,8,1
seamless-immutable,seamless-immutable,,1,2,0,3,5,3,1,100
csx,csx,,1,0,7,1,8,8,8,1
go-git,go-git,,1,4,1,5,5,6,6,300
home-screen-widget,home-screen-widget,,0,0,3,0,3,3,3,1
nlopt,nlopt,,5,6,10,11,16,21,0,20
vpath,vpath,,0,0,1,0,1,1,9,1
smips,smips,,2,0,1,2,1,3,9,1
tds,tds,,2,0,4,2,8,6,8,1
watson-explorer,watson-explorer,,1,0,2,1,3,3,6,1
gui-toolkit,gui-toolkit,,0,0,0,0,2,0,9,1
idatareader,idatareader,,3,1,2,4,6,6,8,1
pyjade,pyjade,,0,0,0,0,2,0,0,1
restivus,restivus,,0,0,0,0,3,0,1,1
meteor-restivus,meteor-restivus,,0,0,0,0,4,0,1,1
xmlencoder,xmlencoder,,0,1,1,1,1,2,3,1
sql-parser,sql-parser,,10,3,7,13,8,20,4,1
opensc,opensc,,2,1,5,3,6,8,6,1
e-token,e-token,,0,1,1,1,1,2,13,1
letteringjs,letteringjs,,0,2,0,2,1,2,1,100
remote-branch,remote-branch,,0,0,3,0,4,3,6,1
session.socket.io,session.socket.io,,0,0,0,0,1,0,1,1
resignfirstresponder,resignfirstresponder,,2,1,3,3,7,6,13,1
qr-decomposition,qr-decomposition,,3,0,2,3,7,5,0,1
mindstorms,mindstorms,,4,1,6,5,10,11,0,1
zotonic,zotonic,,0,0,0,0,1,0,2,1
live-cd,live-cd,,0,0,2,0,4,2,9,1
xmlnodelist,xmlnodelist,,4,4,2,8,9,10,8,1
pym.js,pym.js,,0,0,1,0,1,1,1,1
qgraphicstextitem,qgraphicstextitem,,0,2,2,2,3,4,9,100
remoteio,remoteio,,0,1,0,1,6,1,13,1
jscolor,jscolor,,1,4,3,5,11,8,1,300
zoomcharts,zoomcharts,,0,3,1,3,5,4,1,200
skemitternode,skemitternode,,0,0,3,0,5,3,13,1
civicrm-extension,civicrm-extension,,1,1,1,2,3,3,4,1
hyperledger-explorer,hyperledger-explorer,,13,6,27,19,28,46,6,1
device-emulation,device-emulation,,1,0,3,1,5,4,3,1
wordpress-ecommerce,wordpress-ecommerce,,0,0,3,0,3,3,4,1
scriptlab,scriptlab,,1,4,2,5,7,7,5,300
video-library,video-library,,0,0,2,0,6,2,8,1
r-qgraph,r-qgraph,,0,0,2,0,2,2,0,1
rtmpdump,rtmpdump,,0,0,0,0,1,0,13,1
php-shorttags,php-shorttags,,0,0,0,0,1,0,4,1
alibaba-cloud,alibaba-cloud,,13,6,58,19,28,77,6,1
bass.dll,bass.dll,,0,0,0,0,2,0,13,1
sialertview,sialertview,,0,0,0,0,2,0,13,1
eclipse-clp,eclipse-clp,,23,1,1,24,6,25,0,1
sejda,sejda,,1,0,3,1,1,4,3,1
javapns,javapns,,2,1,1,3,1,4,3,1
shading,shading,,5,2,11,7,23,18,9,1
staleobjectstate,staleobjectstate,,0,0,0,0,2,0,8,1
pcap.net,pcap.net,,3,2,6,5,8,11,9,1
userdel,userdel,,0,0,0,0,1,0,9,1
olpc,olpc,,0,0,0,0,1,0,9,1
htmlparse,htmlparse,,0,0,1,0,2,1,13,1
twitter-gem,twitter-gem,,0,1,2,1,1,3,12,1
promotion-code,promotion-code,,3,0,3,3,3,6,13,1
swagger-node-runner,swagger-node-runner,,0,0,0,0,2,0,3,1
article,article,,6,3,12,9,5,21,4,1
monotouch.dialog,monotouch.dialog,,0,1,1,1,1,2,8,1
swi-prolog-for-sharing,swi-prolog-for-sharing,,0,0,0,0,2,0,0,1
tmediaplayer,tmediaplayer,,1,0,1,1,2,2,9,1
pressure,pressure,,1,1,4,2,5,6,3,1
region-management,region-management,,0,0,1,0,1,1,8,1
aqueduct,aqueduct,,17,8,19,25,15,44,13,1
azure-acs,azure-acs,,0,0,0,0,3,0,6,1
displayname-attribute,displayname-attribute,,1,1,3,2,7,5,8,1
water-jug-problem,water-jug-problem,,2,1,0,3,1,3,0,1
clang-ast-matchers,clang-ast-matchers,,3,4,4,7,9,11,9,33.333333
webfm-api,webfm-api,,0,0,0,0,1,0,13,1
worksite-sdk,worksite-sdk,,1,0,4,1,3,5,5,1
chained-assignment,chained-assignment,,1,2,4,3,6,7,0,100
associated-value,associated-value,,2,2,4,4,8,8,13,1
fiddlercore,fiddlercore,,1,3,7,4,7,11,8,200
team-explorer-everywhere,team-explorer-everywhere,,0,1,5,1,4,6,8,1
dpkt,dpkt,,8,4,4,12,6,16,9,1
windows-1255,windows-1255,,1,0,1,1,1,2,0,1
facebook-send-api,facebook-send-api,,1,2,5,3,7,8,13,100
access-point-name,access-point-name,,0,0,0,0,1,0,9,1
bi-tool,bi-tool,,1,1,1,2,5,3,4,1
servicestack-razor,servicestack-razor,,1,1,0,2,3,2,8,1
ogre3d,ogre3d,,0,0,1,0,3,1,9,1
excel-web-query,excel-web-query,,1,1,7,2,9,9,5,1
tchar,tchar,,1,1,5,2,9,7,9,1
read-unread,read-unread,,1,0,1,1,2,2,5,1
document-view,document-view,,0,1,1,1,2,2,4,1
postgresql-bigsql,postgresql-bigsql,,0,0,0,0,4,0,4,1
servicetestcase,servicetestcase,,0,1,0,1,2,1,3,1
strictnullchecks,strictnullchecks,,2,0,1,2,9,3,1,1
mosby,mosby,,0,0,1,0,11,1,3,1
three-tier,three-tier,,5,1,5,6,6,11,8,1
document-root,document-root,,5,4,13,9,20,22,4,1
toml,toml,,7,6,13,13,21,26,0,1
tilemill,tilemill,,0,1,2,1,5,3,1,1
utfgrids,utfgrids,,0,0,0,0,1,0,1,1
github-codereviews,github-codereviews,,6,1,5,7,3,12,6,1
apache-commons-lang,apache-commons-lang,,1,3,1,4,6,5,3,200
eye-detection,eye-detection,,3,0,3,3,3,6,0,1
line-by-line,line-by-line,,4,1,4,5,9,9,0,1
acfpro,acfpro,,15,13,28,28,21,56,4,1
compilationunit,compilationunit,,0,1,0,1,3,1,9,1
selenium-docker,selenium-docker,,2,3,2,5,1,7,3,50
oracle-aq,oracle-aq,,5,2,10,7,11,17,3,1
asp.net-mvc-3-areas,asp.net-mvc-3-areas,,0,0,0,0,1,0,8,1
crittercism,crittercism,,0,0,0,0,2,0,13,1
gce-persistent-disk,gce-persistent-disk,,1,1,4,2,3,6,6,1
c-minus-minus,c-minus-minus,,0,0,2,0,1,2,9,1
system-tables,system-tables,,0,1,1,1,5,2,4,1
spring-tld,spring-tld,,0,0,1,0,2,1,3,1
axure,axure,,0,1,0,1,2,1,1,1
unmodifiable,unmodifiable,,3,3,0,6,5,6,3,1
chrome-webrequest,chrome-webrequest,,3,3,5,6,11,11,1,1
uitraitcollection,uitraitcollection,,1,6,7,7,3,14,13,500
terriajs,terriajs,,0,0,0,0,1,0,1,1
wmi-service,wmi-service,,0,1,2,1,5,3,8,1
libcloud,libcloud,,2,2,6,4,3,10,0,1
frameworkelement,frameworkelement,,2,0,2,2,5,4,8,1
geosparql,geosparql,,3,2,7,5,13,12,2,1
authomatic,authomatic,,0,0,0,0,1,0,8,1
hasura,hasura,,14,18,9,32,10,41,1,28.571429
intel-composer,intel-composer,,1,0,3,1,6,4,9,1
directory-tree,directory-tree,,1,1,3,2,2,5,0,1
tailwind-css,tailwind-css,,23,35,34,58,22,92,1,52.173913
busy-waiting,busy-waiting,,1,0,3,1,3,4,3,1
reversi,reversi,,0,0,2,0,2,2,3,1
mindate,mindate,,2,1,4,3,3,7,1,1
elasticsearch-nested,elasticsearch-nested,,3,3,2,6,8,8,6,1
idle-timer,idle-timer,,3,2,3,5,7,8,13,1
quicktype,quicktype,,3,0,2,3,1,5,13,1
elm-mdl,elm-mdl,,0,0,0,0,1,0,1,1
windows-desktop-gadgets,windows-desktop-gadgets,,0,1,2,1,4,3,1,1
anyevent,anyevent,,1,2,2,3,4,5,9,100
unmanagedexports,unmanagedexports,,1,0,2,1,13,3,8,1
radix-tree,radix-tree,,3,0,1,3,3,4,0,1
qlcdnumber,qlcdnumber,,1,0,5,1,4,6,0,1
uncertainty,uncertainty,,3,3,9,6,9,15,0,1
polish-notation,polish-notation,,0,0,0,0,4,0,0,1
prefix-notation,prefix-notation,,0,0,0,0,1,0,0,1
customization-point,customization-point,,0,0,0,0,2,0,9,1
doctrine-phpcr,doctrine-phpcr,,0,0,2,0,3,2,4,1
spatial-data,spatial-data,,2,2,3,4,6,7,0,1
cmac,cmac,,1,1,1,2,1,3,6,1
kdf,kdf,,1,2,2,3,2,5,6,100
node-twitter,node-twitter,,0,0,1,0,1,1,0,1
background-position,background-position,,6,2,10,8,15,18,1,1
sqlps,sqlps,,0,1,2,1,5,3,8,1
angular2-custom-pipes,angular2-custom-pipes,,0,1,5,1,3,6,1,1
gorp,gorp,,1,1,1,2,4,3,6,1
openglrenderer,openglrenderer,,0,0,2,0,2,2,3,1
openscoring,openscoring,,0,0,1,0,1,1,0,1
raco,raco,,0,1,3,1,2,4,0,1
uicontrolstate,uicontrolstate,,0,0,1,0,3,1,13,1
bottlenose,bottlenose,,1,1,3,2,3,5,6,1
application-security,application-security,,0,1,2,1,2,3,4,1
blackberry,blackberry,,1,2,5,3,6,8,13,100
smartsheet-api-2.0,smartsheet-api-2.0,,3,10,10,13,16,23,8,233.333333
fiscal,fiscal,,3,0,3,3,6,6,0,1
libconfig,libconfig,,4,1,3,5,6,8,9,1
ean-13,ean-13,,0,0,0,0,5,0,3,1
expando,expando,,1,1,2,2,2,4,8,1
spymemcached,spymemcached,,0,0,4,0,6,4,3,1
sqlmail,sqlmail,,1,0,1,1,1,2,4,1
sensor-fusion,sensor-fusion,,4,3,6,7,11,13,3,1
tabstop,tabstop,,3,0,5,3,5,8,8,1
jsr354,jsr354,,0,0,4,0,5,4,3,1
wsd,wsd,,0,2,1,2,3,3,3,100
auto-ptr,auto-ptr,,0,1,2,1,2,3,9,1
xmlmapper,xmlmapper,,4,1,8,5,11,13,3,1
picturecallback,picturecallback,,0,0,0,0,1,0,3,1
spiceworks,spiceworks,,2,1,0,3,1,3,1,1
wix-react-native-navigation,wix-react-native-navigation,,42,18,79,60,93,139,1,1
renderman,renderman,,0,0,0,0,1,0,3,1
yslow,yslow,,1,0,2,1,4,3,4,1
msvc14,msvc14,,2,4,3,6,4,9,9,100
expression-blend,expression-blend,,1,1,5,2,7,7,8,1
isomorphic-style-loader,isomorphic-style-loader,,0,0,1,0,6,1,1,1
react-flexbox-grid,react-flexbox-grid,,3,0,6,3,4,9,1,1
nsautoreleasepool,nsautoreleasepool,,1,1,3,2,6,5,13,1
evm,evm,,1,3,5,4,6,9,6,200
abstract-type,abstract-type,,4,2,2,6,6,8,2,1
dynamics-nav-2016,dynamics-nav-2016,,0,4,0,4,8,4,8,300
numpy-ndarray,numpy-ndarray,,186,206,255,392,190,647,0,10.752688
payflowlink,payflowlink,,0,0,0,0,1,0,1,1
open62541,open62541,,8,4,4,12,5,16,8,1
hsb,hsb,,0,0,1,0,3,1,0,1
rollingfilesink,rollingfilesink,,1,0,0,1,2,1,2,1
imagehandler,imagehandler,,0,1,1,1,1,2,8,1
valign,valign,,0,1,0,1,2,1,1,1
flask-babel,flask-babel,,0,3,5,3,9,8,0,200
header-bidding,header-bidding,,1,2,4,3,5,7,3,100
spa-template,spa-template,,1,1,3,2,9,5,8,1
xuggler,xuggler,,5,3,4,8,4,12,3,1
xuggle,xuggle,,2,3,0,5,3,5,3,50
wcfserviceclient,wcfserviceclient,,0,1,1,1,7,2,8,1
text-decoding,text-decoding,,0,1,1,1,6,2,0,1
qtwebview,qtwebview,,0,1,2,1,5,3,9,1
gauss,gauss,,0,0,2,0,5,2,0,1
timetable,timetable,,1,3,9,4,13,13,0,200
extjs6.5.1,extjs6.5.1,,0,0,1,0,7,1,1,1
feedjira,feedjira,,0,0,1,0,8,1,12,1
tracesource,tracesource,,3,1,1,4,2,5,8,1
svctraceviewer,svctraceviewer,,0,2,0,2,1,2,8,100
angular6,angular6,,946,623,3941,1569,2181,5510,1,1
sockaddr,sockaddr,,2,0,2,2,1,4,9,1
angular-config,angular-config,,0,0,1,0,1,1,1,1
ncryptoki,ncryptoki,,0,0,0,0,2,0,6,1
cryptoki,cryptoki,,0,2,1,2,5,3,6,100
trello-powerup,trello-powerup,,3,0,6,3,4,9,12,1
stacklayout,stacklayout,,8,8,6,16,17,22,8,1
cflogin,cflogin,,0,0,0,0,1,0,4,1
ferror,ferror,,0,0,0,0,1,0,9,1
paypal-here,paypal-here,,0,0,1,0,2,1,1,1
musicbrainz,musicbrainz,,3,0,2,3,9,5,0,1
preemptive,preemptive,,1,3,6,4,8,10,9,200
mini.css,mini.css,,0,0,0,0,1,0,4,1
scala-java-interop,scala-java-interop,,3,12,6,15,11,21,2,300
python-pattern,python-pattern,,0,1,1,1,1,2,0,1
keyguardlock,keyguardlock,,0,0,0,0,3,0,3,1
yii-routing,yii-routing,,0,0,2,0,2,2,4,1
pycorenlp,pycorenlp,,1,7,5,8,3,13,0,600
invocation,invocation,,3,0,12,3,9,15,3,1
jdedwards,jdedwards,,1,3,5,4,6,9,4,200
baresip,baresip,,1,1,0,2,1,2,13,1
mptcp,mptcp,,1,1,3,2,4,5,9,1
stateful-session-bean,stateful-session-bean,,0,1,3,1,3,4,3,1
case-expression,case-expression,,2,1,4,3,4,7,4,1
cusp-library,cusp-library,,1,0,0,1,2,1,0,1
horde,horde,,2,0,1,2,4,3,4,1
ceilometer,ceilometer,,2,3,0,5,11,5,6,50
heap-size,heap-size,,2,2,5,4,10,9,3,1
fdr,fdr,,0,0,0,0,1,0,0,1
q-value,q-value,,0,0,0,0,1,0,0,1
ng-modal,ng-modal,,0,0,2,0,5,2,1,1
news-ticker,news-ticker,,1,1,3,2,2,5,1,1
strrchr,strrchr,,0,1,0,1,2,1,9,1
code-complexity,code-complexity,,0,3,12,3,13,15,0,200
montgomery-multiplication,montgomery-multiplication,,0,0,0,0,1,0,0,1
standard-evaluation,standard-evaluation,,2,0,1,2,5,3,0,1
highcharttable,highcharttable,,0,0,0,0,2,0,1,1
urlsessiontask,urlsessiontask,,0,0,0,0,2,0,13,1
accelerator,accelerator,,1,2,4,3,3,7,3,100
fluid-mac-app-engine,fluid-mac-app-engine,,0,0,0,0,2,0,6,1
greasekit,greasekit,,0,0,0,0,1,0,6,1
waf,waf,,2,1,5,3,15,8,9,1
compute-capability,compute-capability,,0,0,0,0,1,0,9,1
c++-experimental,c++-experimental,,1,1,3,2,7,5,9,1
oam,oam,,1,2,5,3,2,8,3,100
god-object,god-object,,0,0,0,0,1,0,3,1
launchpad,launchpad,,2,1,2,3,4,5,9,1
pbuilder,pbuilder,,0,0,1,0,2,1,9,1
overflow-menu,overflow-menu,,1,3,6,4,5,10,3,200
appicon,appicon,,8,4,10,12,24,22,13,1
streambuf,streambuf,,2,3,2,5,13,7,9,50
thickbox,thickbox,,0,0,0,0,4,0,4,1
castor,castor,,2,1,2,3,4,5,3,1
jqtransform,jqtransform,,0,0,0,0,2,0,1,1
grass,grass,,4,1,4,5,7,9,0,1
mvcc,mvcc,,3,0,5,3,3,8,4,1
nhibernate-caches,nhibernate-caches,,0,1,0,1,1,1,8,1
pymongo-2.x,pymongo-2.x,,0,0,0,0,1,0,1,1
mud,mud,,1,0,1,1,1,2,0,1
fsyacc,fsyacc,,1,0,0,1,2,1,8,1
fslex,fslex,,0,0,0,0,2,0,8,1
jline2,jline2,,0,0,1,0,2,1,3,1
polarion,polarion,,5,1,6,6,3,12,3,1
gorequest,gorequest,,0,0,1,0,4,1,6,1
pyinvoke,pyinvoke,,0,0,2,0,2,2,0,1
diameter-protocol,diameter-protocol,,5,3,4,8,7,12,9,1
skrollr,skrollr,,2,1,1,3,10,4,1,1
pypandoc,pypandoc,,2,2,3,4,7,7,0,1
system.xml,system.xml,,0,2,3,2,10,5,8,100
iosched,iosched,,0,0,0,0,2,0,3,1
keyof,keyof,,7,4,6,11,9,17,1,1
ehcache-2,ehcache-2,,2,4,5,6,11,11,3,100
time-and-attendance,time-and-attendance,,3,3,13,6,19,19,5,1
exscript,exscript,,0,2,2,2,1,4,0,100
webseal,webseal,,2,0,1,2,7,3,3,1
nestedrecyclerview,nestedrecyclerview,,5,10,18,15,24,33,3,100
microsoft-skype-bot,microsoft-skype-bot,,1,1,4,2,12,6,8,1
satellite-assembly,satellite-assembly,,1,0,0,1,3,1,8,1
jinitiator,jinitiator,,0,0,0,0,2,0,14,1
clicklistener,clicklistener,,0,0,4,0,10,4,3,1
connector-net,connector-net,,0,0,2,0,2,2,8,1
menpo,menpo,,0,0,1,0,1,1,0,1
bootcamp,bootcamp,,0,1,2,1,5,3,13,1
grinder,grinder,,0,0,0,0,4,0,6,1
insertadjacenthtml,insertadjacenthtml,,2,3,3,5,5,8,1,50
libhdfs,libhdfs,,3,1,0,4,3,4,2,1
transitiondrawable,transitiondrawable,,1,0,0,1,3,1,3,1
nextflow,nextflow,,0,1,1,1,2,2,3,1
pyramid-analytics,pyramid-analytics,,0,0,0,0,1,0,0,1
fcmp,fcmp,,2,0,1,2,4,3,0,1
sqlite3-ruby,sqlite3-ruby,,4,1,2,5,11,7,12,1
publisher,publisher,,8,12,9,20,21,29,3,50
dijit.layout,dijit.layout,,1,2,3,3,6,6,1,100
vim-powerline,vim-powerline,,0,0,0,0,3,0,9,1
libsndfile,libsndfile,,0,1,7,1,7,8,9,1
qdomdocument,qdomdocument,,1,0,1,1,4,2,9,1
modelchoicefield,modelchoicefield,,8,5,7,13,16,20,0,1
nsmutabledata,nsmutabledata,,1,2,1,3,5,4,13,100
large-file-support,large-file-support,,0,0,0,0,2,0,6,1
google-voice-actions,google-voice-actions,,3,1,8,4,10,12,3,1
haneke,haneke,,1,0,0,1,1,1,13,1
filterfunction,filterfunction,,0,2,0,2,4,2,2,100
ssis-2017,ssis-2017,,29,12,20,41,11,61,4,1
google-doodle,google-doodle,,0,0,0,0,1,0,4,1
component-space,component-space,,2,2,3,4,3,7,8,1
svg-transform,svg-transform,,0,0,1,0,4,1,1,1
error-kernel,error-kernel,,0,0,0,0,1,0,2,1
teaser,teaser,,0,0,0,0,2,0,4,1
octetstring,octetstring,,2,2,4,4,5,8,1,1
bootrun,bootrun,,0,2,2,2,6,4,3,100
form-serialize,form-serialize,,0,1,1,1,1,2,1,1
floyd-cycle-finding,floyd-cycle-finding,,1,1,2,2,4,4,0,1
rlwrap,rlwrap,,1,0,2,1,2,3,2,1
html.hiddenfor,html.hiddenfor,,1,1,0,2,3,2,8,1
mxhr,mxhr,,0,0,0,0,1,0,1,1
dllnotfoundexception,dllnotfoundexception,,1,1,2,2,4,4,8,1
runcommand,runcommand,,1,0,2,1,6,3,8,1
sinatra-assetpack,sinatra-assetpack,,0,0,0,0,1,0,12,1
opencart-events,opencart-events,,0,2,2,2,4,4,4,100
value-iteration,value-iteration,,2,1,6,3,8,9,0,1
aspxcombobox,aspxcombobox,,1,0,0,1,1,1,8,1
mutablecapabilities,mutablecapabilities,,0,1,2,1,12,3,3,1
raku,raku,,15,11,22,26,50,48,9,1
android-bootstrap,android-bootstrap,,0,1,0,1,2,1,3,1
assembly-signing,assembly-signing,,1,3,3,4,2,7,8,200
jwplayer6,jwplayer6,,0,1,0,1,4,1,1,1
mapguide,mapguide,,1,0,0,1,1,1,8,1
skype4com,skype4com,,1,1,2,2,7,4,8,1
bundletransformer,bundletransformer,,2,0,2,2,2,4,8,1
center-align,center-align,,1,0,3,1,5,4,1,1
editbox,editbox,,2,0,4,2,3,6,9,1
storage-engines,storage-engines,,0,2,2,2,3,4,4,100
optparse,optparse,,4,1,6,5,12,11,0,1
openxlsx,openxlsx,,16,20,37,36,31,73,0,25
interwoven,interwoven,,0,0,0,0,1,0,5,1
inputscope,inputscope,,0,0,0,0,1,0,8,1
server-side-includes,server-side-includes,,1,4,4,5,5,9,4,300
kube-aws,kube-aws,,0,1,0,1,4,1,6,1
ecryptfs,ecryptfs,,2,1,3,3,3,6,9,1
quartz.net-2.0,quartz.net-2.0,,0,1,0,1,2,1,8,1
pymel,pymel,,6,4,5,10,14,15,0,1
shellshock-bash-bug,shellshock-bash-bug,,0,0,1,0,1,1,9,1
google-proximity-api,google-proximity-api,,2,0,3,2,5,5,3,1
sfdc-metadata-api,sfdc-metadata-api,,1,1,3,2,1,5,14,1
camel-jpa,camel-jpa,,0,0,1,0,5,1,3,1
computed-style,computed-style,,0,1,0,1,1,1,1,1
ubifs,ubifs,,1,1,4,2,5,6,9,1
fink,fink,,2,0,1,2,1,3,13,1
django-imagekit,django-imagekit,,2,4,4,6,8,10,0,100
step,step,,3,10,18,13,13,31,0,233.333333
libneo4j-client,libneo4j-client,,1,0,1,1,3,2,2,1
android-moxy,android-moxy,,0,0,3,0,7,3,3,1
xpo,xpo,,5,1,4,6,1,10,8,1
kazoo,kazoo,,1,4,2,5,6,7,2,300
post-commit-hook,post-commit-hook,,3,0,3,3,6,6,6,1
itemtemplateselector,itemtemplateselector,,0,1,1,1,1,2,8,1
docker-command,docker-command,,4,0,3,4,3,7,6,1
windowless,windowless,,0,0,0,0,2,0,9,1
wml,wml,,1,0,1,1,3,2,0,1
cartalyst-sentry,cartalyst-sentry,,0,0,0,0,2,0,1,1
pointofview,pointofview,,0,0,4,0,2,4,13,1
motordriver,motordriver,,6,3,10,9,7,19,0,1
dockpanel,dockpanel,,1,2,1,3,11,4,8,100
tix,tix,,0,0,0,0,12,0,0,1
jquery-ui-widget-factory,jquery-ui-widget-factory,,0,2,1,2,3,3,1,100
criteo,criteo,,0,2,2,2,7,4,6,100
performance-monitor,performance-monitor,,1,0,5,1,7,6,9,1
mit-kerberos,mit-kerberos,,3,3,10,6,6,16,2,1
responsive-emails,responsive-emails,,0,2,0,2,6,2,1,100
all-delete-orphan,all-delete-orphan,,0,0,0,0,3,0,3,1
r-server,r-server,,1,5,3,6,11,9,0,400
opencalais,opencalais,,0,0,0,0,2,0,0,1
filtered-lookup,filtered-lookup,,0,0,0,0,3,0,5,1
msbuild-itemgroup,msbuild-itemgroup,,1,0,2,1,2,3,8,1
android-lvl,android-lvl,,3,2,5,5,10,10,3,1
memory-bandwidth,memory-bandwidth,,3,4,0,7,9,7,9,33.333333
nsprogressindicator,nsprogressindicator,,2,0,0,2,6,2,13,1
sqltalk,sqltalk,,0,0,0,0,2,0,4,1
non-breaking-characters,non-breaking-characters,,2,0,3,2,3,5,1,1
reportviewerformvc,reportviewerformvc,,0,3,4,3,5,7,8,200
android-parser,android-parser,,0,1,1,1,2,2,3,1
logback-groovy,logback-groovy,,0,1,2,1,1,3,3,1
gmavenplus,gmavenplus,,2,1,1,3,5,4,3,1
matrix-storage,matrix-storage,,0,0,0,0,2,0,0,1
xonsh,xonsh,,1,5,7,6,5,13,9,400
liquidfun,liquidfun,,0,0,2,0,4,2,3,1
apertium,apertium,,0,0,1,0,6,1,4,1
fxsave,fxsave,,0,0,0,0,1,0,9,1
autocommand,autocommand,,1,0,0,1,1,1,9,1
plinq,plinq,,6,2,4,8,11,12,8,1
eclipse-formatter,eclipse-formatter,,2,0,3,2,5,5,3,1
pytube,pytube,,14,13,10,27,19,37,0,1
formik,formik,,137,131,123,268,54,391,1,1
neural-mt,neural-mt,,3,1,1,4,7,5,0,1
illegalmonitorstateexcep,illegalmonitorstateexcep,,0,1,1,1,3,2,3,1
firewire,firewire,,0,0,1,0,2,1,9,1
sysml,sysml,,1,4,3,5,6,8,3,300
hip,hip,,0,0,2,0,1,2,9,1
integrator,integrator,,1,3,7,4,3,11,0,200
ibm-infosphere,ibm-infosphere,,5,6,10,11,5,21,4,20
itemdatabound,itemdatabound,,1,0,1,1,3,2,8,1
attr-encrypted,attr-encrypted,,1,0,4,1,6,5,12,1
pylons,pylons,,2,1,6,3,6,9,0,1
fts3,fts3,,1,1,0,2,3,2,3,1
tone-analyzer,tone-analyzer,,2,0,3,2,8,5,6,1
eslintignore,eslintignore,,1,0,2,1,5,3,1,1
eslintrc,eslintrc,,14,12,38,26,44,64,1,1
rspec-api-documentation,rspec-api-documentation,,0,3,1,3,3,4,12,200
apitome,apitome,,1,0,1,1,3,2,12,1
targetnullvalue,targetnullvalue,,1,0,2,1,1,3,8,1
yii2-module,yii2-module,,1,0,1,1,3,2,4,1
reportservice2010,reportservice2010,,0,1,0,1,1,1,3,1
sass-rails,sass-rails,,0,0,3,0,1,3,12,1
f-alloy,f-alloy,,0,0,0,0,1,0,17,1
lightning-workbench,lightning-workbench,,0,0,0,0,1,0,17,1
american-fuzzy-lop,american-fuzzy-lop,,1,1,6,2,3,8,9,1
web-essentials,web-essentials,,1,2,5,3,8,8,8,100
angular2-cookie,angular2-cookie,,0,0,0,0,1,0,1,1
chrome-options,chrome-options,,3,3,11,6,13,17,3,1
python-pool,python-pool,,2,2,4,4,4,8,0,1
cascade-classifier,cascade-classifier,,2,4,5,6,21,11,0,100
django-errors,django-errors,,4,0,6,4,10,10,0,1
netpbm,netpbm,,2,1,0,3,2,3,0,1
drupal-templates,drupal-templates,,2,2,4,4,4,8,4,1
xlsx-js,xlsx-js,,1,2,0,3,2,3,1,100
sheetjs,sheetjs,,18,10,26,28,32,54,1,1
typed-factory-facility,typed-factory-facility,,0,1,0,1,3,1,8,1
web-fragment,web-fragment,,0,2,2,2,2,4,3,100
koloda,koloda,,0,0,0,0,4,0,13,1
movable,movable,,0,1,1,1,2,2,1,1
argument-error,argument-error,,4,1,4,5,6,9,12,1
connect-timeout,connect-timeout,,1,0,0,1,1,1,3,1
twtrcomposer,twtrcomposer,,0,0,0,0,1,0,13,1
minidump,minidump,,1,4,6,5,7,11,9,300
eclim,eclim,,1,0,3,1,4,4,3,1
firebasesimplelogin,firebasesimplelogin,,0,0,0,0,1,0,13,1
metaspace,metaspace,,4,2,9,6,11,15,3,1
easendmail,easendmail,,0,1,1,1,2,2,8,1
conditional-comments,conditional-comments,,1,0,4,1,3,5,1,1
search-multiple-words,search-multiple-words,,0,0,0,0,2,0,4,1
amasty,amasty,,3,0,3,3,3,6,4,1
window.onunload,window.onunload,,1,0,5,1,6,6,1,1
libtorrent-rasterbar,libtorrent-rasterbar,,2,3,1,5,3,6,9,50
bc4j,bc4j,,0,0,0,0,1,0,3,1
novnc,novnc,,1,1,1,2,3,3,9,1
multiple-accounts,multiple-accounts,,0,2,2,2,3,4,4,100
tscrollbox,tscrollbox,,0,1,2,1,1,3,9,1
digital-assets,digital-assets,,0,1,0,1,1,1,13,1
sdcc,sdcc,,2,0,3,2,4,5,9,1
bounding,bounding,,0,3,1,3,5,4,1,200
open-policy-agent,open-policy-agent,,2,5,2,7,1,9,6,150
marie,marie,,3,1,7,4,5,11,9,1
imageresizer,imageresizer,,8,2,13,10,18,23,8,1
jqbootstrapvalidation,jqbootstrapvalidation,,1,2,3,3,2,6,1,100
django-uploads,django-uploads,,2,3,4,5,9,9,0,50
custom-pages,custom-pages,,1,2,4,3,11,7,4,100
wrangle,wrangle,,2,2,1,4,3,5,0,1
combiners,combiners,,2,0,1,2,10,3,0,1
assisted-inject,assisted-inject,,0,1,5,1,6,6,3,1
overlapping-instances,overlapping-instances,,3,1,1,4,3,5,2,1
sharepoint-object-model,sharepoint-object-model,,0,0,1,0,4,1,8,1
ilrepack,ilrepack,,0,0,1,0,5,1,8,1
syntaxhighlighter,syntaxhighlighter,,2,0,2,2,6,4,1,1
mashape,mashape,,2,0,4,2,6,6,4,1
outerhtml,outerhtml,,2,1,5,3,5,8,1,1
onnewintent,onnewintent,,1,1,1,2,9,3,3,1
m2doc,m2doc,,1,0,0,1,1,1,3,1
azure-runbook,azure-runbook,,15,17,27,32,42,59,8,13.333333
openinventor,openinventor,,0,0,0,0,2,0,6,1
sustainsys-saml2,sustainsys-saml2,,20,15,28,35,20,63,8,1
review-board,review-board,,0,1,4,1,4,5,6,1
email-forwarding,email-forwarding,,3,2,3,5,3,8,4,1
xtea,xtea,,0,0,0,0,2,0,6,1
express-vhost,express-vhost,,0,0,0,0,6,0,1,1
remote-backup,remote-backup,,0,1,4,1,4,5,4,1
spring-dm,spring-dm,,0,0,2,0,4,2,3,1
vuex-modules,vuex-modules,,19,19,53,38,53,91,1,1
apache-commons-digester,apache-commons-digester,,0,0,2,0,2,2,3,1
domain-calculus,domain-calculus,,0,0,1,0,1,1,4,1
boost-preprocessor,boost-preprocessor,,1,0,2,1,9,3,9,1
call-recording,call-recording,,5,12,10,17,21,27,3,140
htonl,htonl,,0,0,2,0,3,2,9,1
voice-interaction,voice-interaction,,0,1,0,1,3,1,3,1
svndump,svndump,,0,0,1,0,1,1,6,1
3gp,3gp,,0,0,1,0,5,1,13,1
regex101,regex101,,1,0,2,1,4,3,0,1
invalid-url,invalid-url,,0,0,0,0,1,0,4,1
logfile-analysis,logfile-analysis,,1,1,3,2,4,5,9,1
msn,msn,,0,0,0,0,1,0,4,1
nhibernate-configuration,nhibernate-configuration,,0,0,0,0,2,0,3,1
fastlane-deliver,fastlane-deliver,,1,2,0,3,6,3,13,100
gelly,gelly,,1,0,2,1,7,3,2,1
symfony-process,symfony-process,,0,3,6,3,3,9,4,200
img-area-select-jquery,img-area-select-jquery,,0,1,1,1,1,2,8,1
onupdate,onupdate,,1,1,1,2,5,3,3,1
working-copy,working-copy,,0,0,1,0,1,1,6,1
liblog,liblog,,0,1,1,1,3,2,8,1
mountebank,mountebank,,0,2,2,2,7,4,3,100
adversarial-machines,adversarial-machines,,1,1,0,2,4,2,0,1
property-graph,property-graph,,2,0,4,2,2,6,2,1
mouse-listeners,mouse-listeners,,1,0,1,1,4,2,3,1
web2py-modules,web2py-modules,,1,1,7,2,8,9,0,1
navigateurl,navigateurl,,3,2,3,5,6,8,1,1
big5,big5,,0,2,0,2,2,2,0,100
password-confirmation,password-confirmation,,0,1,2,1,2,3,1,1
lava,lava,,1,0,1,1,2,2,2,1
dstore,dstore,,1,0,2,1,4,3,1,1
htdocs,htdocs,,1,0,10,1,8,11,4,1
codemaid,codemaid,,1,0,1,1,1,2,8,1
imagej-hyperstack,imagej-hyperstack,,0,0,0,0,1,0,0,1
hreflang,hreflang,,3,3,7,6,7,13,4,1
edn,edn,,1,0,1,1,5,2,2,1
freeboard,freeboard,,0,0,0,0,6,0,1,1
ecos,ecos,,0,1,2,1,2,3,9,1
javascript-databinding,javascript-databinding,,2,2,2,4,6,6,1,1
dbref,dbref,,3,1,1,4,5,5,1,1
couchdb-1.6,couchdb-1.6,,0,1,0,1,2,1,1,1
xslf,xslf,,0,1,0,1,2,1,3,1
whmcs-invoice-template,whmcs-invoice-template,,0,3,0,3,7,3,4,200
webdatagrid,webdatagrid,,2,0,4,2,3,6,8,1
event-capturing,event-capturing,,2,0,0,2,5,2,1,1
tidyselect,tidyselect,,4,2,0,6,11,6,0,1
foswiki,foswiki,,0,0,1,0,1,1,8,1
email-router,email-router,,0,0,2,0,1,2,8,1
swrlapi,swrlapi,,0,0,1,0,5,1,2,1
push-diffusion,push-diffusion,,0,0,4,0,2,4,1,1
mui,mui,,2,4,6,6,5,12,1,100
ner,ner,,52,33,53,85,66,138,0,1
bcel,bcel,,2,0,1,2,5,3,3,1
openfoam,openfoam,,7,8,12,15,20,27,0,14.285714
onejar,onejar,,1,1,2,2,3,4,3,1
cordova-media-plugin,cordova-media-plugin,,5,2,1,7,6,8,1,1
add-type,add-type,,0,1,2,1,1,3,8,1
r.js,r.js,,0,0,1,0,5,1,1,1
kendo-ui-vue,kendo-ui-vue,,1,1,8,2,9,10,1,1
bnd,bnd,,4,6,10,10,17,20,3,50
assembly-reference-path,assembly-reference-path,,0,0,0,0,1,0,13,1
sql-server-2014-localdb,sql-server-2014-localdb,,0,2,1,2,3,3,8,100
multilevel-analysis,multilevel-analysis,,8,8,23,16,11,39,0,1
immediate-mode,immediate-mode,,0,2,0,2,1,2,8,100
nipype,nipype,,2,0,2,2,4,4,0,1
stumbleupon,stumbleupon,,0,0,0,0,1,0,4,1
lazylist,lazylist,,0,1,1,1,4,2,2,1
hocon,hocon,,3,1,6,4,6,10,2,1
mglmapview,mglmapview,,1,2,7,3,11,10,13,100
gee,gee,,2,2,4,4,10,8,0,1
ant-colony,ant-colony,,3,1,9,4,5,13,0,1
aerospike-loader,aerospike-loader,,0,0,0,0,4,0,3,1
ibis,ibis,,4,2,2,6,1,8,0,1
ds9,ds9,,0,0,1,0,1,1,1,1
inittab,inittab,,0,1,2,1,2,3,9,1
handoff,handoff,,0,1,4,1,3,5,13,1
get-mapping,get-mapping,,2,1,3,3,3,6,3,1
lifo,lifo,,2,2,1,4,3,5,9,1
external-sorting,external-sorting,,2,2,7,4,7,11,0,1
readlink,readlink,,0,2,2,2,4,4,9,100
device-context,device-context,,0,3,1,3,6,4,9,200
jqpivot,jqpivot,,0,0,0,0,4,0,1,1
designview,designview,,0,0,0,0,2,0,8,1
maven-shade-plugin,maven-shade-plugin,,15,11,30,26,41,56,3,1
android-scrollbar,android-scrollbar,,0,0,1,0,4,1,3,1
pyhoca-cli,pyhoca-cli,,0,0,0,0,1,0,9,1
data-consistency,data-consistency,,4,2,3,6,7,9,3,1
qubole,qubole,,5,3,6,8,16,14,2,1
sass-maps,sass-maps,,0,1,3,1,9,4,1,1
principalcontext,principalcontext,,1,5,9,6,14,15,8,400
php-pthread,php-pthread,,2,5,9,7,4,16,4,150
iso9660,iso9660,,0,0,1,0,3,1,9,1
gmetad,gmetad,,0,0,0,0,2,0,6,1
google-plus-one,google-plus-one,,0,0,0,0,3,0,5,1
pkgdown,pkgdown,,3,4,6,7,5,13,0,33.333333
jquery-week-calendar,jquery-week-calendar,,0,0,1,0,2,1,1,1
hypermedia,hypermedia,,1,1,4,2,2,6,3,1
es5-shim,es5-shim,,0,0,2,0,4,2,1,1
pyorient,pyorient,,1,3,5,4,12,9,2,200
crystal-reports-2016,crystal-reports-2016,,6,1,3,7,6,10,8,1
timefield,timefield,,1,1,4,2,2,6,0,1
vue-reactivity,vue-reactivity,,8,9,23,17,26,40,1,12.5
workflowservice,workflowservice,,0,0,0,0,3,0,6,1
terminal-ide,terminal-ide,,0,0,0,0,1,0,6,1
ionize,ionize,,0,0,0,0,1,0,1,1
binding.pry,binding.pry,,0,0,2,0,4,2,12,1
yellowbrick,yellowbrick,,2,3,2,5,3,7,0,50
slf4j-android,slf4j-android,,0,1,0,1,1,1,3,1
android-appstandby,android-appstandby,,0,0,0,0,2,0,3,1
quantopian,quantopian,,3,1,15,4,6,19,0,1
billboard.js,billboard.js,,2,2,7,4,24,11,1,1
powerbroker,powerbroker,,0,0,0,0,2,0,9,1
microsoft-speech-api,microsoft-speech-api,,3,0,10,3,13,13,6,1
atom-liveserver,atom-liveserver,,1,1,0,2,1,2,1,1
xdt,xdt,,0,2,2,2,3,4,8,100
assemblyresolve,assemblyresolve,,0,1,2,1,2,3,8,1
elasticsearch-6,elasticsearch-6,,36,26,79,62,119,141,6,1
prose,prose,,1,0,0,1,3,1,6,1
lifelines,lifelines,,4,4,4,8,5,12,0,1
sap-bw,sap-bw,,1,5,4,6,7,10,5,400
sql-search,sql-search,,0,0,1,0,1,1,4,1
concat-ws,concat-ws,,1,1,3,2,6,5,4,1
linkerd,linkerd,,2,2,4,4,3,8,6,1
sshkit,sshkit,,0,0,2,0,2,2,12,1
ghc-generics,ghc-generics,,0,1,1,1,3,2,2,1
printscreen,printscreen,,0,2,4,2,1,6,1,100
piracy,piracy,,0,0,0,0,1,0,1,1
narrator,narrator,,3,2,8,5,6,13,8,1
nodechildren,nodechildren,,0,0,0,0,5,0,1,1
always-on-top,always-on-top,,3,0,3,3,7,6,1,1
droidparts,droidparts,,0,0,0,0,1,0,3,1
xml-comments,xml-comments,,3,4,9,7,10,16,8,33.333333
jsonpointer,jsonpointer,,0,2,2,2,2,4,1,100
audioeffect,audioeffect,,2,0,5,2,1,7,3,1
ansys,ansys,,2,1,7,3,4,10,0,1
alt-attribute,alt-attribute,,0,0,1,0,2,1,1,1
customizing,customizing,,1,4,3,5,4,8,1,300
jovo-framework,jovo-framework,,6,5,5,11,16,16,6,1
session-0-isolation,session-0-isolation,,0,2,0,2,1,2,8,100
cujojs,cujojs,,0,1,0,1,1,1,3,1
safari-app-extension,safari-app-extension,,5,4,23,9,15,32,13,1
zk-grid,zk-grid,,0,0,2,0,3,2,3,1
pdo-odbc,pdo-odbc,,0,0,2,0,3,2,4,1
playready,playready,,0,2,5,2,5,7,3,100
pssh,pssh,,2,1,3,3,4,6,9,1
libxl,libxl,,1,0,2,1,6,3,9,1
consoleappender,consoleappender,,0,0,0,0,1,0,3,1
android-vibration,android-vibration,,2,3,9,5,13,14,3,50
information-visualization,information-visualization,,0,1,0,1,1,1,0,1
visual-testing,visual-testing,,4,2,2,6,2,8,3,1
alexa-rank,alexa-rank,,0,0,0,0,2,0,5,1
avro4s,avro4s,,3,0,3,3,9,6,2,1
avrohugger,avrohugger,,0,0,2,0,1,2,2,1
jri,jri,,3,2,2,5,5,7,0,1
java.lang.class,java.lang.class,,1,0,2,1,6,3,3,1
djangocms-text-ckeditor,djangocms-text-ckeditor,,3,1,3,4,4,7,0,1
knockout-sortable,knockout-sortable,,0,0,1,0,4,1,1,1
fileopener2,fileopener2,,0,0,8,0,9,8,1,1
visudo,visudo,,1,0,2,1,4,3,9,1
umongo,umongo,,0,1,2,1,1,3,1,1
mongodb-cluster,mongodb-cluster,,3,1,7,4,10,11,1,1
sky,sky,,0,1,0,1,2,1,1,1
sequential-number,sequential-number,,2,1,2,3,4,5,9,1
symlink-traversal,symlink-traversal,,3,0,4,3,3,7,9,1
tsickle,tsickle,,0,0,0,0,3,0,1,1
imagesloaded,imagesloaded,,0,2,7,2,8,9,1,100
concreteclass,concreteclass,,0,0,0,0,3,0,9,1
rubinius,rubinius,,0,0,0,0,1,0,12,1
libffi,libffi,,0,2,3,2,4,5,0,100
image-clipping,image-clipping,,3,1,3,4,2,7,1,1
eot,eot,,0,0,1,0,1,1,1,1
openstack4j,openstack4j,,3,0,2,3,4,5,6,1
bittorrent-sync,bittorrent-sync,,0,0,1,0,1,1,9,1
type-stability,type-stability,,2,2,0,4,4,4,0,1
getresource,getresource,,8,2,8,10,11,18,3,1
google-ima,google-ima,,7,3,6,10,7,16,3,1
imasdk,imasdk,,3,1,7,4,6,11,3,1
service-factory,service-factory,,0,0,2,0,1,2,8,1
play-templates,play-templates,,0,0,1,0,1,1,2,1
libgit2sharp-ssh,libgit2sharp-ssh,,0,0,2,0,3,2,6,1
bitcoinj,bitcoinj,,1,2,7,3,19,10,6,100
apartments,apartments,,0,1,0,1,2,1,8,1
nsunknownkeyexception,nsunknownkeyexception,,0,2,2,2,8,4,13,100
pystan,pystan,,2,3,12,5,8,17,0,50
calliope,calliope,,0,0,0,0,1,0,18,1
roberta,roberta,,0,0,0,0,1,0,18,1
bitpay,bitpay,,0,0,1,0,6,1,6,1
resty-gwt,resty-gwt,,1,0,5,1,2,6,3,1
volume-shadow-service,volume-shadow-service,,1,2,2,3,4,5,9,100
jaudiotagger,jaudiotagger,,0,2,3,2,7,5,13,100
passport-google-oauth2,passport-google-oauth2,,7,4,9,11,13,20,1,1
copymemory,copymemory,,0,0,0,0,2,0,9,1
basicnamevaluepair,basicnamevaluepair,,1,0,0,1,3,1,3,1
jaxl,jaxl,,0,0,0,0,2,0,3,1
zend-guard,zend-guard,,0,0,0,0,3,0,4,1
piccolo,piccolo,,0,0,0,0,1,0,0,1
c++-faq,c++-faq,,0,1,0,1,1,1,9,1
submitchanges,submitchanges,,0,2,2,2,3,4,8,100
jcop,jcop,,1,1,1,2,13,3,3,1
red-gate-ants,red-gate-ants,,0,0,2,0,2,2,4,1
cfchart,cfchart,,2,1,1,3,3,4,4,1
android-drawable-importer,android-drawable-importer,,0,0,0,0,1,0,3,1
dart-js-interop,dart-js-interop,,2,1,6,3,13,9,13,1
solace-mq,solace-mq,,1,4,2,5,12,7,3,300
hypriot,hypriot,,0,0,3,0,3,3,6,1
djvu,djvu,,1,1,1,2,2,3,8,1
amember,amember,,0,2,1,2,1,3,4,100
hardware-port,hardware-port,,0,0,0,0,1,0,9,1
expression-body,expression-body,,0,1,0,1,2,1,8,1
airbrake,airbrake,,1,2,3,3,9,6,0,100
sasm,sasm,,0,0,5,0,7,5,9,1
api-linkpreview,api-linkpreview,,0,0,0,0,3,0,1,1
agile-project-management,agile-project-management,,0,0,2,0,4,2,6,1
azure-stack,azure-stack,,2,1,4,3,18,7,8,1
zero-copy,zero-copy,,1,0,3,1,7,4,9,1
domoticz,domoticz,,2,3,5,5,5,10,0,50
custom-transition,custom-transition,,1,0,5,1,4,6,13,1
mod-verto,mod-verto,,0,0,3,0,3,3,1,1
outgoing-call,outgoing-call,,2,1,1,3,5,4,3,1
fortify-source,fortify-source,,3,1,1,4,2,5,3,1
idempiere,idempiere,,0,1,0,1,8,1,3,1
cloudera-director,cloudera-director,,0,0,1,0,1,1,2,1
mysql-odbc-connector,mysql-odbc-connector,,0,1,4,1,3,5,4,1
archer,archer,,10,3,5,13,9,18,5,1
rsa-archer-grc,rsa-archer-grc,,10,2,5,12,7,17,5,1
kohana-3,kohana-3,,0,0,1,0,3,1,4,1
magicknet,magicknet,,0,0,0,0,1,0,4,1
twinfield,twinfield,,0,0,0,0,4,0,4,1
inspections,inspections,,0,0,0,0,2,0,3,1
setitimer,setitimer,,1,0,1,1,4,2,9,1
tibco-designer,tibco-designer,,3,3,11,6,3,17,3,1
tablehtml,tablehtml,,0,0,0,0,5,0,0,1
dynamic-type-feature,dynamic-type-feature,,2,1,3,3,5,6,13,1
virtual-directory,virtual-directory,,9,6,13,15,27,28,8,1
const-string,const-string,,1,1,1,2,2,3,9,1
megasync,megasync,,0,0,0,0,1,0,9,1
suexec,suexec,,0,0,0,0,2,0,4,1
simblee,simblee,,0,0,0,0,2,0,3,1
subinacl,subinacl,,0,0,0,0,3,0,9,1
scss-mixins,scss-mixins,,49,41,60,90,53,150,1,1
invert,invert,,0,1,1,1,5,2,0,1
luci,luci,,1,3,3,4,12,7,9,200
pharocloud,pharocloud,,0,0,1,0,2,1,13,1
pharo-5,pharo-5,,0,0,1,0,16,1,13,1
gridle,gridle,,0,1,0,1,5,1,1,1
imgsource,imgsource,,0,0,1,0,2,1,1,1
synthetica,synthetica,,0,0,1,0,1,1,3,1
html-to-text,html-to-text,,2,1,1,3,1,4,8,1
papertrail-app,papertrail-app,,4,3,3,7,8,10,1,1
rubyxl,rubyxl,,1,0,2,1,4,3,12,1
rows-affected,rows-affected,,0,0,2,0,6,2,4,1
double-free,double-free,,5,1,5,6,9,11,9,1
disconnection,disconnection,,3,1,3,4,3,7,1,1
responsibility,responsibility,,1,0,0,1,3,1,9,1
end-user,end-user,,2,0,0,2,4,2,4,1
arq,arq,,1,1,4,2,4,6,2,1
java-scripting-engine,java-scripting-engine,,0,2,2,2,2,4,3,100
undecidable-instances,undecidable-instances,,0,0,1,0,2,1,2,1
cpu-speed,cpu-speed,,1,1,3,2,8,5,0,1
dojox.mobile,dojox.mobile,,0,0,4,0,1,4,1,1
binary-compatibility,binary-compatibility,,1,0,4,1,4,5,9,1
iterate,iterate,,0,0,0,0,5,0,0,1
android-stlport,android-stlport,,0,0,0,0,1,0,3,1
itcl,itcl,,0,1,1,1,11,2,0,1
sqljdbc,sqljdbc,,2,0,4,2,4,6,3,1
ess,ess,,2,3,7,5,15,12,9,50
struts2-jquery,struts2-jquery,,2,5,7,7,3,14,3,150
node-mitm,node-mitm,,1,0,0,1,1,1,1,1
nrvo,nrvo,,2,3,8,5,8,13,9,50
msan,msan,,1,1,0,2,1,2,9,1
laravel-auditing,laravel-auditing,,4,0,7,4,5,11,4,1
hoverfly,hoverfly,,0,2,1,2,5,3,3,100
accent-sensitive,accent-sensitive,,0,1,5,1,8,6,0,1
react-native-debugger,react-native-debugger,,4,8,10,12,12,22,1,100
mongodb-replica,mongodb-replica,,0,0,1,0,2,1,1,1
mvc.jquery.datatables,mvc.jquery.datatables,,4,1,1,5,2,6,8,1
sysv-ipc,sysv-ipc,,1,0,2,1,3,3,9,1
execfile,execfile,,1,1,5,2,5,7,1,1
asplinkbutton,asplinkbutton,,1,2,7,3,3,10,8,100
ggimage,ggimage,,3,0,1,3,9,4,0,1
heap-fragmentation,heap-fragmentation,,1,0,1,1,2,2,9,1
oncreateoptionsmenu,oncreateoptionsmenu,,2,2,4,4,8,8,3,1
openstruct,openstruct,,0,0,0,0,4,0,12,1
pyral,pyral,,2,5,10,7,9,17,3,150
toplink,toplink,,0,0,1,0,4,1,3,1
x-accel-redirect,x-accel-redirect,,1,1,4,2,2,6,6,1
tizen-sdb,tizen-sdb,,0,0,0,0,1,0,13,1
tizen-sdk,tizen-sdk,,0,0,0,0,2,0,13,1
copy-and-swap,copy-and-swap,,0,0,1,0,4,1,9,1
twilio-twiml,twilio-twiml,,4,5,6,9,16,15,13,25
biplot,biplot,,1,2,6,3,5,9,0,100
channeladvisor,channeladvisor,,0,0,0,0,2,0,14,1
icingaweb2,icingaweb2,,1,1,3,2,6,5,6,1
efxclipse,efxclipse,,7,1,11,8,13,19,3,1
remote-login,remote-login,,0,2,2,2,3,4,4,100
koala-gem,koala-gem,,0,1,0,1,3,1,12,1
corosync,corosync,,3,7,6,10,8,16,9,133.333333
pip3,pip3,,0,0,0,0,12,0,0,1
indico,indico,,0,0,0,0,2,0,4,1
scalajs-bundler,scalajs-bundler,,5,7,2,12,8,14,2,40
nerdcommenter,nerdcommenter,,0,0,0,0,1,0,9,1
soundtouch,soundtouch,,1,1,5,2,5,7,8,1
ejb-timer,ejb-timer,,2,0,1,2,3,3,3,1
vips,vips,,12,3,11,15,9,26,0,1
initialization-block,initialization-block,,0,0,2,0,1,2,3,1
evenly,evenly,,0,0,1,0,1,1,0,1
dynpro,dynpro,,0,0,1,0,7,1,5,1
embedding-lookup,embedding-lookup,,1,0,1,1,5,2,0,1
hikvision,hikvision,,3,5,7,8,3,15,13,66.666667
windows-error-reporting,windows-error-reporting,,1,4,3,5,5,8,9,300
mustache.php,mustache.php,,2,4,2,6,6,8,4,100
mruby,mruby,,1,1,1,2,4,3,12,1
django-contenttypes,django-contenttypes,,3,1,6,4,8,10,0,1
pyquery,pyquery,,0,1,4,1,8,5,0,1
ietf-bcp-47,ietf-bcp-47,,1,2,1,3,2,4,9,100
pass-by-pointer,pass-by-pointer,,2,1,5,3,7,8,9,1
go-echo,go-echo,,9,5,7,14,5,21,6,1
tightvnc,tightvnc,,0,2,5,2,3,7,9,100
node-uuid,node-uuid,,1,0,0,1,2,1,1,1
test-more,test-more,,0,0,0,0,1,0,3,1
xmlschemaset,xmlschemaset,,0,0,4,0,4,4,3,1
floating-point-conversion,floating-point-conversion,,2,3,4,5,7,9,0,50
build-rules,build-rules,,0,0,3,0,2,3,9,1
bazel-extra-action,bazel-extra-action,,1,0,1,1,4,2,9,1
textfieldparser,textfieldparser,,0,1,2,1,4,3,8,1
webots,webots,,10,9,8,19,4,27,0,1
renpy,renpy,,4,4,6,8,11,14,0,1
laravel-orm,laravel-orm,,2,1,1,3,10,4,4,1
redefine,redefine,,0,1,0,1,3,1,0,1
perl5,perl5,,1,12,7,13,18,20,9,1100
mysql-error-1292,mysql-error-1292,,0,1,5,1,5,6,4,1
web-developer-toolbar,web-developer-toolbar,,0,2,9,2,5,11,1,100
nscontrol,nscontrol,,1,1,4,2,2,6,13,1
crossword,crossword,,1,1,5,2,4,7,0,1
excel-2011,excel-2011,,1,0,3,1,1,4,5,1
midi.js,midi.js,,0,0,0,0,2,0,0,1
todoist,todoist,,2,2,1,4,3,5,0,1
unidac,unidac,,2,2,1,4,5,5,9,1
less-mixins,less-mixins,,2,0,1,2,6,3,1,1
bounded-quantification,bounded-quantification,,0,0,0,0,1,0,0,1
database-scripts,database-scripts,,0,0,0,0,2,0,4,1
musixmatch,musixmatch,,0,2,0,2,3,2,0,100
apache-camel-aws,apache-camel-aws,,2,4,0,6,10,6,3,100
select-into,select-into,,2,1,6,3,15,9,4,1
alchemy.js,alchemy.js,,0,1,1,1,2,2,1,1
pastry,pastry,,0,0,0,0,1,0,9,1
bevelled,bevelled,,0,1,1,1,1,2,13,1
latexmk,latexmk,,1,0,2,1,3,3,0,1
recovery-testing,recovery-testing,,0,0,0,0,1,0,3,1
cloudkit-environments,cloudkit-environments,,0,0,1,0,6,1,13,1
mkoverlay,mkoverlay,,3,6,8,9,7,17,13,100
database-agnostic,database-agnostic,,0,0,1,0,4,1,4,1
node-amqplib,node-amqplib,,5,5,13,10,12,23,3,1
actionbuilder,actionbuilder,,0,0,0,0,1,0,2,1
night-shift,night-shift,,0,0,0,0,1,0,3,1
oftype,oftype,,0,0,0,0,3,0,8,1
heterogeneous-array,heterogeneous-array,,1,0,5,1,4,6,9,1
apache-modules,apache-modules,,5,4,13,9,10,22,4,1
oslog,oslog,,1,0,8,1,2,9,13,1
slimdx,slimdx,,0,0,5,0,5,5,8,1
vecmath,vecmath,,0,0,0,0,1,0,3,1
yii2-api,yii2-api,,4,0,0,4,6,4,4,1
usmap,usmap,,1,1,5,2,1,7,0,1
foundation-interchange,foundation-interchange,,0,0,0,0,1,0,0,1
fortran95,fortran95,,11,3,6,14,27,20,9,1
django-channels-presence,django-channels-presence,,0,1,0,1,1,1,0,1
ddd-debugger,ddd-debugger,,3,1,2,4,5,6,9,1
apache-apex,apache-apex,,0,0,0,0,5,0,3,1
angular2-headers,angular2-headers,,0,0,1,0,1,1,1,1
lumen-5.5,lumen-5.5,,1,1,1,2,7,3,4,1
john-the-ripper,john-the-ripper,,1,0,2,1,1,3,9,1
sql-server-2012-web,sql-server-2012-web,,0,0,0,0,1,0,8,1
postgresql-8.3,postgresql-8.3,,0,0,1,0,5,1,4,1
geor,geor,,0,0,1,0,5,1,0,1
angularjs-module,angularjs-module,,1,0,3,1,7,4,1,1
user-thread,user-thread,,0,0,0,0,1,0,9,1
suman,suman,,0,0,0,0,1,0,1,1
cleditor,cleditor,,0,0,1,0,3,1,1,1
structure-from-motion,structure-from-motion,,2,4,3,6,13,9,0,100
statefulwidget,statefulwidget,,5,14,15,19,9,34,13,180
statelesswidget,statelesswidget,,5,2,7,7,1,14,13,1
android-profiler,android-profiler,,9,4,18,13,27,31,3,1
haraka,haraka,,2,2,2,4,1,6,4,1
surveillance,surveillance,,0,0,1,0,4,1,0,1
zero-width-space,zero-width-space,,1,3,3,4,4,7,0,200
fuelux,fuelux,,0,0,0,0,1,0,1,1
mozilla-deepspeech,mozilla-deepspeech,,4,4,7,8,8,15,0,1
vscodevim,vscodevim,,9,2,9,11,12,20,9,1
crosh,crosh,,0,0,0,0,1,0,1,1
dangling-else,dangling-else,,0,0,0,0,3,0,9,1
ml-agent,ml-agent,,2,2,6,4,4,10,8,1
getid3,getid3,,2,4,2,6,2,8,4,100
linear-probing,linear-probing,,0,2,4,2,3,6,0,100
ibm-voice-gateway,ibm-voice-gateway,,1,1,3,2,2,5,6,1
gulp-jshint,gulp-jshint,,0,0,0,0,2,0,1,1
sql-maven-plugin,sql-maven-plugin,,0,0,1,0,5,1,3,1
androidstudio-settings,androidstudio-settings,,0,0,0,0,2,0,3,1
taglist,taglist,,0,0,2,0,5,2,9,1
django-tinymce,django-tinymce,,7,4,3,11,5,14,0,1
erlang-nif,erlang-nif,,0,0,1,0,4,1,2,1
vue-strap,vue-strap,,0,0,0,0,8,0,1,1
mongodb-java-3.3.0,mongodb-java-3.3.0,,0,1,3,1,5,4,1,1
wix3.8,wix3.8,,2,2,7,4,13,11,8,1
kite-sdk,kite-sdk,,0,0,0,0,3,0,3,1
idispatch,idispatch,,3,0,1,3,4,4,8,1
image-file,image-file,,0,2,2,2,6,4,4,100
laterjs,laterjs,,0,3,2,3,3,5,1,200
doskey,doskey,,4,0,3,4,3,7,9,1
uipi,uipi,,1,1,2,2,1,4,8,1
timex,timex,,5,0,3,5,4,8,2,1
android-sliding,android-sliding,,1,0,2,1,5,3,3,1
ocaml-toplevel,ocaml-toplevel,,2,0,1,2,6,3,0,1
javaparser,javaparser,,5,5,16,10,18,26,3,1
sql-server-group-concat,sql-server-group-concat,,1,0,1,1,2,2,4,1
soapexception,soapexception,,0,1,1,1,3,2,3,1
troposphere,troposphere,,4,11,8,15,6,23,6,175
badparcelableexception,badparcelableexception,,0,1,0,1,4,1,3,1
rajawalivr,rajawalivr,,0,0,0,0,1,0,3,1
jbossws,jbossws,,0,3,1,3,1,4,3,200
pdfhtml,pdfhtml,,3,1,6,4,3,10,8,1
ionic-zip,ionic-zip,,1,2,0,3,5,3,8,100
episerver-find,episerver-find,,0,0,2,0,2,2,8,1
simplemembership,simplemembership,,0,2,3,2,4,5,8,100
launch4j,launch4j,,9,8,22,17,23,39,3,1
deployr,deployr,,0,0,3,0,1,3,0,1
cachingframework.redis,cachingframework.redis,,0,0,1,0,3,1,8,1
angular2-rc5,angular2-rc5,,0,0,0,0,1,0,1,1
sdmx,sdmx,,0,1,4,1,6,5,0,1
html5-notifications,html5-notifications,,1,1,0,2,4,2,1,1
bosun,bosun,,1,0,2,1,5,3,2,1
jscript.net,jscript.net,,0,3,5,3,2,8,8,200
maplist,maplist,,0,0,3,0,2,3,0,1
sqlite-json1,sqlite-json1,,7,1,4,8,7,12,3,1
lnk2001,lnk2001,,2,3,9,5,8,14,9,50
usb-hostcontroller,usb-hostcontroller,,3,3,4,6,5,10,3,1
sap-lumira,sap-lumira,,0,0,1,0,3,1,5,1
ms-access-2000,ms-access-2000,,1,2,0,3,5,3,5,100
react-toggle,react-toggle,,0,0,0,0,1,0,1,1
iterator-traits,iterator-traits,,0,0,3,0,3,3,9,1
snapping,snapping,,2,0,3,2,4,5,3,1
api-authorization,api-authorization,,2,5,3,7,8,10,4,150
uibarmetrics,uibarmetrics,,0,0,0,0,1,0,13,1
flask-sockets,flask-sockets,,3,1,2,4,1,6,0,1
target-audience,target-audience,,1,4,2,5,3,7,13,300
dib,dib,,1,0,0,1,5,1,9,1
jest-fetch-mock,jest-fetch-mock,,3,2,14,5,4,19,1,1
pathing,pathing,,1,0,1,1,4,2,0,1
jaxbelement,jaxbelement,,1,2,1,3,6,4,3,100
pointofservice,pointofservice,,1,4,4,5,4,9,8,300
angular2-security,angular2-security,,0,1,0,1,1,1,1,1
leveldown,leveldown,,0,0,2,0,3,2,1,1
levelup,levelup,,0,0,1,0,4,1,1,1
rendertransform,rendertransform,,4,2,4,6,3,10,8,1
hierarchyid,hierarchyid,,0,1,4,1,6,5,4,1
scala-repl,scala-repl,,2,0,5,2,8,7,2,1
depot,depot,,0,0,0,0,1,0,9,1
http-status-code-429,http-status-code-429,,1,7,13,8,12,21,4,600
executemany,executemany,,9,2,7,11,11,18,0,1
flask-kvsession,flask-kvsession,,0,0,1,0,1,1,0,1
haskell-wai,haskell-wai,,1,0,4,1,4,5,2,1
time-travel,time-travel,,0,1,1,1,1,2,12,1
pyvenv,pyvenv,,1,1,1,2,3,3,0,1
gorouter,gorouter,,0,1,0,1,2,1,3,1
pyobject,pyobject,,1,1,1,2,5,3,0,1
ei,ei,,3,1,13,4,7,17,14,1
loggerfactory,loggerfactory,,1,1,11,2,5,13,3,1
seam-conversation,seam-conversation,,0,0,0,0,1,0,3,1
rejson,rejson,,2,2,8,4,5,12,3,1
marvin-framework,marvin-framework,,2,1,2,3,2,5,3,1
lemon-graph-library,lemon-graph-library,,2,0,2,2,3,4,9,1
fog-google,fog-google,,0,1,0,1,1,1,12,1
fulfillment,fulfillment,,6,3,27,9,30,36,13,1
antlrworks2,antlrworks2,,0,0,0,0,1,0,0,1
self-intersection,self-intersection,,0,0,1,0,2,1,0,1
outdir,outdir,,0,0,1,0,1,1,1,1
android-sourcesets,android-sourcesets,,1,0,2,1,2,3,3,1
security-identifier,security-identifier,,0,0,0,0,1,0,8,1
dispy,dispy,,0,1,5,1,3,6,0,1
posprinter,posprinter,,0,3,4,3,3,7,8,200
numeric-limits,numeric-limits,,1,4,1,5,10,6,9,300
wavelet-transform,wavelet-transform,,3,4,5,7,12,12,0,33.333333
dbfunctions,dbfunctions,,1,0,5,1,4,6,8,1
rule-of-zero,rule-of-zero,,1,0,0,1,1,1,9,1
test.check,test.check,,1,0,4,1,2,5,2,1
gtkada,gtkada,,1,1,1,2,2,3,9,1
telegraf-output-plugins,telegraf-output-plugins,,4,3,1,7,1,8,6,1
server-farm,server-farm,,4,1,3,5,5,8,8,1
relstorage,relstorage,,0,0,0,0,2,0,0,1
pegjs,pegjs,,1,5,4,6,5,10,0,400
milton,milton,,1,0,1,1,1,2,4,1
tactionmanager,tactionmanager,,0,0,0,0,1,0,9,1
buckminster,buckminster,,0,0,0,0,2,0,3,1
figures,figures,,0,0,0,0,6,0,0,1
git-crypt,git-crypt,,2,2,2,4,3,6,6,1
crossrider,crossrider,,0,0,0,0,1,0,1,1
kango-framework,kango-framework,,0,0,0,0,1,0,1,1
ecb,ecb,,2,1,13,3,11,16,6,1
artillery,artillery,,7,9,7,16,12,23,1,28.571429
sttwitterapi,sttwitterapi,,6,5,7,11,16,18,0,1
general-log,general-log,,0,0,0,0,3,0,4,1
jpcap,jpcap,,1,1,1,2,3,3,9,1
cm-synergy,cm-synergy,,0,1,0,1,1,1,6,1
htmltext,htmltext,,0,2,0,2,4,2,3,100
getwindowlong,getwindowlong,,0,0,1,0,1,1,8,1
cleverhans,cleverhans,,7,11,7,18,1,25,0,57.142857
osx-chameleon,osx-chameleon,,0,0,0,0,2,0,13,1
sap-crm,sap-crm,,0,10,4,10,1,14,5,900
sysfs,sysfs,,6,0,8,6,18,14,9,1
clistctrl,clistctrl,,2,2,7,4,6,11,9,1
subsystem,subsystem,,1,2,3,3,7,6,9,100
jquery-bar-rating,jquery-bar-rating,,0,0,0,0,1,0,1,1
hook-menu,hook-menu,,0,1,1,1,2,2,4,1
team-explorer,team-explorer,,3,6,14,9,25,23,8,100
graphhopper,graphhopper,,5,2,7,7,9,14,3,1
synthetic,synthetic,,2,2,8,4,6,12,3,1
prefixheader.pch,prefixheader.pch,,0,0,1,0,1,1,13,1
material-components-web,material-components-web,,2,4,17,6,36,23,3,100
misspelling,misspelling,,0,0,4,0,4,4,0,1
uitextinputtraits,uitextinputtraits,,1,0,0,1,1,1,13,1
ewsjavaapi,ewsjavaapi,,1,1,4,2,12,6,8,1
xl-deploy,xl-deploy,,6,3,8,9,7,17,6,1
scriptcontrol,scriptcontrol,,1,2,0,3,2,3,5,100
msscriptcontrol,msscriptcontrol,,1,2,1,3,1,4,5,100
form-post,form-post,,0,4,2,4,3,6,1,300
mapdb,mapdb,,2,1,7,3,11,10,3,1
remote-input,remote-input,,0,0,2,0,6,2,3,1
maven-install-plugin,maven-install-plugin,,1,1,4,2,7,6,3,1
vue-test-utils,vue-test-utils,,50,53,103,103,69,206,1,6
ipp-protocol,ipp-protocol,,0,2,1,2,3,3,8,100
macvlan,macvlan,,7,4,7,11,9,18,6,1
c17,c17,,2,2,3,4,4,7,9,1
atoum,atoum,,1,0,0,1,1,1,1,1
nats-streaming-server,nats-streaming-server,,5,2,8,7,6,15,6,1
destruction,destruction,,1,3,0,4,9,4,9,200
ardent,ardent,,0,0,0,0,1,0,4,1
perfecto,perfecto,,0,4,3,4,5,7,3,300
lime,lime,,6,6,8,12,16,20,0,1
srid,srid,,1,1,1,2,4,3,4,1
consensys-truffle,consensys-truffle,,0,0,2,0,14,2,6,1
alluxio,alluxio,,1,3,8,4,12,12,2,200
ase,ase,,0,3,1,3,3,4,4,200
envi,envi,,4,2,2,6,2,8,0,1
xhtml-transitional,xhtml-transitional,,1,0,0,1,2,1,3,1
webshim,webshim,,0,2,3,2,1,5,1,100
conceptual-model,conceptual-model,,3,0,4,3,3,7,4,1
map-directions,map-directions,,3,4,8,7,9,15,1,33.333333
uchiwa,uchiwa,,1,0,1,1,1,2,6,1
freetexttable,freetexttable,,0,1,0,1,2,1,4,1
droptarget,droptarget,,0,0,0,0,1,0,3,1
gpiozero,gpiozero,,4,5,10,9,6,19,0,25
natsort,natsort,,0,0,2,0,3,2,0,1
odata-connected-service,odata-connected-service,,1,1,2,2,2,4,8,1
eclipse-classpath,eclipse-classpath,,2,1,2,3,14,5,3,1
sigar,sigar,,2,1,0,3,5,3,3,1
a2x,a2x,,0,0,0,0,1,0,3,1
react-native-ui-kitten,react-native-ui-kitten,,1,7,2,8,1,10,1,600
ngx-clipboard,ngx-clipboard,,0,0,3,0,5,3,1,1
gcdwebserver,gcdwebserver,,3,1,1,4,5,5,13,1
memcachedb,memcachedb,,0,0,0,0,1,0,9,1
formatjs,formatjs,,0,0,0,0,4,0,1,1
weave,weave,,6,4,16,10,17,26,6,1
asp.net-mvc-filters,asp.net-mvc-filters,,0,0,1,0,5,1,8,1
liblinear,liblinear,,3,1,0,4,7,4,0,1
throwable,throwable,,1,0,5,1,18,6,3,1
emojione,emojione,,3,1,5,4,12,9,1,1
drawstring,drawstring,,1,2,14,3,11,17,8,100
gimpfu,gimpfu,,0,1,7,1,10,8,0,1
phonebook,phonebook,,0,0,3,0,7,3,3,1
real-number,real-number,,0,1,0,1,7,1,0,1
angularjs-fileupload,angularjs-fileupload,,0,0,0,0,10,0,1,1
visual-c++-2008,visual-c++-2008,,0,1,1,1,2,2,9,1
motorola-emdk,motorola-emdk,,4,3,0,7,6,7,8,1
meekro,meekro,,1,0,0,1,3,1,4,1
fla,fla,,0,0,1,0,2,1,13,1
spring-cloud-connectors,spring-cloud-connectors,,3,1,2,4,2,6,3,1
yandex-maps,yandex-maps,,3,2,15,5,15,20,3,1
premature-optimization,premature-optimization,,1,1,0,2,1,2,9,1
rubymotion,rubymotion,,1,0,2,1,4,3,13,1
formotion,formotion,,0,0,0,0,1,0,13,1
aegis,aegis,,0,0,1,0,1,1,3,1
url-link,url-link,,0,0,0,0,1,0,1,1
mockrestserviceserver,mockrestserviceserver,,0,1,0,1,3,1,3,1
net-use,net-use,,5,2,6,7,6,13,4,1
crlf-vulnerability,crlf-vulnerability,,1,4,2,5,6,7,3,300
pact-python,pact-python,,0,0,2,0,4,2,3,1
gifsicle,gifsicle,,0,0,2,0,4,2,12,1
cedet,cedet,,0,1,0,1,1,1,9,1
emacs-semantic,emacs-semantic,,0,1,0,1,2,1,9,1
color-codes,color-codes,,1,2,0,3,5,3,1,100
long-click,long-click,,0,1,1,1,6,2,3,1
adornerlayer,adornerlayer,,1,0,1,1,2,2,8,1
oxm,oxm,,0,0,0,0,2,0,3,1
disk-io,disk-io,,1,2,8,3,5,11,9,100
progressive-download,progressive-download,,0,0,1,0,3,1,3,1
python-mss,python-mss,,5,1,10,6,15,16,0,1
content-platform-engine,content-platform-engine,,0,0,1,0,3,1,15,1
import-libraries,import-libraries,,1,0,1,1,4,2,9,1
cknotification,cknotification,,0,0,0,0,2,0,13,1
hourglass,hourglass,,1,2,3,3,3,6,3,100
virtual-network,virtual-network,,2,2,5,4,5,9,6,1
regsub,regsub,,0,2,3,2,4,5,0,100
letters-and-numbers,letters-and-numbers,,0,0,2,0,1,2,0,1
sqldependencyex,sqldependencyex,,1,0,1,1,1,2,8,1
coderay,coderay,,0,0,1,0,1,1,12,1
sos,sos,,5,2,9,7,10,16,9,1
flamegraph,flamegraph,,1,5,2,6,6,8,9,400
git-server,git-server,,1,0,6,1,7,7,6,1
craftcms,craftcms,,9,19,34,28,19,62,4,111.111111
groovy-sql,groovy-sql,,0,0,0,0,3,0,4,1
clangpowertools,clangpowertools,,0,0,0,0,3,0,9,1
parser-generator,parser-generator,,1,4,7,5,5,12,0,300
timecodes,timecodes,,2,2,4,4,7,8,13,1
aframe-super-hands,aframe-super-hands,,0,0,1,0,5,1,1,1
resource-id,resource-id,,0,0,0,0,6,0,3,1
yui-pure-css,yui-pure-css,,0,0,1,0,3,1,1,1
ncl,ncl,,1,2,0,3,5,3,0,100
bit-banding,bit-banding,,0,0,0,0,1,0,9,1
lc3-trap,lc3-trap,,0,0,1,0,6,1,9,1
keystore-access,keystore-access,,0,0,0,0,3,0,3,1
jmap,jmap,,3,1,6,4,12,10,3,1
django-reversion,django-reversion,,4,0,0,4,6,4,0,1
seandroid,seandroid,,2,1,1,3,3,4,3,1
cakephp-debug-kit,cakephp-debug-kit,,0,0,1,0,3,1,4,1
tig,tig,,0,1,1,1,2,2,6,1
htmleditorkit,htmleditorkit,,0,0,2,0,4,2,3,1
rlmlinkingobjects,rlmlinkingobjects,,0,0,0,0,4,0,13,1
hdpi,hdpi,,1,2,4,3,6,7,3,100
member-access,member-access,,1,2,0,3,3,3,9,100
vendors,vendors,,0,0,0,0,3,0,4,1
openstacksdk,openstacksdk,,1,1,0,2,3,2,6,1
php-phantomjs,php-phantomjs,,0,1,0,1,7,1,4,1
sweepgradient,sweepgradient,,0,0,0,0,3,0,3,1
multi-query,multi-query,,1,1,0,2,5,2,4,1
annoy,annoy,,3,3,2,6,2,8,0,1
object-layout,object-layout,,0,0,0,0,4,0,9,1
jsprit,jsprit,,0,0,6,0,4,6,3,1
yfiles,yfiles,,0,0,1,0,6,1,3,1
epic,epic,,0,1,4,1,2,5,1,1
fiware-wirecloud,fiware-wirecloud,,8,0,4,8,15,12,6,1
dtls,dtls,,4,6,7,10,15,17,6,50
linden-scripting-language,linden-scripting-language,,0,0,0,0,2,0,1,1
orca,orca,,5,5,10,10,6,20,8,1
dedicated-hosting,dedicated-hosting,,1,0,0,1,1,1,4,1
okuma,okuma,,0,2,0,2,6,2,8,100
gradle-2,gradle-2,,0,0,0,0,1,0,3,1
django-contrib,django-contrib,,0,2,3,2,4,5,0,100
system-f,system-f,,1,1,1,2,3,3,2,1
ajax.net,ajax.net,,0,0,0,0,1,0,8,1
function.prototype,function.prototype,,0,0,1,0,2,1,1,1
git-post-receive,git-post-receive,,1,3,5,4,10,9,6,200
ucrop,ucrop,,1,0,5,1,4,6,3,1
pecl-event,pecl-event,,0,0,0,0,1,0,4,1
aurelia-ux,aurelia-ux,,0,0,0,0,3,0,1,1
hana-xs,hana-xs,,2,1,4,3,10,7,5,1
daggermock,daggermock,,0,0,1,0,3,1,3,1
rendertarget,rendertarget,,2,0,3,2,7,5,9,1
syncsort,syncsort,,0,1,1,1,2,2,4,1
httpruntime,httpruntime,,0,0,0,0,1,0,8,1
new-webserviceproxy,new-webserviceproxy,,1,2,1,3,4,4,8,100
infinite-carousel,infinite-carousel,,0,0,1,0,1,1,4,1
squashfs,squashfs,,2,3,4,5,4,9,9,50
visual-studio-project,visual-studio-project,,1,1,6,2,5,8,8,1
flex-direction,flex-direction,,4,1,4,5,7,9,1,1
tsclust,tsclust,,1,1,2,2,1,4,0,1
.net-bcl,.net-bcl,,0,0,0,0,1,0,8,1
laravel-views,laravel-views,,2,2,6,4,12,10,4,1
base-60,base-60,,0,0,0,0,1,0,0,1
pagoda-box,pagoda-box,,0,0,0,0,1,0,4,1
kendo-listview,kendo-listview,,7,1,5,8,5,13,1,1
wcf-rest-contrib,wcf-rest-contrib,,0,0,0,0,1,0,8,1
mysql-error-1062,mysql-error-1062,,0,0,1,0,5,1,4,1
calendarextender,calendarextender,,0,0,0,0,1,0,8,1
redips.drag,redips.drag,,0,0,0,0,1,0,1,1
treecell,treecell,,1,0,1,1,2,2,3,1
spectrumjs,spectrumjs,,0,0,0,0,2,0,1,1
spring-3,spring-3,,5,0,6,5,15,11,3,1
openapi.net,openapi.net,,1,1,0,2,1,2,3,1
fixed-length-record,fixed-length-record,,0,1,2,1,6,3,3,1
icontrol,icontrol,,0,0,2,0,1,2,6,1
header-row,header-row,,0,1,2,1,3,3,5,1
virtual-desktop,virtual-desktop,,0,1,1,1,6,2,9,1
less-rails,less-rails,,0,0,0,0,1,0,12,1
setbackground,setbackground,,1,3,2,4,4,6,3,200
hygiene,hygiene,,1,1,1,2,6,3,9,1
hashbang,hashbang,,0,2,2,2,2,4,1,100
usn,usn,,0,1,2,1,3,3,9,1
gonum,gonum,,2,0,4,2,9,6,6,1
openbd,openbd,,0,0,0,0,3,0,4,1
joined-subclass,joined-subclass,,0,1,0,1,2,1,3,1
rowdatabound,rowdatabound,,3,0,3,3,11,6,8,1
mssql-tools,mssql-tools,,0,1,1,1,1,2,4,1
pyke,pyke,,1,0,0,1,2,1,0,1
router-os,router-os,,3,1,3,4,7,7,4,1
octopack,octopack,,1,1,1,2,8,3,8,1
hawtio,hawtio,,0,4,6,4,17,10,3,300
key-storage,key-storage,,2,0,2,2,2,4,6,1
visual-studio-6,visual-studio-6,,1,1,3,2,4,5,8,1
django-pyodbc-azure,django-pyodbc-azure,,1,2,6,3,8,9,0,100
cfnetworking,cfnetworking,,0,0,0,0,2,0,13,1
styletron,styletron,,0,0,0,0,1,0,1,1
apiclient,apiclient,,0,3,7,3,4,10,3,200
jive,jive,,0,2,3,2,14,5,1,100
google-sitemap,google-sitemap,,5,2,8,7,12,15,4,1
synth,synth,,1,0,3,1,6,4,3,1
typescript1.8,typescript1.8,,2,0,7,2,4,9,1,1
banana,banana,,2,0,9,2,5,11,2,1
truclient,truclient,,3,2,0,5,5,5,3,1
qdial,qdial,,0,2,0,2,2,2,0,100
authorize.net-cim,authorize.net-cim,,1,3,6,4,8,10,4,200
as88,as88,,0,0,0,0,1,0,9,1
avurlasset,avurlasset,,2,0,6,2,14,8,13,1
lispworks,lispworks,,0,3,3,3,5,6,0,200
h2db,h2db,,2,1,6,3,16,9,3,1
cxfrs,cxfrs,,3,5,7,8,2,15,3,66.666667
const-char,const-char,,0,3,2,3,8,5,9,200
marklogic-dhf,marklogic-dhf,,20,10,54,30,28,84,3,1
msvc12,msvc12,,0,2,2,2,11,4,9,100
cat.net,cat.net,,0,0,0,0,1,0,9,1
unit-conversion,unit-conversion,,1,2,4,3,7,7,0,100
tuleap,tuleap,,0,1,3,1,7,4,6,1
database-update,database-update,,1,1,5,2,4,7,4,1
modeline,modeline,,0,1,1,1,2,2,9,1
aspnet-compiler,aspnet-compiler,,2,1,5,3,8,8,8,1
apify,apify,,2,13,6,15,5,21,1,550
filemerge,filemerge,,2,1,2,3,2,5,1,1
jviewport,jviewport,,0,0,1,0,1,1,3,1
redux-mock-store,redux-mock-store,,2,2,13,4,13,17,1,1
elmish,elmish,,3,8,9,11,4,20,8,166.666667
swank,swank,,0,1,0,1,1,1,0,1
arithmeticexception,arithmeticexception,,1,0,2,1,5,3,3,1
google-settings,google-settings,,1,0,1,1,4,2,3,1
hud,hud,,0,0,2,0,7,2,13,1
onkeylistener,onkeylistener,,2,1,5,3,4,8,3,1
mobile-phones,mobile-phones,,1,1,1,2,3,3,3,1
vinyl,vinyl,,0,0,0,0,1,0,2,1
inner-exception,inner-exception,,0,1,1,1,3,2,8,1
route-constraint,route-constraint,,0,0,0,0,1,0,8,1
equality-operator,equality-operator,,0,4,1,4,5,5,9,300
organizational-chart,organizational-chart,,1,0,8,1,3,9,1,1
avs,avs,,0,1,5,1,6,6,6,1
redux-form-validators,redux-form-validators,,1,1,5,2,9,7,1,1
cgaffinetransformscale,cgaffinetransformscale,,1,1,3,2,4,5,13,1
django-pyodbc,django-pyodbc,,2,1,6,3,7,9,0,1
dropbear,dropbear,,2,0,1,2,6,3,9,1
consul-template,consul-template,,3,6,5,9,5,14,3,100
http.sys,http.sys,,2,3,5,5,5,10,8,50
windsor-3.0,windsor-3.0,,0,0,0,0,1,0,8,1
phpquery,phpquery,,2,0,6,2,3,8,4,1
intel-parallel-studio,intel-parallel-studio,,2,3,5,5,5,10,9,50
jsr356,jsr356,,0,1,1,1,3,2,3,1
database-diagram,database-diagram,,1,3,5,4,4,9,4,200
libspotify,libspotify,,1,1,2,2,5,4,4,1
orafce,orafce,,1,0,0,1,2,1,4,1
cardio,cardio,,0,0,0,0,3,0,3,1
foshttpcachebundle,foshttpcachebundle,,0,1,2,1,2,3,4,1
fire-and-forget,fire-and-forget,,1,1,3,2,9,5,8,1
manatee.trello,manatee.trello,,0,0,0,0,4,0,12,1
lumberjack,lumberjack,,1,1,3,2,6,5,13,1
goldmine,goldmine,,0,0,0,0,1,0,4,1
newrelic-platform,newrelic-platform,,6,7,6,13,7,19,6,16.666667
relic,relic,,1,2,1,3,1,4,6,100
unicode-range,unicode-range,,2,0,0,2,3,2,1,1
umbraco4,umbraco4,,0,0,0,0,3,0,8,1
stream-management,stream-management,,0,0,0,0,1,0,3,1
marmalade,marmalade,,0,1,0,1,2,1,3,1
jstree-dnd,jstree-dnd,,4,1,1,5,7,6,1,1
adempiere,adempiere,,1,3,3,4,2,7,3,200
advanced-queuing,advanced-queuing,,1,4,4,5,12,9,4,300
multidatatrigger,multidatatrigger,,2,0,5,2,3,7,8,1
uvc,uvc,,6,3,13,9,11,22,3,1
raknet,raknet,,0,0,1,0,7,1,9,1
doctrine-mapping,doctrine-mapping,,0,1,1,1,3,2,4,1
owin-security,owin-security,,1,1,0,2,3,2,8,1
silverlight-2.0,silverlight-2.0,,0,0,0,0,1,0,5,1
injected-class-name,injected-class-name,,0,0,1,0,3,1,9,1
fluentwait,fluentwait,,5,2,4,7,4,11,3,1
array-flip,array-flip,,1,0,1,1,2,2,4,1
color-channel,color-channel,,1,1,1,2,1,3,0,1
css-hack,css-hack,,1,0,3,1,4,4,1,1
yourkit,yourkit,,3,2,7,5,10,12,3,1
openslide,openslide,,3,3,8,6,5,14,0,1
php-cpp,php-cpp,,0,0,1,0,4,1,9,1
chronograf,chronograf,,5,3,10,8,8,18,6,1
geodesic-sphere,geodesic-sphere,,1,2,3,3,5,6,0,100
intel-inspector,intel-inspector,,0,1,0,1,1,1,9,1
sim800,sim800,,14,10,23,24,23,47,9,1
kerning,kerning,,1,1,4,2,6,6,13,1
pebble-watch,pebble-watch,,0,0,1,0,4,1,6,1
pebble-sdk,pebble-sdk,,0,0,1,0,3,1,6,1
cloudpebble,cloudpebble,,0,0,0,0,3,0,6,1
python-datamodel,python-datamodel,,4,4,3,8,8,11,0,1
action-hook,action-hook,,1,2,3,3,1,6,4,100
reactive-extensions-js,reactive-extensions-js,,2,1,1,3,7,4,1,1
c++builder-10.2-tokyo,c++builder-10.2-tokyo,,3,5,20,8,30,28,9,66.666667
mysql-error-1111,mysql-error-1111,,1,0,0,1,1,1,4,1
structured-array,structured-array,,6,3,10,9,11,19,0,1
gcc4.7,gcc4.7,,2,0,1,2,3,3,9,1
strdup,strdup,,1,1,1,2,4,3,9,1
azure-durable-functions,azure-durable-functions,,22,26,57,48,18,105,8,18.181818
securitymanager,securitymanager,,2,3,9,5,7,14,3,50
rapid-prototyping,rapid-prototyping,,0,1,1,1,3,2,13,1
microsoft-expression,microsoft-expression,,0,1,0,1,1,1,8,1
scriptaculous,scriptaculous,,1,0,0,1,3,1,1,1
propertychanged,propertychanged,,0,1,8,1,11,9,8,1
gulp-minify-css,gulp-minify-css,,0,0,0,0,4,0,1,1
ssrs-2017,ssrs-2017,,44,15,28,59,22,87,4,1
mobiscroll,mobiscroll,,1,2,4,3,1,7,1,100
glidejs,glidejs,,2,5,2,7,2,9,1,150
table-per-type,table-per-type,,0,0,0,0,3,0,8,1
vlc-qt,vlc-qt,,1,1,7,2,6,9,9,1
nvdec,nvdec,,0,1,3,1,4,4,13,1
windows-8.1-universal,windows-8.1-universal,,0,2,4,2,6,6,8,100
viewdraghelper,viewdraghelper,,1,1,1,2,1,3,3,1
appsee,appsee,,3,0,0,3,6,3,13,1
memberof,memberof,,1,2,2,3,5,5,8,100
jquery-multidatespicker,jquery-multidatespicker,,5,0,2,5,4,7,1,1
object-relational-model,object-relational-model,,3,2,4,5,5,9,4,1
incapsula,incapsula,,3,0,4,3,6,7,0,1
digital-persona-sdk,digital-persona-sdk,,7,1,6,8,7,14,8,1
iostat,iostat,,0,0,4,0,4,4,9,1
sitemesh,sitemesh,,2,2,1,4,3,5,3,1
mt19937,mt19937,,3,1,2,4,2,6,9,1
zimbra,zimbra,,5,2,11,7,17,18,4,1
value-restriction,value-restriction,,2,0,0,2,4,2,9,1
startmenu,startmenu,,3,2,5,5,9,10,8,1
intersystems-ensemble,intersystems-ensemble,,0,0,0,0,6,0,4,1
knp-snappy,knp-snappy,,6,2,14,8,11,22,4,1
qmdiarea,qmdiarea,,2,4,1,6,2,7,0,100
wsdualhttpbinding,wsdualhttpbinding,,0,2,1,2,2,3,8,100
jxtreetable,jxtreetable,,0,0,0,0,2,0,3,1
custom-action-filter,custom-action-filter,,3,0,11,3,2,14,8,1
sxs,sxs,,1,0,0,1,3,1,8,1
git-show,git-show,,3,2,3,5,4,8,6,1
adaptive-layout,adaptive-layout,,0,3,4,3,7,7,13,200
griddler,griddler,,0,1,0,1,2,1,12,1
parsoid,parsoid,,4,2,3,6,6,9,4,1
through2,through2,,1,1,3,2,4,5,1,1
javah,javah,,3,0,3,3,4,6,3,1
boost-compute,boost-compute,,1,1,3,2,6,5,9,1
opensoundcontrol,opensoundcontrol,,2,1,0,3,1,3,0,1
iisreset,iisreset,,0,2,1,2,1,3,8,100
domready,domready,,0,1,1,1,2,2,1,1
jpct,jpct,,0,0,2,0,2,2,3,1
prestashop-themes,prestashop-themes,,0,0,0,0,1,0,4,1
file-diffs,file-diffs,,0,0,0,0,1,0,0,1
gtkwave,gtkwave,,1,0,0,1,3,1,9,1
cordova-plugin-camera,cordova-plugin-camera,,3,4,5,7,13,12,1,33.333333
erlide,erlide,,0,1,0,1,1,1,2,1
spark-jdbc,spark-jdbc,,9,1,5,10,12,15,2,1
sortables,sortables,,2,4,5,6,9,11,1,100
opensearchdescription,opensearchdescription,,1,0,0,1,4,1,1,1
cedit,cedit,,0,0,2,0,4,2,9,1
dtcoretext,dtcoretext,,1,1,0,2,2,2,13,1
server.transfer,server.transfer,,1,1,0,2,2,2,8,1
wix4,wix4,,1,1,0,2,3,2,8,1
activeperl,activeperl,,0,1,3,1,6,4,9,1
wxperl,wxperl,,0,0,0,0,3,0,9,1
mpmediapickercontroller,mpmediapickercontroller,,2,2,2,4,5,6,13,1
lubm,lubm,,0,0,0,0,1,0,2,1
unassigned-variable,unassigned-variable,,2,2,1,4,5,5,8,1
excel-writer-xlsx,excel-writer-xlsx,,5,0,4,5,2,9,9,1
jrules,jrules,,1,3,1,4,4,5,3,200
karma-viewport,karma-viewport,,0,0,0,0,1,0,1,1
instancecontextmode,instancecontextmode,,1,0,0,1,1,1,8,1
jml,jml,,2,0,1,2,4,3,3,1
openjml,openjml,,2,0,1,2,2,3,3,1
jfreechart-fx,jfreechart-fx,,0,2,0,2,2,2,3,100
dnspython,dnspython,,4,1,9,5,13,14,0,1
webpack-4,webpack-4,,154,154,441,308,292,749,1,1
apigee-baas,apigee-baas,,0,1,1,1,1,2,4,1
apigee127,apigee127,,4,1,2,5,1,7,4,1
zend-validate,zend-validate,,1,0,2,1,6,3,4,1
system.err,system.err,,0,0,0,0,2,0,3,1
serializearray,serializearray,,2,0,2,2,5,4,1,1
calico,calico,,8,6,12,14,9,26,6,1
class-visibility,class-visibility,,2,3,4,5,2,9,3,50
geohashing,geohashing,,8,9,16,17,11,33,0,12.5
gpars,gpars,,1,2,1,3,5,4,3,100
smoothie.js,smoothie.js,,1,0,0,1,5,1,1,1
voce,voce,,0,0,0,0,1,0,3,1
resourcestring,resourcestring,,0,0,1,0,2,1,8,1
enunciate,enunciate,,1,2,3,3,3,6,3,100
lightstreamer,lightstreamer,,1,1,0,2,1,2,1,1
stonith,stonith,,1,0,1,1,2,2,9,1
decal,decal,,2,0,2,2,2,4,8,1
boost-signals2,boost-signals2,,0,1,0,1,6,1,9,1
flash-media-server,flash-media-server,,1,0,0,1,1,1,13,1
angularjs-resource,angularjs-resource,,1,0,1,1,4,2,1,1
blackhole,blackhole,,0,0,0,0,1,0,4,1
moa,moa,,0,1,2,1,1,3,0,1
cmp,cmp,,3,3,3,6,7,9,0,1
dav,dav,,0,0,0,0,2,0,8,1
reactjs-testutils,reactjs-testutils,,3,2,0,5,5,5,1,1
ios-stickers,ios-stickers,,4,3,6,7,8,13,13,1
escape-analysis,escape-analysis,,0,0,0,0,5,0,3,1
netbeans-9,netbeans-9,,2,0,36,2,10,38,3,1
windows-composition-api,windows-composition-api,,6,2,5,8,7,13,8,1
xaml-composition,xaml-composition,,2,2,2,4,3,6,8,1
r10k,r10k,,1,0,3,1,3,4,6,1
compgen,compgen,,0,1,1,1,3,2,9,1
stplanr,stplanr,,1,0,3,1,2,4,0,1
stomp-websocket,stomp-websocket,,1,0,1,1,1,2,3,1
octobercms-viewbag,octobercms-viewbag,,0,0,1,0,2,1,4,1
latent-semantic-indexing,latent-semantic-indexing,,2,2,3,4,3,7,0,1
latent-semantic-analysis,latent-semantic-analysis,,1,1,0,2,1,2,0,1
socket.io-1.0,socket.io-1.0,,2,1,6,3,18,9,1,1
specs,specs,,1,2,2,3,3,5,3,100
ui-codemirror,ui-codemirror,,0,0,1,0,3,1,1,1
amazon-mobile-analytics,amazon-mobile-analytics,,2,0,0,2,2,2,6,1
webchem,webchem,,0,0,0,0,1,0,0,1
grunt-contrib-imagemin,grunt-contrib-imagemin,,0,0,1,0,1,1,1,1
ngx-pagination,ngx-pagination,,4,10,7,14,10,21,1,150
spin.js,spin.js,,1,0,0,1,3,1,1,1
ocamlyacc,ocamlyacc,,2,0,2,2,4,4,0,1
trait-objects,trait-objects,,3,5,7,8,11,15,9,66.666667
jalopy,jalopy,,0,0,0,0,1,0,3,1
pyshark,pyshark,,14,13,18,27,19,45,9,1
c#-8.0,c#-8.0,,21,20,26,41,6,67,8,1
border-spacing,border-spacing,,1,1,1,2,4,3,1,1
angularjs-model,angularjs-model,,0,0,0,0,2,0,1,1
academic-graph,academic-graph,,0,1,2,1,2,3,8,1
edge-list,edge-list,,0,4,0,4,5,4,0,300
trackpad,trackpad,,3,2,5,5,8,10,13,1
argon2-ffi,argon2-ffi,,8,3,8,11,7,19,4,1
posting,posting,,0,3,3,3,5,6,1,200
logical-foundations,logical-foundations,,13,6,7,19,1,26,2,1
legacy-database,legacy-database,,2,1,0,3,5,3,0,1
maptools,maptools,,5,2,8,7,11,15,0,1
scala-arm,scala-arm,,0,1,0,1,1,1,2,1
webchromeclient,webchromeclient,,4,2,6,6,9,12,3,1
couchbase-nodejs-sdk,couchbase-nodejs-sdk,,0,1,0,1,1,1,3,1
limit-per-group,limit-per-group,,1,0,0,1,6,1,4,1
azure-oms,azure-oms,,0,2,12,2,16,14,8,100
servlet-container,servlet-container,,1,1,2,2,6,4,3,1
nodejs-liveserver,nodejs-liveserver,,1,3,0,4,4,4,1,200
verificationexception,verificationexception,,0,0,0,0,1,0,8,1
external-project,external-project,,5,6,6,11,9,17,9,20
repositorylookupedit,repositorylookupedit,,1,0,1,1,1,2,8,1
gridlookupedit,gridlookupedit,,1,0,1,1,2,2,8,1
infinite-recursion,infinite-recursion,,0,1,3,1,5,4,3,1
ssdp,ssdp,,4,1,6,5,13,11,9,1
gles20,gles20,,1,0,0,1,3,1,3,1
unicenta,unicenta,,1,0,1,1,4,2,4,1
pixijs,pixijs,,4,13,21,17,29,38,1,225
azure-packaging,azure-packaging,,0,0,0,0,1,0,8,1
oboe,oboe,,6,6,11,12,1,23,3,1
python-sounddevice,python-sounddevice,,5,13,14,18,8,32,0,160
fortran-iso-c-binding,fortran-iso-c-binding,,2,2,5,4,16,9,9,1
plesk-onyx,plesk-onyx,,11,15,32,26,33,58,4,36.363636
kr-c,kr-c,,0,0,0,0,1,0,9,1
subgit,subgit,,1,0,7,1,7,8,6,1
application-start,application-start,,2,1,3,3,4,6,8,1
realpath,realpath,,2,4,4,6,5,10,9,100
scriptcraft,scriptcraft,,0,0,0,0,1,0,1,1
aws-cloud9,aws-cloud9,,23,27,34,50,44,84,6,17.391304
atk4,atk4,,0,0,0,0,1,0,4,1
neo4j-shell,neo4j-shell,,0,0,1,0,3,1,2,1
seekbar-thumb,seekbar-thumb,,0,1,2,1,3,3,3,1
lwp-useragent,lwp-useragent,,1,2,3,3,11,6,9,100
world-of-warcraft,world-of-warcraft,,0,4,3,4,6,7,9,300
expat-parser,expat-parser,,0,1,3,1,3,4,0,1
badpaddingexception,badpaddingexception,,2,0,5,2,5,7,6,1
cookieconsent,cookieconsent,,6,1,2,7,12,9,1,1
drawing2d,drawing2d,,3,1,6,4,11,10,8,1
spotlight-dbpedia,spotlight-dbpedia,,0,1,3,1,5,4,2,1
autobahnjs,autobahnjs,,0,0,1,0,2,1,0,1
objectdataprovider,objectdataprovider,,0,0,2,0,3,2,8,1
foregroundnotification,foregroundnotification,,3,6,5,9,9,14,3,100
python-aiofiles,python-aiofiles,,0,2,2,2,4,4,0,100
multiplechoicefield,multiplechoicefield,,2,1,0,3,6,3,0,1
django-redis,django-redis,,3,4,2,7,8,9,0,33.333333
saleor,saleor,,7,9,14,16,14,30,0,28.571429
adaptive-icon,adaptive-icon,,4,2,5,6,13,11,3,1
input-sanitization,input-sanitization,,0,0,4,0,10,4,4,1
aws-fargate,aws-fargate,,45,70,77,115,85,192,6,55.555556
webcal,webcal,,1,3,3,4,1,7,4,200
npyscreen,npyscreen,,3,0,6,3,4,9,0,1
dart-sdk,dart-sdk,,3,1,7,4,4,11,13,1
view-debugging,view-debugging,,1,0,1,1,5,2,13,1
selectionmodel,selectionmodel,,1,4,1,5,3,6,3,300
non-convex,non-convex,,2,0,4,2,4,6,0,1
image-optimization,image-optimization,,4,2,2,6,6,8,1,1
zend-pdf,zend-pdf,,1,0,1,1,2,2,4,1
scatterpie,scatterpie,,5,1,2,6,4,8,0,1
uimanageddocument,uimanageddocument,,0,0,1,0,4,1,13,1
software-serial,software-serial,,3,3,2,6,5,8,9,1
wxglade,wxglade,,3,0,0,3,4,3,0,1
sap-conversational-ai,sap-conversational-ai,,2,1,6,3,8,9,8,1
duplex-channel,duplex-channel,,0,0,0,0,2,0,8,1
qquickwidget,qquickwidget,,0,1,4,1,4,5,9,1
directory-traversal,directory-traversal,,2,0,3,2,3,5,8,1
gulp-compass,gulp-compass,,0,0,1,0,1,1,1,1
android-embedded-api,android-embedded-api,,0,0,0,0,1,0,3,1
mkdirection,mkdirection,,2,1,2,3,5,5,13,1
xsd2code,xsd2code,,0,2,1,2,7,3,3,100
gdb-python,gdb-python,,3,0,13,3,11,16,9,1
javaoptions,javaoptions,,2,1,1,3,4,4,3,1
django-tagging,django-tagging,,1,0,1,1,5,2,0,1
magick-r-package,magick-r-package,,0,1,0,1,1,1,0,1
reportico,reportico,,0,0,0,0,2,0,4,1
system-paths,system-paths,,1,3,2,4,2,6,0,200
xbox360,xbox360,,0,3,0,3,5,3,8,200
doctrine-orm-postgres,doctrine-orm-postgres,,0,1,1,1,1,2,4,1
angular-template-form,angular-template-form,,4,1,6,5,3,11,1,1
qwebelement,qwebelement,,2,0,0,2,2,2,3,1
pci-bus,pci-bus,,1,0,0,1,4,1,9,1
queryselectall,queryselectall,,0,0,1,0,2,1,1,1
clean-css,clean-css,,2,2,2,4,7,6,1,1
emeditor,emeditor,,2,2,4,4,2,8,0,1
springboard,springboard,,1,4,3,5,2,8,13,300
asternet,asternet,,0,0,2,0,2,2,13,1
android-color,android-color,,5,5,9,10,21,19,3,1
sparktable,sparktable,,0,0,0,0,1,0,2,1
mupad,mupad,,1,2,1,3,2,4,0,100
insert-iterator,insert-iterator,,0,0,0,0,1,0,9,1
main-method,main-method,,2,0,6,2,8,8,3,1
pq,pq,,6,3,4,9,14,13,6,1
bootstrap-duallistbox,bootstrap-duallistbox,,1,1,2,2,4,4,1,1
javax.sound.sampled,javax.sound.sampled,,2,2,4,4,3,8,3,1
clrmd,clrmd,,1,0,4,1,4,5,8,1
cwlsignal,cwlsignal,,0,0,0,0,1,0,6,1
side-scroller,side-scroller,,0,1,0,1,7,1,3,1
guppy,guppy,,2,0,1,2,3,3,0,1
got,got,,2,5,8,7,4,15,9,150
llvm-3.0,llvm-3.0,,0,0,0,0,6,0,9,1
boost-gil,boost-gil,,1,1,1,2,4,3,9,1
marginal-effects,marginal-effects,,2,3,7,5,7,12,0,50
mit-scratch,mit-scratch,,2,6,11,8,13,19,1,200
stagexl,stagexl,,1,0,1,1,2,2,13,1
django-wsgi,django-wsgi,,4,6,6,10,14,16,0,50
java-ee-8,java-ee-8,,14,19,45,33,15,78,3,35.714286
qhostaddress,qhostaddress,,0,0,0,0,4,0,9,1
amazon-sagemaker,amazon-sagemaker,,86,129,171,215,141,386,6,50
soundchannel,soundchannel,,0,0,0,0,2,0,13,1
qtwayland,qtwayland,,1,2,2,3,9,5,9,100
xcarchive,xcarchive,,0,0,1,0,5,1,13,1
header-fields,header-fields,,0,0,0,0,1,0,4,1
caracal,caracal,,0,0,1,0,3,1,12,1
ex,ex,,2,1,5,3,8,8,5,1
mysql-innodb-cluster,mysql-innodb-cluster,,4,1,4,5,1,9,4,1
gmaven,gmaven,,0,0,3,0,2,3,3,1
android-preference-v14,android-preference-v14,,0,0,0,0,3,0,3,1
elasticsearch-shield,elasticsearch-shield,,0,0,0,0,1,0,6,1
dynamic-analysis,dynamic-analysis,,1,3,1,4,4,5,9,200
phonon,phonon,,1,0,2,1,4,3,0,1
umdh,umdh,,0,0,1,0,1,1,9,1
jquery-append,jquery-append,,0,1,4,1,3,5,1,1
azure-aks,azure-aks,,96,62,147,158,23,305,6,1
azure-kubernetes,azure-kubernetes,,57,56,136,113,63,249,6,1
statechart,statechart,,1,1,2,2,6,4,3,1
gruntfile,gruntfile,,1,2,4,3,5,7,1,100
protege4,protege4,,0,0,3,0,8,3,2,1
ironruby,ironruby,,0,0,0,0,1,0,12,1
frege,frege,,0,0,0,0,1,0,9,1
file-system-storage,file-system-storage,,2,0,2,2,3,4,0,1
webextension-storage,webextension-storage,,0,1,3,1,2,4,1,1
osgearth,osgearth,,2,1,5,3,6,8,9,1
database-reconciliation,database-reconciliation,,0,1,2,1,4,3,5,1
axios-cookiejar-support,axios-cookiejar-support,,0,0,0,0,1,0,1,1
runatserver,runatserver,,3,0,1,3,7,4,8,1
datavisualization.toolkit,datavisualization.toolkit,,1,0,1,1,3,2,8,1
kotlin-companion,kotlin-companion,,2,0,6,2,9,8,3,1
itemrenderer,itemrenderer,,0,0,0,0,3,0,13,1
gperf,gperf,,0,0,1,0,1,1,9,1
data-science-studio,data-science-studio,,1,0,0,1,2,1,4,1
ephesoft,ephesoft,,0,0,0,0,2,0,0,1
zend-date,zend-date,,0,0,0,0,1,0,9,1
netapp,netapp,,3,3,1,6,6,7,9,1
listfield,listfield,,1,3,3,4,4,7,1,200
novaclient,novaclient,,0,0,0,0,4,0,4,1
hibernate-batch-updates,hibernate-batch-updates,,0,1,0,1,1,1,3,1
bndtools,bndtools,,2,1,11,3,12,14,3,1
proximitysensor,proximitysensor,,3,3,6,6,9,12,3,1
session-hijacking,session-hijacking,,2,2,6,4,5,10,4,1
jira-filter,jira-filter,,0,0,0,0,2,0,6,1
aws-snowball,aws-snowball,,2,0,0,2,2,2,6,1
slimerjs,slimerjs,,2,1,3,3,7,6,3,1
ssas-2012,ssas-2012,,1,4,9,5,14,14,4,300
jquery.form.js,jquery.form.js,,0,1,0,1,1,1,1,1
interopservices,interopservices,,1,2,7,3,11,10,8,100
localserversocket,localserversocket,,1,0,1,1,2,2,9,1
mutablemap,mutablemap,,1,0,0,1,2,1,2,1
pymol,pymol,,3,6,4,9,6,13,0,100
jquery-guillotine,jquery-guillotine,,0,0,1,0,3,1,1,1
varray,varray,,0,2,6,2,9,8,4,100
google-language-api,google-language-api,,0,3,3,3,4,6,1,200
es6-shim,es6-shim,,0,0,0,0,2,0,1,1
no-match,no-match,,0,1,3,1,1,4,1,1
pa11y,pa11y,,0,0,3,0,11,3,13,1
octobercms-user-plugin,octobercms-user-plugin,,1,0,2,1,7,3,4,1
repmgr,repmgr,,1,0,1,1,3,2,4,1
charm-crypto,charm-crypto,,0,0,3,0,1,3,6,1
umbraco-contour,umbraco-contour,,1,0,0,1,1,1,8,1
umbraco-forms,umbraco-forms,,1,1,0,2,6,2,8,1
phrets,phrets,,0,4,1,4,3,5,4,300
membership-provider,membership-provider,,1,1,6,2,9,8,8,1
parentid,parentid,,0,0,1,0,2,1,0,1
django-syndication,django-syndication,,0,1,0,1,2,1,0,1
maximum-profit-problem,maximum-profit-problem,,1,1,1,2,1,3,0,1
frapi,frapi,,0,0,0,0,1,0,4,1
activeweb,activeweb,,2,1,8,3,8,11,3,1
supplementary,supplementary,,1,0,1,1,1,2,0,1
timage,timage,,0,2,5,2,4,7,9,100
tgrid,tgrid,,0,1,0,1,1,1,9,1
southeast-asian-languages,southeast-asian-languages,,1,0,0,1,1,1,4,1
textile,textile,,0,1,0,1,2,1,0,1
maven-extension,maven-extension,,1,0,2,1,5,3,3,1
intero,intero,,1,0,2,1,13,3,2,1
wxgrid,wxgrid,,1,2,2,3,4,5,0,100
stdevp,stdevp,,0,0,1,0,1,1,4,1
mvcmailer,mvcmailer,,0,0,2,0,2,2,8,1
candy,candy,,1,0,1,1,2,2,3,1
dynamic-script-loading,dynamic-script-loading,,0,4,4,4,6,8,1,300
tessellation,tessellation,,2,2,11,4,10,15,9,1
typekit,typekit,,0,1,5,1,3,6,1,1
facter,facter,,3,1,6,4,9,10,6,1
puppetlabs-apache,puppetlabs-apache,,2,0,4,2,6,6,6,1
specific-stylesheets,specific-stylesheets,,0,0,0,0,2,0,1,1
concave,concave,,2,3,1,5,4,6,0,50
node-libcurl,node-libcurl,,0,0,2,0,3,2,1,1
free-diameter,free-diameter,,0,0,0,0,1,0,9,1
uniqueness-typing,uniqueness-typing,,1,0,0,1,2,1,2,1
imapi,imapi,,1,1,0,2,3,2,8,1
ggdendro,ggdendro,,1,0,2,1,4,3,0,1
google-style-guide,google-style-guide,,0,1,4,1,6,5,9,1
fastinfoset,fastinfoset,,0,0,0,0,3,0,3,1
process-control,process-control,,0,1,1,1,1,2,9,1
application-variables,application-variables,,1,0,0,1,4,1,8,1
firmata,firmata,,0,2,2,2,10,4,9,100
modelio,modelio,,1,0,1,1,7,2,13,1
dart-dev-compiler,dart-dev-compiler,,0,1,2,1,3,3,13,1
jquery-trigger,jquery-trigger,,0,0,1,0,2,1,1,1
mender,mender,,0,1,1,1,2,2,9,1
linux-from-scratch,linux-from-scratch,,1,6,8,7,8,15,9,500
swagger-tools,swagger-tools,,0,0,4,0,4,4,3,1
namedpipeserverstream,namedpipeserverstream,,1,0,3,1,2,4,8,1
dss,dss,,1,0,6,1,6,7,14,1
mls,mls,,1,0,0,1,3,1,12,1
chrome-extension-async,chrome-extension-async,,1,3,4,4,10,8,1,200
project-reference,project-reference,,3,4,3,7,2,10,8,33.333333
static-initializer,static-initializer,,1,1,3,2,5,5,3,1
sas-hash,sas-hash,,0,1,0,1,1,1,0,1
md5-file,md5-file,,2,0,3,2,5,5,12,1
dropbox-php,dropbox-php,,0,0,1,0,5,1,4,1
timelapse,timelapse,,2,4,7,6,3,13,13,100
microc,microc,,0,0,0,0,4,0,9,1
uxcam,uxcam,,0,2,1,2,1,3,3,100
gkmatchmaker,gkmatchmaker,,0,0,0,0,1,0,13,1
fme,fme,,5,3,5,8,8,13,0,1
clipspy,clipspy,,2,0,9,2,3,11,0,1
allen-sdk,allen-sdk,,0,0,0,0,3,0,0,1
nwb,nwb,,2,0,4,2,7,6,1,1
imagespan,imagespan,,0,1,5,1,5,6,3,1
cpp-netlib,cpp-netlib,,1,1,2,2,3,4,9,1
reward-system,reward-system,,0,0,2,0,9,2,13,1
asciiencoding,asciiencoding,,0,0,1,0,2,1,0,1
autodiscovery,autodiscovery,,1,4,4,5,5,9,8,300
aws-marketplace,aws-marketplace,,3,2,4,5,6,9,6,1
deep-diff,deep-diff,,0,1,1,1,2,2,0,1
triplot,triplot,,2,1,0,3,1,3,0,1
angular-component-router,angular-component-router,,2,2,2,4,5,6,1,1
xcode7.3,xcode7.3,,0,1,1,1,6,2,13,1
server-application,server-application,,1,0,0,1,3,1,3,1
db2-connect,db2-connect,,0,0,1,0,3,1,4,1
peripherals,peripherals,,0,2,4,2,2,6,3,100
waithandle,waithandle,,1,0,0,1,3,1,8,1
vrone,vrone,,0,0,0,0,1,0,3,1
psoc,psoc,,1,0,4,1,6,5,9,1
ggproto,ggproto,,6,1,2,7,10,9,0,1
native-methods,native-methods,,0,0,2,0,2,2,3,1
dev-mode,dev-mode,,2,2,2,4,1,6,3,1
vanishing-point,vanishing-point,,0,2,0,2,2,2,0,100
simpleioc,simpleioc,,2,0,1,2,4,3,8,1
shodan,shodan,,1,0,3,1,6,4,0,1
reference-class,reference-class,,0,2,4,2,3,6,0,100
defaulttreemodel,defaulttreemodel,,0,0,0,0,3,0,3,1
itemeditor,itemeditor,,0,0,0,0,1,0,13,1
deoptimization,deoptimization,,0,0,1,0,1,1,0,1
zenoss,zenoss,,0,0,1,0,2,1,6,1
service-control-manager,service-control-manager,,0,1,0,1,2,1,9,1
v4l2loopback,v4l2loopback,,19,6,26,25,6,51,1,1
memory-optimized-tables,memory-optimized-tables,,3,1,8,4,10,12,4,1
twincat-ads-.net,twincat-ads-.net,,1,1,2,2,2,4,9,1
maping,maping,,0,1,1,1,5,2,1,1
wit-ai,wit-ai,,0,0,1,0,4,1,0,1
kotlin-experimental,kotlin-experimental,,1,1,0,2,2,2,3,1
update-all,update-all,,1,0,1,1,2,2,12,1
editplus,editplus,,0,0,1,0,2,1,0,1
alchemy,alchemy,,0,0,0,0,3,0,0,1
chdir,chdir,,2,3,4,5,11,9,0,50
periodic-processing,periodic-processing,,0,0,1,0,1,1,0,1
retaincount,retaincount,,0,0,2,0,4,2,13,1
compareobject,compareobject,,1,1,12,2,10,14,8,1
automl,automl,,25,24,38,49,39,87,6,1
yubico,yubico,,9,6,11,15,8,26,6,1
notary,notary,,7,3,5,10,6,15,6,1
pinch,pinch,,3,3,3,6,7,9,1,1
path-2d,path-2d,,1,0,1,1,3,2,1,1
librarian-puppet,librarian-puppet,,0,0,0,0,2,0,6,1
acts-as-follower,acts-as-follower,,1,0,4,1,3,5,12,1
svn-hooks,svn-hooks,,1,1,4,2,2,6,6,1
modelbinders,modelbinders,,1,6,0,7,6,7,8,500
flatfilereader,flatfilereader,,1,1,4,2,4,6,3,1
independent-set,independent-set,,0,1,3,1,3,4,0,1
xmlbeans,xmlbeans,,6,10,10,16,13,26,3,66.666667
mupdf,mupdf,,1,6,11,7,10,18,3,500
ob-get-contents,ob-get-contents,,0,3,0,3,4,3,4,200
sugarrecord,sugarrecord,,0,0,2,0,2,2,3,1
iis-manager,iis-manager,,0,3,4,3,3,7,8,200
jform,jform,,0,2,3,2,7,5,3,100
messageui,messageui,,0,1,2,1,10,3,13,1
reinforced-typings,reinforced-typings,,1,1,0,2,2,2,8,1
tfs2018,tfs2018,,38,22,104,60,134,164,8,1
suppressmessage,suppressmessage,,2,0,2,2,1,4,0,1
equivalence,equivalence,,2,1,7,3,7,10,0,1
usersession,usersession,,2,1,5,3,3,8,8,1
cflow,cflow,,0,0,1,0,1,1,9,1
messagebird,messagebird,,0,1,0,1,3,1,4,1
studio3t,studio3t,,2,8,14,10,23,24,1,300
semantic-merge,semantic-merge,,0,0,0,0,1,0,9,1
drupal-hooks,drupal-hooks,,0,0,2,0,5,2,4,1
asymmetric,asymmetric,,2,2,2,4,3,6,0,1
mu4e,mu4e,,2,0,3,2,3,5,9,1
binstar,binstar,,0,0,0,0,1,0,0,1
typhoon,typhoon,,0,1,1,1,3,2,13,1
experience-manager,experience-manager,,2,0,0,2,2,2,3,1
bankers-algorithm,bankers-algorithm,,0,0,0,0,1,0,9,1
gpu-atomics,gpu-atomics,,0,3,1,3,2,4,9,200
azure-iot-edge,azure-iot-edge,,33,35,56,68,55,124,8,6.060606
simpsons-rule,simpsons-rule,,2,1,6,3,10,9,0,1
timeago,timeago,,0,2,6,2,4,8,1,100
hangfire.ninject,hangfire.ninject,,0,0,1,0,2,1,8,1
waffle-chart,waffle-chart,,4,0,7,4,14,11,0,1
wds,wds,,1,3,3,4,5,7,8,200
goquery,goquery,,4,1,4,5,4,9,6,1
qvector3d,qvector3d,,2,0,1,2,3,3,8,1
textmatching,textmatching,,0,0,6,0,6,6,0,1
pythoncom,pythoncom,,3,6,5,9,11,14,0,100
picture-element,picture-element,,0,1,4,1,2,5,1,1
interruption,interruption,,4,1,1,5,4,6,9,1
static-generator,static-generator,,0,1,1,1,4,2,1,1
deldir,deldir,,0,0,2,0,1,2,0,1
yokozuna,yokozuna,,0,0,0,0,1,0,2,1
arraycopy,arraycopy,,0,0,0,0,5,0,3,1
earley-parser,earley-parser,,1,0,0,1,1,1,0,1
nearley,nearley,,1,1,3,2,5,5,0,1
azure-repos,azure-repos,,13,15,7,28,1,35,8,15.384615
anemic-domain-model,anemic-domain-model,,0,0,1,0,2,1,8,1
rich-domain-model,rich-domain-model,,1,0,2,1,1,3,8,1
dtf,dtf,,1,0,2,1,1,3,8,1
topojson2,topojson2,,0,0,0,0,1,0,1,1
storing-information,storing-information,,2,1,4,3,1,7,4,1
opendialog,opendialog,,1,0,1,1,3,2,8,1
ray,ray,,30,31,17,61,3,78,0,3.333333
xml-to-json,xml-to-json,,4,4,4,8,10,12,3,1
light-4j,light-4j,,1,0,3,1,5,4,3,1
firebase-queue,firebase-queue,,1,0,0,1,7,1,13,1
accept.js,accept.js,,3,2,1,5,6,6,4,1
image-resolution,image-resolution,,0,0,3,0,2,3,3,1
ocamldebug,ocamldebug,,0,1,0,1,1,1,0,1
aws-appsync,aws-appsync,,121,108,206,229,208,435,6,1
storagefolder,storagefolder,,0,3,5,3,6,8,8,200
treelist,treelist,,1,1,3,2,5,5,8,1
google-data-api,google-data-api,,0,1,1,1,8,2,6,1
cassandra-sasi-index,cassandra-sasi-index,,0,0,2,0,1,2,2,1
taillistener,taillistener,,0,0,0,0,1,0,3,1
blocked-threads,blocked-threads,,1,0,0,1,4,1,3,1
dropshadoweffect,dropshadoweffect,,0,0,3,0,2,3,8,1
pdf-reader,pdf-reader,,7,9,14,16,14,30,8,28.571429
ants,ants,,4,0,3,4,2,7,8,1
android-scripting,android-scripting,,0,0,0,0,1,0,9,1
hyperledger-cello,hyperledger-cello,,0,0,2,0,10,2,6,1
haskell-spock,haskell-spock,,1,1,1,2,3,3,2,1
jalali-calendar,jalali-calendar,,3,2,5,5,11,10,1,1
camunda-modeler,camunda-modeler,,10,7,19,17,37,36,3,1
f#-async,f#-async,,1,1,0,2,3,2,8,1
rnw,rnw,,1,1,5,2,6,7,0,1
tinyscrollbar,tinyscrollbar,,0,0,0,0,1,0,1,1
mongodb-security,mongodb-security,,1,0,2,1,3,3,1,1
hibernate-cache,hibernate-cache,,5,2,5,7,9,12,3,1
pyth,pyth,,0,0,0,0,1,0,0,1
knockout-es5-plugin,knockout-es5-plugin,,0,0,0,0,1,0,1,1
realmrecyclerviewadapter,realmrecyclerviewadapter,,0,2,3,2,5,5,3,100
crtdbg.h,crtdbg.h,,1,0,0,1,1,1,9,1
separating-axis-theorem,separating-axis-theorem,,1,0,2,1,4,3,0,1
openstack-keystone,openstack-keystone,,3,1,4,4,9,8,6,1
viewswitcher,viewswitcher,,1,0,0,1,4,1,3,1
seekbarpreference,seekbarpreference,,0,0,1,0,1,1,3,1
lob,lob,,0,2,7,2,7,9,4,100
exprtk,exprtk,,1,0,2,1,2,3,9,1
ruby-datamapper,ruby-datamapper,,0,0,2,0,4,2,12,1
hibernate-filters,hibernate-filters,,1,0,1,1,4,2,3,1
scitools,scitools,,1,0,1,1,2,2,0,1
md-card,md-card,,4,0,0,4,6,4,1,1
network-scan,network-scan,,0,1,1,1,2,2,9,1
unity-ui,unity-ui,,4,9,10,13,30,23,8,125
automatic-variable,automatic-variable,,0,0,0,0,1,0,9,1
icacls,icacls,,6,4,5,10,12,15,9,1
mochiweb,mochiweb,,0,0,0,0,1,0,2,1
jiffy,jiffy,,0,1,0,1,1,1,2,1
kephas,kephas,,13,2,0,15,2,15,8,1
internet-explorer-7,internet-explorer-7,,0,0,6,0,7,6,1,1
monger,monger,,1,0,0,1,5,1,2,1
grunt-usemin,grunt-usemin,,0,1,1,1,7,2,1,1
grunt-wiredep,grunt-wiredep,,0,0,1,0,1,1,1,1
chrome-runtime,chrome-runtime,,2,0,1,2,1,3,1,1
sql-server-authentication,sql-server-authentication,,2,0,1,2,1,3,4,1
postgres-xl,postgres-xl,,1,0,2,1,9,3,4,1
node.js-napi,node.js-napi,,0,0,4,0,6,4,1,1
avahi,avahi,,5,1,3,6,6,9,9,1
datagridviewcellstyle,datagridviewcellstyle,,0,2,4,2,1,6,8,100
windows-mobile-5.0,windows-mobile-5.0,,0,0,0,0,3,0,8,1
squeel,squeel,,0,1,0,1,1,1,12,1
shellcheck,shellcheck,,1,1,5,2,5,7,9,1
klocwork,klocwork,,6,3,3,9,7,12,9,1
marketo,marketo,,6,6,12,12,11,24,1,1
ignore-case,ignore-case,,0,1,2,1,7,3,0,1
fam-proposal,fam-proposal,,0,0,0,0,1,0,2,1
blind,blind,,2,2,4,4,2,8,13,1
ubuntu-13.04,ubuntu-13.04,,0,0,0,0,1,0,9,1
chakracore,chakracore,,4,0,0,4,7,4,8,1
bulk-collect,bulk-collect,,3,2,5,5,11,10,4,1
google-genomics,google-genomics,,1,1,4,2,7,6,6,1
qt-resource,qt-resource,,0,0,1,0,3,1,9,1
label-for,label-for,,0,0,0,0,1,0,1,1
superfish,superfish,,0,1,0,1,4,1,1,1
dry-rb,dry-rb,,1,1,6,2,2,8,12,1
nsorderedset,nsorderedset,,1,0,1,1,2,2,13,1
cuda-gdb,cuda-gdb,,2,0,2,2,1,4,0,1
jde,jde,,0,0,3,0,7,3,4,1
grunt-connect-proxy,grunt-connect-proxy,,0,0,0,0,1,0,1,1
ghc-api,ghc-api,,0,1,0,1,3,1,2,1
wuapi,wuapi,,0,0,1,0,5,1,8,1
ngmock,ngmock,,0,1,3,1,3,4,1,1
node-archiver,node-archiver,,7,1,4,8,6,12,1,1
fbsdklikecontrol,fbsdklikecontrol,,0,0,0,0,1,0,13,1
multi-mapping,multi-mapping,,0,0,3,0,1,3,8,1
luajava,luajava,,2,0,1,2,1,3,9,1
bitflags,bitflags,,3,3,6,6,6,12,9,1
hgrc,hgrc,,0,0,2,0,2,2,6,1
inflector,inflector,,0,1,0,1,2,1,4,1
cruisecontrol.net,cruisecontrol.net,,3,0,1,3,6,4,8,1
stylus-pen,stylus-pen,,1,0,9,1,7,10,3,1
simulationx,simulationx,,0,0,0,0,1,0,0,1
null-propagation-operator,null-propagation-operator,,2,1,0,3,4,3,8,1
apache-spark-1.4,apache-spark-1.4,,0,0,0,0,1,0,0,1
system-preferences,system-preferences,,1,1,6,2,2,8,13,1
rets,rets,,3,6,4,9,5,13,4,100
emitter,emitter,,2,0,3,2,6,5,1,1
if-case,if-case,,0,0,0,0,1,0,9,1
aldeedmeteor-tabular,aldeedmeteor-tabular,,0,0,0,0,1,0,1,1
emacs24,emacs24,,1,0,1,1,6,2,9,1
walrus,walrus,,0,0,0,0,1,0,0,1
articulate,articulate,,3,0,3,3,4,6,8,1
rwlock,rwlock,,0,1,2,1,4,3,9,1
accessibility-inspector,accessibility-inspector,,1,0,0,1,1,1,13,1
android-tools-namespace,android-tools-namespace,,0,0,3,0,5,3,3,1
polish,polish,,6,1,6,7,6,13,0,1
raw-types,raw-types,,4,3,5,7,12,12,3,1
angular-gantt,angular-gantt,,2,1,4,3,3,7,1,1
polarssl,polarssl,,0,0,2,0,1,2,9,1
fluentftp,fluentftp,,4,8,4,12,3,16,8,100
httpful,httpful,,0,0,2,0,5,2,4,1
goo.gl,goo.gl,,0,0,1,0,6,1,5,1
ims-db,ims-db,,1,0,0,1,4,1,3,1
algebra.js,algebra.js,,0,0,0,0,3,0,1,1
atomic-swap,atomic-swap,,1,0,0,1,2,1,9,1
email-confirmation,email-confirmation,,2,7,6,9,11,15,4,250
xnet,xnet,,0,0,8,0,3,8,8,1
akka-camel,akka-camel,,0,0,2,0,3,2,3,1
numbered-list,numbered-list,,0,2,1,2,3,3,3,100
double-dispatch,double-dispatch,,3,1,5,4,4,9,9,1
permgen,permgen,,0,0,3,0,6,3,3,1
android-attributes,android-attributes,,3,7,4,10,7,14,3,133.333333
texturepacker,texturepacker,,2,6,6,8,3,14,1,200
property-list,property-list,,3,3,0,6,4,6,13,1
war-filedeployment,war-filedeployment,,1,0,1,1,4,2,3,1
jsf-1.1,jsf-1.1,,2,0,0,2,5,2,3,1
symfony-2.4,symfony-2.4,,1,0,1,1,1,2,4,1
ray-picking,ray-picking,,0,1,1,1,2,2,9,1
pageloadtimeout,pageloadtimeout,,1,3,3,4,2,7,3,200
facebook-graph-api-v2.4,facebook-graph-api-v2.4,,1,0,0,1,2,1,13,1
j-security-check,j-security-check,,2,3,4,5,4,9,3,50
treecontrol,treecontrol,,1,0,2,1,5,3,8,1
imce-file-browser,imce-file-browser,,0,0,0,0,1,0,4,1
application-name,application-name,,1,0,1,1,2,2,9,1
acquia,acquia,,4,1,6,5,10,11,4,1
pythonxy,pythonxy,,0,1,1,1,3,2,0,1
cs0246,cs0246,,1,0,2,1,2,3,8,1
base-path,base-path,,1,1,1,2,2,3,4,1
direct-update,direct-update,,0,0,1,0,2,1,13,1
omnipascal,omnipascal,,0,0,0,0,2,0,9,1
oid,oid,,4,2,4,6,8,10,9,1
sharekit,sharekit,,0,0,0,0,1,0,13,1
multiselect.js,multiselect.js,,1,1,0,2,3,2,1,1
jmathplot,jmathplot,,0,0,0,0,1,0,3,1
gwttestcase,gwttestcase,,1,0,0,1,1,1,3,1
expansion-files,expansion-files,,0,1,1,1,1,2,3,1
openscad,openscad,,6,1,5,7,6,12,0,1
action-menu,action-menu,,1,0,0,1,3,1,3,1
spdep,spdep,,3,3,3,6,6,9,0,1
giraph,giraph,,2,0,6,2,15,8,2,1
fabricjs2,fabricjs2,,18,19,26,37,39,63,1,5.555556
ice-protocol,ice-protocol,,1,0,0,1,1,1,13,1
gulp-rev,gulp-rev,,1,0,7,1,2,8,1,1
soc,soc,,1,2,10,3,7,13,9,100
partially-applied-type,partially-applied-type,,1,0,1,1,1,2,2,1
android-downloadable-fonts,android-downloadable-fonts,,0,1,1,1,12,2,3,1
fastcall,fastcall,,0,0,0,0,1,0,1,1
thumbor,thumbor,,1,2,1,3,4,4,6,100
svnsync,svnsync,,1,0,4,1,2,5,6,1
ora-00918,ora-00918,,1,1,2,2,3,4,4,1
cratedb,cratedb,,3,4,14,7,14,21,4,33.333333
upwork-api,upwork-api,,1,0,2,1,8,3,4,1
go-flag,go-flag,,0,0,1,0,4,1,6,1
sql-authentication,sql-authentication,,0,0,1,0,2,1,4,1
chronometer,chronometer,,3,9,14,12,26,26,3,200
knitr-spin,knitr-spin,,1,0,1,1,4,2,0,1
facebook-iframe,facebook-iframe,,4,3,3,7,5,10,1,1
asp.net-core-3.0,asp.net-core-3.0,,27,57,6,84,1,90,8,111.111111
commitizen,commitizen,,2,1,1,3,4,4,6,1
node-xmpp,node-xmpp,,1,1,4,2,5,6,3,1
vstest.console,vstest.console,,1,1,3,2,6,5,8,1
credui,credui,,0,0,1,0,1,1,8,1
perl-html-template,perl-html-template,,0,0,1,0,1,1,9,1
github-organizations,github-organizations,,3,2,4,5,7,9,6,1
r6rs,r6rs,,0,0,4,0,4,4,0,1
mencoder,mencoder,,0,1,2,1,2,3,13,1
spml,spml,,4,0,0,4,3,4,0,1
rackup,rackup,,0,0,2,0,4,2,12,1
mdbg,mdbg,,1,0,0,1,2,1,8,1
usertokenprovider,usertokenprovider,,0,0,1,0,2,1,8,1
trilinos,trilinos,,0,1,1,1,3,2,9,1
ant-contrib,ant-contrib,,1,1,2,2,4,4,3,1
authorize.net-webhooks,authorize.net-webhooks,,0,2,4,2,4,6,4,100
jaeger,jaeger,,18,30,24,48,20,72,3,66.666667
aubio,aubio,,1,0,2,1,6,3,0,1
chakram,chakram,,0,0,3,0,11,3,1,1
nmock,nmock,,0,0,0,0,2,0,1,1
python-nonlocal,python-nonlocal,,1,0,1,1,10,2,0,1
pgf,pgf,,2,3,5,5,8,10,0,50
tibero,tibero,,2,0,1,2,1,3,4,1
simplex-noise,simplex-noise,,3,2,4,5,5,9,0,1
avd-manager,avd-manager,,8,8,12,16,28,28,3,1
getstring,getstring,,1,1,1,2,6,3,3,1
php-java-bridge,php-java-bridge,,1,1,1,2,5,3,4,1
manual,manual,,8,6,15,14,15,29,4,1
alexa-flash-briefing,alexa-flash-briefing,,1,0,1,1,3,2,6,1
updatexml,updatexml,,0,0,1,0,4,1,4,1
array-agg,array-agg,,3,3,6,6,8,12,4,1
opc-da,opc-da,,0,3,4,3,3,7,8,200
baml2006reader,baml2006reader,,0,0,0,0,1,0,8,1
mdx-query,mdx-query,,6,6,28,12,36,40,4,1
accurev,accurev,,1,0,2,1,4,3,6,1
twill,twill,,0,2,3,2,3,5,0,100
shared-state,shared-state,,0,1,1,1,2,2,0,1
ioref,ioref,,0,1,2,1,3,3,2,1
cqlengine,cqlengine,,2,3,5,5,6,10,2,50
extended-procedures,extended-procedures,,0,0,0,0,1,0,4,1
pubxml,pubxml,,1,0,2,1,5,3,8,1
reverse-dns,reverse-dns,,4,3,10,7,20,17,4,1
block-comments,block-comments,,1,1,1,2,2,3,3,1
fetch-mock,fetch-mock,,3,4,8,7,8,15,1,33.333333
cucumber-cpp,cucumber-cpp,,0,1,1,1,2,2,9,1
fiddler-dev,fiddler-dev,,0,0,4,0,1,4,8,1
mongo-scala-driver,mongo-scala-driver,,2,3,1,5,8,6,2,50
net-reactor,net-reactor,,2,0,2,2,2,4,8,1
poplib,poplib,,0,5,4,5,4,9,4,400
illegalaccessexception,illegalaccessexception,,2,2,6,4,5,10,3,1
automationelement,automationelement,,3,1,1,4,6,5,8,1
tabwidget,tabwidget,,0,1,0,1,3,1,3,1
iio,iio,,3,0,1,3,5,4,9,1
orientation-changes,orientation-changes,,1,3,8,4,5,12,3,200
easyhook,easyhook,,1,1,6,2,4,8,8,1
fba,fba,,2,1,3,3,2,6,6,1
windows-networking,windows-networking,,0,2,4,2,5,6,9,100
plotnine,plotnine,,3,5,12,8,21,20,0,66.666667
stringcomparer,stringcomparer,,0,0,2,0,1,2,8,1
xpathnodeiterator,xpathnodeiterator,,0,0,0,0,2,0,3,1
777,777,,0,0,1,0,1,1,9,1
thucydides,thucydides,,1,0,3,1,5,4,3,1
tweenjs,tweenjs,,1,4,5,5,9,10,1,300
numeral.js,numeral.js,,0,0,3,0,9,3,1,1
effective-c++,effective-c++,,1,1,1,2,8,3,9,1
laravel-dotenv,laravel-dotenv,,1,0,3,1,6,4,4,1
splunk-sdk,splunk-sdk,,5,8,19,13,9,32,6,60
cameraoverlayview,cameraoverlayview,,2,0,0,2,2,2,13,1
cornerstone,cornerstone,,3,2,6,5,7,11,1,1
remobjects,remobjects,,0,0,0,0,3,0,9,1
polynomial-approximations,polynomial-approximations,,4,3,6,7,7,13,0,1
gridviewcolumn,gridviewcolumn,,1,0,0,1,5,1,8,1
georchestra,georchestra,,0,0,0,0,1,0,4,1
dtn,dtn,,1,1,3,2,2,5,3,1
iommu,iommu,,0,1,4,1,3,5,9,1
excelpackage,excelpackage,,2,0,4,2,5,6,8,1
language-interoperability,language-interoperability,,9,0,6,9,9,15,13,1
xpath-1.0,xpath-1.0,,30,37,37,67,18,104,3,23.333333
jmock,jmock,,0,1,5,1,8,6,3,1
rebex,rebex,,0,1,1,1,3,2,8,1
dup,dup,,0,1,2,1,7,3,9,1
razor-3,razor-3,,0,0,0,0,3,0,8,1
sparsehash,sparsehash,,0,0,2,0,3,2,9,1
sharepointadmin,sharepointadmin,,1,0,1,1,5,2,8,1
negative-zero,negative-zero,,0,0,2,0,2,2,0,1
kotlin-multiplatform,kotlin-multiplatform,,27,33,50,60,19,110,3,22.222222
swiftystorekit,swiftystorekit,,3,5,11,8,6,19,13,66.666667
string-iteration,string-iteration,,1,0,1,1,2,2,0,1
razorsql,razorsql,,2,2,1,4,6,5,4,1
caldroid,caldroid,,0,0,2,0,1,2,3,1
physx,physx,,4,2,6,6,9,12,8,1
slony,slony,,0,0,1,0,1,1,4,1
python-netifaces,python-netifaces,,1,1,1,2,2,3,8,1
pythonnet,pythonnet,,0,0,0,0,25,0,8,1
pen,pen,,1,2,3,3,9,6,1,100
android-flavordimension,android-flavordimension,,2,3,6,5,5,11,3,50
iframe-resizer,iframe-resizer,,4,6,7,10,13,17,1,50
ora-00907,ora-00907,,2,1,1,3,9,4,4,1
mod-auth-kerb,mod-auth-kerb,,0,0,3,0,2,3,2,1
amplitude,amplitude,,2,6,4,8,11,12,0,200
runhaskell,runhaskell,,0,0,1,0,2,1,2,1
incr-tcl,incr-tcl,,0,0,0,0,1,0,1,1
android-strictmode,android-strictmode,,2,1,7,3,10,10,3,1
pbrt,pbrt,,0,0,1,0,3,1,9,1
vdsp,vdsp,,2,0,5,2,2,7,13,1
devicecheck,devicecheck,,5,5,8,10,7,18,13,1
fputs,fputs,,2,0,2,2,7,4,9,1
rmaps,rmaps,,0,0,0,0,1,0,0,1
ndjson,ndjson,,5,8,10,13,6,23,1,60
enigma-catalyst,enigma-catalyst,,0,0,1,0,2,1,0,1
variable-variables,variable-variables,,4,1,3,5,9,8,4,1
go-back-n,go-back-n,,2,0,3,2,2,5,9,1
speedglm,speedglm,,0,0,0,0,2,0,0,1
gateways,gateways,,0,0,0,0,1,0,8,1
onready,onready,,0,0,0,0,1,0,5,1
stanza.io,stanza.io,,1,1,2,2,8,4,3,1
wingdings,wingdings,,0,0,0,0,1,0,5,1
bitmapregiondecoder,bitmapregiondecoder,,0,0,0,0,1,0,3,1
argp,argp,,1,0,1,1,2,2,9,1
web-midi,web-midi,,3,4,2,7,6,9,1,33.333333
minoccurs,minoccurs,,1,0,2,1,1,3,3,1
trail,trail,,0,4,2,4,4,6,0,300
pytmx,pytmx,,4,4,1,8,3,9,0,1
rsocket,rsocket,,2,3,2,5,3,7,3,50
discord.io,discord.io,,6,3,10,9,14,19,1,1
libyaml,libyaml,,1,1,1,2,3,3,12,1
qoci,qoci,,0,0,1,0,2,1,9,1
prolog-coroutining,prolog-coroutining,,0,0,1,0,1,1,0,1
parametric-equations,parametric-equations,,1,2,5,3,5,8,0,100
browsable,browsable,,1,0,2,1,2,3,3,1
actionhero,actionhero,,1,0,1,1,3,2,1,1
google-api-ruby-client,google-api-ruby-client,,2,2,4,4,13,8,5,1
netlify-cms,netlify-cms,,26,14,29,40,18,69,1,1
dot-matrix,dot-matrix,,0,0,3,0,7,3,1,1
tapjoy,tapjoy,,0,0,0,0,1,0,13,1
pdf-extraction,pdf-extraction,,8,4,16,12,8,28,0,1
flask-assets,flask-assets,,2,2,1,4,4,5,0,1
deepl,deepl,,2,0,1,2,1,3,4,1
mod-security2,mod-security2,,7,2,11,9,10,20,4,1
modx-evolution,modx-evolution,,1,0,1,1,5,2,4,1
pyelasticsearch,pyelasticsearch,,0,2,1,2,6,3,6,100
rtcp,rtcp,,0,2,2,2,9,4,13,100
kafka-streams-scala,kafka-streams-scala,,0,0,6,0,5,6,2,1
pspice,pspice,,0,1,1,1,1,2,9,1
printk,printk,,0,4,2,4,3,6,9,300
pffacebookutils,pffacebookutils,,0,0,0,0,2,0,13,1
dispatchertimer,dispatchertimer,,4,2,7,6,15,13,8,1
convention-over-configur,convention-over-configur,,0,1,0,1,1,1,1,1
welcome-file,welcome-file,,1,0,2,1,4,3,3,1
websocket++,websocket++,,1,0,3,1,3,4,9,1
entity-model,entity-model,,0,1,0,1,2,1,8,1
angular2-render,angular2-render,,0,0,0,0,1,0,1,1
google-timeline-chart,google-timeline-chart,,4,1,1,5,3,6,1,1
rdtsc,rdtsc,,1,4,8,5,5,13,9,300
msf,msf,,0,1,0,1,1,1,4,1
asynctest,asynctest,,0,0,0,0,3,0,0,1
hive-hplsql,hive-hplsql,,0,0,2,0,2,2,2,1
ckrecordzone,ckrecordzone,,1,0,3,1,2,4,13,1
opencl-c,opencl-c,,4,4,2,8,8,10,0,1
facebook-customer-chat,facebook-customer-chat,,3,2,5,5,9,10,13,1
gcore,gcore,,0,0,1,0,4,1,9,1
performance-estimation,performance-estimation,,0,0,0,0,1,0,0,1
swrl,swrl,,4,5,3,9,30,12,2,25
tvjs,tvjs,,0,1,9,1,4,10,13,1
dart-mirrors,dart-mirrors,,2,0,3,2,4,5,13,1
self-extracting,self-extracting,,1,0,1,1,3,2,9,1
qt-vs-addin,qt-vs-addin,,1,0,2,1,3,3,9,1
boost-container,boost-container,,0,0,1,0,2,1,9,1
spectral-density,spectral-density,,1,0,2,1,3,3,0,1
scodec,scodec,,0,0,1,0,2,1,2,1
rc.d,rc.d,,0,0,2,0,2,2,9,1
sitecore-instance-manager,sitecore-instance-manager,,0,0,0,0,1,0,8,1
bhm,bhm,,0,0,0,0,1,0,8,1
mapwingis,mapwingis,,1,2,2,3,2,5,8,100
selectionchanged,selectionchanged,,3,5,12,8,7,20,8,66.666667
wheelcollider,wheelcollider,,0,0,0,0,1,0,8,1
letrec,letrec,,0,1,2,1,2,3,2,1
qtquick-designer,qtquick-designer,,0,0,2,0,1,2,9,1
serp,serp,,0,1,2,1,4,3,4,1
jingle,jingle,,1,0,0,1,3,1,3,1
wordsearch,wordsearch,,0,1,13,1,8,14,0,1
superpower,superpower,,0,2,6,2,3,8,0,100
qt5.10,qt5.10,,0,0,1,0,23,1,9,1
explicit-interface,explicit-interface,,0,1,0,1,5,1,8,1
riak-search,riak-search,,0,3,2,3,1,5,2,200
powerpoint-2013,powerpoint-2013,,2,1,2,3,7,5,5,1
webcenter-sites,webcenter-sites,,2,1,1,3,3,4,3,1
datemodified,datemodified,,1,1,2,2,7,4,9,1
higher-rank-types,higher-rank-types,,0,1,0,1,9,1,2,1
filesort,filesort,,0,0,2,0,5,2,4,1
system.web.extensions,system.web.extensions,,0,0,0,0,2,0,8,1
forecastr,forecastr,,0,1,1,1,2,2,0,1
layout-inspector,layout-inspector,,2,0,2,2,5,4,3,1
imap-open,imap-open,,2,1,1,3,3,4,4,1
ruby-install,ruby-install,,0,0,0,0,1,0,12,1
timing-attack,timing-attack,,2,1,2,3,3,5,4,1
firefox-nightly,firefox-nightly,,0,1,0,1,5,1,1,1
qtftp,qtftp,,0,0,0,0,3,0,9,1
entity-framework-core-2.1,entity-framework-core-2.1,,8,7,56,15,48,71,8,1
google-cloud-cdn,google-cloud-cdn,,6,5,10,11,21,21,6,1
caemittercell,caemittercell,,0,0,5,0,5,5,13,1
paypal-pdt,paypal-pdt,,1,1,6,2,5,8,4,1
shakespeare-text,shakespeare-text,,0,0,0,0,2,0,2,1
mne-python,mne-python,,1,3,3,4,6,7,0,200
kuromoji,kuromoji,,0,1,0,1,3,1,0,1
clap,clap,,3,2,5,5,9,10,9,1
object-type,object-type,,2,0,6,2,3,8,4,1
s3transfermanager,s3transfermanager,,0,0,1,0,2,1,6,1
hyperref,hyperref,,0,1,1,1,3,2,0,1
epub.js,epub.js,,0,4,6,4,6,10,1,300
pg-ctl,pg-ctl,,1,0,2,1,5,3,4,1
firebird-embedded,firebird-embedded,,2,2,7,4,8,11,4,1
appengine-wordpress,appengine-wordpress,,0,0,1,0,1,1,6,1
stashy,stashy,,0,0,0,0,2,0,0,1
quokka.js,quokka.js,,0,0,1,0,3,1,1,1
htk,htk,,0,1,8,1,5,9,6,1
apache-wink,apache-wink,,0,0,2,0,2,2,3,1
amdatu,amdatu,,0,0,0,0,1,0,3,1
image-enhancement,image-enhancement,,1,2,1,3,5,4,0,100
fb-graph,fb-graph,,5,1,4,6,2,10,13,1
snowplow,snowplow,,1,1,1,2,2,3,2,1
openssl-engine,openssl-engine,,2,4,0,6,7,6,6,100
ng2-tag-input,ng2-tag-input,,0,2,1,2,2,3,1,100
function-points,function-points,,1,0,0,1,1,1,4,1
j2html,j2html,,1,0,2,1,8,3,3,1
apache-commons-compress,apache-commons-compress,,3,1,7,4,5,11,3,1
aspnetcoretemplatepack,aspnetcoretemplatepack,,1,0,5,1,2,6,8,1
numexpr,numexpr,,3,2,2,5,8,7,0,1
keyrelease,keyrelease,,0,0,1,0,6,1,3,1
sage50,sage50,,3,3,1,6,6,7,4,1
papaja,papaja,,2,4,8,6,6,14,0,100
gac-msil,gac-msil,,1,0,0,1,2,1,8,1
ip-restrictions,ip-restrictions,,2,2,5,4,11,9,8,1
encoder-decoder,encoder-decoder,,12,12,16,24,22,40,0,1
metro-ui-css,metro-ui-css,,2,1,3,3,7,6,1,1
iauthorizationfilter,iauthorizationfilter,,0,0,2,0,1,2,8,1
fast-scroller,fast-scroller,,0,0,0,0,1,0,8,1
diff-lcs,diff-lcs,,0,0,0,0,1,0,12,1
nsbatchdeleterequest,nsbatchdeleterequest,,0,0,1,0,3,1,13,1
asp.net-mvc-ajax,asp.net-mvc-ajax,,1,0,1,1,6,2,8,1
umbraco-blog,umbraco-blog,,1,0,1,1,3,2,8,1
python-fire,python-fire,,2,2,1,4,1,5,0,1
csqldataprovider,csqldataprovider,,1,0,1,1,2,2,8,1
home-assistant,home-assistant,,5,5,4,10,5,14,6,1
linkchecker,linkchecker,,0,0,0,0,3,0,4,1
freestanding,freestanding,,0,0,3,0,4,3,9,1
xcode-plugin,xcode-plugin,,0,0,2,0,2,2,13,1
hypnotoad,hypnotoad,,1,0,1,1,5,2,9,1
morbo,morbo,,1,0,0,1,2,1,9,1
flow-js,flow-js,,0,0,3,0,2,3,1,1
zscript,zscript,,0,0,0,0,1,0,0,1
fishpig,fishpig,,0,0,1,0,9,1,4,1
xvalue,xvalue,,2,0,3,2,6,5,9,1
surrogate-key,surrogate-key,,1,0,1,1,5,2,4,1
pg8000,pg8000,,4,2,3,6,2,9,4,1
wattpad,wattpad,,0,0,0,0,1,0,4,1
dbcp,dbcp,,4,2,5,6,2,11,3,1
textmate2,textmate2,,0,1,3,1,3,4,9,1
wikimedia-dumps,wikimedia-dumps,,0,0,1,0,5,1,2,1
jsmodeler,jsmodeler,,0,0,1,0,1,1,1,1
prezi,prezi,,0,0,0,0,1,0,1,1
lilypond,lilypond,,1,4,4,5,4,9,0,300
valentina-studio,valentina-studio,,0,0,0,0,2,0,4,1
b-plus-tree,b-plus-tree,,2,2,0,4,1,4,0,1
better-sqlite3,better-sqlite3,,6,7,17,13,4,30,1,16.666667
ora-00923,ora-00923,,0,0,1,0,2,1,4,1
filedrop.js,filedrop.js,,1,0,0,1,1,1,1,1
smacss,smacss,,0,0,0,0,2,0,1,1
asp.net-bundling,asp.net-bundling,,1,1,3,2,6,5,8,1
xwork,xwork,,0,0,2,0,1,2,3,1
pygst,pygst,,0,0,1,0,1,1,13,1
recyclerview-multiselect,recyclerview-multiselect,,0,0,0,0,1,0,3,1
neo4j-plugin,neo4j-plugin,,0,0,1,0,3,1,2,1
recordreader,recordreader,,0,1,2,1,2,3,2,1
d3fc,d3fc,,3,2,0,5,2,5,1,1
abstract-algebra,abstract-algebra,,0,0,0,0,4,0,0,1
contentplaceholder,contentplaceholder,,0,0,1,0,5,1,1,1
pico-8,pico-8,,0,0,2,0,7,2,9,1
wso2cloud,wso2cloud,,0,0,1,0,2,1,14,1
glteximage2d,glteximage2d,,0,0,1,0,4,1,9,1
font-lock,font-lock,,1,0,3,1,2,4,9,1
colorbrewer,colorbrewer,,2,2,5,4,12,9,0,1
tag-soup,tag-soup,,1,0,3,1,2,4,3,1
filenet-cpe,filenet-cpe,,2,1,0,3,14,3,15,1
nvidia-flex,nvidia-flex,,1,1,2,2,1,4,8,1
enum-map,enum-map,,1,1,6,2,8,8,3,1
array-unset,array-unset,,2,0,1,2,3,3,4,1
datastax-php-driver,datastax-php-driver,,0,1,1,1,7,2,2,1
posix-api,posix-api,,0,0,1,0,4,1,9,1
mysql-management,mysql-management,,1,1,0,2,6,2,4,1
xmlresourceparser,xmlresourceparser,,0,0,3,0,2,3,3,1
jena-rules,jena-rules,,2,3,4,5,7,9,2,50
apache-commons-email,apache-commons-email,,2,6,1,8,3,9,3,200
google-chrome-flags,google-chrome-flags,,2,1,1,3,2,4,1,1
sabredav,sabredav,,3,4,7,7,10,14,4,33.333333
mysite,mysite,,0,0,1,0,2,1,8,1
ginput,ginput,,0,1,4,1,1,5,0,1
sqwrl,sqwrl,,1,0,0,1,6,1,2,1
treemodel,treemodel,,0,1,3,1,1,4,3,1
database-testing,database-testing,,3,5,3,8,8,11,3,66.666667
23andme-api,23andme-api,,0,1,0,1,2,1,4,1
cdecl,cdecl,,1,2,1,3,5,4,9,100
dbcc,dbcc,,0,3,4,3,8,7,4,200
trident,trident,,3,3,2,6,8,8,2,1
transactionmanager,transactionmanager,,5,2,5,7,9,12,3,1
elmah.mvc,elmah.mvc,,2,0,6,2,3,8,8,1
tkinter-scale,tkinter-scale,,1,4,4,5,1,9,0,300
addr2line,addr2line,,0,1,2,1,6,3,9,1
plotgooglemaps,plotgooglemaps,,0,0,0,0,2,0,0,1
ordbms,ordbms,,3,0,3,3,6,6,4,1
device-width,device-width,,1,1,3,2,3,5,1,1
lesti-fpc,lesti-fpc,,1,0,0,1,1,1,4,1
gosu,gosu,,18,4,6,22,9,28,12,1
guidewire,guidewire,,15,3,9,18,9,27,12,1
certenroll,certenroll,,6,0,1,6,4,7,8,1
upickle,upickle,,6,0,5,6,3,11,2,1
nsrunloop,nsrunloop,,1,2,4,3,7,7,13,100
string-interning,string-interning,,3,3,3,6,14,9,3,1
dependency-tree,dependency-tree,,0,4,1,4,3,5,0,300
goamz,goamz,,0,0,0,0,1,0,6,1
azure-application-settings,azure-application-settings,,5,1,0,6,7,6,8,1
fedora-27,fedora-27,,2,0,3,2,29,5,9,1
pyscard,pyscard,,5,0,1,5,5,6,0,1
coveo,coveo,,2,0,2,2,2,4,1,1
predefined-macro,predefined-macro,,1,2,0,3,1,3,9,100
limit-choices-to,limit-choices-to,,0,0,0,0,1,0,0,1
partial-trust,partial-trust,,0,0,1,0,2,1,8,1
angular-ide,angular-ide,,0,0,2,0,5,2,1,1
magnify,magnify,,2,2,3,4,2,7,1,1
tone.js,tone.js,,4,9,6,13,5,19,1,125
eloquent--relationship,eloquent--relationship,,47,37,46,84,2,130,4,1
badgerfish,badgerfish,,0,0,0,0,2,0,3,1
django-supervisor,django-supervisor,,1,1,2,2,2,4,0,1
option-strict,option-strict,,0,0,1,0,3,1,8,1
http-head,http-head,,0,2,6,2,2,8,4,100
angular-material-paginator,angular-material-paginator,,1,2,2,3,1,5,1,100
forestadmin,forestadmin,,1,1,1,2,2,3,1,1
brightway,brightway,,0,1,5,1,7,6,0,1
vsam,vsam,,3,0,2,3,5,5,4,1
java-interop,java-interop,,1,0,0,1,3,1,3,1
tfs-aggregator,tfs-aggregator,,0,1,0,1,4,1,8,1
getscript,getscript,,2,0,9,2,5,11,1,1
starmap,starmap,,3,2,4,5,4,9,0,1
aggregateexception,aggregateexception,,4,0,6,4,2,10,8,1
aws-ssm,aws-ssm,,14,5,14,19,27,33,6,1
string-utils,string-utils,,0,4,2,4,5,6,3,300
android-4.0.3-ice-cream-sandwich,android-4.0.3-ice-cream-sandwich,,1,0,0,1,1,1,3,1
strtod,strtod,,0,1,1,1,2,2,9,1
adehabitathr,adehabitathr,,3,2,2,5,6,7,0,1
authz,authz,,0,0,5,0,2,5,6,1
authzforce,authzforce,,3,4,3,7,9,10,4,33.333333
photoshop-cs5,photoshop-cs5,,0,0,0,0,2,0,1,1
q#,q#,,7,0,11,7,30,18,0,1
srv,srv,,3,1,6,4,6,10,4,1
working-remotely,working-remotely,,1,1,2,2,2,4,8,1
zipexception,zipexception,,1,0,1,1,6,2,3,1
uname,uname,,1,0,0,1,3,1,6,1
sublimecodeintel,sublimecodeintel,,0,1,0,1,1,1,0,1
cfpdf,cfpdf,,0,2,2,2,1,4,4,100
sharepoint-branding,sharepoint-branding,,0,1,0,1,1,1,8,1
pyresttest,pyresttest,,0,0,0,0,1,0,3,1
php-zip-archive,php-zip-archive,,0,2,1,2,9,3,4,100
fieldcollapsing,fieldcollapsing,,0,0,0,0,1,0,2,1
qradiobutton,qradiobutton,,1,1,3,2,10,5,0,1
avr32,avr32,,0,1,1,1,1,2,9,1
sql-pl,sql-pl,,0,2,1,2,4,3,4,100
.xproj,.xproj,,1,0,0,1,2,1,8,1
fslab,fslab,,1,1,0,2,4,2,8,1
elasticsearch-model,elasticsearch-model,,1,0,2,1,5,3,6,1
postman-collection-runner,postman-collection-runner,,20,30,57,50,71,107,4,50
selecteditemchanged,selecteditemchanged,,0,0,0,0,2,0,8,1
pushsharp,pushsharp,,6,1,4,7,11,11,8,1
vdm-sl,vdm-sl,,0,0,0,0,1,0,2,1
ignition,ignition,,2,2,7,4,6,11,4,1
scada-ignition,scada-ignition,,0,2,0,2,3,2,4,100
travel-time,travel-time,,1,1,0,2,3,2,1,1
load-order,load-order,,0,1,0,1,2,1,1,1
taskstackbuilder,taskstackbuilder,,0,1,0,1,4,1,3,1
msbuild-wpp,msbuild-wpp,,0,0,1,0,1,1,8,1
idml,idml,,1,0,0,1,1,1,1,1
report-viewer2010,report-viewer2010,,3,0,3,3,5,6,8,1
aws-sdk-net,aws-sdk-net,,25,9,14,34,23,48,6,1
terminal.app,terminal.app,,0,2,1,2,1,3,9,100
final-form,final-form,,9,23,17,32,20,49,1,155.555556
react-final-form,react-final-form,,27,67,41,94,32,135,1,148.148148
xdoclet,xdoclet,,0,0,1,0,1,1,3,1
bitmapsource,bitmapsource,,4,2,3,6,3,9,8,1
bitmapframe,bitmapframe,,0,1,0,1,2,1,8,1
git-track,git-track,,0,0,1,0,4,1,6,1
live-connect-sdk,live-connect-sdk,,1,1,1,2,3,3,13,1
sql-domain,sql-domain,,0,0,0,0,2,0,4,1
saprfc,saprfc,,10,5,13,15,15,28,5,1
azure-ilb,azure-ilb,,0,0,0,0,2,0,8,1
azure-ase,azure-ase,,1,0,1,1,4,2,8,1
hammingweight,hammingweight,,1,1,2,2,2,4,9,1
fmt,fmt,,3,8,3,11,3,14,9,166.666667
photobooth,photobooth,,1,2,1,3,2,4,0,100
evopdf,evopdf,,1,3,5,4,5,9,8,200
monocle-scala,monocle-scala,,0,0,0,0,4,0,2,1
onmouseup,onmouseup,,0,2,1,2,4,3,1,100
csip-simple,csip-simple,,1,1,3,2,6,5,3,1
horizon,horizon,,5,6,8,11,9,19,4,20
feature-descriptor,feature-descriptor,,3,1,5,4,3,9,0,1
neo4j-browser,neo4j-browser,,3,4,10,7,17,17,2,33.333333
reactive-cocoa-5,reactive-cocoa-5,,0,0,1,0,1,1,13,1
krpano,krpano,,0,2,2,2,4,4,1,100
update-site,update-site,,1,2,1,3,3,4,3,100
sqlapi++,sqlapi++,,1,1,1,2,4,3,9,1
leftalign,leftalign,,1,0,0,1,3,1,1,1
uia,uia,,2,1,3,3,6,6,3,1
android-4.3-jelly-bean,android-4.3-jelly-bean,,1,0,1,1,7,2,3,1
camel-quickfix,camel-quickfix,,1,2,0,3,2,3,14,100
vue-select,vue-select,,9,7,10,16,20,26,1,1
glscene,glscene,,0,0,0,0,1,0,9,1
rawcontacts,rawcontacts,,0,0,0,0,1,0,3,1
url-design,url-design,,5,1,3,6,10,9,4,1
app-shell,app-shell,,1,0,2,1,3,3,1,1
ibm-certificate-manager,ibm-certificate-manager,,1,0,0,1,4,1,6,1
yii-behaviour,yii-behaviour,,0,0,0,0,2,0,4,1
autodesk-webhooks,autodesk-webhooks,,2,1,2,3,1,5,14,1
microblogging,microblogging,,0,0,1,0,1,1,1,1
python-sacred,python-sacred,,1,0,1,1,2,2,0,1
multiple-entries,multiple-entries,,1,3,5,4,5,9,1,200
testcontext,testcontext,,2,1,3,3,4,6,8,1
handset,handset,,0,0,0,0,1,0,3,1
element-ui,element-ui,,41,36,70,77,96,147,1,1
jetty-8,jetty-8,,4,2,5,6,5,11,3,1
android-native-library,android-native-library,,0,5,2,5,2,7,3,400
pdftex,pdftex,,0,0,1,0,1,1,0,1
goaccess,goaccess,,0,2,2,2,1,4,6,100
jspec,jspec,,0,0,0,0,1,0,3,1
celleditorlistener,celleditorlistener,,0,0,0,0,1,0,1,1
spring-data-neo4,spring-data-neo4,,0,0,1,0,2,1,2,1
expression-encoder-sdk,expression-encoder-sdk,,1,0,0,1,1,1,3,1
rpt,rpt,,4,3,6,7,4,13,8,1
elastic-mq,elastic-mq,,2,2,2,4,2,6,6,1
concatmap,concatmap,,3,4,7,7,7,14,1,33.333333
kognitio-wx2,kognitio-wx2,,0,0,0,0,2,0,4,1
kognitio,kognitio,,0,0,0,0,2,0,4,1
wx2,wx2,,0,0,0,0,2,0,4,1
reactxp,reactxp,,1,1,4,2,11,6,1,1
custom-eventlog,custom-eventlog,,0,0,3,0,4,3,8,1
text-chunking,text-chunking,,0,1,0,1,8,1,0,1
ios5,ios5,,0,1,0,1,2,1,13,1
turi,turi,,0,1,2,1,10,3,0,1
turi-create,turi-create,,6,3,8,9,23,17,0,1
dotless,dotless,,0,2,1,2,3,3,8,100
psqlodbc,psqlodbc,,2,0,3,2,1,5,4,1
asp.net-mvc-templates,asp.net-mvc-templates,,0,0,0,0,1,0,8,1
gulp-useref,gulp-useref,,1,0,2,1,3,3,1,1
gulp-merge,gulp-merge,,0,0,0,0,2,0,1,1
ngx-quill,ngx-quill,,9,7,6,16,1,22,1,1
activation-record,activation-record,,1,1,0,2,3,2,9,1
orcid,orcid,,2,1,1,3,1,4,4,1
xmlsocket,xmlsocket,,0,0,1,0,1,1,13,1
audio-device,audio-device,,2,0,2,2,3,4,13,1
search-regex,search-regex,,0,0,0,0,2,0,1,1
adobe-bridge,adobe-bridge,,0,0,2,0,1,2,1,1
cocoaasyncsocket,cocoaasyncsocket,,1,0,5,1,6,6,13,1
nsd,nsd,,6,7,5,13,9,18,3,16.666667
chipmunk,chipmunk,,3,0,5,3,6,8,0,1
gomoku,gomoku,,0,0,1,0,2,1,0,1
autopy,autopy,,0,3,1,3,1,4,0,200
ilog,ilog,,3,3,9,6,7,15,0,1
node-oracledb,node-oracledb,,11,15,10,26,4,36,1,36.363636
adwords-api-v201109,adwords-api-v201109,,3,1,7,4,4,11,5,1
qdebug,qdebug,,2,2,7,4,6,11,9,1
createparams,createparams,,0,2,0,2,2,2,8,100
activitylog,activitylog,,4,3,4,7,5,11,4,1
cal-heatmap,cal-heatmap,,0,1,2,1,3,3,1,1
nipy,nipy,,1,1,2,2,1,4,0,1
cbor,cbor,,3,4,5,7,10,12,6,33.333333
picoblaze,picoblaze,,0,1,2,1,1,3,9,1
aspectj-maven-plugin,aspectj-maven-plugin,,1,4,11,5,6,16,3,300
efs,efs,,1,9,9,10,17,19,6,800
fastsearch,fastsearch,,0,0,0,0,1,0,8,1
wcf-proxy,wcf-proxy,,0,0,1,0,2,1,8,1
peddler,peddler,,0,0,1,0,1,1,12,1
renewal,renewal,,3,1,0,4,4,4,4,1
radiance-flamingo,radiance-flamingo,,2,2,0,4,2,4,3,1
renewcommand,renewcommand,,1,0,1,1,1,2,0,1
x-ua-compatible,x-ua-compatible,,0,1,3,1,2,4,1,1
free-variable,free-variable,,0,0,2,0,3,2,1,1
http-status-code-304,http-status-code-304,,3,3,2,6,10,8,4,1
viterbi,viterbi,,3,3,9,6,8,15,0,1
effective-pom,effective-pom,,0,0,0,0,3,0,3,1
nativescript-firebase,nativescript-firebase,,7,2,2,9,1,11,1,1
page-lifecycle,page-lifecycle,,1,6,4,7,4,11,8,500
embedded-javascript,embedded-javascript,,2,2,3,4,5,7,1,1
non-unicode,non-unicode,,2,1,2,3,5,5,0,1
xcode-extension,xcode-extension,,2,1,4,3,6,7,13,1
altitude,altitude,,3,3,6,6,5,12,13,1
vaadin-valo-theme,vaadin-valo-theme,,1,0,0,1,3,1,3,1
support-v4,support-v4,,1,1,4,2,12,6,3,1
scom,scom,,2,4,3,6,20,9,8,100
jool-library,jool-library,,0,0,0,0,3,0,3,1
recreate,recreate,,2,3,3,5,6,8,3,50
ancs,ancs,,1,3,1,4,3,5,3,200
ion-list,ion-list,,2,0,4,2,6,6,1,1
ion-grid,ion-grid,,3,2,2,5,8,7,1,1
redmi-permission,redmi-permission,,0,0,0,0,2,0,3,1
marytts,marytts,,3,0,1,3,2,4,3,1
ortc,ortc,,0,1,1,1,2,2,1,1
frontpage,frontpage,,2,0,3,2,4,5,4,1
facebook-app-center,facebook-app-center,,1,0,0,1,4,1,13,1
stencil-compiler,stencil-compiler,,0,0,1,0,2,1,1,1
row-key,row-key,,1,3,1,4,4,5,2,200
node-notifier,node-notifier,,2,0,4,2,7,6,1,1
qoq,qoq,,1,2,6,3,3,9,4,100
webscarab,webscarab,,0,0,2,0,6,2,0,1
irepository,irepository,,0,1,1,1,4,2,8,1
triples,triples,,4,2,7,6,11,13,2,1
dynamic-dispatch,dynamic-dispatch,,3,1,7,4,12,11,9,1
static-binding,static-binding,,0,1,0,1,5,1,9,1
express-gateway,express-gateway,,3,3,11,6,11,17,1,1
jgap,jgap,,0,0,0,0,1,0,3,1
yesod-test,yesod-test,,0,0,0,0,4,0,2,1
xmlstreamreader,xmlstreamreader,,1,0,1,1,7,2,3,1
jspx,jspx,,0,0,3,0,6,3,3,1
explicit-intent,explicit-intent,,1,2,0,3,3,3,3,100
socketstream,socketstream,,0,0,2,0,2,2,13,1
haskell-ffi,haskell-ffi,,2,1,1,3,2,4,2,1
python-bindings,python-bindings,,1,1,2,2,1,4,0,1
hfst,hfst,,0,0,1,0,1,1,0,1
pv,pv,,6,3,7,9,5,16,9,1
zend-form2,zend-form2,,0,0,0,0,1,0,4,1
fontello,fontello,,1,1,2,2,3,4,1,1
dirtyrectangle,dirtyrectangle,,0,0,0,0,1,0,3,1
isoneway,isoneway,,0,0,2,0,1,2,8,1
content-experiments,content-experiments,,1,0,0,1,2,1,5,1
ctakes,ctakes,,2,2,7,4,4,11,3,1
checkvalidity,checkvalidity,,1,3,3,4,4,7,1,200
ora-01031,ora-01031,,0,0,0,0,2,0,4,1
starcounter,starcounter,,0,0,0,0,3,0,8,1
brightstardb,brightstardb,,0,0,0,0,1,0,2,1
dojo.xhrget,dojo.xhrget,,1,0,0,1,3,1,1,1
android-compatibility,android-compatibility,,0,1,3,1,4,4,3,1
ng2-completer,ng2-completer,,1,0,3,1,7,4,1,1
view-source,view-source,,3,2,3,5,11,8,1,1
analytics-engine,analytics-engine,,0,0,4,0,22,4,6,1
analytics-engine-python-sdk,analytics-engine-python-sdk,,0,0,0,0,1,0,6,1
pymodbus,pymodbus,,18,11,41,29,21,70,0,1
windowsformshost,windowsformshost,,3,4,9,7,4,16,8,33.333333
user-object,user-object,,2,0,1,2,4,3,4,1
tkmessagebox,tkmessagebox,,2,0,3,2,7,5,0,1
mix-and-match,mix-and-match,,0,1,0,1,2,1,13,1
vertex-array,vertex-array,,0,0,2,0,4,2,9,1
browser-bugs,browser-bugs,,0,0,0,0,3,0,1,1
r-zelig,r-zelig,,4,2,2,6,5,8,0,1
uiglassbutton,uiglassbutton,,0,0,0,0,1,0,0,1
ndc,ndc,,0,1,0,1,2,1,3,1
xpathnavigator,xpathnavigator,,1,0,1,1,2,2,3,1
qutip,qutip,,2,1,8,3,6,11,0,1
beancreationexception,beancreationexception,,0,0,4,0,6,4,3,1
jsxgraph,jsxgraph,,2,9,3,11,10,14,1,350
python-jose,python-jose,,0,1,4,1,1,5,4,1
hazelcast-jet,hazelcast-jet,,7,0,8,7,23,15,3,1
ios-homekit,ios-homekit,,0,0,8,0,2,8,13,1
covariant-return-types,covariant-return-types,,0,0,4,0,5,4,9,1
orchestra,orchestra,,0,0,3,0,1,3,9,1
lptstr,lptstr,,0,0,1,0,2,1,9,1
struts2-interceptors,struts2-interceptors,,1,1,5,2,2,7,3,1
interceptorstack,interceptorstack,,0,0,0,0,1,0,3,1
linux-distro,linux-distro,,2,0,3,2,2,5,9,1
eulers-number,eulers-number,,3,0,1,3,9,4,0,1
onconfigurationchanged,onconfigurationchanged,,4,3,6,7,3,13,3,1
r-extension,r-extension,,0,1,0,1,3,1,0,1
iana,iana,,2,2,1,4,5,5,4,1
pydrill,pydrill,,0,0,2,0,2,2,4,1
react-animated-weather,react-animated-weather,,0,0,0,0,2,0,1,1
teamwork-projects,teamwork-projects,,0,1,2,1,1,3,6,1
colordialog,colordialog,,0,2,1,2,4,3,8,100
linq-to-json,linq-to-json,,0,0,4,0,3,4,8,1
shinythemes,shinythemes,,1,0,2,1,2,3,0,1
button-to,button-to,,0,0,1,0,1,1,12,1
android-vertical-seekbar,android-vertical-seekbar,,3,2,1,5,5,6,3,1
actuate,actuate,,0,1,0,1,2,1,3,1
sap-r3,sap-r3,,0,0,0,0,1,0,5,1
counter-cache,counter-cache,,0,1,4,1,4,5,12,1
dompurify,dompurify,,2,0,3,2,1,5,4,1
reliable-multicast,reliable-multicast,,0,0,0,0,1,0,9,1
openbox,openbox,,0,0,2,0,3,2,9,1
geckoboard,geckoboard,,1,1,1,2,2,3,9,1
geckosdk,geckosdk,,0,0,0,0,3,0,9,1
sap-connector,sap-connector,,1,1,5,2,12,7,5,1
xinclude,xinclude,,3,2,4,5,5,9,3,1
gcc5,gcc5,,4,1,7,5,5,12,9,1
oracle11gr1,oracle11gr1,,0,0,0,0,2,0,4,1
sprache,sprache,,1,2,1,3,4,4,8,100
asihttprequest,asihttprequest,,0,0,0,0,3,0,13,1
segment-analytics,segment-analytics,,2,1,1,3,4,4,1,1
conferencing,conferencing,,0,0,1,0,3,1,13,1
hudson-api,hudson-api,,0,0,1,0,2,1,6,1
gcallowverylargeobjects,gcallowverylargeobjects,,1,2,1,3,2,4,8,100
gollum-wiki,gollum-wiki,,0,0,0,0,3,0,6,1
unsupported-class-version,unsupported-class-version,,3,5,7,8,7,15,3,66.666667
z-wave,z-wave,,1,1,2,2,7,4,8,1
ember-1,ember-1,,5,0,7,5,1,12,1,1
browser-close,browser-close,,1,1,2,2,2,4,1,1
npm-registry,npm-registry,,3,1,5,4,9,9,1,1
camel-jdbc,camel-jdbc,,0,0,0,0,2,0,3,1
socketscan,socketscan,,0,0,1,0,2,1,8,1
simplemde,simplemde,,0,0,4,0,3,4,1,1
voximal,voximal,,0,1,0,1,2,1,13,1
combodate,combodate,,0,0,0,0,2,0,1,1
react-native-in-app-utils,react-native-in-app-utils,,0,1,0,1,2,1,1,1
focusout,focusout,,0,2,2,2,16,4,1,100
monadfix,monadfix,,0,0,0,0,2,0,2,1
hbmxml,hbmxml,,1,2,1,3,4,4,3,100
elementname,elementname,,1,0,1,1,2,2,8,1
outputstylesheet,outputstylesheet,,0,0,0,0,1,0,3,1
popup.js,popup.js,,1,0,0,1,3,1,1,1
jibx,jibx,,2,1,3,3,3,6,3,1
rabl,rabl,,3,2,0,5,5,5,12,1
posready,posready,,0,0,0,0,2,0,6,1
outer-apply,outer-apply,,1,0,3,1,11,4,4,1
typespec,typespec,,0,1,0,1,8,1,2,1
adaptive-threshold,adaptive-threshold,,1,1,6,2,5,8,0,1
clang-plugin,clang-plugin,,0,1,3,1,1,4,9,1
pendulum,pendulum,,4,3,2,7,9,9,0,1
react-native-swiper,react-native-swiper,,3,5,6,8,9,14,1,66.666667
xml-schema-collection,xml-schema-collection,,2,0,5,2,4,7,3,1
tdictionary,tdictionary,,0,0,0,0,2,0,9,1
nsdocumentdirectory-ios8,nsdocumentdirectory-ios8,,0,0,0,0,1,0,13,1
google-gdk,google-gdk,,2,0,2,2,4,4,3,1
grouped-table,grouped-table,,1,2,3,3,5,6,0,100
spmetal,spmetal,,0,0,1,0,1,1,8,1
quantities,quantities,,1,0,3,1,3,4,0,1
distributed-algorithm,distributed-algorithm,,0,0,0,0,3,0,9,1
django-excel,django-excel,,3,0,3,3,3,6,0,1
dtr,dtr,,0,0,0,0,7,0,6,1
tkplot,tkplot,,1,0,1,1,1,2,0,1
redux-orm,redux-orm,,1,4,1,5,7,6,1,300
poe,poe,,0,0,0,0,1,0,9,1
direnv,direnv,,0,3,4,3,3,7,9,200
idbobjectstore,idbobjectstore,,0,0,2,0,1,2,1,1
null-object-pattern,null-object-pattern,,0,1,5,1,9,6,3,1
handbrake,handbrake,,0,1,9,1,3,10,13,1
apple-numbers-formula,apple-numbers-formula,,0,0,1,0,1,1,5,1
javascriptmvc,javascriptmvc,,0,0,1,0,2,1,1,1
sql-except,sql-except,,1,1,1,2,4,3,4,1
azure-pack,azure-pack,,0,0,1,0,1,1,8,1
rapidsql,rapidsql,,0,0,0,0,3,0,4,1
knitrbootstrap,knitrbootstrap,,0,0,0,0,2,0,0,1
multicorn,multicorn,,0,0,0,0,1,0,4,1
libnet,libnet,,0,0,3,0,4,3,9,1
agentset,agentset,,0,1,2,1,3,3,0,1
package-info,package-info,,0,2,5,2,3,7,3,100
binarywriter,binarywriter,,1,1,6,2,7,8,8,1
font-linking,font-linking,,0,0,0,0,1,0,9,1
bcolz,bcolz,,1,2,2,3,4,5,0,100
buildbot,buildbot,,7,7,8,14,12,22,6,1
ubuntu-15.10,ubuntu-15.10,,0,0,2,0,1,2,4,1
mpfi,mpfi,,0,0,0,0,1,0,9,1
distribution-list,distribution-list,,2,0,1,2,5,3,8,1
pouchdb-adapter-localstorage,pouchdb-adapter-localstorage,,0,0,1,0,3,1,1,1
code-sharing,code-sharing,,1,3,4,4,6,8,1,200
bigmod,bigmod,,0,0,0,0,1,0,0,1
amend,amend,,2,2,10,4,10,14,6,1
adbwireless,adbwireless,,0,0,0,0,2,0,3,1
optional-binding,optional-binding,,3,0,4,3,5,7,13,1
udash,udash,,1,1,0,2,1,2,2,1
trifecta,trifecta,,0,1,1,1,3,2,2,1
waveout,waveout,,0,1,0,1,4,1,9,1
simplecaptcha,simplecaptcha,,0,1,1,1,3,2,3,1
ssreflect,ssreflect,,1,1,4,2,6,6,2,1
z-axis,z-axis,,2,2,1,4,3,5,0,1
crdt,crdt,,0,0,2,0,5,2,0,1
wma,wma,,0,1,3,1,3,4,1,1
rpyc,rpyc,,5,5,5,10,8,15,0,1
filemq,filemq,,0,0,0,0,1,0,0,1
ultratree,ultratree,,0,0,1,0,1,1,8,1
ncybreadcrumb,ncybreadcrumb,,0,0,0,0,1,0,1,1
nsdatecomponent,nsdatecomponent,,0,0,0,0,1,0,13,1
opencv-mat,opencv-mat,,1,1,5,2,12,7,0,1
svn-propset,svn-propset,,1,1,0,2,3,2,6,1
mosml,mosml,,0,0,0,0,13,0,2,1
jsondecoder,jsondecoder,,27,18,56,45,85,101,13,1
titanium-android,titanium-android,,1,1,3,2,4,5,13,1
xml-builder,xml-builder,,1,1,3,2,5,5,1,1
pear-mail,pear-mail,,0,0,1,0,4,1,4,1
space-filling-curve,space-filling-curve,,0,0,3,0,4,3,0,1
margin-left,margin-left,,1,1,1,2,6,3,1,1
neo4j-desktop,neo4j-desktop,,3,2,4,5,11,9,2,1
login-system,login-system,,1,1,4,2,4,6,4,1
interactor-backend,interactor-backend,,0,0,0,0,1,0,3,1
gnu-common-lisp,gnu-common-lisp,,0,0,2,0,3,2,0,1
ipod-touch,ipod-touch,,0,0,0,0,2,0,13,1
s7graphview,s7graphview,,0,0,0,0,1,0,3,1
facebook-wall,facebook-wall,,0,0,1,0,5,1,13,1
wordcloud2,wordcloud2,,3,6,7,9,10,16,0,100
sxssf,sxssf,,1,0,2,1,5,3,3,1
os.execl,os.execl,,0,0,0,0,3,0,0,1
django-generic-relations,django-generic-relations,,4,1,1,5,5,6,0,1
tabledit,tabledit,,2,3,5,5,3,10,1,50
react-thunk,react-thunk,,6,3,9,9,11,18,1,1
libtcod,libtcod,,1,0,5,1,3,6,0,1
request.form,request.form,,3,0,1,3,7,4,8,1
y-combinator,y-combinator,,2,1,6,3,6,9,2,1
firebase-cli,firebase-cli,,40,46,95,86,134,181,13,15
stacktable.js,stacktable.js,,0,1,0,1,1,1,1,1
quasiquotes,quasiquotes,,4,4,8,8,8,16,0,1
data-capture,data-capture,,0,0,3,0,1,3,9,1
ipfw,ipfw,,1,0,0,1,3,1,9,1
fourcc,fourcc,,3,2,2,5,4,7,13,1
docbook-xsl,docbook-xsl,,2,0,3,2,4,5,3,1
flvplayback,flvplayback,,1,0,0,1,2,1,13,1
green-shoes,green-shoes,,0,0,0,0,3,0,12,1
gtkentry,gtkentry,,1,0,1,1,1,2,9,1
ambiguous-call,ambiguous-call,,2,3,8,5,7,13,9,50
nsmutablestring,nsmutablestring,,3,1,0,4,6,4,13,1
qtquickextras,qtquickextras,,0,0,0,0,2,0,9,1
const-pointer,const-pointer,,1,0,6,1,2,7,9,1
gopherjs,gopherjs,,1,1,1,2,5,3,1,1
cardano,cardano,,2,4,1,6,4,7,6,100
audioclip,audioclip,,3,2,4,5,5,9,8,1
nowrap,nowrap,,2,1,2,3,6,5,1,1
visual-c++-2010,visual-c++-2010,,1,1,1,2,4,3,9,1
lbph-algorithm,lbph-algorithm,,6,2,8,8,15,16,0,1
xcf,xcf,,0,1,2,1,1,3,0,1
qsystemtrayicon,qsystemtrayicon,,2,0,6,2,2,8,0,1
opengl-es-1.1,opengl-es-1.1,,0,0,1,0,4,1,3,1
buzz,buzz,,0,0,0,0,1,0,6,1
vectormath,vectormath,,2,3,4,5,7,9,8,50
textlabel,textlabel,,1,1,5,2,2,7,13,1
countries,countries,,3,3,6,6,8,12,4,1
nlua,nlua,,2,0,6,2,7,8,8,1
google-maps-android-api-1,google-maps-android-api-1,,1,0,0,1,1,1,3,1
healpy,healpy,,4,5,4,9,13,13,0,25
avcodec,avcodec,,2,0,0,2,4,2,13,1
callblocking,callblocking,,0,3,0,3,2,3,13,200
integer-partition,integer-partition,,0,4,0,4,4,4,0,300
unirx,unirx,,0,5,5,5,4,10,8,400
rethrow,rethrow,,1,2,2,3,4,5,3,100
ihttphandler,ihttphandler,,3,1,7,4,6,11,8,1
pdp-11,pdp-11,,0,1,1,1,6,2,9,1
vue-class-components,vue-class-components,,13,8,5,21,10,26,1,1
vram,vram,,2,2,1,4,3,5,9,1
sql-server-unit-testing,sql-server-unit-testing,,1,0,0,1,1,1,4,1
termcolor,termcolor,,0,4,1,4,6,5,0,300
zenhub,zenhub,,0,1,2,1,3,3,6,1
findby,findby,,1,5,7,6,10,13,3,400
mate-desktop,mate-desktop,,1,0,2,1,1,3,9,1
light-sensor,light-sensor,,0,4,1,4,4,5,3,300
jogetworkflow,jogetworkflow,,1,0,2,1,1,3,3,1
surround,surround,,4,1,3,5,6,8,9,1
dist-zilla,dist-zilla,,2,0,1,2,2,3,9,1
ruby-on-rails-5.2,ruby-on-rails-5.2,,97,73,140,170,158,310,12,1
mysql-error-1050,mysql-error-1050,,0,0,0,0,1,0,4,1
partial-functions,partial-functions,,2,0,3,2,3,5,2,1
dynamic-data,dynamic-data,,12,3,15,15,14,30,8,1
angularbootstrap-lightbox,angularbootstrap-lightbox,,0,0,0,0,1,0,1,1
fusedlocationproviderclient,fusedlocationproviderclient,,19,12,27,31,38,58,3,1
jabberd2,jabberd2,,0,0,0,0,1,0,8,1
current-principal,current-principal,,0,0,0,0,2,0,8,1
highline,highline,,0,0,1,0,2,1,12,1
bulletproof,bulletproof,,0,0,2,0,2,2,4,1
facebook-monetization-manager,facebook-monetization-manager,,1,1,4,2,4,6,3,1
senti-wordnet,senti-wordnet,,1,0,3,1,2,4,0,1
short-open-tags,short-open-tags,,0,0,0,0,1,0,4,1
proteus,proteus,,0,6,1,6,3,7,3,500
linkedin-ios-sdk,linkedin-ios-sdk,,0,1,0,1,1,1,13,1
std-filesystem,std-filesystem,,8,8,7,16,12,23,9,1
incredibuild,incredibuild,,2,0,3,2,6,5,8,1
reliable-actors,reliable-actors,,0,1,1,1,4,2,8,1
omise,omise,,0,0,1,0,1,1,4,1
stdany,stdany,,3,5,2,8,5,10,9,66.666667
mylyn,mylyn,,2,0,2,2,3,4,3,1
grid.mvc,grid.mvc,,3,3,7,6,6,13,8,1
virtual-server,virtual-server,,4,2,2,6,7,8,4,1
qfileinfo,qfileinfo,,0,0,1,0,4,1,9,1
osx-mountain-lion,osx-mountain-lion,,0,0,0,0,1,0,9,1
svncommit,svncommit,,2,1,1,3,2,4,6,1
thread-sanitizer,thread-sanitizer,,3,1,3,4,9,7,9,1
actian,actian,,0,4,0,4,2,4,4,300
clojure-testing,clojure-testing,,1,1,0,2,3,2,2,1
previewcallback,previewcallback,,0,0,0,0,1,0,3,1
audioqueueservices,audioqueueservices,,1,3,0,4,5,4,13,200
chatfuel,chatfuel,,3,2,10,5,11,15,13,1
monitors,monitors,,0,0,0,0,5,0,3,1
file-connection,file-connection,,1,0,0,1,1,1,14,1
optional-variables,optional-variables,,0,0,1,0,4,1,13,1
applicationreference,applicationreference,,0,0,0,0,1,0,1,1
ndbunit,ndbunit,,0,0,0,0,1,0,6,1
aapt2,aapt2,,9,5,33,14,49,47,3,1
root-certificate,root-certificate,,2,4,5,6,4,11,6,100
certifi,certifi,,1,1,1,2,4,3,6,1
stringgrid,stringgrid,,0,0,2,0,4,2,9,1
moo,moo,,0,2,2,2,9,4,9,100
api-eveonline,api-eveonline,,1,0,0,1,4,1,4,1
function-literal,function-literal,,0,0,1,0,4,1,2,1
zeta-components,zeta-components,,0,0,0,0,1,0,4,1
smartsheet-java-sdk-v2,smartsheet-java-sdk-v2,,0,2,0,2,2,2,8,100
httpfilecollection,httpfilecollection,,0,0,0,0,1,0,8,1
jvm-languages,jvm-languages,,0,0,2,0,2,2,3,1
java-runtime-compiler,java-runtime-compiler,,2,2,3,4,4,7,3,1
kendo-tabstrip,kendo-tabstrip,,4,3,8,7,6,15,1,1
webflow,webflow,,9,13,11,22,6,33,1,44.444444
hp-exstream,hp-exstream,,0,0,1,0,3,1,8,1
android-shell,android-shell,,0,1,1,1,3,2,3,1
geometric-arc,geometric-arc,,0,0,2,0,1,2,0,1
site-definition,site-definition,,0,0,0,0,1,0,8,1
cookie-authentication,cookie-authentication,,11,7,10,18,14,28,8,1
visitor-statistic,visitor-statistic,,2,0,4,2,1,6,5,1
jcodemodel,jcodemodel,,3,0,3,3,4,6,3,1
dxt,dxt,,1,1,2,2,1,4,0,1
multiplicity,multiplicity,,2,3,4,5,8,9,3,50
pyx,pyx,,1,3,2,4,10,6,0,200
windows-clustering,windows-clustering,,2,4,4,6,8,10,4,100
quartzcode,quartzcode,,0,0,0,0,1,0,13,1
sockjs-tornado,sockjs-tornado,,0,0,0,0,1,0,0,1
weatherdata,weatherdata,,1,0,3,1,2,4,4,1
ubuntu-17.10,ubuntu-17.10,,1,1,8,2,73,10,9,1
result-of,result-of,,1,0,2,1,6,3,9,1
android-viewtreeobserver,android-viewtreeobserver,,3,1,4,4,5,8,3,1
ngx-uploader,ngx-uploader,,0,2,4,2,5,6,1,100
kendonumerictextbox,kendonumerictextbox,,0,1,1,1,8,2,1,1
seneca,seneca,,2,2,3,4,9,7,1,1
tibco-topic,tibco-topic,,1,1,4,2,5,6,3,1
database-comparison,database-comparison,,0,2,0,2,1,2,4,100
equal-range,equal-range,,2,1,1,3,4,4,9,1
ammo.js,ammo.js,,1,2,3,3,5,6,1,100
mercurial-revsets,mercurial-revsets,,0,0,0,0,2,0,6,1
angular-changedetection,angular-changedetection,,19,28,43,47,35,90,1,47.368421
tcc,tcc,,2,1,7,3,9,10,9,1
rtw,rtw,,0,0,0,0,1,0,0,1
raw-disk,raw-disk,,0,0,0,0,2,0,6,1
taglib-ruby,taglib-ruby,,0,0,0,0,1,0,12,1
hexagon-dsp,hexagon-dsp,,0,0,2,0,9,2,3,1
type-bounds,type-bounds,,5,3,6,8,15,14,2,1
jsontemplate,jsontemplate,,1,1,0,2,1,2,1,1
mercator,mercator,,2,1,6,3,7,9,0,1
onlinebanking,onlinebanking,,2,0,4,2,5,6,4,1
html-content-extraction,html-content-extraction,,3,2,1,5,3,6,3,1
fastutil,fastutil,,1,0,6,1,4,7,3,1
jboss-modules,jboss-modules,,1,3,5,4,7,9,3,200
graphson,graphson,,0,0,1,0,5,1,2,1
jdoql,jdoql,,0,2,1,2,1,3,3,100
ms-tracing-eventsource,ms-tracing-eventsource,,0,0,0,0,1,0,8,1
basedon,basedon,,1,0,0,1,2,1,8,1
carekit,carekit,,0,1,0,1,3,1,13,1
autoexposurecompensation,autoexposurecompensation,,0,2,2,2,1,4,3,100
smartmeter,smartmeter,,0,0,1,0,2,1,0,1
flanneld,flanneld,,1,1,4,2,6,6,6,1
ops4j,ops4j,,1,1,0,2,4,2,3,1
mercadopagosdk,mercadopagosdk,,5,0,2,5,5,7,4,1
mercadopago,mercadopago,,7,3,6,10,9,16,4,1
zapproxy,zapproxy,,0,1,2,1,3,3,4,1
pasting,pasting,,1,4,1,5,2,6,5,300
directcompute,directcompute,,2,10,3,12,3,15,9,400
neoload,neoload,,3,2,4,5,9,9,3,1
xmlservice,xmlservice,,0,3,5,3,1,8,5,200
figaro-lang,figaro-lang,,0,0,0,0,1,0,0,1
enigma2,enigma2,,1,0,0,1,3,1,0,1
command-timeout,command-timeout,,3,0,1,3,3,4,4,1
castra,castra,,0,0,0,0,2,0,0,1
apdex,apdex,,0,2,0,2,2,2,3,100
filebrowse,filebrowse,,1,0,0,1,1,1,1,1
hyperloop,hyperloop,,0,0,1,0,2,1,13,1
adhearsion,adhearsion,,1,0,0,1,1,1,13,1
xdoc,xdoc,,1,2,5,3,6,8,8,100
neoeloquent,neoeloquent,,2,0,5,2,3,7,4,1
jtoolbar,jtoolbar,,2,1,0,3,5,3,3,1
fedora20,fedora20,,0,0,0,0,3,0,9,1
dynamic-compilation,dynamic-compilation,,0,1,4,1,7,5,8,1
winmail.dat,winmail.dat,,0,0,1,0,1,1,4,1
filter-run-excluding,filter-run-excluding,,0,0,0,0,2,0,12,1
objenesis,objenesis,,0,0,0,0,2,0,3,1
user-testing,user-testing,,0,0,1,0,1,1,12,1
android-deep-link,android-deep-link,,13,11,23,24,1,47,3,1
locf,locf,,2,1,6,3,8,9,0,1
qqmllistproperty,qqmllistproperty,,1,0,0,1,5,1,9,1
puphpet,puphpet,,0,2,1,2,6,3,4,100
port-number,port-number,,1,0,8,1,9,9,4,1
bgi,bgi,,4,3,7,7,12,14,9,1
toolstripitem,toolstripitem,,1,0,0,1,1,1,8,1
textrenderer,textrenderer,,0,0,1,0,4,1,8,1
wcf-routing,wcf-routing,,0,0,0,0,1,0,8,1
web-compiler,web-compiler,,1,4,5,5,5,10,8,300
jquery-data,jquery-data,,0,0,0,0,3,0,1,1
jform-designer,jform-designer,,0,0,1,0,4,1,3,1
phpdebugbar,phpdebugbar,,3,2,1,5,3,6,4,1
log4r,log4r,,0,0,0,0,1,0,12,1
savepoints,savepoints,,3,2,3,5,1,8,4,1
encodable,encodable,,10,4,9,14,18,23,13,1
fluent-security,fluent-security,,0,0,0,0,1,0,4,1
actualheight,actualheight,,0,0,0,0,1,0,8,1
android-banner,android-banner,,0,0,0,0,2,0,3,1
uielement,uielement,,3,1,9,4,9,13,8,1
kubernetes-custom-resources,kubernetes-custom-resources,,6,3,7,9,7,16,6,1
input-history,input-history,,3,2,3,5,3,8,9,1
ml-gradle,ml-gradle,,3,6,7,9,5,16,3,100
aes-ni,aes-ni,,1,0,1,1,3,2,6,1
tabactivity,tabactivity,,1,1,1,2,3,3,3,1
class-decorator,class-decorator,,1,1,1,2,2,3,0,1
pimple,pimple,,1,1,0,2,2,2,4,1
custom-selectors,custom-selectors,,1,2,0,3,2,3,1,100
execution-api,execution-api,,0,1,0,1,1,1,5,1
inky,inky,,2,1,3,3,6,6,1,1
jboss-amq,jboss-amq,,0,0,2,0,8,2,3,1
deferred-result,deferred-result,,1,1,5,2,4,7,3,1
ember-rails,ember-rails,,0,0,0,0,1,0,1,1
lineplusbarchart,lineplusbarchart,,0,0,2,0,3,2,1,1
dumpbin,dumpbin,,2,1,5,3,6,8,9,1
pdfium,pdfium,,4,4,7,8,14,15,8,1
toolsapi,toolsapi,,0,0,1,0,6,1,9,1
cubic,cubic,,0,1,4,1,2,5,0,1
sitebricks,sitebricks,,1,0,0,1,1,1,3,1
console.readkey,console.readkey,,0,1,2,1,3,3,8,1
rgraph,rgraph,,1,6,3,7,5,10,1,500
rook-storage,rook-storage,,1,4,2,5,2,7,6,300
ppdb,ppdb,,0,0,0,0,1,0,8,1
red-system,red-system,,0,0,0,0,1,0,0,1
jquery-jscroll,jquery-jscroll,,3,1,3,4,4,7,4,1
aide,aide,,4,1,10,5,7,15,3,1
proftpd,proftpd,,1,2,6,3,9,9,4,100
resolveurl,resolveurl,,0,0,1,0,1,1,1,1
keystrokes,keystrokes,,0,0,0,0,4,0,9,1
phpdocx,phpdocx,,0,0,1,0,2,1,4,1
bank-conflict,bank-conflict,,0,0,0,0,3,0,0,1
void-t,void-t,,0,1,1,1,3,2,9,1
musl,musl,,5,3,8,8,6,16,9,1
parceljs,parceljs,,45,28,67,73,44,140,1,1
cilium,cilium,,1,1,5,2,1,7,6,1
kubernetes-networkpolicy,kubernetes-networkpolicy,,7,8,15,15,15,30,6,14.285714
virtual-device-manager,virtual-device-manager,,0,1,4,1,7,5,3,1
zurb-ink,zurb-ink,,1,2,6,3,7,9,1,100
twemoji,twemoji,,2,2,1,4,3,5,0,1
gap-system,gap-system,,0,0,0,0,4,0,0,1
twitter-button,twitter-button,,0,0,0,0,1,0,1,1
sourcelink,sourcelink,,5,1,6,6,3,12,8,1
java-metro-framework,java-metro-framework,,0,2,3,2,1,5,3,100
generative-art,generative-art,,0,1,1,1,3,2,0,1
filestreamresult,filestreamresult,,2,1,2,3,4,5,8,1
spir,spir,,0,0,1,0,2,1,0,1
pandora,pandora,,0,0,0,0,2,0,1,1
arrange-act-assert,arrange-act-assert,,0,0,0,0,1,0,0,1
kissxml,kissxml,,0,0,2,0,2,2,13,1
bitmap-fonts,bitmap-fonts,,0,0,2,0,5,2,3,1
mkmapcamera,mkmapcamera,,0,0,0,0,1,0,13,1
fluture,fluture,,1,0,1,1,5,2,2,1
norm,norm,,1,3,5,4,6,9,0,200
google-client-login,google-client-login,,2,1,3,3,5,6,5,1
register-globals,register-globals,,0,1,0,1,1,1,4,1
tabletop.js,tabletop.js,,5,1,7,6,4,13,1,1
xbmc,xbmc,,0,0,1,0,4,1,0,1
buildconfig,buildconfig,,2,1,3,3,8,6,3,1
gridviewrow,gridviewrow,,2,1,1,3,2,4,8,1
adxstudio-portals,adxstudio-portals,,1,6,5,7,11,12,8,500
scaletype,scaletype,,2,1,5,3,7,8,3,1
angular2-filtering,angular2-filtering,,0,0,0,0,3,0,1,1
django-upgrade,django-upgrade,,0,0,2,0,5,2,0,1
unity3d-mecanim,unity3d-mecanim,,4,1,4,5,2,9,8,1
bcdedit,bcdedit,,3,0,1,3,6,4,9,1
variation,variation,,0,0,0,0,13,0,4,1
hermit,hermit,,1,0,9,1,10,10,2,1
hello.js,hello.js,,3,1,7,4,5,11,8,1
scala-maven-plugin,scala-maven-plugin,,4,1,1,5,7,6,3,1
scrollreveal.js,scrollreveal.js,,1,1,1,2,10,3,1,1
django-endless-pagination,django-endless-pagination,,0,0,0,0,6,0,0,1
nexus-10,nexus-10,,1,0,1,1,1,2,3,1
bamboo-artifacts,bamboo-artifacts,,1,0,3,1,5,4,6,1
sirtrevor,sirtrevor,,0,0,0,0,1,0,12,1
questasim,questasim,,3,4,5,7,4,12,9,33.333333
laravel-cache,laravel-cache,,0,1,3,1,7,4,4,1
trigraphs,trigraphs,,0,0,1,0,1,1,9,1
wordpress-shortcode,wordpress-shortcode,,17,17,32,34,45,66,4,1
pagefile,pagefile,,0,0,3,0,1,3,9,1
vora,vora,,0,0,2,0,5,2,5,1
quantile-regression,quantile-regression,,7,3,7,10,10,17,0,1
cvxr,cvxr,,3,3,3,6,4,9,0,1
hungarian-notation,hungarian-notation,,1,0,2,1,3,3,8,1
humanizer,humanizer,,0,1,2,1,2,3,8,1
xmlconvert,xmlconvert,,0,0,2,0,3,2,3,1
little-proxy,little-proxy,,0,1,1,1,5,2,3,1
libmagic,libmagic,,2,1,6,3,5,9,0,1
digital-filter,digital-filter,,0,0,2,0,3,2,0,1
crocodoc,crocodoc,,0,0,0,0,1,0,8,1
mammoth,mammoth,,3,1,3,4,2,7,1,1
git-bisect,git-bisect,,1,0,4,1,3,5,6,1
caemitterlayer,caemitterlayer,,1,1,9,2,5,11,13,1
in-memory-data-grid,in-memory-data-grid,,2,1,2,3,7,5,3,1
maximage2,maximage2,,0,0,0,0,1,0,1,1
decimal-precision,decimal-precision,,0,0,0,0,2,0,0,1
postgres-plpython,postgres-plpython,,0,2,1,2,3,3,4,100
workflow-foundation-4.5,workflow-foundation-4.5,,0,1,1,1,1,2,8,1
uideviceorientation,uideviceorientation,,2,0,2,2,5,4,13,1
rcrawler,rcrawler,,5,0,4,5,10,9,0,1
doze,doze,,2,2,9,4,16,13,3,1
xquery-3.1,xquery-3.1,,1,2,3,3,6,6,3,100
webclient.uploaddata,webclient.uploaddata,,0,2,0,2,3,2,8,100
youku,youku,,0,1,5,1,2,6,1,1
oracle-service-bus,oracle-service-bus,,2,1,4,3,7,7,3,1
orangehrm,orangehrm,,0,1,1,1,4,2,4,1
libketama,libketama,,0,0,0,0,2,0,3,1
skydns,skydns,,0,1,1,1,3,2,6,1
groupme,groupme,,2,3,6,5,4,11,0,50
loggly,loggly,,1,2,7,3,4,10,8,100
appsflyer-ios-sdk,appsflyer-ios-sdk,,3,0,2,3,2,5,13,1
appsflyer-cordova-sdk,appsflyer-cordova-sdk,,1,0,1,1,4,2,1,1
spquery,spquery,,0,0,1,0,1,1,8,1
babeltrace,babeltrace,,1,1,4,2,2,6,8,1
reqwest,reqwest,,2,3,6,5,11,11,9,50
hyperspec,hyperspec,,0,1,1,1,3,2,0,1
gulp-webpack,gulp-webpack,,1,0,1,1,5,2,1,1
mws,mws,,0,0,0,0,9,0,6,1
wixsharp,wixsharp,,3,3,6,6,9,12,8,1
http-content-range,http-content-range,,2,0,3,2,2,5,1,1
multiple-arguments,multiple-arguments,,4,0,3,4,8,7,0,1
longest-prefix,longest-prefix,,0,1,4,1,1,5,0,1
amazon-neptune,amazon-neptune,,29,32,55,61,52,116,2,10.344828
voting-system,voting-system,,4,4,4,8,5,12,0,1
rollovers,rollovers,,0,0,0,0,1,0,1,1
ipmitool,ipmitool,,2,1,0,3,4,3,9,1
sharepoint-userprofile,sharepoint-userprofile,,0,0,3,0,4,3,8,1
httpresponsecache,httpresponsecache,,1,0,1,1,2,2,8,1
copilot,copilot,,2,1,0,3,1,3,13,1
python-egg-cache,python-egg-cache,,0,0,0,0,1,0,0,1
azure-eventhub-capture,azure-eventhub-capture,,2,8,13,10,9,23,8,300
common-data-format,common-data-format,,0,0,1,0,1,1,0,1
cl-who,cl-who,,2,0,1,2,2,3,0,1
parenscript,parenscript,,1,0,0,1,4,1,0,1
gl-triangle-strip,gl-triangle-strip,,0,2,0,2,4,2,9,100
getdirectories,getdirectories,,0,3,1,3,2,4,8,200
spike,spike,,0,1,2,1,4,3,0,1
drupal-permissions,drupal-permissions,,0,0,1,0,1,1,4,1
drupal-roles,drupal-roles,,0,1,1,1,1,2,4,1
typescript2.6,typescript2.6,,0,0,0,0,7,0,1,1
opennmt,opennmt,,5,7,3,12,3,15,0,40
oajax.js,oajax.js,,0,0,0,0,1,0,1,1
pmw,pmw,,0,1,0,1,1,1,0,1
performselector,performselector,,0,1,2,1,7,3,13,1
slick-2.0,slick-2.0,,0,0,3,0,3,3,2,1
ibm-data-studio,ibm-data-studio,,1,5,5,6,13,11,4,400
magic-constants,magic-constants,,0,5,1,5,4,6,4,400
operationcontext,operationcontext,,0,1,1,1,1,2,8,1
weboperationcontext,weboperationcontext,,0,0,3,0,1,3,8,1
node-ipc,node-ipc,,1,1,3,2,1,5,1,1
meteor-slingshot,meteor-slingshot,,0,0,0,0,5,0,6,1
ex-navigation,ex-navigation,,0,0,0,0,1,0,1,1
delimiter-separated-values,delimiter-separated-values,,4,4,12,8,13,20,0,1
bitboard,bitboard,,4,0,4,4,4,8,0,1
project-valhalla,project-valhalla,,0,0,2,0,3,2,3,1
google-optimize,google-optimize,,11,13,11,24,26,35,5,18.181818
expresso-store,expresso-store,,0,0,0,0,1,0,6,1
pyv8,pyv8,,0,0,1,0,3,1,0,1
kali-linux,kali-linux,,9,17,8,26,1,34,9,88.888889
pypdf,pypdf,,5,9,13,14,12,27,0,80
android-components,android-components,,4,4,4,8,11,12,3,1
timezonedb,timezonedb,,1,0,1,1,3,2,4,1
toolstripmenu,toolstripmenu,,2,1,0,3,4,3,8,1
cd-rom,cd-rom,,0,4,4,4,6,8,9,300
cytoscape-web,cytoscape-web,,1,0,1,1,5,2,1,1
toolstripbutton,toolstripbutton,,1,0,1,1,2,2,8,1
backstage,backstage,,1,0,0,1,1,1,5,1
devise-recoverable,devise-recoverable,,1,2,1,3,6,4,12,100
dependency-graph,dependency-graph,,2,1,0,3,6,3,9,1
plagiarism-detection,plagiarism-detection,,1,0,2,1,2,3,4,1
hamiltonian-cycle,hamiltonian-cycle,,2,1,3,3,7,6,0,1
rsyntaxtextarea,rsyntaxtextarea,,1,0,1,1,4,2,3,1
akka-fsm,akka-fsm,,0,0,3,0,5,3,2,1
shader-storage-buffer,shader-storage-buffer,,1,2,1,3,4,4,9,100
cppunit,cppunit,,1,6,4,7,4,11,9,500
grunt-contrib-coffee,grunt-contrib-coffee,,0,0,0,0,1,0,1,1
ace-tao,ace-tao,,0,0,1,0,1,1,9,1
strapi,strapi,,29,57,64,86,36,150,1,96.551724
xml-simple,xml-simple,,0,0,4,0,1,4,9,1
pyrserve,pyrserve,,0,0,0,0,1,0,0,1
obscured-view,obscured-view,,1,0,0,1,2,1,13,1
jsr107,jsr107,,0,6,1,6,6,7,3,500
bootstrap-vue,bootstrap-vue,,82,91,115,173,104,288,1,10.97561
syn,syn,,0,1,3,1,4,4,9,1
page-editor,page-editor,,0,0,0,0,1,0,8,1
netbsd,netbsd,,1,0,4,1,2,5,9,1
pkgsrc,pkgsrc,,0,1,0,1,1,1,9,1
winreg,winreg,,1,2,6,3,11,9,0,100
jsonencoder,jsonencoder,,6,6,5,12,29,17,13,1
codepage-437,codepage-437,,0,0,2,0,3,2,9,1
r-modis,r-modis,,6,3,2,9,5,11,0,1
objective-c-literals,objective-c-literals,,0,0,0,0,1,0,13,1
axibase,axibase,,0,0,0,0,1,0,0,1
animatewithduration,animatewithduration,,0,1,0,1,3,1,13,1
browserify-shim,browserify-shim,,1,0,0,1,1,1,1,1
librato,librato,,2,0,0,2,5,2,3,1
orbot,orbot,,0,0,2,0,2,2,0,1
parameter-sets,parameter-sets,,1,2,1,3,5,4,8,100
blogengine.net,blogengine.net,,0,1,1,1,2,2,8,1
xenu,xenu,,0,0,0,0,3,0,4,1
activitydesigner,activitydesigner,,1,1,0,2,1,2,8,1
vuzixm100,vuzixm100,,0,1,0,1,2,1,3,1
zentest,zentest,,0,0,0,0,1,0,12,1
design-documents,design-documents,,0,1,1,1,3,2,1,1
id-generation,id-generation,,2,2,8,4,6,12,3,1
caddyfile,caddyfile,,9,1,10,10,17,20,6,1
intersystems-cache-studio,intersystems-cache-studio,,0,0,0,0,3,0,4,1
intersystems-cache-zen,intersystems-cache-zen,,0,0,0,0,1,0,4,1
intersystems-healthshare,intersystems-healthshare,,0,0,0,0,1,0,4,1
couchrest,couchrest,,0,0,0,0,1,0,12,1
explicit-specialization,explicit-specialization,,0,0,1,0,3,1,9,1
uimafit,uimafit,,3,0,0,3,1,3,3,1
window.external,window.external,,0,0,0,0,1,0,1,1
window-tester,window-tester,,0,0,0,0,1,0,6,1
python-manylinux,python-manylinux,,0,0,2,0,5,2,0,1
java-access-bridge,java-access-bridge,,1,2,2,3,3,5,3,100
html-compression,html-compression,,0,0,0,0,2,0,1,1
timbre,timbre,,0,0,3,0,1,3,2,1
rel,rel,,4,1,4,5,8,9,1,1
renice,renice,,0,0,0,0,1,0,3,1
angularfire2-offline,angularfire2-offline,,0,1,2,1,3,3,13,1
syslistview32,syslistview32,,1,0,1,1,4,2,8,1
movefile,movefile,,1,1,3,2,8,5,0,1
groc,groc,,0,0,0,0,1,0,6,1
child-nodes,child-nodes,,4,4,5,8,12,13,1,1
softirq,softirq,,0,0,2,0,3,2,9,1
windows-mixed-reality,windows-mixed-reality,,23,11,17,34,17,51,8,1
parrot-os,parrot-os,,3,1,4,4,8,8,9,1
actualwidth,actualwidth,,1,1,1,2,1,3,8,1
pusher-js,pusher-js,,9,7,23,16,15,39,4,1
ghostscriptsharp,ghostscriptsharp,,0,0,0,0,1,0,8,1
pim,pim,,1,2,3,3,7,6,4,100
laravel-form,laravel-form,,3,8,4,11,11,15,4,166.666667
dbexpress,dbexpress,,3,2,1,5,10,6,9,1
srtm,srtm,,0,1,0,1,3,1,0,1
hgt,hgt,,0,0,0,0,2,0,13,1
openfaas,openfaas,,6,3,6,9,3,15,6,1
facebook-public-feed-api,facebook-public-feed-api,,0,0,0,0,2,0,13,1
sage-300,sage-300,,1,0,0,1,2,1,8,1
visual-c++-2012,visual-c++-2012,,1,0,2,1,2,3,9,1
content-pipeline,content-pipeline,,0,0,0,0,1,0,9,1
dispatchworkitem,dispatchworkitem,,0,1,3,1,5,4,13,1
hypertrack,hypertrack,,0,0,0,0,7,0,13,1
bifunctor,bifunctor,,1,2,2,3,3,5,2,100
distributive,distributive,,1,0,0,1,3,1,2,1
layout-animation,layout-animation,,1,2,5,3,8,8,1,100
dynamics-365-sales,dynamics-365-sales,,1,4,2,5,1,7,8,300
dynamics-crm-365-v9,dynamics-crm-365-v9,,2,2,15,4,28,19,8,1
type-resolution,type-resolution,,0,0,3,0,4,3,3,1
languageservice,languageservice,,0,0,1,0,5,1,9,1
system.exit,system.exit,,4,1,1,5,5,6,3,1
winelib,winelib,,1,0,0,1,2,1,9,1
commenting,commenting,,1,4,6,5,10,11,0,300
webresource,webresource,,0,4,5,4,9,9,8,300
zsh-alias,zsh-alias,,2,0,2,2,1,4,9,1
gamecontroller,gamecontroller,,4,2,2,6,7,8,8,1
metaocaml,metaocaml,,0,0,0,0,1,0,9,1
angular-materialize,angular-materialize,,0,0,1,0,1,1,1,1
concurrent-processing,concurrent-processing,,0,0,0,0,3,0,8,1
emoji-tones,emoji-tones,,0,1,1,1,3,2,0,1
formmail,formmail,,1,0,2,1,3,3,4,1
.git-folder,.git-folder,,1,2,2,3,7,5,6,100
serviceextension,serviceextension,,0,0,2,0,3,2,13,1
clang-cl,clang-cl,,2,6,4,8,5,12,9,200
fieldtype,fieldtype,,0,0,3,0,10,3,4,1
package-explorer,package-explorer,,0,0,1,0,3,1,3,1
redhat-dts,redhat-dts,,1,0,1,1,1,2,9,1
white-labelling,white-labelling,,4,0,4,4,9,8,4,1
maptiler,maptiler,,0,2,5,2,6,7,1,100
viola-jones,viola-jones,,1,1,0,2,3,2,0,1
i3,i3,,16,7,15,23,11,38,9,1
three-valued-logic,three-valued-logic,,0,1,1,1,3,2,4,1
glowscript,glowscript,,0,2,2,2,4,4,0,100
xamlreader,xamlreader,,1,0,0,1,1,1,8,1
nssavepanel,nssavepanel,,0,0,2,0,3,2,13,1
fgetpos,fgetpos,,0,0,1,0,1,1,9,1
smallbasic,smallbasic,,0,0,1,0,3,1,0,1
google-cloud-debugger,google-cloud-debugger,,0,1,2,1,2,3,6,1
unnamed-namespace,unnamed-namespace,,0,0,0,0,1,0,9,1
conda-forge,conda-forge,,5,6,0,11,2,11,0,20
python-dataclasses,python-dataclasses,,20,21,38,41,29,79,0,5
post-receive-email,post-receive-email,,0,0,0,0,1,0,6,1
logstash-input-jdbc,logstash-input-jdbc,,0,0,0,0,1,0,3,1
dynamic-parallelism,dynamic-parallelism,,0,1,1,1,4,2,0,1
axosoft,axosoft,,0,0,0,0,2,0,6,1
python-module-unicodedata,python-module-unicodedata,,2,1,1,3,4,4,0,1
reloadable,reloadable,,0,0,0,0,2,0,3,1
grunt-concurrent,grunt-concurrent,,0,0,0,0,2,0,1,1
homoiconicity,homoiconicity,,0,0,1,0,1,1,2,1
moonsharp,moonsharp,,3,0,0,3,3,3,9,1
worker-pool,worker-pool,,1,1,2,2,1,4,6,1
twitter-anywhere,twitter-anywhere,,0,0,0,0,1,0,4,1
keywindow,keywindow,,0,0,1,0,2,1,13,1
ponylang,ponylang,,0,1,1,1,1,2,2,1
curve-25519,curve-25519,,0,2,0,2,2,2,6,100
uib,uib,,3,1,2,4,4,6,1,1
focuslistener,focuslistener,,2,0,3,2,2,5,3,1
ditto,ditto,,0,0,2,0,1,2,13,1
errorprovider,errorprovider,,2,0,6,2,2,8,8,1
clean-url,clean-url,,0,0,0,0,4,0,4,1
watch-face-api,watch-face-api,,0,1,4,1,3,5,3,1
nth-root,nth-root,,1,0,0,1,1,1,0,1
gitbucket,gitbucket,,0,0,4,0,4,4,6,1
nixops,nixops,,0,0,0,0,4,0,2,1
raml-java-parser,raml-java-parser,,1,1,2,2,2,4,14,1
angular2-injection,angular2-injection,,0,0,0,0,4,0,1,1
delegating-constructor,delegating-constructor,,0,1,1,1,3,2,9,1
identification,identification,,3,2,10,5,11,15,0,1
layered-windows,layered-windows,,0,2,0,2,2,2,9,100
privilege-elevation,privilege-elevation,,1,1,2,2,3,4,9,1
esky,esky,,0,0,0,0,2,0,0,1
google-play-books,google-play-books,,0,0,0,0,1,0,3,1
grunt-browserify,grunt-browserify,,0,1,3,1,2,4,1,1
ember-local-storage,ember-local-storage,,0,0,0,0,1,0,1,1
secret-manager,secret-manager,,2,1,4,3,4,7,6,1
ora-00928,ora-00928,,0,0,0,0,2,0,4,1
textreader,textreader,,0,0,0,0,4,0,8,1
mtl-file,mtl-file,,3,1,4,4,7,8,1,1
poly-google,poly-google,,0,0,0,0,1,0,3,1
rspec2,rspec2,,2,2,3,4,2,7,12,1
mongodb-c,mongodb-c,,0,0,1,0,2,1,1,1
nsubiquitouskeyvaluestore,nsubiquitouskeyvaluestore,,1,2,1,3,2,4,13,100
video-compression,video-compression,,3,6,9,9,13,18,13,100
clojure-contrib,clojure-contrib,,0,0,0,0,3,0,2,1
aquery,aquery,,1,0,1,1,2,2,3,1
hive-query,hive-query,,7,10,8,17,20,25,2,42.857143
keynotfoundexception,keynotfoundexception,,0,0,2,0,1,2,8,1
mathjs,mathjs,,4,2,2,6,6,8,1,1
compositeitemwriter,compositeitemwriter,,0,1,3,1,3,4,3,1
fan-page,fan-page,,0,0,0,0,1,0,13,1
zend-inputfilter,zend-inputfilter,,0,0,2,0,8,2,4,1
debian-7.6.0,debian-7.6.0,,0,0,0,0,3,0,4,1
docker-multi-stage-build,docker-multi-stage-build,,10,14,25,24,23,49,6,40
zcash,zcash,,1,1,2,2,6,4,6,1
global-namespace,global-namespace,,1,0,0,1,3,1,9,1
google-cloud-tpu,google-cloud-tpu,,10,13,46,23,26,69,0,30
customtaskpane,customtaskpane,,0,2,4,2,4,6,8,100
vispy,vispy,,3,4,4,7,9,11,0,33.333333
slam-algorithm,slam-algorithm,,1,1,0,2,2,2,0,1
uidocumentinteractioncontroller,uidocumentinteractioncontroller,,1,0,5,1,14,6,13,1
mkcircle,mkcircle,,0,0,4,0,4,4,13,1
aquamacs,aquamacs,,1,0,0,1,3,1,9,1
wso2sp,wso2sp,,21,19,24,40,30,64,14,1
cubemx,cubemx,,7,2,12,9,22,21,9,1
stm32f1,stm32f1,,8,5,5,13,18,18,9,1
html.beginform,html.beginform,,1,6,5,7,7,12,8,500
java-deployment-toolkit,java-deployment-toolkit,,1,0,1,1,2,2,3,1
usernametoken,usernametoken,,0,0,2,0,6,2,3,1
ironpython-studio,ironpython-studio,,0,0,0,0,1,0,8,1
epm,epm,,2,0,0,2,3,2,5,1
floating-ip,floating-ip,,1,1,1,2,2,3,6,1
discord.py-rewrite,discord.py-rewrite,,110,107,87,217,41,304,0,1
imsdroid,imsdroid,,0,0,0,0,1,0,13,1
custom-arrayadapter,custom-arrayadapter,,4,7,17,11,17,28,3,75
monetdblite,monetdblite,,1,0,7,1,7,8,0,1
push-promise,push-promise,,1,0,0,1,4,1,3,1
logstash-forwarder,logstash-forwarder,,0,1,3,1,3,4,6,1
propertyinfo,propertyinfo,,2,2,8,4,16,12,8,1
as-operator,as-operator,,0,1,1,1,1,2,8,1
nagle,nagle,,1,0,3,1,1,4,9,1
data-uri-scheme,data-uri-scheme,,0,0,0,0,1,0,3,1
accordionpane,accordionpane,,0,1,0,1,1,1,1,1
mitreid-connect,mitreid-connect,,1,3,5,4,1,9,3,200
webhttp,webhttp,,1,0,1,1,1,2,8,1
design-rationale,design-rationale,,0,0,0,0,1,0,9,1
intel-mpi,intel-mpi,,2,1,6,3,4,9,9,1
net-sftp,net-sftp,,1,2,2,3,8,5,12,100
rlike,rlike,,3,1,1,4,4,5,2,1
android-shortcutmanager,android-shortcutmanager,,1,0,0,1,4,1,3,1
eos,eos,,3,8,19,11,12,30,6,166.666667
ruby-rgl,ruby-rgl,,0,0,0,0,1,0,12,1
s7-1200,s7-1200,,2,0,2,2,2,4,9,1
siemens,siemens,,8,2,6,10,2,16,9,1
tia-portal,tia-portal,,1,0,2,1,2,3,9,1
data-layers,data-layers,,2,8,11,10,1,21,5,300
obexftp,obexftp,,0,1,2,1,2,3,3,1
ncsdk,ncsdk,,2,1,0,3,4,3,0,1
container-image,container-image,,2,1,3,3,4,6,6,1
cassandraunit,cassandraunit,,1,0,0,1,5,1,3,1
dottrace,dottrace,,5,1,4,6,8,10,8,1
code-splitting-async,code-splitting-async,,1,1,2,2,10,4,1,1
stylesheet-link-tag,stylesheet-link-tag,,0,0,1,0,1,1,1,1
signalmaster,signalmaster,,0,0,0,0,2,0,1,1
let-binding,let-binding,,0,0,0,0,1,0,0,1
android-ide,android-ide,,0,0,5,0,3,5,3,1
linuxbrew,linuxbrew,,1,3,4,4,4,8,9,200
osm.pbf,osm.pbf,,4,2,5,6,6,11,1,1
casper-dataset,casper-dataset,,0,0,0,0,1,0,3,1
katalon-recorder,katalon-recorder,,13,3,27,16,19,43,3,1
perl-prove,perl-prove,,1,0,0,1,2,1,9,1
catalan,catalan,,2,3,5,5,5,10,0,50
emacs-helm,emacs-helm,,3,5,1,8,6,9,9,66.666667
dismissviewcontroller,dismissviewcontroller,,3,2,8,5,10,13,13,1
box2d-joints,box2d-joints,,0,0,2,0,1,2,3,1
gulp-mocha,gulp-mocha,,1,0,4,1,3,5,1,1
ninject-conventions,ninject-conventions,,0,0,0,0,1,0,8,1
system-analysis,system-analysis,,0,0,1,0,3,1,3,1
radius-protocol,radius-protocol,,0,0,0,0,4,0,9,1
libcoap,libcoap,,2,0,0,2,1,2,9,1
triple-equals,triple-equals,,0,2,1,2,2,3,0,100
flappy-bird-clone,flappy-bird-clone,,4,1,4,5,3,9,0,1
image-effects,image-effects,,0,1,2,1,7,3,1,1
mpc,mpc,,2,1,4,3,5,7,9,1
.app,.app,,1,3,6,4,8,10,13,200
safe-publication,safe-publication,,1,0,1,1,14,2,3,1
android-os-handler,android-os-handler,,1,0,1,1,4,2,3,1
qaxwidget,qaxwidget,,0,0,0,0,1,0,9,1
google-maps-autocomplete,google-maps-autocomplete,,1,3,6,4,7,10,1,200
api-auth,api-auth,,0,2,0,2,2,2,4,100
kendo-datepicker,kendo-datepicker,,6,1,11,7,15,18,1,1
phpthumb,phpthumb,,1,1,2,2,1,4,4,1
panorama-control,panorama-control,,0,0,2,0,1,2,1,1
visual-c#-express-2010,visual-c#-express-2010,,2,1,1,3,4,4,8,1
.mov,.mov,,0,1,1,1,1,2,3,1
symfony-2.0,symfony-2.0,,0,0,0,0,1,0,1,1
amazon-ssm-agent,amazon-ssm-agent,,1,2,0,3,5,3,6,100
apache-syncope,apache-syncope,,1,0,1,1,2,2,3,1
android-drm,android-drm,,0,0,4,0,2,4,3,1
bizdays,bizdays,,2,1,2,3,3,5,0,1
formborderstyle,formborderstyle,,0,0,2,0,3,2,8,1
node-imagemagick,node-imagemagick,,0,0,2,0,4,2,12,1
lifetime-scoping,lifetime-scoping,,1,3,1,4,5,5,9,200
dynamicpdf-table2,dynamicpdf-table2,,0,0,0,0,1,0,8,1
cflint,cflint,,0,0,0,0,2,0,4,1
ternary-search-tree,ternary-search-tree,,1,0,0,1,1,1,3,1
ms-project-server-2010,ms-project-server-2010,,0,1,1,1,3,2,5,1
mpp,mpp,,0,1,1,1,3,2,5,1
queryselector,queryselector,,1,19,0,20,1,20,5,1800
lessc,lessc,,1,0,0,1,1,1,1,1
control-language,control-language,,1,1,3,2,2,5,4,1
jcanvas,jcanvas,,1,0,0,1,6,1,1,1
content-tools,content-tools,,1,3,0,4,2,4,1,200
trumbowyg,trumbowyg,,2,6,5,8,9,13,1,200
consuming,consuming,,0,1,0,1,1,1,3,1
built-in-types,built-in-types,,1,0,4,1,5,5,0,1
tlist,tlist,,1,1,1,2,1,3,9,1
levenberg-marquardt,levenberg-marquardt,,5,1,6,6,5,12,0,1
camel-blueprint,camel-blueprint,,0,1,0,1,2,1,3,1
element-io,element-io,,1,0,4,1,3,5,1,1
ios9.2,ios9.2,,0,0,1,0,1,1,13,1
gjallarhorn,gjallarhorn,,0,0,0,0,1,0,8,1
datagridcell,datagridcell,,0,2,4,2,8,6,8,100
bogus,bogus,,2,1,5,3,3,8,8,1
librarian,librarian,,0,0,1,0,1,1,9,1
dynamic-resizing,dynamic-resizing,,3,1,2,4,6,6,1,1
mpj-express,mpj-express,,2,0,0,2,2,2,3,1
mit-scheme,mit-scheme,,3,0,6,3,18,9,0,1
filetree,filetree,,3,0,3,3,6,6,0,1
haxelib,haxelib,,0,0,0,0,5,0,9,1
qfilesystemwatcher,qfilesystemwatcher,,0,0,0,0,3,0,9,1
nocount,nocount,,0,0,3,0,3,3,4,1
cachefactory,cachefactory,,0,0,1,0,2,1,1,1
etrade-api,etrade-api,,1,1,3,2,1,5,4,1
writexml,writexml,,3,1,1,4,5,5,8,1
delay-load,delay-load,,1,1,1,2,2,3,9,1
flyweight-pattern,flyweight-pattern,,1,2,1,3,8,4,3,100
qcalendarwidget,qcalendarwidget,,4,3,2,7,4,9,0,1
luxon,luxon,,4,10,7,14,4,21,1,150
cosign-api,cosign-api,,0,0,0,0,1,0,8,1
fsharpchart,fsharpchart,,0,0,1,0,3,1,8,1
portus,portus,,1,0,0,1,1,1,6,1
neocomplete,neocomplete,,0,0,0,0,1,0,9,1
quickbasic,quickbasic,,0,3,1,3,2,4,5,200
yahoo-mail,yahoo-mail,,3,3,8,6,11,14,4,1
nivo-slider,nivo-slider,,2,1,2,3,1,5,1,1
timeofday,timeofday,,2,0,3,2,1,5,13,1
aiopg,aiopg,,0,1,3,1,2,4,0,1
lsm-tree,lsm-tree,,0,1,4,1,2,5,2,1
react-laravel,react-laravel,,1,0,2,1,2,3,1,1
wepay,wepay,,0,0,1,0,3,1,4,1
webrole,webrole,,0,1,0,1,2,1,8,1
dojox.gfx,dojox.gfx,,0,0,0,0,2,0,1,1
snipmate,snipmate,,0,1,0,1,2,1,9,1
world-map,world-map,,3,2,6,5,6,11,13,1
roundhouse,roundhouse,,0,0,0,0,5,0,4,1
looking-glass,looking-glass,,0,0,0,0,1,0,9,1
yalinqo,yalinqo,,0,0,0,0,1,0,8,1
stencils,stencils,,0,0,2,0,13,2,1,1
android-data-usage,android-data-usage,,2,2,5,4,4,9,3,1
mongomapper,mongomapper,,0,1,0,1,3,1,12,1
oauth2-server,oauth2-server,,1,0,3,1,1,4,4,1
ipojo,ipojo,,0,0,3,0,3,3,3,1
gwr,gwr,,1,1,1,2,3,3,0,1
spgwr,spgwr,,1,0,1,1,2,2,0,1
arrayref,arrayref,,0,0,1,0,2,1,9,1
redirect-loop,redirect-loop,,3,2,3,5,7,8,4,1
nexusdb,nexusdb,,3,3,1,6,5,7,9,1
sofea,sofea,,0,0,0,0,1,0,1,1
declare-styleable,declare-styleable,,2,1,0,3,2,3,3,1
pii,pii,,2,1,5,3,8,8,5,1
rhino-mocks-3.5,rhino-mocks-3.5,,0,0,0,0,1,0,1,1
lightspeed,lightspeed,,0,3,2,3,4,5,4,200
errata,errata,,0,0,0,0,6,0,9,1
setalarmclock,setalarmclock,,0,3,2,3,4,5,3,200
sco-unix,sco-unix,,0,0,1,0,1,1,9,1
python-redmine,python-redmine,,0,0,2,0,2,2,12,1
onfocusout,onfocusout,,0,1,0,1,3,1,1,1
mean.io,mean.io,,1,0,2,1,5,3,1,1
tendermint,tendermint,,2,5,12,7,9,19,6,150
generategenerator,generategenerator,,0,0,0,0,1,0,1,1
generate,generate,,17,18,45,35,77,80,0,5.882353
graphics3d,graphics3d,,0,0,1,0,1,1,0,1
distributedlog,distributedlog,,0,0,0,0,1,0,6,1
brk,brk,,3,0,2,3,2,5,9,1
townedcollection,townedcollection,,0,0,0,0,1,0,9,1
diode,diode,,0,0,3,0,2,3,2,1
structlayout,structlayout,,0,0,1,0,3,1,8,1
sharppcap,sharppcap,,2,4,3,6,3,9,9,100
fundamentals-ts,fundamentals-ts,,1,0,1,1,1,2,9,1
openxml-table,openxml-table,,2,0,3,2,3,5,8,1
smart-listing,smart-listing,,0,0,1,0,2,1,12,1
vivaldi,vivaldi,,1,0,3,1,2,4,1,1
delta-index,delta-index,,0,0,1,0,1,1,2,1
dspic,dspic,,3,3,4,6,4,10,9,1
xc16,xc16,,1,0,3,1,9,4,9,1
cfsearch,cfsearch,,0,0,0,0,1,0,4,1
roleprovider,roleprovider,,0,0,4,0,5,4,8,1
availability-group,availability-group,,3,1,4,4,4,8,4,1
crossdomain-request.js,crossdomain-request.js,,0,0,1,0,4,1,1,1
zend-session,zend-session,,0,0,0,0,1,0,4,1
texturing,texturing,,1,0,2,1,7,3,9,1
windows-principal,windows-principal,,0,0,1,0,1,1,8,1
html-escape,html-escape,,1,1,3,2,4,5,1,1
symfony-filesystem,symfony-filesystem,,1,0,0,1,1,1,4,1
xz,xz,,2,3,4,5,11,9,0,50
electron-window,electron-window,,1,0,1,1,2,2,1,1
dnlib,dnlib,,1,1,4,2,4,6,8,1
unicast,unicast,,2,3,5,5,8,10,9,50
epiphany,epiphany,,0,1,1,1,3,2,1,1
peverify,peverify,,0,0,1,0,4,1,8,1
candidate,candidate,,2,0,1,2,4,3,3,1
asp.net-4.0,asp.net-4.0,,21,5,5,26,7,31,8,1
clojureclr,clojureclr,,0,0,0,0,2,0,2,1
immutablelist,immutablelist,,2,1,2,3,4,5,1,1
asyncpg,asyncpg,,6,7,7,13,10,20,0,16.666667
bufferedstream,bufferedstream,,1,0,3,1,1,4,8,1
project-navigator,project-navigator,,0,0,0,0,1,0,13,1
filecontentresult,filecontentresult,,0,1,7,1,5,8,8,1
jsencrypt,jsencrypt,,1,2,0,3,7,3,6,100
rune,rune,,0,2,4,2,2,6,0,100
cdo.message,cdo.message,,2,3,5,5,6,10,5,50
iban,iban,,1,2,4,3,4,7,4,100
asp.net-webcontrol,asp.net-webcontrol,,0,0,0,0,2,0,8,1
cmdb,cmdb,,3,0,3,3,9,6,1,1
externals,externals,,0,0,0,0,5,0,1,1
diff2html,diff2html,,0,0,5,0,2,5,1,1
lsyncd,lsyncd,,1,1,1,2,2,3,9,1
classformaterror,classformaterror,,0,0,2,0,2,2,3,1
running-balance,running-balance,,0,0,0,0,2,0,4,1
git-ftp,git-ftp,,3,1,4,4,10,8,6,1
netrw,netrw,,1,1,2,2,8,4,9,1
pscx,pscx,,0,0,1,0,3,1,8,1
java-failsafe,java-failsafe,,0,2,1,2,1,3,3,100
xcode-scheme,xcode-scheme,,0,0,3,0,2,3,13,1
autorepeat,autorepeat,,0,0,1,0,2,1,1,1
pocket,pocket,,1,0,5,1,1,6,1,1
allatori,allatori,,1,0,0,1,1,1,3,1
aiff,aiff,,4,0,2,4,1,6,13,1
loose-typing,loose-typing,,0,0,0,0,2,0,1,1
db-schema,db-schema,,0,1,1,1,4,2,4,1
gwt-celltable,gwt-celltable,,0,0,0,0,4,0,3,1
asar,asar,,2,1,4,3,10,7,1,1
search-and-promote,search-and-promote,,0,0,0,0,1,0,3,1
project-files,project-files,,0,2,3,2,7,5,8,100
google-cloud-trace,google-cloud-trace,,1,1,3,2,7,5,6,1
gitweb,gitweb,,0,0,3,0,3,3,6,1
vdso,vdso,,1,0,2,1,4,3,9,1
angular-fontawesome,angular-fontawesome,,2,4,10,6,12,16,1,100
snipcart,snipcart,,2,2,2,4,5,6,1,1
google-tasks-api,google-tasks-api,,8,4,14,12,12,26,5,1
custom-formatting,custom-formatting,,2,3,1,5,3,6,5,50
point-to-point,point-to-point,,1,0,0,1,4,1,13,1
manage-nuget-packages,manage-nuget-packages,,2,0,3,2,3,5,8,1
ordinal-indicator,ordinal-indicator,,0,0,0,0,2,0,0,1
ggmosaic,ggmosaic,,0,1,3,1,5,4,0,1
mediarss,mediarss,,0,0,1,0,2,1,4,1
dot-operator,dot-operator,,0,1,0,1,2,1,12,1
embedded-flashplayer,embedded-flashplayer,,1,0,0,1,1,1,1,1
flashplayer-debug,flashplayer-debug,,0,0,1,0,1,1,1,1
ngx-chips,ngx-chips,,4,6,9,10,8,19,1,50
qstk,qstk,,0,0,0,0,3,0,0,1
contenttype,contenttype,,0,1,2,1,4,3,8,1
vertxoptions,vertxoptions,,0,3,3,3,6,6,3,200
abstractverticle,abstractverticle,,0,1,0,1,1,1,3,1
tornado-redis,tornado-redis,,0,0,1,0,3,1,0,1
amqp-client,amqp-client,,1,1,2,2,2,4,3,1
glpointsize,glpointsize,,1,0,0,1,1,1,9,1
codemod,codemod,,1,1,0,2,3,2,1,1
woe-id,woe-id,,0,0,0,0,3,0,0,1
numpy-indexing,numpy-indexing,,3,1,7,4,12,11,0,1
numpy-slicing,numpy-slicing,,15,19,15,34,24,49,0,26.666667
instar,instar,,1,0,0,1,1,1,13,1
qvalidator,qvalidator,,1,1,2,2,1,4,0,1
after-save,after-save,,0,1,1,1,7,2,12,1
pmwiki,pmwiki,,0,2,0,2,3,2,4,100
vertex-buffer-objects,vertex-buffer-objects,,0,0,2,0,2,2,9,1
video4linux,video4linux,,1,0,3,1,6,4,13,1
vcpu,vcpu,,1,2,0,3,5,3,6,100
xcode7.2,xcode7.2,,0,1,0,1,2,1,13,1
residemenu,residemenu,,0,1,2,1,4,3,3,1
appscript,appscript,,4,5,16,9,7,25,5,25
html-title,html-title,,1,2,1,3,3,4,1,100
aurelia-http-client,aurelia-http-client,,1,0,2,1,2,3,1,1
quoted-identifier,quoted-identifier,,5,4,10,9,15,19,4,1
nand2tetris,nand2tetris,,7,6,1,13,5,14,9,1
ituneslibrary,ituneslibrary,,0,1,0,1,2,1,13,1
povray,povray,,1,1,1,2,8,3,0,1
hashrocket,hashrocket,,0,0,0,0,1,0,12,1
nircmd,nircmd,,1,1,1,2,6,3,9,1
r-graphviz,r-graphviz,,1,0,1,1,2,2,0,1
rlib,rlib,,0,0,0,0,1,0,9,1
settings.settings,settings.settings,,1,1,2,2,1,4,8,1
paypal-android-sdk,paypal-android-sdk,,0,0,0,0,1,0,3,1
spring-oxm,spring-oxm,,0,2,1,2,7,3,3,100
burrows-wheeler-transform,burrows-wheeler-transform,,0,0,0,0,2,0,0,1
haskell-cmdargs,haskell-cmdargs,,0,0,0,0,1,0,9,1
xdcr,xdcr,,0,0,3,0,2,3,3,1
nsapplication,nsapplication,,1,3,2,4,5,6,13,200
subject-alternative-name,subject-alternative-name,,1,2,4,3,5,7,6,100
automated-deployment,automated-deployment,,2,1,1,3,4,4,6,1
new-window,new-window,,5,3,4,8,11,12,1,1
register-tick-function,register-tick-function,,0,0,0,0,1,0,4,1
visio2013,visio2013,,0,0,1,0,2,1,5,1
fnv,fnv,,1,0,1,1,1,2,0,1
r-dygraphs,r-dygraphs,,5,6,6,11,18,17,0,20
pyrcc,pyrcc,,1,1,0,2,1,2,0,1
angularjs-ng-value,angularjs-ng-value,,0,0,3,0,3,3,1,1
sas-metadata,sas-metadata,,2,0,1,2,4,3,0,1
design-choices,design-choices,,0,0,0,0,1,0,2,1
scene7,scene7,,3,1,1,4,3,5,1,1
backing-beans,backing-beans,,2,0,0,2,5,2,3,1
fresnel,fresnel,,0,0,0,0,3,0,0,1
barista,barista,,0,0,0,0,2,0,3,1
runtime-identifier,runtime-identifier,,1,0,1,1,3,2,8,1
datagridviewtextboxcell,datagridviewtextboxcell,,1,0,3,1,3,4,8,1
rfc3161,rfc3161,,0,2,2,2,4,4,6,100
avassetimagegenerator,avassetimagegenerator,,1,0,4,1,4,5,13,1
react-fullstack,react-fullstack,,8,6,10,14,9,24,1,1
interactive-shell,interactive-shell,,2,1,3,3,4,6,9,1
angular2viewencapsulation,angular2viewencapsulation,,4,1,2,5,8,7,1,1
hierarchical-query,hierarchical-query,,1,1,5,2,14,7,4,1
paypal-plus,paypal-plus,,1,1,3,2,3,5,4,1
apache-knox,apache-knox,,3,3,2,6,5,8,2,1
asyncresttemplate,asyncresttemplate,,4,1,1,5,5,6,3,1
react-web,react-web,,2,1,2,3,4,5,1,1
android-overlay,android-overlay,,1,0,3,1,7,4,3,1
podofo,podofo,,5,3,2,8,3,10,9,1
cyber-ark,cyber-ark,,2,4,2,6,2,8,3,100
off-screen,off-screen,,2,0,3,2,8,5,13,1
yacas,yacas,,1,0,1,1,2,2,0,1
gitosis,gitosis,,0,0,0,0,1,0,6,1
session-less,session-less,,0,1,0,1,1,1,8,1
angular-calendar,angular-calendar,,12,8,16,20,20,36,1,1
office-communicator,office-communicator,,0,0,0,0,1,0,8,1
exception-logging,exception-logging,,0,0,1,0,2,1,3,1
xpath-3.1,xpath-3.1,,2,1,2,3,2,5,3,1
invokeandwait,invokeandwait,,0,0,0,0,2,0,3,1
add-filter,add-filter,,7,5,6,12,7,18,4,1
rspec-sidekiq,rspec-sidekiq,,1,0,3,1,3,4,12,1
runtime-packages,runtime-packages,,1,3,0,4,1,4,9,200
wm-command,wm-command,,0,0,0,0,1,0,9,1
named-routing,named-routing,,0,2,2,2,4,4,1,100
pyshp,pyshp,,3,3,5,6,7,11,0,1
bootstrap-growl,bootstrap-growl,,1,0,1,1,1,2,1,1
wolkenkit,wolkenkit,,1,2,3,3,10,6,8,100
object-code,object-code,,1,0,0,1,4,1,9,1
qrubberband,qrubberband,,1,1,0,2,1,2,0,1
real-time-strategy,real-time-strategy,,0,0,0,0,1,0,8,1
amazon-echo-show,amazon-echo-show,,0,1,0,1,5,1,6,1
ice,ice,,2,6,12,8,8,20,1,200
erc20,erc20,,5,9,28,14,41,42,6,80
class-factory,class-factory,,0,1,1,1,1,2,0,1
keyset,keyset,,0,2,4,2,5,6,3,100
galois-field,galois-field,,2,2,3,4,8,7,0,1
setwd,setwd,,0,1,1,1,3,2,0,1
qtruby,qtruby,,0,0,0,0,1,0,9,1
typescript1.5,typescript1.5,,0,1,2,1,2,3,1,1
npm-cli,npm-cli,,1,0,2,1,5,3,1,1
child-fragment,child-fragment,,1,0,4,1,3,5,3,1
tabular-form,tabular-form,,1,1,1,2,3,3,4,1
cpropertysheet,cpropertysheet,,0,0,1,0,2,1,9,1
clearscript,clearscript,,5,4,1,9,6,10,8,1
vsvim,vsvim,,0,0,5,0,1,5,8,1
typetoken,typetoken,,0,0,3,0,5,3,3,1
qsqlquerymodel,qsqlquerymodel,,0,0,7,0,11,7,9,1
ctabctrl,ctabctrl,,0,0,2,0,2,2,9,1
pm2-logrotate,pm2-logrotate,,4,0,4,4,2,8,1,1
django-timezone,django-timezone,,4,3,6,7,10,13,0,1
oauth2orize,oauth2orize,,2,0,1,2,4,3,1,1
non-maximum-suppression,non-maximum-suppression,,1,0,4,1,4,5,0,1
appimage,appimage,,2,4,1,6,3,7,9,100
drupal-fields,drupal-fields,,0,0,3,0,1,3,4,1
drupal-form-validation,drupal-form-validation,,0,0,0,0,2,0,4,1
comsol,comsol,,2,4,2,6,2,8,0,100
quickdraw,quickdraw,,0,0,2,0,2,2,0,1
chainercv,chainercv,,4,1,6,5,2,11,0,1
slidify,slidify,,0,3,1,3,1,4,0,200
ongr,ongr,,1,4,3,5,4,8,6,300
smscaster,smscaster,,1,0,0,1,1,1,3,1
skvideonode,skvideonode,,0,3,3,3,7,6,13,200
website-homepage,website-homepage,,6,3,12,9,17,21,4,1
windows-server-2008-x64,windows-server-2008-x64,,0,0,0,0,1,0,9,1
finder-extension,finder-extension,,0,0,0,0,1,0,13,1
porter-stemmer,porter-stemmer,,3,2,7,5,5,12,0,1
wmd-markdown,wmd-markdown,,0,0,0,0,1,0,0,1
ifs-erp,ifs-erp,,0,0,1,0,2,1,4,1
celltable,celltable,,0,0,0,0,6,0,3,1
socketrocket,socketrocket,,0,0,3,0,6,3,13,1
data-url,data-url,,0,0,0,0,4,0,1,1
nodevm,nodevm,,0,0,3,0,3,3,1,1
git-rerere,git-rerere,,0,0,3,0,4,3,6,1
into-outfile,into-outfile,,1,0,3,1,7,4,4,1
sysinternals,sysinternals,,1,5,8,6,12,14,9,400
static-html,static-html,,6,1,4,7,5,11,1,1
grunt-contrib-compress,grunt-contrib-compress,,0,0,0,0,2,0,1,1
apollo-link-state,apollo-link-state,,1,1,22,2,6,24,1,1
plug,plug,,4,6,15,10,11,25,2,50
spotify-desktop,spotify-desktop,,1,0,1,1,2,2,4,1
formal-semantics,formal-semantics,,0,1,2,1,1,3,2,1
epicorerp,epicorerp,,5,3,4,8,5,12,4,1
automatic-semicolon-insertion,automatic-semicolon-insertion,,1,3,0,4,2,4,0,200
structured-references,structured-references,,0,0,0,0,1,0,5,1
oracle-bam,oracle-bam,,0,0,0,0,1,0,4,1
melpa,melpa,,1,0,0,1,6,1,9,1
android-sparsearray,android-sparsearray,,1,1,2,2,1,4,3,1
getcaretpos,getcaretpos,,0,0,2,0,1,2,1,1
rakudo,rakudo,,4,2,11,6,10,17,9,1
rakudo-star,rakudo-star,,0,1,0,1,4,1,9,1
zef,zef,,3,2,4,5,4,9,9,1
tora,tora,,0,0,0,0,1,0,4,1
omnibox,omnibox,,2,1,5,3,2,8,1,1
pomelo,pomelo,,0,1,7,1,9,8,8,1
db4o,db4o,,1,0,1,1,1,2,3,1
jsdelivr,jsdelivr,,0,0,1,0,2,1,1,1
ng-build,ng-build,,15,14,32,29,43,61,1,1
parallel-for,parallel-for,,1,1,5,2,10,7,9,1
unity-remote,unity-remote,,2,1,0,3,2,3,8,1
responsive-design-view,responsive-design-view,,0,0,2,0,1,2,3,1
code.org,code.org,,7,0,10,7,10,17,1,1
image-graphviz,image-graphviz,,0,0,2,0,3,2,0,1
jbchartview,jbchartview,,0,0,0,0,2,0,13,1
nokia,nokia,,2,2,6,4,4,10,3,1
chewy-gem,chewy-gem,,1,1,9,2,7,11,12,1
dbn,dbn,,0,1,2,1,2,3,0,1
android-text-color,android-text-color,,0,1,0,1,6,1,3,1
tfidfvectorizer,tfidfvectorizer,,36,34,59,70,57,129,0,1
lateral,lateral,,0,1,3,1,3,4,4,1
currentitem,currentitem,,0,0,0,0,1,0,8,1
xetex,xetex,,0,1,1,1,2,2,0,1
scollector,scollector,,0,0,0,0,2,0,2,1
ngcloak,ngcloak,,1,1,1,2,4,3,1,1
dynet,dynet,,0,0,2,0,9,2,0,1
simplexmlrpcserver,simplexmlrpcserver,,1,0,1,1,2,2,0,1
google-analytics-campaign-builder,google-analytics-campaign-builder,,1,1,7,2,6,9,5,1
samsung-pay,samsung-pay,,1,0,1,1,1,2,4,1
ibm-bpm,ibm-bpm,,5,7,9,12,10,21,3,40
portable-areas,portable-areas,,0,0,0,0,1,0,8,1
automapper-2,automapper-2,,0,0,1,0,1,1,8,1
null-coalescing,null-coalescing,,3,5,7,8,2,15,8,66.666667
optional-chaining,optional-chaining,,0,0,3,0,2,3,13,1
trickle,trickle,,0,0,1,0,1,1,9,1
dynamicpdf,dynamicpdf,,4,0,0,4,3,4,4,1
powershell-1.0,powershell-1.0,,3,1,3,4,3,7,8,1
remote-registry,remote-registry,,1,0,1,1,3,2,9,1
prolog-assert,prolog-assert,,1,0,1,1,1,2,0,1
humhub,humhub,,0,2,0,2,2,2,4,100
libexif,libexif,,1,0,0,1,1,1,9,1
productbuild,productbuild,,1,2,4,3,6,7,13,100
reverse-ajax,reverse-ajax,,0,1,1,1,1,2,3,1
bayeux,bayeux,,2,1,1,3,4,4,3,1
beam-search,beam-search,,1,3,0,4,10,4,0,200
rxiosble,rxiosble,,1,0,1,1,1,2,13,1
coccinelle,coccinelle,,0,0,0,0,1,0,9,1
debian-stretch,debian-stretch,,31,20,64,51,55,115,9,1
html5-clipboard-api,html5-clipboard-api,,0,0,1,0,1,1,1,1
dex-limit,dex-limit,,0,0,2,0,1,2,3,1
microsoft-speech-platform,microsoft-speech-platform,,1,0,7,1,4,8,6,1
flask-ask,flask-ask,,3,1,13,4,27,17,6,1
teststack,teststack,,10,1,14,11,15,25,8,1
capacity-planning,capacity-planning,,2,3,8,5,3,13,2,50
annotated-pojos,annotated-pojos,,0,0,0,0,1,0,3,1
webdriver-w3c-spec,webdriver-w3c-spec,,3,6,7,9,2,16,3,100
itunes-api,itunes-api,,2,1,6,3,2,9,13,1
ibm-appid,ibm-appid,,6,7,5,13,18,18,6,16.666667
oracleexception,oracleexception,,0,0,0,0,1,0,4,1
front-controller,front-controller,,4,3,1,7,2,8,4,1
node-apn,node-apn,,2,2,4,4,8,8,13,1
haskell-miso,haskell-miso,,0,0,0,0,2,0,2,1
boost-lexicalcast,boost-lexicalcast,,0,0,0,0,3,0,9,1
filestack,filestack,,6,4,6,10,7,16,1,1
elastic-database-pool,elastic-database-pool,,0,0,0,0,2,0,8,1
qvideowidget,qvideowidget,,2,2,8,4,5,12,9,1
zstandard,zstandard,,2,2,0,4,5,4,0,1
meta-predicate,meta-predicate,,3,1,3,4,1,7,0,1
positional-operator,positional-operator,,1,0,1,1,1,2,1,1
identity-map,identity-map,,0,0,0,0,1,0,3,1
mysql-error-1222,mysql-error-1222,,0,0,0,0,2,0,4,1
genomicranges,genomicranges,,3,4,4,7,10,11,0,33.333333
svn-merge,svn-merge,,0,1,3,1,6,4,6,1
memcachier,memcachier,,0,0,1,0,2,1,4,1
numeric-conversion,numeric-conversion,,0,0,1,0,1,1,4,1
automap,automap,,1,1,0,2,1,2,8,1
in-parameters,in-parameters,,0,0,1,0,3,1,8,1
capslock,capslock,,4,3,7,7,6,14,13,1
particle-electron,particle-electron,,2,0,0,2,2,2,6,1
mat-autocomplete,mat-autocomplete,,11,8,14,19,18,33,1,1
parsel,parsel,,1,0,2,1,1,3,0,1
mobx-persist,mobx-persist,,1,0,4,1,4,5,1,1
synced-folder,synced-folder,,1,0,2,1,2,3,4,1
bitstuffing,bitstuffing,,2,0,2,2,2,4,9,1
complete.ly,complete.ly,,0,0,0,0,2,0,1,1
elasticsearch-ruby,elasticsearch-ruby,,1,1,1,2,4,3,6,1
spark-ar-studio,spark-ar-studio,,9,16,9,25,1,34,1,77.777778
mystic,mystic,,3,2,6,5,2,11,0,1
reflector,reflector,,2,1,3,3,2,6,8,1
tvos11,tvos11,,0,0,3,0,6,3,13,1
compressed-class,compressed-class,,0,0,0,0,1,0,3,1
cefpython,cefpython,,4,2,6,6,17,12,0,1
cevelop,cevelop,,0,0,0,0,5,0,3,1
github-hub,github-hub,,1,1,0,2,2,2,6,1
facebook-rss,facebook-rss,,0,0,0,0,1,0,4,1
query-designer,query-designer,,0,0,1,0,3,1,5,1
djangoappengine,djangoappengine,,0,0,1,0,2,1,6,1
gae-quotas,gae-quotas,,0,1,2,1,1,3,6,1
drawingcontext,drawingcontext,,2,1,5,3,4,8,8,1
full-text-catalog,full-text-catalog,,0,0,2,0,2,2,4,1
nomachine-nx,nomachine-nx,,1,7,0,8,2,8,1,600
structuremap-automocking,structuremap-automocking,,0,0,1,0,1,1,8,1
build-numbers,build-numbers,,4,0,1,4,2,5,13,1
nsautolayout,nsautolayout,,3,1,3,4,5,7,13,1
clientcache,clientcache,,1,1,1,2,2,3,3,1
ajdt,ajdt,,0,0,0,0,4,0,3,1
jgoodies,jgoodies,,0,1,2,1,1,3,3,1
expr,expr,,1,1,8,2,7,10,9,1
cellinfo,cellinfo,,2,1,4,3,4,7,3,1
easyar,easyar,,2,5,2,7,3,9,8,150
kubernetes-service,kubernetes-service,,18,25,35,43,24,78,6,38.888889
uploadstring,uploadstring,,0,0,0,0,2,0,8,1
qstyle,qstyle,,2,1,4,3,5,7,9,1
yii2-dynagrid,yii2-dynagrid,,0,0,0,0,1,0,4,1
auto-build,auto-build,,1,0,5,1,4,6,6,1
luasql,luasql,,0,1,1,1,2,2,9,1
booking.com-api,booking.com-api,,1,2,1,3,1,4,4,100
abstraction-layer,abstraction-layer,,0,0,1,0,2,1,3,1
getmessage,getmessage,,0,1,2,1,3,3,9,1
dnx,dnx,,0,1,0,1,3,1,8,1
prettytime,prettytime,,0,0,1,0,2,1,13,1
mediaview,mediaview,,1,0,4,1,5,5,3,1
jsmpp,jsmpp,,0,1,6,1,2,7,3,1
word-field,word-field,,0,1,7,1,5,8,5,1
null-character,null-character,,5,0,2,5,7,7,0,1
sharepoint-security,sharepoint-security,,0,0,0,0,2,0,8,1
inet-ntop,inet-ntop,,1,1,1,2,1,3,9,1
facebook-node-sdk,facebook-node-sdk,,0,0,0,0,2,0,13,1
job-control,job-control,,4,0,6,4,6,10,9,1
mainclass,mainclass,,1,4,3,5,3,8,3,300
ganache,ganache,,9,14,18,23,2,41,6,55.555556
cleartype,cleartype,,1,1,2,2,2,4,1,1
mysql-cli,mysql-cli,,3,2,1,5,6,6,4,1
boost-proto,boost-proto,,0,1,0,1,1,1,9,1
gulp-cheerio,gulp-cheerio,,0,0,0,0,1,0,1,1
kdoc,kdoc,,3,4,12,7,11,19,3,33.333333
gold-linker,gold-linker,,0,1,2,1,10,3,9,1
fstat,fstat,,0,1,5,1,4,6,9,1
lmtp,lmtp,,0,0,2,0,2,2,4,1
sorttable.js,sorttable.js,,1,0,1,1,3,2,1,1
signatures,signatures,,0,0,0,0,5,0,9,1
opensmpp,opensmpp,,1,0,0,1,2,1,3,1
freebuilder,freebuilder,,0,0,0,0,1,0,3,1
minko,minko,,0,0,0,0,1,0,9,1
aec,aec,,0,2,2,2,5,4,13,100
persisted-column,persisted-column,,1,0,2,1,2,3,4,1
class-table-inheritance,class-table-inheritance,,1,1,3,2,3,5,4,1
typedoc,typedoc,,3,4,6,7,12,13,1,33.333333
session-keys,session-keys,,1,0,1,1,2,2,6,1
scalikejdbc,scalikejdbc,,6,4,9,10,15,19,2,1
virtual-path,virtual-path,,1,0,2,1,3,3,8,1
code-map,code-map,,2,0,3,2,2,5,8,1
outwatch,outwatch,,0,0,0,0,1,0,2,1
sourcegraph,sourcegraph,,0,0,1,0,2,1,6,1
multi-targeting,multi-targeting,,0,0,0,0,8,0,8,1
mbsync,mbsync,,0,0,1,0,2,1,4,1
felix-dependency-manager,felix-dependency-manager,,0,0,2,0,2,2,3,1
aircrack-ng,aircrack-ng,,2,1,4,3,3,7,9,1
repeating-linear-gradient,repeating-linear-gradient,,0,0,5,0,4,5,1,1
berkeley-sockets,berkeley-sockets,,2,0,1,2,3,3,9,1
fieldmanager,fieldmanager,,0,0,0,0,1,0,4,1
windows-phone-7,windows-phone-7,,0,0,0,0,1,0,1,1
ng-generate,ng-generate,,0,0,0,0,2,0,1,1
video-watermarking,video-watermarking,,3,3,4,6,9,10,13,1
aspnet-development-server,aspnet-development-server,,0,0,0,0,1,0,8,1
inplace-editing,inplace-editing,,0,0,2,0,4,2,3,1
beaker-notebook,beaker-notebook,,1,2,0,3,3,3,0,100
sql-psm,sql-psm,,0,0,0,0,2,0,4,1
react-component,react-component,,58,76,103,134,125,237,1,31.034483
dtexec,dtexec,,5,2,7,7,6,14,4,1
zomato-api,zomato-api,,0,2,2,2,7,4,1,100
default-copy-constructor,default-copy-constructor,,1,2,3,3,5,6,9,100
objectpath,objectpath,,2,2,7,4,2,11,0,1
vscode-snippets,vscode-snippets,,2,15,8,17,6,25,9,650
chartio,chartio,,0,0,1,0,2,1,4,1
inverse-kinematics,inverse-kinematics,,7,6,14,13,8,27,8,1
microsoft-iot-central,microsoft-iot-central,,4,1,6,5,3,11,8,1
mprotect,mprotect,,1,0,0,1,4,1,9,1
line-through,line-through,,0,1,0,1,2,1,1,1
mysql-error-150,mysql-error-150,,0,0,1,0,2,1,4,1
database-create,database-create,,0,0,0,0,1,0,9,1
djoser,djoser,,1,5,8,6,1,14,0,400
common-schema,common-schema,,0,0,0,0,2,0,4,1
parslet,parslet,,1,2,1,3,2,4,12,100
iequatable,iequatable,,0,1,3,1,10,4,8,1
mllp,mllp,,1,2,0,3,1,3,14,100
post-parameter,post-parameter,,1,1,3,2,2,5,4,1
pitch-detection,pitch-detection,,0,1,3,1,2,4,13,1
spectre,spectre,,2,4,9,6,21,15,9,100
side-channel-attacks,side-channel-attacks,,0,1,1,1,2,2,9,1
pixabay,pixabay,,0,0,3,0,4,3,1,1
elm-style-elements,elm-style-elements,,0,0,0,0,4,0,1,1
emacsclient,emacsclient,,4,0,3,4,4,7,9,1
sun-codemodel,sun-codemodel,,2,0,0,2,6,2,3,1
alibaba-cloud-ros,alibaba-cloud-ros,,1,0,0,1,2,1,6,1
sheetrock,sheetrock,,0,0,3,0,1,3,1,1
watch-notification,watch-notification,,0,0,0,0,1,0,13,1
multikey,multikey,,3,1,1,4,6,5,1,1
tivoli-work-scheduler,tivoli-work-scheduler,,1,0,4,1,7,5,3,1
azure-function-async,azure-function-async,,5,4,7,9,1,16,8,1
kairos-api,kairos-api,,0,0,2,0,10,2,0,1
trial,trial,,3,0,1,3,7,4,13,1
flex4.6,flex4.6,,0,0,0,0,4,0,13,1
devextreme-angular,devextreme-angular,,3,15,17,18,21,35,1,400
document-types,document-types,,1,0,3,1,1,4,13,1
android-json-rpc,android-json-rpc,,1,0,0,1,1,1,3,1
hibernate3,hibernate3,,3,2,1,5,6,6,3,1
sql-data-tools,sql-data-tools,,0,0,1,0,1,1,4,1
nxlog,nxlog,,0,3,5,3,6,8,6,200
jslink,jslink,,3,3,4,6,5,10,8,1
multiple-sites,multiple-sites,,2,2,1,4,2,5,4,1
setenvif,setenvif,,1,3,3,4,6,7,4,200
drupal-computed-field,drupal-computed-field,,0,0,0,0,1,0,4,1
eglibc,eglibc,,1,0,1,1,1,2,9,1
documentlistener,documentlistener,,0,0,3,0,4,3,3,1
one-click-web-publishing,one-click-web-publishing,,0,1,2,1,2,3,8,1
crossdomain.xml,crossdomain.xml,,1,0,0,1,2,1,1,1
nls-lang,nls-lang,,2,0,1,2,4,3,4,1
maxreceivedmessagesize,maxreceivedmessagesize,,0,0,0,0,3,0,8,1
salt-creation,salt-creation,,0,0,1,0,1,1,4,1
elinks,elinks,,1,0,0,1,1,1,1,1
fastexport,fastexport,,1,0,4,1,5,5,4,1
apache-traffic-server,apache-traffic-server,,1,1,1,2,4,3,6,1
korma,korma,,0,0,1,0,4,1,2,1
sqlkorma,sqlkorma,,0,0,1,0,7,1,2,1
eden,eden,,0,0,0,0,2,0,4,1
selectedindexchanged,selectedindexchanged,,2,1,10,3,6,13,8,1
c-header,c-header,,1,1,1,2,3,3,9,1
tool-uml,tool-uml,,0,1,0,1,6,1,3,1
return-value-optimization,return-value-optimization,,2,1,0,3,12,3,9,1
sql-drop,sql-drop,,0,1,1,1,2,2,4,1
translation-unit,translation-unit,,3,4,4,7,4,11,9,33.333333
online-compilation,online-compilation,,0,0,3,0,2,3,9,1
adapt-strap,adapt-strap,,0,0,0,0,1,0,1,1
lua-userdata,lua-userdata,,2,0,3,2,4,5,9,1
arduino-ultra-sonic,arduino-ultra-sonic,,13,4,4,17,4,21,9,1
bazaar,bazaar,,0,0,1,0,5,1,6,1
ifdefine,ifdefine,,1,0,2,1,1,3,4,1
ajaxify,ajaxify,,0,0,1,0,2,1,1,1
hidden-characters,hidden-characters,,0,0,0,0,3,0,5,1
django-rosetta,django-rosetta,,0,0,1,0,2,1,0,1
maude-system,maude-system,,0,0,0,0,1,0,0,1
spoofax,spoofax,,0,0,0,0,1,0,0,1
neo4django,neo4django,,1,0,1,1,1,2,2,1
xml-dml,xml-dml,,0,0,1,0,9,1,4,1
phpcas,phpcas,,0,1,4,1,4,5,4,1
jruby-rack,jruby-rack,,0,0,0,0,1,0,12,1
sealed-class,sealed-class,,1,5,11,6,7,17,3,400
rails-spring,rails-spring,,0,0,1,0,2,1,12,1
godoc,godoc,,3,1,7,4,8,11,6,1
threadscope,threadscope,,0,0,0,0,1,0,4,1
uipicker,uipicker,,0,0,1,0,5,1,13,1
mulan,mulan,,0,0,1,0,1,1,0,1
amos,amos,,0,0,0,0,2,0,5,1
splitcontainer,splitcontainer,,1,0,3,1,6,4,8,1
archlinux-arm,archlinux-arm,,1,1,3,2,3,5,9,1
runkit,runkit,,1,1,0,2,4,2,1,1
row-major-order,row-major-order,,1,0,1,1,7,2,0,1
windowsbuilder,windowsbuilder,,5,1,5,6,6,11,3,1
g95,g95,,0,0,1,0,1,1,9,1
linktable,linktable,,1,0,2,1,2,3,4,1
multiselectlistpreference,multiselectlistpreference,,1,2,1,3,2,4,3,100
displaymode,displaymode,,1,0,0,1,1,1,1,1
nvapi,nvapi,,1,0,3,1,3,4,9,1
combinators,combinators,,3,0,6,3,4,9,2,1
lock-in,lock-in,,0,0,0,0,1,0,3,1
tspan,tspan,,3,2,3,5,5,8,1,1
tactic,tactic,,0,0,0,0,1,0,13,1
php-pdftk,php-pdftk,,1,1,3,2,2,5,8,1
css-color,css-color,,0,1,1,1,4,2,1,1
dddd,dddd,,1,1,1,2,5,3,8,1
ndesk.options,ndesk.options,,1,0,1,1,2,2,8,1
dcm4che,dcm4che,,3,5,5,8,13,13,3,66.666667
p4python,p4python,,1,3,8,4,6,12,6,200
corewlan,corewlan,,1,0,2,1,1,3,13,1
ocelot,ocelot,,8,9,19,17,3,36,8,12.5
maven-gpg-plugin,maven-gpg-plugin,,0,1,3,1,3,4,3,1
sails-redis,sails-redis,,0,0,0,0,1,0,1,1
vuforia-cloud-recognition,vuforia-cloud-recognition,,4,1,11,5,6,16,8,1
gnuwin32,gnuwin32,,0,0,5,0,8,5,9,1
awtutilities,awtutilities,,1,0,0,1,1,1,3,1
yardstick,yardstick,,0,2,0,2,4,2,0,100
tidymodels,tidymodels,,2,0,2,2,1,4,0,1
ijvm,ijvm,,1,0,0,1,5,1,9,1
google-api-console,google-api-console,,3,1,6,4,5,10,3,1
google-api-explorer,google-api-explorer,,0,0,0,0,16,0,5,1
ltrace,ltrace,,0,1,1,1,4,2,9,1
treap,treap,,3,0,0,3,2,3,0,1
fieldcodes,fieldcodes,,0,0,0,0,2,0,5,1
fotorama,fotorama,,2,8,4,10,6,14,1,300
qdatetime,qdatetime,,1,3,0,4,6,4,9,200
overscroll,overscroll,,3,2,3,5,2,8,3,1
sceneeditor,sceneeditor,,0,0,1,0,1,1,13,1
volumio,volumio,,0,1,0,1,1,1,0,1
systemd-journal-remote,systemd-journal-remote,,0,0,0,0,2,0,9,1
octree,octree,,4,4,9,8,6,17,0,1
mjml,mjml,,4,8,7,12,17,19,1,100
scribd,scribd,,0,0,0,0,2,0,0,1
uisearchbardisplaycontrol,uisearchbardisplaycontrol,,0,0,1,0,1,1,13,1
axd,axd,,0,0,1,0,1,1,8,1
cordova-hooks,cordova-hooks,,0,1,2,1,1,3,1,1
ggts,ggts,,0,0,1,0,4,1,3,1
jest-preset-angular,jest-preset-angular,,0,1,6,1,5,7,1,1
phpmqtt,phpmqtt,,3,1,3,4,4,7,6,1
ruby-mqtt,ruby-mqtt,,0,0,0,0,2,0,6,1
spring-integration-mqtt,spring-integration-mqtt,,1,0,7,1,5,8,3,1
markerspiderfier,markerspiderfier,,2,3,1,5,4,6,1,50
pdf-annotations,pdf-annotations,,3,4,9,7,8,16,13,33.333333
cakephp-2.8,cakephp-2.8,,1,0,2,1,3,3,4,1
multiple-return-values,multiple-return-values,,1,3,6,4,7,10,0,200
pushbullet,pushbullet,,1,5,2,6,3,8,4,400
modular-design,modular-design,,3,2,7,5,19,12,1,1
stay-logged-in,stay-logged-in,,0,1,0,1,5,1,4,1
endpointnotfoundexception,endpointnotfoundexception,,0,0,0,0,2,0,8,1
direct-path,direct-path,,1,0,0,1,1,1,0,1
jquery-infinite-scroll,jquery-infinite-scroll,,0,0,1,0,1,1,1,1
android-wear-complication,android-wear-complication,,1,0,4,1,5,5,3,1
mousemotionevent,mousemotionevent,,0,0,1,0,2,1,3,1
openpop,openpop,,0,2,6,2,6,8,8,100
mic-1,mic-1,,0,0,1,0,1,1,9,1
pass-by-name,pass-by-name,,1,1,0,2,3,2,9,1
portainer,portainer,,8,6,15,14,11,29,6,1
poc,poc,,0,1,0,1,2,1,6,1
zurb-foundation-5,zurb-foundation-5,,2,1,3,3,5,6,1,1
changestream,changestream,,9,9,14,18,16,32,1,1
sublime-syntax,sublime-syntax,,0,0,1,0,4,1,0,1
multi-database,multi-database,,1,3,10,4,6,14,3,200
django-paypal,django-paypal,,2,0,5,2,6,7,4,1
filter-input,filter-input,,2,1,1,3,1,4,4,1
fencepost,fencepost,,0,0,0,0,1,0,5,1
mod-fcgid,mod-fcgid,,3,0,2,3,6,5,4,1
mss,mss,,0,2,1,2,2,3,9,100
cegui,cegui,,0,0,0,0,1,0,9,1
xgrabpointer,xgrabpointer,,0,0,0,0,1,0,9,1
dday,dday,,0,0,0,0,2,0,8,1
atomicboolean,atomicboolean,,1,2,1,3,2,4,3,100
workflow-activity,workflow-activity,,0,1,0,1,3,1,8,1
cggradientref,cggradientref,,1,0,0,1,2,1,13,1
donations,donations,,1,1,0,2,4,2,4,1
ats,ats,,0,1,1,1,5,2,0,1
installshield-2010,installshield-2010,,1,1,1,2,1,3,8,1
setforegroundwindow,setforegroundwindow,,3,2,2,5,4,7,8,1
scorm1.2,scorm1.2,,4,0,2,4,10,6,1,1
pynput,pynput,,34,37,60,71,23,131,0,8.823529
jboss-4.0.x,jboss-4.0.x,,1,1,0,2,2,2,3,1
asmack,asmack,,1,0,3,1,4,4,3,1
web-farm,web-farm,,4,1,9,5,3,14,8,1
status-register,status-register,,0,0,0,0,5,0,9,1
build-events,build-events,,2,0,2,2,5,4,8,1
esi,esi,,1,3,1,4,4,5,4,200
meteor-collection-hooks,meteor-collection-hooks,,0,1,1,1,3,2,1,1
jquery-selectric,jquery-selectric,,0,0,3,0,4,3,1,1
stagemonitor,stagemonitor,,1,0,0,1,3,1,3,1
multiple-results,multiple-results,,0,1,1,1,7,2,4,1
ps2,ps2,,0,0,0,0,2,0,9,1
existential-operator,existential-operator,,0,0,0,0,1,0,4,1
jtest,jtest,,1,0,1,1,3,2,3,1
software-protection,software-protection,,0,0,0,0,3,0,3,1
amixer,amixer,,2,4,2,6,1,8,13,100
bootclasspath,bootclasspath,,1,1,1,2,6,3,3,1
vix,vix,,1,0,1,1,2,2,6,1
heap-analytics,heap-analytics,,1,0,1,1,3,2,3,1
asp.net-dynamic-data,asp.net-dynamic-data,,0,0,2,0,1,2,8,1
dremel,dremel,,1,0,2,1,3,3,4,1
project-structuring,project-structuring,,0,1,3,1,1,4,8,1
twisted.client,twisted.client,,0,1,1,1,1,2,0,1
endevor,endevor,,0,0,0,0,1,0,6,1
quali-cloudshell,quali-cloudshell,,0,0,0,0,1,0,6,1
koloboke,koloboke,,0,0,0,0,2,0,3,1
cmdline-args,cmdline-args,,1,0,3,1,2,4,9,1
nested-checkboxes,nested-checkboxes,,1,0,0,1,3,1,12,1
symmetric-key,symmetric-key,,1,0,5,1,3,6,6,1
editview,editview,,1,0,0,1,2,1,8,1
ansi-common-lisp,ansi-common-lisp,,0,2,0,2,3,2,0,100
canalyzer,canalyzer,,1,4,7,5,4,12,9,300
sklabelnode,sklabelnode,,2,5,1,7,11,8,13,150
cacti,cacti,,2,1,2,3,9,5,9,1
mrtg,mrtg,,0,0,2,0,1,2,9,1
nested-map,nested-map,,0,3,2,3,5,5,3,200
pathfinder,pathfinder,,0,1,5,1,4,6,0,1
liblas,liblas,,1,1,0,2,2,2,0,1
http-status-code-407,http-status-code-407,,2,3,5,5,4,10,6,50
curie,curie,,0,1,0,1,1,1,3,1
boost-circularbuffer,boost-circularbuffer,,0,0,0,0,2,0,9,1
web-search,web-search,,1,1,1,2,5,3,8,1
gcloud-java,gcloud-java,,0,0,0,0,2,0,6,1
liquigraph,liquigraph,,1,0,0,1,5,1,2,1
qcc,qcc,,0,3,3,3,1,6,0,200
resemblejs,resemblejs,,1,1,1,2,2,3,3,1
return-by-reference,return-by-reference,,1,3,2,4,7,6,9,200
printthis,printthis,,0,0,2,0,6,2,1,1
weinre,weinre,,0,0,0,0,5,0,1,1
tomtom,tomtom,,3,4,11,7,7,18,3,33.333333
unshelve,unshelve,,0,1,2,1,5,3,6,1
kde-plasma,kde-plasma,,3,4,11,7,4,18,9,33.333333
dronekit-android,dronekit-android,,0,0,0,0,4,0,0,1
graph-store-protocol,graph-store-protocol,,0,0,1,0,2,1,2,1
marshalbyrefobject,marshalbyrefobject,,2,0,4,2,1,6,8,1
jsonata,jsonata,,4,2,2,6,7,8,1,1
time-estimation,time-estimation,,0,0,1,0,2,1,0,1
bean-manager,bean-manager,,1,0,1,1,1,2,3,1
sifting-appender,sifting-appender,,2,0,2,2,1,4,3,1
powerapps-formula,powerapps-formula,,12,8,30,20,1,50,8,1
filereference,filereference,,5,1,0,6,4,6,4,1
routedata,routedata,,0,1,0,1,6,1,8,1
sequencematcher,sequencematcher,,2,4,7,6,6,13,0,100
file-templates,file-templates,,4,0,1,4,4,5,3,1
snowfall,snowfall,,2,0,1,2,7,3,0,1
sendmail.exe,sendmail.exe,,0,1,3,1,2,4,4,1
canonical-schema,canonical-schema,,0,0,0,0,2,0,3,1
render-to-response,render-to-response,,1,0,0,1,1,1,0,1
sparse-dataframe,sparse-dataframe,,0,0,0,0,4,0,0,1
clgeocoder,clgeocoder,,2,2,4,4,8,8,13,1
gfsh,gfsh,,0,3,2,3,2,5,3,200
exception-notification,exception-notification,,0,0,0,0,1,0,12,1
aurelia-loader,aurelia-loader,,0,0,0,0,1,0,1,1
klist,klist,,0,0,1,0,1,1,8,1
prisma,prisma,,77,55,87,132,65,219,1,1
prisma-graphql,prisma-graphql,,57,41,47,98,26,145,1,1
umbrella,umbrella,,4,3,6,7,5,13,2,1
byte-code-enhancement,byte-code-enhancement,,2,3,1,5,2,6,3,50
stimulusjs,stimulusjs,,4,6,1,10,4,11,12,50
ssas-2008,ssas-2008,,0,0,2,0,9,2,4,1
mongomock,mongomock,,0,0,2,0,5,2,1,1
peoplesoft-app-engine,peoplesoft-app-engine,,2,1,7,3,4,10,4,1
cisco-jtapi,cisco-jtapi,,0,1,0,1,2,1,6,1
dbisam,dbisam,,0,1,0,1,1,1,9,1
remotecommand,remotecommand,,2,2,2,4,3,6,8,1
chocolat.js,chocolat.js,,0,0,1,0,1,1,1,1
git-apply,git-apply,,1,1,8,2,5,10,6,1
eclipse-dtp,eclipse-dtp,,0,1,0,1,1,1,3,1
fiware-perseo,fiware-perseo,,3,0,2,3,6,5,6,1
zend-search-lucene,zend-search-lucene,,0,1,0,1,2,1,4,1
inherited-resources,inherited-resources,,0,1,1,1,1,2,12,1
geographic-lib,geographic-lib,,0,0,2,0,3,2,0,1
list-comparison,list-comparison,,3,3,2,6,5,8,0,1
semantic-ui-segment,semantic-ui-segment,,0,0,0,0,1,0,1,1
trove4j,trove4j,,0,0,0,0,1,0,3,1
structured-logging,structured-logging,,1,5,3,6,5,9,8,400
import-contacts,import-contacts,,1,0,3,1,3,4,3,1
beginthreadex,beginthreadex,,0,0,2,0,2,2,9,1
variable-subsitution,variable-subsitution,,0,0,1,0,4,1,9,1
cordova-plugin-app-name,cordova-plugin-app-name,,0,0,0,0,1,0,1,1
pcx,pcx,,0,0,0,0,1,0,3,1
listjs,listjs,,2,0,4,2,5,6,1,1
rack-pow,rack-pow,,0,0,0,0,1,0,4,1
balloon,balloon,,1,1,2,2,3,4,1,1
device-instance-id,device-instance-id,,0,1,1,1,2,2,9,1
tensorflow-layers,tensorflow-layers,,2,0,1,2,6,3,0,1
mediastreamsource,mediastreamsource,,0,1,1,1,2,2,1,1
pdfparser,pdfparser,,6,4,6,10,6,16,8,1
osticket,osticket,,1,0,9,1,6,10,4,1
declval,declval,,2,2,4,4,5,8,9,1
invocable,invocable,,0,1,0,1,2,1,9,1
damerau-levenshtein,damerau-levenshtein,,1,1,0,2,3,2,0,1
gforth,gforth,,0,1,3,1,21,4,9,1
dismo,dismo,,1,1,5,2,6,7,0,1
editpad,editpad,,0,0,2,0,5,2,0,1
nosuchfieldexception,nosuchfieldexception,,1,0,0,1,1,1,3,1
contact-list,contact-list,,1,0,3,1,3,4,3,1
uidragitem,uidragitem,,0,1,1,1,4,2,13,1
scaldi,scaldi,,0,0,0,0,2,0,2,1
azure-load-balancer,azure-load-balancer,,19,16,45,35,48,80,8,1
xt,xt,,0,0,0,0,1,0,0,1
uibuttonbaritem,uibuttonbaritem,,0,0,1,0,2,1,13,1
rgooglemaps,rgooglemaps,,0,1,1,1,6,2,0,1
array-sum,array-sum,,3,2,7,5,9,12,4,1
webpack-bundle-analyzer,webpack-bundle-analyzer,,1,2,6,3,6,9,1,100
cocor,cocor,,0,1,0,1,1,1,0,1
installshield-2015,installshield-2015,,2,0,2,2,5,4,8,1
ninject-interception,ninject-interception,,0,0,0,0,1,0,8,1
pycodestyle,pycodestyle,,1,2,3,3,8,6,0,100
library-project,library-project,,2,0,3,2,2,5,8,1
wincache,wincache,,0,0,0,0,2,0,4,1
gvm,gvm,,0,1,0,1,1,1,3,1
posh-gvm,posh-gvm,,0,0,0,0,1,0,9,1
signavio,signavio,,0,0,0,0,1,0,1,1
type-ahead,type-ahead,,0,0,1,0,2,1,1,1
resource-scheduling,resource-scheduling,,1,1,3,2,3,5,0,1
hotswapagent,hotswapagent,,2,2,6,4,5,10,3,1
zxcvbn,zxcvbn,,0,0,1,0,3,1,1,1
plotkml,plotkml,,0,0,1,0,1,1,0,1
tps,tps,,1,0,3,1,5,4,3,1
feasibility,feasibility,,1,2,2,3,2,5,0,100
underflow,underflow,,1,3,8,4,8,12,0,200
stopiteration,stopiteration,,1,2,5,3,6,8,0,100
m2e-pro,m2e-pro,,1,0,2,1,4,3,4,1
mbcs,mbcs,,2,1,0,3,2,3,9,1
gke-networking,gke-networking,,2,7,6,9,4,15,6,250
netmsmqbinding,netmsmqbinding,,0,0,1,0,1,1,8,1
msmq-wcf,msmq-wcf,,1,0,0,1,2,1,8,1
pyxb,pyxb,,2,1,5,3,4,8,3,1
rss2,rss2,,1,3,5,4,5,9,4,200
virtuozzo,virtuozzo,,0,0,0,0,2,0,6,1
xulrunner,xulrunner,,1,1,3,2,5,5,8,1
jslinq,jslinq,,0,0,0,0,1,0,1,1
wsod,wsod,,1,0,0,1,4,1,4,1
easy-thumbnails,easy-thumbnails,,0,0,4,0,3,4,0,1
linker-warning,linker-warning,,2,2,2,4,7,6,9,1
visualmicro,visualmicro,,1,0,0,1,1,1,9,1
npx,npx,,13,10,16,23,14,39,1,1
user-warning,user-warning,,0,1,1,1,2,2,0,1
gadinterstitial,gadinterstitial,,3,2,2,5,1,7,13,1
session-set-save-handler,session-set-save-handler,,0,0,0,0,2,0,4,1
sipjs,sipjs,,5,1,2,6,1,8,1,1
abtest,abtest,,2,3,3,5,7,8,13,50
gpyopt,gpyopt,,1,2,2,3,3,5,0,100
maven-scm-plugin,maven-scm-plugin,,2,1,1,3,2,4,3,1
ios-pdfkit,ios-pdfkit,,10,13,19,23,4,42,13,30
log4cpp,log4cpp,,1,0,3,1,4,4,9,1
react-16,react-16,,4,6,22,10,36,32,1,50
reloading,reloading,,2,0,4,2,5,6,1,1
docx4j.net,docx4j.net,,0,0,0,0,2,0,5,1
vungle-ads,vungle-ads,,0,0,1,0,3,1,3,1
spring-environment,spring-environment,,0,0,1,0,5,1,3,1
sectionheader,sectionheader,,2,1,3,3,2,6,13,1
angular-sortablejs,angular-sortablejs,,0,1,0,1,3,1,1,1
.lib,.lib,,2,2,7,4,8,11,9,1
tinylog,tinylog,,1,0,0,1,1,1,3,1
dlms,dlms,,0,0,1,0,1,1,0,1
algorithmia,algorithmia,,0,1,0,1,3,1,13,1
hybrid-runbook-worker,hybrid-runbook-worker,,0,2,0,2,4,2,8,100
twilio-taskrouter,twilio-taskrouter,,2,3,9,5,8,14,13,50
document-provider,document-provider,,2,0,2,2,3,4,3,1
mongodb-lookup,mongodb-lookup,,2,2,4,4,2,8,1,1
read-text,read-text,,3,2,6,5,11,11,0,1
nosuchproviderexception,nosuchproviderexception,,0,0,0,0,2,0,3,1
stretching,stretching,,0,1,3,1,4,4,8,1
dynamics-crm-uci,dynamics-crm-uci,,5,2,7,7,4,14,8,1
platform-independent,platform-independent,,0,0,4,0,5,4,3,1
kendo-angular-ui,kendo-angular-ui,,10,9,14,19,15,33,1,1
objectfactory,objectfactory,,0,1,3,1,3,4,3,1
vpi,vpi,,0,0,1,0,8,1,9,1
boxstarter,boxstarter,,0,0,0,0,1,0,9,1
chatbase,chatbase,,0,0,4,0,8,4,8,1
jericho-html-parser,jericho-html-parser,,0,0,0,0,1,0,3,1
wicket-1.4,wicket-1.4,,0,0,0,0,1,0,3,1
ion-range-slider,ion-range-slider,,3,0,9,3,15,12,1,1
passport-linkedin,passport-linkedin,,2,0,1,2,2,3,1,1
sequence-points,sequence-points,,4,0,9,4,4,13,9,1
kusto,kusto,,49,48,35,97,4,132,8,1
azure-data-explorer,azure-data-explorer,,29,28,22,57,2,79,8,1
version-compatibility,version-compatibility,,0,0,0,0,2,0,13,1
boost-exception,boost-exception,,0,0,0,0,3,0,9,1
delphi-2007,delphi-2007,,10,7,19,17,21,36,9,1
comaddin,comaddin,,2,3,2,5,3,7,8,50
qcoreapplication,qcoreapplication,,0,0,2,0,5,2,9,1
long-filenames,long-filenames,,0,3,1,3,3,4,8,200
umbraco-macros,umbraco-macros,,0,0,0,0,1,0,8,1
habanero,habanero,,0,0,0,0,2,0,0,1
numerics,numerics,,0,0,0,0,6,0,0,1
magic-chunks,magic-chunks,,0,0,0,0,1,0,8,1
bidirectional-relation,bidirectional-relation,,5,2,2,7,4,9,3,1
webusercontrol,webusercontrol,,1,1,7,2,6,9,8,1
core-telephony,core-telephony,,1,1,14,2,6,16,13,1
minimum-size,minimum-size,,0,0,1,0,4,1,3,1
stl-fileformat,stl-fileformat,,1,0,0,1,1,1,8,1
3d-printing,3d-printing,,2,1,3,3,9,6,0,1
asenumerable,asenumerable,,1,0,0,1,5,1,8,1
continuous-fourier,continuous-fourier,,3,2,4,5,9,9,0,1
uses-feature,uses-feature,,1,2,0,3,2,3,3,100
environ,environ,,1,2,6,3,4,9,5,100
scriptbundle,scriptbundle,,0,1,1,1,3,2,8,1
webgrease,webgrease,,1,0,3,1,2,4,8,1
path-manipulation,path-manipulation,,2,1,1,3,2,4,8,1
rfc5988,rfc5988,,0,0,0,0,2,0,4,1
gnus,gnus,,0,0,0,0,2,0,9,1
sar,sar,,4,1,4,5,6,9,9,1
versionone,versionone,,4,3,2,7,3,9,8,1
crm-sitemap,crm-sitemap,,0,0,0,0,1,0,8,1
braintree-data,braintree-data,,0,0,2,0,1,2,4,1
edwin,edwin,,0,0,0,0,1,0,0,1
command-text,command-text,,1,2,1,3,2,4,4,100
lastpass,lastpass,,0,3,3,3,8,6,1,200
fossil,fossil,,0,0,3,0,6,3,6,1
mars,mars,,2,2,10,4,10,14,9,1
spring-boot-docker-plugin,spring-boot-docker-plugin,,0,0,2,0,1,2,3,1
pedestal,pedestal,,1,0,3,1,4,4,2,1
verbatim,verbatim,,2,1,1,3,4,4,0,1
pptxgenjs,pptxgenjs,,2,3,9,5,4,14,1,50
lttng,lttng,,2,1,8,3,7,11,8,1
poset,poset,,0,0,0,0,2,0,0,1
audiosegment,audiosegment,,1,1,1,2,3,3,0,1
cap,cap,,3,0,4,3,5,7,3,1
xamarin-zebble,xamarin-zebble,,0,0,0,0,3,0,8,1
speculative-execution,speculative-execution,,3,1,1,4,7,5,9,1
ashot,ashot,,2,0,9,2,8,11,3,1
unity3d-ui,unity3d-ui,,4,0,1,4,1,5,8,1
reliable-message-delivery,reliable-message-delivery,,1,1,0,2,10,2,3,1
mate,mate,,1,2,3,3,2,6,9,100
inertial-navigation,inertial-navigation,,0,1,1,1,4,2,1,1
fin-hypergrid,fin-hypergrid,,0,0,2,0,2,2,1,1
xspec,xspec,,1,1,3,2,2,5,3,1
android-scrolling,android-scrolling,,1,1,0,2,2,2,3,1
afp,afp,,1,2,4,3,2,7,3,100
governator,governator,,0,1,0,1,1,1,3,1
zts,zts,,0,2,0,2,3,2,4,100
google-glass,google-glass,,1,2,13,3,7,16,3,100
glassfish-2.x,glassfish-2.x,,0,0,1,0,2,1,3,1
cocoapods-1.0.1,cocoapods-1.0.1,,0,0,0,0,2,0,13,1
drupal-smart-ip,drupal-smart-ip,,0,0,0,0,1,0,4,1
measurementformatter,measurementformatter,,1,1,0,2,3,2,13,1
php-printer,php-printer,,0,0,1,0,6,1,4,1
lacp,lacp,,0,0,0,0,1,0,9,1
document-set,document-set,,0,0,3,0,4,3,8,1
clockkit,clockkit,,5,0,6,5,4,11,13,1
reprex,reprex,,4,2,4,6,2,10,0,1
remoteapi,remoteapi,,1,0,0,1,2,1,1,1
highcharts-convert,highcharts-convert,,1,0,0,1,1,1,1,1
filestreams,filestreams,,0,0,0,0,7,0,9,1
tstream,tstream,,0,0,1,0,1,1,9,1
google-noto,google-noto,,0,1,0,1,2,1,8,1
exadata,exadata,,4,2,4,6,6,10,4,1
dialog-framework,dialog-framework,,1,1,0,2,1,2,8,1
wordpress-gutenberg,wordpress-gutenberg,,103,77,158,180,28,338,4,1
bindingnavigator,bindingnavigator,,2,1,2,3,5,5,8,1
visual-inheritance,visual-inheritance,,2,0,1,2,1,3,8,1
angularjs-ng-switch,angularjs-ng-switch,,0,0,3,0,2,3,1,1
microformats,microformats,,0,2,4,2,3,6,1,100
factorymuffin,factorymuffin,,1,0,0,1,1,1,4,1
3dcamera,3dcamera,,0,0,1,0,4,1,0,1
rml,rml,,0,1,2,1,4,3,0,1
jquery-widgets,jquery-widgets,,1,3,2,4,4,6,1,200
apache-camel-mail,apache-camel-mail,,1,0,5,1,5,6,3,1
pwntools,pwntools,,3,1,4,4,5,8,0,1
redmon,redmon,,2,1,2,3,3,5,8,1
eid,eid,,0,2,0,2,1,2,3,100
tooltipster,tooltipster,,7,4,6,11,10,17,1,1
setsid,setsid,,1,2,1,3,2,4,9,100
groupstyle,groupstyle,,0,0,0,0,2,0,8,1
psapi,psapi,,1,1,3,2,4,5,9,1
angularjs-bootstrap,angularjs-bootstrap,,0,0,5,0,4,5,1,1
soft-hyphen,soft-hyphen,,0,0,0,0,2,0,3,1
activepython,activepython,,0,0,0,0,1,0,0,1
e-notices,e-notices,,1,1,1,2,3,3,4,1
launching-application,launching-application,,2,4,9,6,11,15,3,100
xlrelease,xlrelease,,0,0,1,0,1,1,6,1
entity-framework-core-migrations,entity-framework-core-migrations,,8,3,10,11,23,21,8,1
aphrodite,aphrodite,,1,2,4,3,3,7,1,100
speed-test,speed-test,,4,1,2,5,5,7,0,1
fontspec,fontspec,,0,2,0,2,2,2,0,100
embedly,embedly,,0,3,1,3,1,4,1,200
spring-loaded,spring-loaded,,0,0,1,0,2,1,3,1
componentmodel,componentmodel,,1,0,0,1,2,1,8,1
push.js,push.js,,1,1,2,2,1,4,13,1
sentinelsat,sentinelsat,,2,0,2,2,3,4,0,1
lanterna,lanterna,,2,1,2,3,4,5,3,1
simplegraph,simplegraph,,0,0,0,0,7,0,2,1
jtwig,jtwig,,0,0,4,0,1,4,3,1
google-drive-team-drive,google-drive-team-drive,,28,13,56,41,61,97,5,1
policy-based-security,policy-based-security,,0,0,1,0,2,1,8,1
awsdeploy,awsdeploy,,2,2,2,4,2,6,6,1
xy-grid,xy-grid,,1,5,4,6,4,10,1,400
num-lock,num-lock,,0,0,3,0,2,3,1,1
nrwl-nx,nrwl-nx,,7,26,2,33,4,35,1,271.428571
generative-testing,generative-testing,,0,0,1,0,2,1,2,1
instance-initializers,instance-initializers,,0,0,0,0,2,0,9,1
libsigc++,libsigc++,,0,1,0,1,2,1,9,1
nomin,nomin,,0,0,0,0,4,0,3,1
coloranimation,coloranimation,,0,2,2,2,1,4,8,100
ivalidatableobject,ivalidatableobject,,1,2,5,3,2,8,8,100
resharper-plugins,resharper-plugins,,0,0,2,0,2,2,8,1
onreadystatechange,onreadystatechange,,0,1,5,1,8,6,1,1
bungeecord,bungeecord,,0,0,4,0,3,4,3,1
repa,repa,,0,0,2,0,2,2,2,1
bluecove,bluecove,,0,1,6,1,8,7,3,1
nativeapplication,nativeapplication,,3,0,2,3,6,5,1,1
lock-timeout,lock-timeout,,0,1,1,1,3,2,3,1
color-theory,color-theory,,2,4,0,6,8,6,0,100
syswow64,syswow64,,0,5,1,5,1,6,9,400
cake-pattern,cake-pattern,,0,0,1,0,3,1,2,1
spartan,spartan,,1,4,2,5,13,7,9,300
mercurial-queue,mercurial-queue,,0,0,0,0,3,0,6,1
expressionbuilder,expressionbuilder,,1,0,3,1,10,4,8,1
re2c,re2c,,1,1,0,2,1,2,9,1
popup-blocker,popup-blocker,,1,0,2,1,1,3,1,1
browser-security,browser-security,,2,1,1,3,3,4,1,1
fsfs,fsfs,,0,0,0,0,2,0,6,1
oracle-xml-db,oracle-xml-db,,1,5,2,6,6,8,4,400
oracle-xml-db-repository,oracle-xml-db-repository,,1,0,0,1,1,1,4,1
remotestorage,remotestorage,,0,0,0,0,1,0,6,1
ngui,ngui,,2,1,5,3,7,8,8,1
ngrx-entity,ngrx-entity,,9,14,26,23,24,49,1,55.555556
mockk,mockk,,17,21,36,38,12,74,3,23.529412
typehints,typehints,,13,17,22,30,5,52,0,30.769231
enumerize,enumerize,,1,0,0,1,1,1,12,1
code-analyst,code-analyst,,0,0,0,0,2,0,1,1
wispr,wispr,,0,0,1,0,2,1,13,1
cakefile,cakefile,,0,0,0,0,1,0,13,1
grunt-eslint,grunt-eslint,,1,0,1,1,2,2,1,1
iron.io,iron.io,,0,0,0,0,2,0,3,1
smack-stack,smack-stack,,0,0,1,0,1,1,6,1
python-config,python-config,,0,1,1,1,2,2,0,1
recaptcha-v3,recaptcha-v3,,30,22,44,52,7,96,1,1
search-engine-bots,search-engine-bots,,0,1,0,1,1,1,4,1
web-scripting,web-scripting,,1,2,2,3,5,5,0,100
scott-encoding,scott-encoding,,0,0,0,0,2,0,2,1
git-husky,git-husky,,3,3,9,6,8,15,6,1
jawr,jawr,,1,0,1,1,2,2,3,1
spongeapi,spongeapi,,0,0,0,0,3,0,3,1
connexion,connexion,,13,10,12,23,1,35,0,1
physijs,physijs,,1,3,2,4,2,6,1,200
listmodel,listmodel,,1,2,3,3,6,6,9,100
perwebrequest,perwebrequest,,0,0,0,0,1,0,8,1
property-editor,property-editor,,0,0,0,0,1,0,9,1
phpstorm2017.3,phpstorm2017.3,,0,0,0,0,4,0,4,1
power-bi-report-server,power-bi-report-server,,13,18,29,31,25,60,5,38.461538
fvp,fvp,,0,0,1,0,1,1,9,1
github-release,github-release,,1,2,5,3,7,8,6,100
tcserver,tcserver,,3,0,3,3,3,6,3,1
this-keyword,this-keyword,,0,1,2,1,3,3,1,1
typescript-types,typescript-types,,5,5,33,10,9,43,1,1
mikroc,mikroc,,3,7,6,10,4,16,9,133.333333
cflocation,cflocation,,0,0,2,0,3,2,4,1
isapi-rewrite,isapi-rewrite,,2,2,0,4,3,4,8,1
autoformat,autoformat,,1,0,3,1,3,4,9,1
noreturn,noreturn,,1,1,2,2,5,4,9,1
git-clean,git-clean,,1,1,0,2,7,2,6,1
neo-crypto,neo-crypto,,0,0,0,0,1,0,6,1
azure-information-protection,azure-information-protection,,5,5,4,10,3,14,8,1
microsoft-information-protection,microsoft-information-protection,,4,2,3,6,1,9,8,1
mu-law,mu-law,,2,0,1,2,2,3,13,1
bottender,bottender,,0,0,0,0,3,0,1,1
srp-protocol,srp-protocol,,0,1,3,1,4,4,6,1
audio-analysis,audio-analysis,,3,4,4,7,4,11,0,33.333333
edismax,edismax,,5,2,5,7,4,12,2,1
eazfuscator,eazfuscator,,0,0,1,0,3,1,8,1
grapheme,grapheme,,0,0,3,0,4,3,0,1
internal-compiler-error,internal-compiler-error,,1,1,2,2,2,4,9,1
fakevim,fakevim,,0,0,0,0,1,0,9,1
codata,codata,,1,0,0,1,1,1,2,1
phfetchoptions,phfetchoptions,,1,1,1,2,5,3,13,1
message-loop,message-loop,,1,0,0,1,5,1,8,1
uiimagview,uiimagview,,0,0,0,0,2,0,13,1
django-nonrel,django-nonrel,,0,0,1,0,2,1,1,1
seckeyref,seckeyref,,0,1,2,1,6,3,13,1
jbatch,jbatch,,1,0,3,1,5,4,3,1
stretched,stretched,,0,0,2,0,2,2,1,1
point-in-time,point-in-time,,0,0,1,0,1,1,6,1
persistent-connection,persistent-connection,,2,2,6,4,6,10,3,1
dragular,dragular,,0,0,1,0,1,1,0,1
samsung-browser,samsung-browser,,2,1,6,3,3,9,1,1
probing,probing,,2,0,4,2,3,6,8,1
skulpt,skulpt,,2,3,3,5,4,8,0,50
file-properties,file-properties,,2,3,1,5,3,6,8,50
webgl-globe,webgl-globe,,0,0,1,0,2,1,1,1
bind9,bind9,,1,4,9,5,8,14,4,300
fancy-pointers,fancy-pointers,,0,0,1,0,1,1,9,1
chruby,chruby,,1,0,2,1,4,3,12,1
ion-koush,ion-koush,,2,6,0,8,2,8,3,200
listcontrol,listcontrol,,0,0,0,0,3,0,9,1
media-buttons,media-buttons,,2,1,2,3,3,5,3,1
zest,zest,,3,0,0,3,4,3,3,1
installation-path,installation-path,,1,0,2,1,6,3,8,1
ip-fragmentation,ip-fragmentation,,0,1,3,1,6,4,9,1
alibaba-cloud-ecs,alibaba-cloud-ecs,,2,4,22,6,13,28,6,100
tspl,tspl,,1,0,1,1,2,2,3,1
keyhook,keyhook,,2,1,4,3,1,7,8,1
phpactiverecord,phpactiverecord,,0,0,0,0,4,0,4,1
google-admin-audit-api,google-admin-audit-api,,0,0,3,0,1,3,5,1
thoughtbot,thoughtbot,,1,0,2,1,2,3,12,1
recommender-systems,recommender-systems,,18,20,34,38,35,72,0,11.111111
dogecoin-api,dogecoin-api,,0,1,2,1,4,3,6,1
google-gadget,google-gadget,,0,1,0,1,3,1,5,1
redux-async-actions,redux-async-actions,,0,1,2,1,2,3,1,1
r2jags,r2jags,,2,4,4,6,7,10,0,100
java-ee-mvc,java-ee-mvc,,0,0,0,0,1,0,3,1
ozark,ozark,,0,0,1,0,1,1,3,1
gulp-plugin,gulp-plugin,,1,1,1,2,1,3,1,1
collocation,collocation,,0,0,6,0,3,6,0,1
riff,riff,,3,1,1,4,6,5,13,1
libunwind,libunwind,,6,1,2,7,4,9,9,1
cef4delphi,cef4delphi,,2,1,2,3,3,5,9,1
arc2,arc2,,0,1,0,1,2,1,2,1
context-configuration,context-configuration,,1,1,2,2,3,4,3,1
qhull,qhull,,2,4,5,6,5,11,0,100
fireos,fireos,,1,0,1,1,3,2,3,1
aws-elasticfilesystem,aws-elasticfilesystem,,0,0,6,0,5,6,6,1
stability,stability,,3,3,7,6,10,13,0,1
dotnet-restore,dotnet-restore,,0,3,4,3,8,7,8,200
onutterancecompleted,onutterancecompleted,,0,0,0,0,1,0,3,1
haxl,haxl,,0,0,0,0,2,0,2,1
js-of-ocaml,js-of-ocaml,,0,1,5,1,5,6,0,1
python-routes,python-routes,,0,0,0,0,1,0,0,1
nidaqmx,nidaqmx,,4,5,7,9,9,16,0,25
daq-mx,daq-mx,,0,0,2,0,3,2,0,1
font-awesome-4,font-awesome-4,,3,2,3,5,2,8,1,1
scala-swing,scala-swing,,0,0,0,0,1,0,2,1
mdriven,mdriven,,0,0,1,0,16,1,3,1
jspsych,jspsych,,0,1,2,1,2,3,1,1
wcftestclient,wcftestclient,,2,1,2,3,3,5,8,1
kind-projector,kind-projector,,1,1,2,2,3,4,2,1
android-listview,android-listview,,146,104,139,250,4,389,3,1
space-leak,space-leak,,1,2,1,3,1,4,2,100
xml-entities,xml-entities,,1,1,3,2,2,5,3,1
javahelp,javahelp,,2,0,6,2,4,8,3,1
js-amd,js-amd,,0,2,2,2,3,4,1,100
python-iptables,python-iptables,,0,1,2,1,2,3,0,1
libgosu,libgosu,,6,4,3,10,5,13,12,1
opalrb,opalrb,,8,0,2,8,1,10,12,1
starcraftgym,starcraftgym,,1,1,1,2,4,3,0,1
ansi-92,ansi-92,,0,0,0,0,1,0,4,1
protobuf-csharp-port,protobuf-csharp-port,,1,1,1,2,7,3,8,1
ppx,ppx,,0,0,1,0,2,1,9,1
google-pay,google-pay,,21,26,51,47,27,98,3,23.809524
elasticsearch.net,elasticsearch.net,,4,4,7,8,9,15,6,1
sql-server-2017-express,sql-server-2017-express,,5,6,7,11,16,18,4,20
ironspeed,ironspeed,,0,0,0,0,1,0,4,1
apache-marmotta,apache-marmotta,,0,0,0,0,1,0,2,1
grails-config,grails-config,,0,1,0,1,2,1,3,1
nodename,nodename,,0,0,2,0,3,2,3,1
tamper-data,tamper-data,,0,0,2,0,1,2,1,1
mongokit,mongokit,,0,0,1,0,1,1,1,1
paillier,paillier,,0,1,2,1,1,3,6,1
webkit-overflow-scrolling,webkit-overflow-scrolling,,2,1,3,3,1,6,1,1
rhdf5,rhdf5,,0,1,3,1,5,4,0,1
configobj,configobj,,0,1,2,1,3,3,0,1
acceleratorkey,acceleratorkey,,1,1,4,2,3,6,8,1
invoices,invoices,,0,0,1,0,10,1,4,1
checkout-payments,checkout-payments,,1,0,1,1,2,2,4,1
xsl-output,xsl-output,,0,0,0,0,2,0,14,1
ccl,ccl,,3,1,5,4,4,9,0,1
opencv-drawcontour,opencv-drawcontour,,1,1,4,2,4,6,0,1
timelion,timelion,,5,1,12,6,6,18,6,1
uinib,uinib,,1,0,2,1,6,3,13,1
dets,dets,,0,0,0,0,1,0,2,1
angular-in-memory-web-api,angular-in-memory-web-api,,4,2,13,6,13,19,1,1
session-reuse,session-reuse,,0,0,0,0,3,0,0,1
qfuture,qfuture,,0,1,1,1,7,2,9,1
csscomb,csscomb,,0,0,2,0,2,2,1,1
xamlparseexception,xamlparseexception,,3,1,3,4,1,7,8,1
cfrunloop,cfrunloop,,0,2,1,2,2,3,13,100
postgres-9.4,postgres-9.4,,1,1,0,2,1,2,4,1
expecto,expecto,,0,1,0,1,4,1,8,1
qshareddata,qshareddata,,0,0,0,0,1,0,9,1
input-filter,input-filter,,0,0,1,0,2,1,3,1
hallo-js,hallo-js,,0,0,0,0,3,0,0,1
resolve-url-loader,resolve-url-loader,,2,1,2,3,3,5,1,1
currval,currval,,0,0,1,0,1,1,4,1
microsoft-media-server,microsoft-media-server,,0,0,0,0,1,0,6,1
android-soong,android-soong,,0,4,7,4,4,11,3,300
safari-11,safari-11,,0,0,1,0,5,1,1,1
twitter-flight,twitter-flight,,0,0,0,0,1,0,1,1
rcloud,rcloud,,0,0,0,0,6,0,0,1
eclipse-ecf,eclipse-ecf,,0,0,0,0,2,0,3,1
bcache,bcache,,0,0,0,0,1,0,8,1
docbase,docbase,,0,1,0,1,1,1,3,1
bull.js,bull.js,,2,0,1,2,3,3,3,1
authlib,authlib,,3,12,23,15,17,38,0,300
mapshaper,mapshaper,,2,3,2,5,2,7,0,50
javaexec-gradle-plugin,javaexec-gradle-plugin,,0,1,1,1,3,2,3,1
project-explorer,project-explorer,,1,1,3,2,3,5,3,1
javascriptservices,javascriptservices,,2,2,3,4,7,7,8,1
livescribe,livescribe,,0,0,1,0,1,1,1,1
php-fig,php-fig,,0,0,1,0,4,1,4,1
neodynamic,neodynamic,,0,0,3,0,3,3,8,1
database-connectivity,database-connectivity,,2,0,3,2,3,5,3,1
codeskulptor,codeskulptor,,1,1,6,2,2,8,0,1
mpay24,mpay24,,0,0,0,0,2,0,4,1
zephir,zephir,,0,0,0,0,4,0,4,1
clojars,clojars,,0,0,1,0,2,1,2,1
px4,px4,,1,3,6,4,3,10,0,200
language-extension,language-extension,,0,1,0,1,2,1,2,1
manchester-syntax,manchester-syntax,,0,0,0,0,1,0,2,1
square-checkout,square-checkout,,0,1,1,1,2,2,4,1
facepy,facepy,,0,0,0,0,1,0,0,1
enyim,enyim,,0,0,1,0,2,1,8,1
xmemcached,xmemcached,,0,1,1,1,1,2,3,1
xml-encryption,xml-encryption,,3,0,1,3,3,4,6,1
app-shortcut,app-shortcut,,0,0,0,0,1,0,3,1
rgeo-shapefile,rgeo-shapefile,,5,1,1,6,5,7,0,1
app-lab,app-lab,,2,1,3,3,4,6,1,1
date-sunrise,date-sunrise,,0,1,0,1,1,1,0,1
grouping-sets,grouping-sets,,2,0,2,2,1,4,4,1
heap-randomization,heap-randomization,,0,0,0,0,1,0,0,1
detekt,detekt,,1,6,3,7,6,10,3,500
setediting,setediting,,0,0,1,0,2,1,13,1
vobject,vobject,,0,1,0,1,5,1,0,1
cloudbees,cloudbees,,7,4,19,11,16,30,6,1
taskservice,taskservice,,0,0,2,0,3,2,8,1
starman,starman,,0,0,1,0,1,1,9,1
format-conversion,format-conversion,,2,2,5,4,6,9,0,1
n-quads,n-quads,,3,0,0,3,2,3,2,1
tinkerpop-blueprint,tinkerpop-blueprint,,0,0,1,0,2,1,2,1
oracle-data-modeler,oracle-data-modeler,,2,1,3,3,2,6,4,1
2-3-tree,2-3-tree,,0,1,0,1,4,1,0,1
zeplin,zeplin,,1,1,3,2,6,5,1,1
the-update-framework,the-update-framework,,0,0,0,0,1,0,6,1
stolon,stolon,,0,0,1,0,1,1,4,1
system.js,system.js,,0,0,1,0,4,1,1,1
perlapi,perlapi,,0,1,1,1,7,2,9,1
qt3,qt3,,0,0,0,0,3,0,9,1
apache-ace,apache-ace,,0,0,0,0,1,0,3,1
removable-storage,removable-storage,,1,0,0,1,3,1,3,1
docplex,docplex,,5,8,16,13,5,29,0,60
rfc6265,rfc6265,,1,0,0,1,1,1,4,1
c1001,c1001,,0,0,0,0,1,0,9,1
php-code-coverage,php-code-coverage,,2,0,3,2,3,5,4,1
egnyte,egnyte,,0,0,0,0,2,0,8,1
system.web.routing,system.web.routing,,0,0,0,0,1,0,8,1
groq,groq,,0,2,2,2,4,4,1,100
window-position,window-position,,1,1,2,2,5,4,8,1
lapis,lapis,,0,0,0,0,3,0,6,1
ruby-smpp,ruby-smpp,,1,0,0,1,1,1,12,1
sonar-gerrit,sonar-gerrit,,0,0,1,0,5,1,6,1
large-object-heap,large-object-heap,,2,0,3,2,2,5,8,1
iota,iota,,3,7,6,10,3,16,1,133.333333
adf-task-flow,adf-task-flow,,0,0,0,0,2,0,3,1
datahandler,datahandler,,0,2,2,2,2,4,4,100
python-trio,python-trio,,3,9,4,12,12,16,0,200
linqdatasource,linqdatasource,,0,0,1,0,2,1,8,1
teamcity-8.0,teamcity-8.0,,1,1,3,2,4,5,8,1
system-font,system-font,,0,0,1,0,4,1,1,1
italics,italics,,2,0,2,2,5,4,0,1
mapping-model,mapping-model,,1,0,0,1,1,1,13,1
data-aware,data-aware,,0,0,2,0,1,2,9,1
phplot,phplot,,0,0,1,0,1,1,4,1
mongodb-shell,mongodb-shell,,2,2,3,4,5,7,1,1
ocamldoc,ocamldoc,,1,0,1,1,1,2,0,1
parsimonious,parsimonious,,1,1,2,2,2,4,0,1
gwt-bootstrap,gwt-bootstrap,,0,0,0,0,2,0,3,1
nimble,nimble,,0,0,1,0,1,1,13,1
zimlet,zimlet,,1,0,0,1,1,1,4,1
zimbra-talk,zimbra-talk,,0,0,0,0,1,0,4,1
split-button,split-button,,0,0,1,0,2,1,8,1
scnvector3,scnvector3,,0,0,2,0,6,2,13,1
svg-edit,svg-edit,,1,0,6,1,4,7,1,1
libdl,libdl,,0,2,2,2,4,4,9,100
arduino-mkr1000,arduino-mkr1000,,2,3,3,5,2,8,9,50
nsdocumentcontroller,nsdocumentcontroller,,0,0,4,0,1,4,13,1
activity-monitor,activity-monitor,,3,1,0,4,2,4,4,1
write-error,write-error,,0,0,2,0,1,2,2,1
kubernetes-dashboard,kubernetes-dashboard,,13,7,29,20,24,49,6,1
cmock,cmock,,1,0,1,1,5,2,9,1
adobe-captivate,adobe-captivate,,1,1,5,2,4,7,1,1
salesforcesharp,salesforcesharp,,0,0,0,0,1,0,8,1
jmxmp,jmxmp,,0,0,0,0,1,0,3,1
scala-wartremover,scala-wartremover,,0,0,0,0,3,0,2,1
lodepng,lodepng,,1,0,0,1,3,1,9,1
bluetooth-5,bluetooth-5,,0,1,2,1,3,3,3,1
activex-exe,activex-exe,,0,0,1,0,3,1,8,1
aspnetdb,aspnetdb,,0,1,0,1,1,1,4,1
z39.50,z39.50,,2,0,1,2,4,3,4,1
pivottable.js,pivottable.js,,5,0,6,5,15,11,1,1
automapper-4,automapper-4,,1,0,2,1,3,3,8,1
commutativity,commutativity,,1,1,5,2,6,7,0,1
mysql-error-1045,mysql-error-1045,,0,3,2,3,6,5,4,200
osx-snow-leopard,osx-snow-leopard,,0,1,1,1,5,2,13,1
vsflexgrid,vsflexgrid,,0,0,1,0,3,1,8,1
windows-ribbon-framework,windows-ribbon-framework,,1,0,0,1,2,1,9,1
multivariate-partition,multivariate-partition,,1,0,1,1,2,2,0,1
accpac,accpac,,0,0,0,0,2,0,8,1
libspatialindex,libspatialindex,,0,2,1,2,2,3,0,100
mb-convert-encoding,mb-convert-encoding,,3,0,3,3,3,6,4,1
standby,standby,,4,3,1,7,6,8,3,1
windows-xp-embedded,windows-xp-embedded,,0,0,0,0,1,0,8,1
petri-net,petri-net,,1,3,4,4,3,8,2,200
jtooltip,jtooltip,,0,1,0,1,1,1,3,1
invalidselectorexception,invalidselectorexception,,2,0,1,2,2,3,3,1
typeset,typeset,,1,0,0,1,1,1,0,1
accessory,accessory,,1,1,4,2,4,6,3,1
getpwnam,getpwnam,,2,0,1,2,1,3,9,1
amazon-device-messaging,amazon-device-messaging,,0,0,0,0,4,0,13,1
tail-call,tail-call,,1,1,0,2,4,2,0,1
ruby-c-extension,ruby-c-extension,,1,1,1,2,4,3,12,1
wkuidelegate,wkuidelegate,,1,1,0,2,2,2,13,1
mks,mks,,0,0,2,0,6,2,9,1
sasl-scram,sasl-scram,,0,0,2,0,2,2,2,1
mongodb-3.6,mongodb-3.6,,2,3,2,5,15,7,1,50
ribbon-button,ribbon-button,,0,0,0,0,1,0,8,1
qtsvg,qtsvg,,0,2,0,2,3,2,0,100
ellipsize,ellipsize,,2,0,2,2,5,4,3,1
dcf77,dcf77,,0,0,0,0,1,0,9,1
dali,dali,,0,0,1,0,5,1,3,1
spgridview,spgridview,,0,0,0,0,1,0,8,1
spsitedataquery,spsitedataquery,,0,0,0,0,2,0,8,1
dllmain,dllmain,,1,1,2,2,2,4,9,1
netbeans-6.9,netbeans-6.9,,0,0,0,0,1,0,1,1
cabal-new,cabal-new,,2,2,3,4,3,7,2,1
qsslsocket,qsslsocket,,2,0,0,2,3,2,9,1
qabstractsocket,qabstractsocket,,0,0,0,0,1,0,9,1
truezip,truezip,,0,1,1,1,1,2,3,1
instant-view,instant-view,,1,1,4,2,1,6,3,1
detectrtc,detectrtc,,0,0,0,0,1,0,1,1
bessel-functions,bessel-functions,,2,2,7,4,10,11,0,1
dedicated,dedicated,,1,1,1,2,2,3,4,1
git-archive,git-archive,,3,1,2,4,4,6,6,1
xmltransient,xmltransient,,0,0,0,0,1,0,3,1
equal-heights,equal-heights,,3,0,7,3,6,10,1,1
j48,j48,,3,3,9,6,3,15,0,1
smartdevicelink,smartdevicelink,,0,0,0,0,1,0,13,1
project-properties,project-properties,,0,0,2,0,2,2,8,1
pyhdf,pyhdf,,1,1,1,2,6,3,0,1
gulp-ftp,gulp-ftp,,0,0,0,0,1,0,1,1
aztec-barcode,aztec-barcode,,1,1,4,2,3,6,3,1
railtie,railtie,,0,0,0,0,3,0,12,1
activation-context-api,activation-context-api,,0,1,1,1,3,2,8,1
google-api-v3,google-api-v3,,3,0,1,3,1,4,5,1
ppl,ppl,,1,1,4,2,12,6,8,1
triton,triton,,0,0,0,0,1,0,6,1
text-width,text-width,,0,1,0,1,1,1,1,1
embedded-object,embedded-object,,0,0,2,0,1,2,5,1
python4delphi,python4delphi,,0,1,0,1,2,1,9,1
mpxj,mpxj,,1,0,1,1,6,2,5,1
tsavedialog,tsavedialog,,0,0,0,0,2,0,9,1
pyforms,pyforms,,2,1,1,3,5,4,0,1
azure-performancecounters,azure-performancecounters,,0,0,0,0,1,0,8,1
enumdropdownlistfor,enumdropdownlistfor,,1,0,3,1,4,4,8,1
cfdata,cfdata,,0,0,2,0,2,2,13,1
webi,webi,,8,6,10,14,10,24,5,1
springjunit4classrunner,springjunit4classrunner,,0,1,4,1,7,5,3,1
startup-error,startup-error,,0,0,1,0,1,1,13,1
qor,qor,,0,0,0,0,2,0,6,1
zip4j,zip4j,,5,3,4,8,7,12,3,1
cryptojacking,cryptojacking,,0,0,0,0,1,0,3,1
backquote,backquote,,1,0,2,1,4,3,0,1
app-offline.htm,app-offline.htm,,0,1,4,1,1,5,8,1
qmovie,qmovie,,2,3,2,5,1,7,0,50
selectcommand,selectcommand,,1,0,1,1,1,2,8,1
cellpadding,cellpadding,,2,0,1,2,1,3,1,1
zend-soap,zend-soap,,2,0,2,2,2,4,3,1
thredds,thredds,,4,0,0,4,3,4,0,1
ncwms1.2,ncwms1.2,,0,0,0,0,1,0,0,1
eclipse-gmf,eclipse-gmf,,1,1,4,2,2,6,3,1
usb-modeswitch,usb-modeswitch,,0,0,2,0,1,2,3,1
primary-key-design,primary-key-design,,1,0,1,1,8,2,4,1
zeus,zeus,,0,0,0,0,1,0,12,1
ipcopen3,ipcopen3,,0,0,0,0,1,0,9,1
rainbows,rainbows,,0,0,0,0,2,0,1,1
angular-router-params,angular-router-params,,2,1,6,3,3,9,1,1
reserved-ip-addresses,reserved-ip-addresses,,1,0,0,1,2,1,9,1
http-digest,http-digest,,0,0,1,0,1,1,4,1
jquery-textext,jquery-textext,,0,0,1,0,1,1,1,1
droidgap,droidgap,,0,0,0,0,1,0,1,1
og-meta,og-meta,,1,1,0,2,4,2,13,1
service-installer,service-installer,,0,0,1,0,1,1,8,1
occlusion-culling,occlusion-culling,,3,0,1,3,3,4,8,1
dynamics-nav-2009,dynamics-nav-2009,,0,0,2,0,2,2,8,1
stamen-maps,stamen-maps,,2,2,3,4,3,7,0,1
easyrdf,easyrdf,,0,1,1,1,3,2,2,1
node-neo4j,node-neo4j,,0,0,0,0,1,0,2,1
ads-api,ads-api,,0,1,1,1,2,2,0,1
extjs6.5,extjs6.5,,0,7,8,7,17,15,1,600
tadotable,tadotable,,1,0,0,1,2,1,9,1
mkstemp,mkstemp,,1,1,1,2,3,3,9,1
aspnet-regiis.exe,aspnet-regiis.exe,,5,0,4,5,4,9,8,1
trusted,trusted,,0,1,3,1,4,4,6,1
custom-dimensions,custom-dimensions,,1,1,8,2,13,10,5,1
roottools,roottools,,0,0,0,0,2,0,9,1
oclint-json-compilation,oclint-json-compilation,,0,0,0,0,4,0,13,1
neo4j-node,neo4j-node,,0,0,0,0,2,0,2,1
freeware,freeware,,0,1,0,1,1,1,8,1
fatjar,fatjar,,10,3,23,13,13,36,3,1
avisynth,avisynth,,1,1,1,2,2,3,13,1
nspersistentdocument,nspersistentdocument,,0,0,0,0,4,0,13,1
adobe-director,adobe-director,,0,0,1,0,1,1,13,1
jbake-templates,jbake-templates,,0,0,0,0,1,0,3,1
eclipse-rcptt,eclipse-rcptt,,0,6,4,6,13,10,3,500
angular-constant,angular-constant,,0,0,0,0,1,0,1,1
clippy,clippy,,2,0,3,2,2,5,9,1
core-banking,core-banking,,0,0,0,0,2,0,4,1
esent,esent,,1,1,0,2,4,2,9,1
mail-gem,mail-gem,,2,3,0,5,2,5,12,50
loading-image,loading-image,,0,2,1,2,2,3,1,100
nsparagraphstyle,nsparagraphstyle,,2,2,1,4,4,5,13,1
interface-class,interface-class,,0,0,0,0,3,0,9,1
joiner,joiner,,0,0,1,0,3,1,3,1
scanpy,scanpy,,0,0,0,0,1,0,0,1
httpruntime.cache,httpruntime.cache,,0,0,0,0,1,0,8,1
in-class-initialization,in-class-initialization,,0,0,3,0,3,3,9,1
caph-framework,caph-framework,,0,0,2,0,2,2,13,1
graphql-tag,graphql-tag,,4,10,10,14,12,24,1,150
uikit-transitions,uikit-transitions,,0,0,1,0,2,1,13,1
cvv8,cvv8,,0,0,0,0,1,0,0,1
prototypal,prototypal,,0,0,0,0,1,0,1,1
stellar,stellar,,7,2,9,9,3,18,6,1
curio,curio,,0,2,0,2,4,2,0,100
range-checking,range-checking,,1,0,1,1,1,2,0,1
ocaml-batteries,ocaml-batteries,,0,0,0,0,1,0,0,1
typed-dataset,typed-dataset,,0,0,0,0,1,0,8,1
native-web-component,native-web-component,,8,10,17,18,24,35,1,25
data-serialization,data-serialization,,1,1,2,2,2,4,13,1
mqueue,mqueue,,1,1,0,2,2,2,9,1
ckeditor-wordcount,ckeditor-wordcount,,0,0,0,0,1,0,1,1
android-actionmode,android-actionmode,,6,9,4,15,7,19,3,50
mio,mio,,1,0,2,1,4,3,9,1
dynamic-chart-series,dynamic-chart-series,,1,2,3,3,4,6,0,100
cci,cci,,1,0,0,1,2,1,3,1
xbuild,xbuild,,3,1,3,4,3,7,8,1
gcal,gcal,,5,1,5,6,5,11,1,1
cydia,cydia,,5,1,0,6,6,6,13,1
unidecoder,unidecoder,,0,0,0,0,3,0,0,1
rsvp.js,rsvp.js,,0,1,0,1,7,1,1,1
rsvp-promise,rsvp-promise,,0,0,0,0,3,0,1,1
imu,imu,,15,4,17,19,7,36,3,1
after-create,after-create,,0,1,0,1,2,1,12,1
persistent-set,persistent-set,,0,0,0,0,1,0,3,1
react-swipeable-views,react-swipeable-views,,1,0,1,1,4,2,1,1
audio-capture,audio-capture,,3,1,3,4,4,7,13,1
single-file,single-file,,1,0,0,1,4,1,6,1
websub,websub,,4,0,2,4,4,6,5,1
pyro.ai,pyro.ai,,0,3,3,3,2,6,0,200
communicationexception,communicationexception,,0,2,0,2,3,2,8,100
bingbot,bingbot,,1,0,1,1,1,2,4,1
bencoding,bencoding,,0,0,0,0,1,0,13,1
jasig,jasig,,4,0,7,4,4,11,3,1
mod-plsql,mod-plsql,,0,1,0,1,5,1,4,1
plsql-psp,plsql-psp,,0,0,0,0,2,0,4,1
drupal-rules,drupal-rules,,0,0,1,0,4,1,4,1
gae-python27,gae-python27,,0,1,2,1,4,3,0,1
unparseable,unparseable,,1,0,4,1,6,5,3,1
dynamic-scope,dynamic-scope,,1,0,3,1,7,4,1,1
scrutinizer,scrutinizer,,2,1,0,3,8,3,4,1
channelfactory,channelfactory,,1,0,2,1,4,3,8,1
fat-client,fat-client,,0,0,0,0,1,0,8,1
spring2.x,spring2.x,,1,1,1,2,3,3,3,1
aws-iam,aws-iam,,4,3,97,7,101,104,6,1
sas-visual-analytics,sas-visual-analytics,,1,1,1,2,1,3,0,1
arcball,arcball,,1,1,2,2,2,4,9,1
primeng-turbotable,primeng-turbotable,,23,9,47,32,63,79,1,1
gutenberg-blocks,gutenberg-blocks,,47,28,72,75,12,147,4,1
fuslogvw,fuslogvw,,0,0,1,0,1,1,8,1
gqlquery,gqlquery,,2,0,0,2,6,2,6,1
apportable,apportable,,0,0,0,0,1,0,3,1
jcarousel,jcarousel,,1,2,0,3,2,3,1,100
hjson,hjson,,1,0,0,1,4,1,8,1
reluctant-quantifiers,reluctant-quantifiers,,0,0,0,0,1,0,0,1
rfc2898,rfc2898,,0,0,1,0,3,1,8,1
rowexpansion,rowexpansion,,0,2,4,2,3,6,3,100
react-create-app,react-create-app,,5,8,9,13,30,22,1,60
rosetta-code,rosetta-code,,0,1,0,1,1,1,0,1
blu-ray,blu-ray,,1,0,3,1,2,4,13,1
method-parameters,method-parameters,,0,1,1,1,3,2,3,1
agresso,agresso,,0,0,1,0,2,1,3,1
reflect-metadata,reflect-metadata,,6,2,4,8,9,12,1,1
cart-analysis,cart-analysis,,3,0,0,3,1,3,0,1
r-faq,r-faq,,0,1,0,1,1,1,0,1
latin-square,latin-square,,0,0,0,0,2,0,0,1
pkgcloud,pkgcloud,,0,2,0,2,4,2,6,100
nstableviewheader,nstableviewheader,,0,0,0,0,2,0,13,1
js-csp,js-csp,,0,0,0,0,1,0,1,1
prometheus-net,prometheus-net,,1,0,3,1,6,4,8,1
mpesa,mpesa,,1,1,1,2,1,3,4,1
ibm-installation-manager,ibm-installation-manager,,0,0,0,0,3,0,3,1
partitioned-view,partitioned-view,,0,0,0,0,1,0,2,1
tsify,tsify,,1,0,0,1,2,1,1,1
tcollection,tcollection,,0,0,0,0,3,0,9,1
skreferencenode,skreferencenode,,0,0,2,0,2,2,13,1
visualtreehelper,visualtreehelper,,0,0,1,0,3,1,8,1
system.windows.media,system.windows.media,,0,0,1,0,3,1,8,1
nexus-7,nexus-7,,1,1,0,2,1,2,3,1
pixelsense,pixelsense,,0,1,0,1,1,1,8,1
kotti,kotti,,2,0,0,2,2,2,0,1
basis,basis,,3,0,3,3,4,6,0,1
bokehjs,bokehjs,,11,4,11,15,13,26,0,1
currency-pipe,currency-pipe,,0,1,1,1,2,2,1,1
segwit,segwit,,0,0,0,0,2,0,6,1
nonfactors-mvc-grid,nonfactors-mvc-grid,,1,1,1,2,8,3,8,1
minimatch,minimatch,,2,1,4,3,3,7,1,1
google-apps-activity,google-apps-activity,,0,1,0,1,2,1,5,1
securesocial,securesocial,,0,0,3,0,3,3,2,1
close-application,close-application,,1,1,1,2,2,3,8,1
angular2-modal,angular2-modal,,0,0,0,0,3,0,1,1
x86-emulation,x86-emulation,,1,1,3,2,2,5,3,1
pantone,pantone,,1,0,1,1,2,2,1,1
controlvalueaccessor,controlvalueaccessor,,12,9,13,21,15,34,1,1
fixed-point-iteration,fixed-point-iteration,,0,3,3,3,4,6,0,200
patroni,patroni,,0,1,3,1,3,4,4,1
voip-android,voip-android,,5,2,4,7,10,11,3,1
jarduino,jarduino,,0,0,0,0,1,0,3,1
nsresponder,nsresponder,,1,0,2,1,4,3,13,1
responder-chain,responder-chain,,1,3,1,4,3,5,13,200
formsy-react,formsy-react,,3,1,3,4,5,7,1,1
phash,phash,,2,3,2,5,5,7,12,50
stencil-component,stencil-component,,3,3,3,6,9,9,1,1
metamug,metamug,,0,0,0,0,3,0,4,1
class-level,class-level,,1,0,0,1,1,1,9,1
geokit,geokit,,0,1,7,1,5,8,12,1
blitz3d,blitz3d,,0,0,0,0,1,0,9,1
blitzmax,blitzmax,,0,0,0,0,1,0,9,1
react-native-device-info,react-native-device-info,,2,4,4,6,4,10,1,100
rst2pdf,rst2pdf,,2,2,0,4,2,4,0,1
reentrantreadwritelock,reentrantreadwritelock,,2,1,1,3,3,4,3,1
systemd-journald,systemd-journald,,8,2,12,10,13,22,9,1
beeswarm,beeswarm,,2,1,2,3,5,5,0,1
setf,setf,,0,1,2,1,4,3,0,1
pybitcoin,pybitcoin,,0,0,0,0,1,0,0,1
user-mode-linux,user-mode-linux,,1,2,1,3,5,4,9,100
sorting-network,sorting-network,,0,0,0,0,4,0,0,1
let-over-lambda,let-over-lambda,,0,0,0,0,1,0,0,1
sbt-web,sbt-web,,0,0,2,0,2,2,2,1
citrix-access-gateway,citrix-access-gateway,,0,2,5,2,1,7,8,100
colordrawable,colordrawable,,1,0,1,1,4,2,3,1
texlipse,texlipse,,0,0,2,0,1,2,3,1
visual-assist,visual-assist,,0,0,3,0,2,3,8,1
social-graph,social-graph,,0,0,3,0,1,3,0,1
twentyseventeen,twentyseventeen,,1,1,9,2,7,11,4,1
qchartview,qchartview,,4,2,4,6,10,10,9,1
broadcom,broadcom,,1,1,2,2,3,4,9,1
gbdk,gbdk,,2,3,2,5,1,7,9,50
saf,saf,,1,1,0,2,1,2,3,1
unexpectendoffile,unexpectendoffile,,0,0,1,0,4,1,3,1
formstack,formstack,,0,0,1,0,3,1,1,1
exchange-sharp,exchange-sharp,,0,0,0,0,1,0,8,1
tolower,tolower,,2,3,2,5,10,7,9,50
appcmd,appcmd,,4,2,5,6,8,11,8,1
google-room,google-room,,0,1,1,1,2,2,3,1
zen-of-python,zen-of-python,,0,1,1,1,1,2,0,1
pyicu,pyicu,,1,0,3,1,6,4,0,1
codeworld,codeworld,,0,0,0,0,6,0,2,1
git-history,git-history,,4,6,9,10,7,19,6,50
docusaurus,docusaurus,,1,6,7,7,4,14,1,500
spark-ada,spark-ada,,2,1,3,3,6,6,9,1
rapidoid,rapidoid,,0,1,1,1,1,2,3,1
android-beam,android-beam,,1,2,2,3,7,5,3,100
maximization,maximization,,2,2,7,4,4,11,0,1
nsq,nsq,,0,1,8,1,5,9,6,1
pynsq,pynsq,,0,0,0,0,4,0,0,1
hbasetestingutility,hbasetestingutility,,0,0,0,0,2,0,2,1
platform-independence,platform-independence,,0,0,0,0,1,0,9,1
lumen-routing,lumen-routing,,0,1,0,1,2,1,4,1
filevisitor,filevisitor,,0,0,0,0,2,0,3,1
ngb-datepicker,ngb-datepicker,,10,4,14,14,9,28,1,1
asp.net-caching,asp.net-caching,,0,0,0,0,2,0,8,1
peano-numbers,peano-numbers,,0,0,1,0,2,1,2,1
react-native-mapbox-gl,react-native-mapbox-gl,,4,11,5,15,3,20,1,175
cmaltimeter,cmaltimeter,,1,1,1,2,3,3,13,1
hound,hound,,0,1,1,1,2,2,2,1
cutycapt,cutycapt,,0,0,1,0,1,1,3,1
sql-server-2008-express,sql-server-2008-express,,0,1,1,1,4,2,4,1
phpbrew,phpbrew,,2,2,0,4,5,4,4,1
oversampling,oversampling,,18,12,22,30,18,52,0,1
corrupted-state-exception,corrupted-state-exception,,1,0,1,1,3,2,8,1
jepsen,jepsen,,0,0,0,0,1,0,2,1
jqvmap,jqvmap,,2,2,5,4,7,9,1,1
apache-sentry,apache-sentry,,1,2,6,3,8,9,2,100
extglob,extglob,,1,0,1,1,2,2,9,1
llvm-config,llvm-config,,0,0,1,0,1,1,9,1
company-hub,company-hub,,0,0,0,0,1,0,8,1
ng-content,ng-content,,8,7,12,15,9,27,1,1
jquery-datatables-rails,jquery-datatables-rails,,0,1,0,1,2,1,12,1
peoplecode,peoplecode,,5,5,15,10,12,25,4,1
codeigniter-4,codeigniter-4,,0,1,1,1,4,2,4,1
implication,implication,,1,1,1,2,2,3,0,1
database-engine,database-engine,,0,1,1,1,3,2,4,1
xml.modify,xml.modify,,0,0,2,0,3,2,4,1
drf-yasg,drf-yasg,,7,9,5,16,8,21,0,28.571429
stream-socket-client,stream-socket-client,,0,1,9,1,5,10,8,1
dirty-checking,dirty-checking,,0,2,3,2,4,5,3,100
large-scale,large-scale,,3,2,3,5,1,8,0,1
amp-img,amp-img,,3,0,7,3,7,10,1,1
elm-test,elm-test,,1,1,2,2,2,4,1,1
forceunwrap,forceunwrap,,0,0,0,0,3,0,13,1
dragonfly-gem,dragonfly-gem,,1,0,3,1,1,4,12,1
drupal-panels,drupal-panels,,0,0,1,0,2,1,4,1
cwnd,cwnd,,1,0,1,1,1,2,9,1
chef-vault,chef-vault,,1,1,3,2,3,5,12,1
uglifyjs-folder,uglifyjs-folder,,0,0,0,0,1,0,1,1
mugenmvvmtoolkit,mugenmvvmtoolkit,,0,0,0,0,1,0,8,1
workload,workload,,2,2,2,4,5,6,0,1
nite,nite,,3,1,1,4,2,5,0,1
sql-mode,sql-mode,,1,4,6,5,8,11,4,300
ggpmisc,ggpmisc,,0,2,5,2,5,7,0,100
nodeclipse,nodeclipse,,0,0,2,0,1,2,3,1
chrome-ios,chrome-ios,,0,2,4,2,4,6,1,100
ngmocke2e,ngmocke2e,,0,0,2,0,1,2,1,1
android-go,android-go,,1,0,0,1,3,1,3,1
bartender,bartender,,2,3,2,5,7,7,5,50
regtlib,regtlib,,0,0,0,0,1,0,8,1
group-membership,group-membership,,1,0,2,1,2,3,8,1
breakiterator,breakiterator,,0,1,0,1,1,1,9,1
jcolorchooser,jcolorchooser,,3,0,3,3,3,6,3,1
outliner,outliner,,0,0,1,0,1,1,0,1
great-circle,great-circle,,1,1,3,2,3,5,0,1
vimeo-ios,vimeo-ios,,4,1,0,5,1,5,1,1
clickstream,clickstream,,2,0,7,2,2,9,0,1
micr,micr,,1,3,1,4,1,5,8,200
porter-duff,porter-duff,,2,3,6,5,4,11,3,50
tippyjs,tippyjs,,8,3,18,11,7,29,1,1
gulp-connect-php,gulp-connect-php,,0,0,2,0,3,2,1,1
groupprincipal,groupprincipal,,0,0,0,0,3,0,8,1
database-deployment,database-deployment,,1,0,3,1,1,4,4,1
coldfusion-8,coldfusion-8,,1,0,2,1,4,3,4,1
wiimote,wiimote,,0,2,3,2,4,5,0,100
svn-merge-reintegrate,svn-merge-reintegrate,,0,0,0,0,4,0,6,1
fxruby,fxruby,,3,0,2,3,2,5,12,1
jethro,jethro,,0,0,0,0,4,0,3,1
iris-go,iris-go,,0,0,0,0,3,0,6,1
foaf,foaf,,0,0,2,0,4,2,2,1
oql,oql,,1,1,1,2,4,3,3,1
dropwizard-templates,dropwizard-templates,,0,1,0,1,4,1,3,1
injectableprovider,injectableprovider,,0,0,0,0,1,0,1,1
careplicatorlayer,careplicatorlayer,,0,0,1,0,1,1,13,1
nsbatchupdaterequest,nsbatchupdaterequest,,0,0,2,0,1,2,13,1
playmaker,playmaker,,0,1,0,1,1,1,8,1
python-typing,python-typing,,21,20,27,41,7,68,0,1
frame-grab,frame-grab,,0,0,1,0,3,1,3,1
tomcat-dbcp,tomcat-dbcp,,2,0,2,2,4,4,3,1
mantissa,mantissa,,0,0,5,0,4,5,0,1
neos-server,neos-server,,1,0,2,1,1,3,0,1
objectquery,objectquery,,0,0,0,0,1,0,8,1
.net-mac,.net-mac,,0,0,1,0,1,1,8,1
terminal-color,terminal-color,,0,1,3,1,1,4,9,1
refind,refind,,3,0,0,3,2,3,9,1
ora-24247,ora-24247,,1,0,4,1,1,5,4,1
ibooks,ibooks,,0,1,4,1,3,5,13,1
google-apps-script-api,google-apps-script-api,,17,14,18,31,23,49,5,1
nsapplication-delegate,nsapplication-delegate,,1,3,2,4,2,6,13,200
togaf,togaf,,0,0,1,0,1,1,3,1
laravel-broadcast,laravel-broadcast,,4,0,5,4,3,9,4,1
common-test,common-test,,0,0,2,0,2,2,2,1
blaze,blaze,,0,0,8,0,8,8,1,1
registrator,registrator,,1,0,1,1,2,2,6,1
mongodb-3.3,mongodb-3.3,,0,0,0,0,1,0,1,1
pointer-to-array,pointer-to-array,,1,0,1,1,2,2,9,1
awt-eventqueue,awt-eventqueue,,1,3,1,4,2,5,3,200
mod-php,mod-php,,2,0,2,2,4,4,4,1
django-floppyforms,django-floppyforms,,0,0,0,0,2,0,0,1
nslayoutmanager,nslayoutmanager,,3,4,6,7,6,13,13,33.333333
libreoffice-impress,libreoffice-impress,,0,0,0,0,1,0,5,1
workbox-webpack-plugin,workbox-webpack-plugin,,8,18,30,26,23,56,1,125
bats-core,bats-core,,1,0,3,1,2,4,9,1
odp,odp,,2,0,1,2,1,3,8,1
ora-01481,ora-01481,,0,0,0,0,2,0,4,1
kendo-spa,kendo-spa,,0,0,0,0,1,0,1,1
babel-preset-env,babel-preset-env,,9,8,13,17,13,30,1,1
java1.4,java1.4,,0,1,1,1,1,2,3,1
kannel,kannel,,1,0,10,1,9,11,3,1
jasmin-sms,jasmin-sms,,1,0,4,1,3,5,4,1
dmv,dmv,,3,3,11,6,4,17,4,1
swaggerhub,swaggerhub,,1,3,8,4,6,12,3,200
implicit-parameters,implicit-parameters,,0,0,0,0,3,0,2,1
baasbox,baasbox,,0,0,0,0,1,0,4,1
grass-file,grass-file,,0,0,0,0,3,0,2,1
min3d,min3d,,1,1,0,2,3,2,3,1
pocodynamo,pocodynamo,,1,1,1,2,1,3,6,1
formsauthentication,formsauthentication,,0,0,0,0,3,0,8,1
craigslist,craigslist,,0,1,2,1,7,3,0,1
autonomy,autonomy,,0,0,1,0,1,1,0,1
form-load,form-load,,1,0,2,1,3,3,8,1
junos-automation,junos-automation,,3,3,10,6,4,16,6,1
pyez,pyez,,3,0,6,3,6,9,6,1
azure-disk,azure-disk,,0,4,7,4,5,11,8,300
plexus,plexus,,0,0,2,0,2,2,3,1
aws-guardduty,aws-guardduty,,0,0,0,0,1,0,6,1
gplearn,gplearn,,0,1,1,1,2,2,0,1
multiple-login,multiple-login,,2,1,1,3,3,4,4,1
pin-ptr,pin-ptr,,1,0,0,1,1,1,9,1
jquery-traversing,jquery-traversing,,1,3,4,4,4,8,1,200
winrt-async,winrt-async,,1,1,2,2,2,4,8,1
system.net.websockets,system.net.websockets,,1,1,2,2,3,4,8,1
ecdhe,ecdhe,,0,0,3,0,3,3,6,1
escalation,escalation,,0,0,1,0,1,1,4,1
xerces2-j,xerces2-j,,0,1,1,1,3,2,3,1
umbraco-cloud,umbraco-cloud,,0,0,3,0,3,3,8,1
ws4py,ws4py,,0,0,0,0,2,0,0,1
request.servervariables,request.servervariables,,0,0,1,0,1,1,8,1
fastlane-scan,fastlane-scan,,0,1,2,1,2,3,13,1
simple-oauth2,simple-oauth2,,2,0,4,2,3,6,1,1
angular-renderer,angular-renderer,,0,0,1,0,4,1,1,1
shadermaterial,shadermaterial,,1,1,0,2,2,2,9,1
fleet,fleet,,1,0,2,1,2,3,8,1
firebase-assistant,firebase-assistant,,0,2,2,2,7,4,3,100
tiny-core-linux,tiny-core-linux,,0,0,1,0,2,1,0,1
hd44780,hd44780,,0,0,0,0,2,0,9,1
vue-context-menu,vue-context-menu,,0,0,0,0,1,0,1,1
semantic-ui-redux-form-fields,semantic-ui-redux-form-fields,,1,1,0,2,2,2,1,1
picaxe,picaxe,,1,0,0,1,1,1,0,1
growl,growl,,0,1,0,1,4,1,3,1
function-templates,function-templates,,10,15,27,25,7,52,9,50
autodesk-realitycapture,autodesk-realitycapture,,3,4,3,7,4,10,14,33.333333
convexity-defects,convexity-defects,,1,0,2,1,3,3,0,1
tomahawk,tomahawk,,0,0,3,0,9,3,3,1
laravel-5.6,laravel-5.6,,67,40,513,107,1176,620,4,1
amazon-mq,amazon-mq,,9,12,14,21,8,35,3,33.333333
apache-minifi,apache-minifi,,7,4,8,11,5,19,2,1
pair-programming,pair-programming,,0,0,0,0,1,0,6,1
jquery-color,jquery-color,,0,2,0,2,2,2,1,100
processhtml,processhtml,,0,0,1,0,1,1,1,1
createreactclass,createreactclass,,0,0,0,0,1,0,1,1
temporaries,temporaries,,0,0,0,0,1,0,9,1
return-code,return-code,,0,4,4,4,6,8,9,300
unowned-references,unowned-references,,2,1,1,3,7,4,13,1
eruby,eruby,,0,0,0,0,3,0,12,1
lmax,lmax,,2,0,4,2,6,6,3,1
single-file-generator,single-file-generator,,0,1,1,1,2,2,8,1
symmetric,symmetric,,9,2,10,11,16,21,0,1
digit-separator,digit-separator,,1,1,2,2,2,4,0,1
xcode3.2,xcode3.2,,2,0,0,2,1,2,13,1
dbfit,dbfit,,1,1,1,2,4,3,3,1
hibernate-session,hibernate-session,,3,1,3,4,7,7,3,1
updatesourcetrigger,updatesourcetrigger,,1,1,3,2,5,5,8,1
tibco-mdm,tibco-mdm,,0,0,0,0,1,0,3,1
yecc,yecc,,0,2,0,2,1,2,2,100
mktileoverlay,mktileoverlay,,5,0,2,5,4,7,13,1
user-select,user-select,,0,1,2,1,2,3,1,1
antixsslibrary,antixsslibrary,,2,2,2,4,4,6,8,1
jncryptor,jncryptor,,0,0,0,0,1,0,3,1
streamex,streamex,,0,0,0,0,2,0,3,1
rivets,rivets,,0,0,0,0,2,0,8,1
intermittent,intermittent,,1,2,5,3,5,8,8,100
wli,wli,,0,0,0,0,1,0,3,1
dragger,dragger,,0,0,2,0,1,2,3,1
gsmcomm,gsmcomm,,3,5,4,8,2,12,8,66.666667
rxjs6,rxjs6,,132,84,332,216,292,548,1,1
translation-scheme,translation-scheme,,0,0,0,0,1,0,4,1
html5-formvalidation,html5-formvalidation,,0,0,2,0,7,2,1,1
incanter,incanter,,0,0,0,0,2,0,2,1
refspec,refspec,,0,2,1,2,1,3,6,100
elips-studio,elips-studio,,0,0,0,0,1,0,3,1
mraid,mraid,,1,0,1,1,2,2,1,1
table-structure,table-structure,,1,0,0,1,3,1,4,1
ggnetwork,ggnetwork,,1,1,5,2,9,7,0,1
breach-attack,breach-attack,,1,1,2,2,2,4,4,1
authorizationservices,authorizationservices,,0,0,0,0,1,0,8,1
viridis,viridis,,4,1,5,5,6,10,0,1
iidentity,iidentity,,0,0,0,0,1,0,8,1
tbb-flow-graph,tbb-flow-graph,,1,0,0,1,5,1,9,1
reactivesearch,reactivesearch,,11,12,28,23,19,51,1,9.090909
maskededitextender,maskededitextender,,0,0,0,0,2,0,8,1
epmd,epmd,,0,2,3,2,4,5,2,100
dante,dante,,1,0,1,1,5,2,6,1
jbox,jbox,,1,0,1,1,2,2,1,1
vsperfmon,vsperfmon,,0,1,2,1,1,3,8,1
emacs25,emacs25,,2,0,0,2,3,2,9,1
vistime,vistime,,1,0,2,1,1,3,0,1
list-definition,list-definition,,0,0,1,0,2,1,8,1
itemspaneltemplate,itemspaneltemplate,,0,1,1,1,2,2,8,1
tag-dispatching,tag-dispatching,,1,0,1,1,2,2,9,1
xcode-debugger,xcode-debugger,,3,0,1,3,5,4,13,1
windows-performance-analyzer,windows-performance-analyzer,,0,0,0,0,3,0,9,1
lastaccesstime,lastaccesstime,,2,0,1,2,2,3,0,1
greengrass,greengrass,,7,5,18,12,9,30,6,1
http-accept-language,http-accept-language,,2,0,4,2,5,6,4,1
ballerina-composer,ballerina-composer,,0,1,0,1,6,1,14,1
cinnamon,cinnamon,,2,4,7,6,10,13,9,100
windeployqt,windeployqt,,1,2,6,3,3,9,9,100
mongoose-auto-increment,mongoose-auto-increment,,0,3,2,3,2,5,1,200
event-id,event-id,,3,0,1,3,2,4,6,1
picturegallery,picturegallery,,0,0,1,0,2,1,0,1
clone-element,clone-element,,0,0,1,0,2,1,1,1
wordperfect,wordperfect,,0,0,1,0,1,1,5,1
taskwarrior,taskwarrior,,0,2,1,2,5,3,9,100
nclam,nclam,,0,0,0,0,1,0,8,1
wbem,wbem,,2,0,1,2,1,3,8,1
mime-mail,mime-mail,,4,5,6,9,9,15,4,25
p4api.net,p4api.net,,0,0,1,0,4,1,6,1
objectcache,objectcache,,1,0,1,1,4,2,8,1
gdata-api,gdata-api,,1,0,0,1,1,1,4,1
sgp4,sgp4,,0,0,0,0,3,0,0,1
content-model,content-model,,0,0,1,0,3,1,3,1
pg-dumpall,pg-dumpall,,1,3,1,4,7,5,4,200
visualdesigner,visualdesigner,,0,2,1,2,2,3,8,100
git-annex,git-annex,,0,0,2,0,1,2,6,1
rbindlist,rbindlist,,4,2,7,6,6,13,0,1
morphline,morphline,,0,1,0,1,3,1,2,1
groupchat,groupchat,,1,1,0,2,4,2,3,1
auto-compile,auto-compile,,1,1,2,2,1,4,3,1
oneplusone,oneplusone,,0,1,3,1,2,4,3,1
alibaba-cloud-rds,alibaba-cloud-rds,,1,1,5,2,1,7,4,1
boggle,boggle,,2,0,0,2,6,2,0,1
typo3-4.7,typo3-4.7,,0,0,0,0,1,0,4,1
unichar,unichar,,0,1,0,1,1,1,0,1
r-egg,r-egg,,0,0,0,0,1,0,0,1
websync,websync,,0,0,1,0,3,1,1,1
openviewerfx,openviewerfx,,0,0,0,0,1,0,3,1
multitasking-gestures,multitasking-gestures,,0,0,0,0,2,0,13,1
ngx-editor,ngx-editor,,1,1,6,2,4,8,1,1
mp3agic,mp3agic,,2,1,0,3,3,3,3,1
ember-cli-rails,ember-cli-rails,,0,0,0,0,2,0,12,1
database-mail,database-mail,,1,2,5,3,8,8,4,100
drupal-behaviors,drupal-behaviors,,0,3,0,3,1,3,4,200
jfxtras,jfxtras,,2,0,2,2,10,4,3,1
amiga,amiga,,0,0,0,0,2,0,9,1
pushover,pushover,,0,0,3,0,3,3,0,1
kiwi-tcms,kiwi-tcms,,5,4,8,9,1,17,6,1
protect-from-forgery,protect-from-forgery,,1,0,1,1,3,2,12,1
velocity-tools,velocity-tools,,0,0,0,0,2,0,3,1
lambda-metafactory,lambda-metafactory,,0,0,4,0,3,4,3,1
hotplugging,hotplugging,,1,1,8,2,2,10,9,1
keyfilter,keyfilter,,0,1,1,1,3,2,3,1
overridependingtransition,overridependingtransition,,1,0,3,1,2,4,3,1
define-syntax,define-syntax,,1,0,3,1,3,4,0,1
syntax-rules,syntax-rules,,3,0,0,3,2,3,0,1
xcode9.3-beta,xcode9.3-beta,,0,0,0,0,10,0,13,1
image-text,image-text,,0,0,1,0,1,1,3,1
digital-handwritting,digital-handwritting,,0,1,0,1,1,1,0,1
fluent-mongo,fluent-mongo,,0,0,0,0,1,0,6,1
td-agent,td-agent,,6,5,11,11,8,22,6,1
trilateration,trilateration,,6,6,3,12,4,15,3,1
abstractmethoderror,abstractmethoderror,,1,1,3,2,1,5,3,1
azure-availability-zones,azure-availability-zones,,1,0,0,1,2,1,8,1
problem-steps-recorder,problem-steps-recorder,,0,0,1,0,1,1,0,1
custom-pipeline-component,custom-pipeline-component,,0,1,1,1,2,2,8,1
biztalk-pipelines,biztalk-pipelines,,0,0,0,0,4,0,8,1
pdf2htmlex,pdf2htmlex,,2,0,3,2,5,5,0,1
raster-graphics,raster-graphics,,0,0,0,0,1,0,0,1
discounts,discounts,,0,0,0,0,2,0,4,1
ilasm,ilasm,,0,0,2,0,5,2,8,1
crudbooster,crudbooster,,7,1,3,8,1,11,4,1
pascalcasing,pascalcasing,,2,0,2,2,1,4,8,1
git-rm,git-rm,,3,6,2,9,3,11,6,100
uniobjects,uniobjects,,0,2,0,2,1,2,9,100
dacapo,dacapo,,0,0,0,0,2,0,3,1
ilnumerics,ilnumerics,,1,0,3,1,2,4,8,1
frameset-iframe,frameset-iframe,,0,2,0,2,1,2,1,100
fixpoint-combinators,fixpoint-combinators,,1,1,4,2,9,6,2,1
cdo-climate,cdo-climate,,2,8,0,10,2,10,0,300
underlyingtype,underlyingtype,,1,0,0,1,1,1,9,1
gnome-keyring-daemon,gnome-keyring-daemon,,0,0,3,0,3,3,9,1
qtpositioning,qtpositioning,,0,2,0,2,3,2,9,100
inspection,inspection,,2,2,6,4,6,10,0,1
yii-widgets,yii-widgets,,2,0,0,2,2,2,4,1
mongoose-middleware,mongoose-middleware,,0,1,3,1,2,4,1,1
vector-multiplication,vector-multiplication,,1,2,3,3,4,6,0,100
cgit,cgit,,0,0,0,0,1,0,6,1
devserver,devserver,,2,1,6,3,5,9,4,1
uiprintpagerenderer,uiprintpagerenderer,,2,2,2,4,4,6,13,1
kendo-confirm,kendo-confirm,,0,0,0,0,2,0,8,1
rfc5766turnserver,rfc5766turnserver,,0,1,2,1,3,3,1,1
cgns,cgns,,1,0,1,1,1,2,0,1
source-monitor,source-monitor,,0,0,1,0,1,1,9,1
posh-git,posh-git,,0,1,2,1,4,3,8,1
vuejs-transition,vuejs-transition,,6,2,8,8,6,16,1,1
jmagick,jmagick,,0,0,3,0,3,3,12,1
compound-file,compound-file,,0,0,0,0,1,0,1,1
rhtml,rhtml,,0,0,0,0,1,0,12,1
graceful-degradation,graceful-degradation,,0,0,2,0,4,2,1,1
generic-foreign-key,generic-foreign-key,,1,4,4,5,9,9,0,300
custom-backend,custom-backend,,1,2,2,3,4,5,4,100
litecoin,litecoin,,3,1,2,4,16,6,6,1
android-enterprise-features,android-enterprise-features,,0,3,1,3,2,4,3,200
kubernetes-hpa,kubernetes-hpa,,2,1,1,3,2,4,6,1
bootstrap-wysihtml5,bootstrap-wysihtml5,,0,1,2,1,2,3,1,1
avaya,avaya,,6,4,11,10,3,21,5,1
scrollstotop,scrollstotop,,0,0,0,0,1,0,1,1
mspec,mspec,,1,1,2,2,6,4,8,1
ischecked,ischecked,,2,1,1,3,4,4,3,1
xmldatasource,xmldatasource,,1,0,1,1,1,2,4,1
windows-screensaver,windows-screensaver,,0,0,2,0,3,2,9,1
vegasjs,vegasjs,,2,0,0,2,2,2,1,1
noip,noip,,3,3,9,6,5,15,4,1
apng,apng,,7,3,1,10,2,11,1,1
auctex,auctex,,1,0,1,1,2,2,9,1
qbuttongroup,qbuttongroup,,0,0,3,0,1,3,0,1
angular-timer,angular-timer,,2,0,0,2,1,2,1,1
emmeans,emmeans,,9,13,27,22,20,49,0,44.444444
thread-state,thread-state,,1,0,0,1,2,1,3,1
tealium,tealium,,2,5,7,7,9,14,5,150
propertyconfigurator,propertyconfigurator,,0,0,0,0,2,0,3,1
eccn,eccn,,0,1,0,1,1,1,13,1
deface,deface,,1,1,2,2,1,4,12,1
fr3dldapbundle,fr3dldapbundle,,0,0,1,0,3,1,4,1
alexa-sdk-nodejs,alexa-sdk-nodejs,,1,3,13,4,9,17,6,200
foscommentbundle,foscommentbundle,,0,0,1,0,3,1,4,1
aws-ecr,aws-ecr,,13,7,35,20,17,55,6,1
casbah,casbah,,1,0,2,1,3,3,1,1
ibm-connections,ibm-connections,,1,2,7,3,4,10,6,100
cleave,cleave,,0,3,1,3,4,4,1,200
faircom-db-sql,faircom-db-sql,,1,0,1,1,4,2,4,1
radiant,radiant,,0,0,0,0,1,0,0,1
xmlroot,xmlroot,,0,0,3,0,1,3,8,1
angular-material-5,angular-material-5,,4,1,18,5,126,23,1,1
ssh-config,ssh-config,,2,2,4,4,5,8,9,1
loginradius,loginradius,,0,0,1,0,1,1,9,1
msqc,msqc,,0,1,0,1,1,1,0,1
control-charts,control-charts,,1,6,1,7,4,8,0,500
nt-native-api,nt-native-api,,0,1,1,1,2,2,9,1
network-service,network-service,,1,0,2,1,2,3,8,1
nsdmanager,nsdmanager,,0,1,3,1,3,4,3,1
libigl,libigl,,4,1,4,5,5,9,9,1
type-accelerators,type-accelerators,,0,0,0,0,2,0,8,1
aescryptoserviceprovider,aescryptoserviceprovider,,0,0,3,0,2,3,6,1
maproute,maproute,,2,2,3,4,2,7,8,1
sceptre,sceptre,,1,0,0,1,6,1,6,1
clickbank,clickbank,,1,0,2,1,1,3,4,1
hibernate-tools,hibernate-tools,,2,4,4,6,8,10,3,100
wordpress.com,wordpress.com,,0,0,2,0,4,2,4,1
grails-spring-security,grails-spring-security,,2,2,2,4,4,6,3,1
volume-claim-template,volume-claim-template,,0,0,1,0,2,1,6,1
cfeclipse,cfeclipse,,0,0,0,0,1,0,3,1
hypertools,hypertools,,0,1,0,1,1,1,0,1
gapply,gapply,,0,0,0,0,2,0,2,1
coovachilli,coovachilli,,1,1,2,2,2,4,9,1
animate-on-scroll,animate-on-scroll,,6,2,4,8,3,12,1,1
fasd,fasd,,0,0,0,0,1,0,9,1
cacls,cacls,,0,0,2,0,1,2,9,1
spark-ec2,spark-ec2,,0,0,0,0,1,0,6,1
scrapyjs,scrapyjs,,0,0,0,0,1,0,0,1
oai-pmh,oai-pmh,,5,0,2,5,4,7,3,1
dnsimple,dnsimple,,0,0,0,0,4,0,4,1
felogin,felogin,,2,1,4,3,11,7,4,1
qtxml,qtxml,,1,0,2,1,1,3,9,1
lambdabot,lambdabot,,0,0,0,0,1,0,2,1
tx,tx,,0,1,3,1,4,4,9,1
distributed-apps,distributed-apps,,1,0,3,1,4,4,6,1
ibm-blockchain,ibm-blockchain,,17,15,56,32,78,88,6,1
codefluent,codefluent,,0,0,1,0,2,1,8,1
manipulators,manipulators,,0,4,2,4,3,6,9,300
column-major-order,column-major-order,,3,0,0,3,2,3,0,1
multidispatch,multidispatch,,0,0,1,0,2,1,9,1
js2-mode,js2-mode,,0,0,0,0,3,0,9,1
grunt-babel,grunt-babel,,0,0,0,0,4,0,1,1
teamspeak,teamspeak,,2,0,7,2,8,9,3,1
intrusive-containers,intrusive-containers,,0,0,2,0,1,2,9,1
joptimizer,joptimizer,,0,0,0,0,1,0,3,1
ib-api,ib-api,,3,6,3,9,3,12,0,100
ref-qualifier,ref-qualifier,,0,1,2,1,4,3,9,1
nxt,nxt,,0,0,5,0,4,5,0,1
surge.sh,surge.sh,,0,4,3,4,5,7,1,300
ejbscheduler,ejbscheduler,,1,0,0,1,1,1,3,1
spiffs,spiffs,,5,1,7,6,4,13,9,1
current-page,current-page,,0,1,0,1,2,1,1,1
openmq,openmq,,0,1,0,1,2,1,3,1
posiflex,posiflex,,0,0,0,0,1,0,3,1
hirb,hirb,,0,0,0,0,1,0,12,1
play-ws,play-ws,,3,1,3,4,3,7,2,1
c18,c18,,0,0,0,0,4,0,9,1
web-safe-fonts,web-safe-fonts,,0,0,1,0,2,1,1,1
sql-match-all,sql-match-all,,0,1,1,1,1,2,4,1
fuzzyfinder,fuzzyfinder,,0,0,0,0,2,0,9,1
herman,herman,,0,0,0,0,1,0,1,1
chef-attributes,chef-attributes,,0,0,1,0,3,1,12,1
cliptobounds,cliptobounds,,1,0,1,1,3,2,13,1
android-2.2-froyo,android-2.2-froyo,,0,0,0,0,2,0,3,1
mobile-robots,mobile-robots,,0,1,3,1,1,4,0,1
fieldeditor,fieldeditor,,0,1,1,1,1,2,3,1
tbitmap,tbitmap,,1,1,4,2,5,6,9,1
python-control,python-control,,0,0,2,0,1,2,0,1
html-xml-utils,html-xml-utils,,0,0,2,0,1,2,3,1
comdat-folding,comdat-folding,,0,0,0,0,1,0,9,1
setneedsdisplay,setneedsdisplay,,1,1,1,2,1,3,13,1
daemonset,daemonset,,3,5,8,8,3,16,6,66.666667
visual-web-developer-2010,visual-web-developer-2010,,2,0,1,2,2,3,1,1
dokku-alt,dokku-alt,,0,0,0,0,2,0,6,1
frappe,frappe,,9,2,3,11,3,14,9,1
perforce-stream,perforce-stream,,1,2,1,3,11,4,6,100
ruby-upgrade,ruby-upgrade,,0,0,1,0,1,1,12,1
graphical-programming,graphical-programming,,0,2,2,2,2,4,0,100
connect-modrewrite,connect-modrewrite,,0,0,0,0,2,0,1,1
kotlin-logging,kotlin-logging,,0,0,1,0,1,1,3,1
w3wp.exe,w3wp.exe,,0,2,2,2,3,4,8,100
sinch-verification,sinch-verification,,0,0,3,0,6,3,13,1
inotifydataerrorinfo,inotifydataerrorinfo,,0,1,2,1,4,3,8,1
dot.js,dot.js,,1,0,1,1,4,2,1,1
operationcontract,operationcontract,,1,0,2,1,3,3,8,1
php-closures,php-closures,,0,0,1,0,1,1,4,1
nscell,nscell,,0,1,0,1,2,1,13,1
http-status-code-100,http-status-code-100,,1,0,1,1,1,2,3,1
dfc,dfc,,1,1,1,2,5,3,16,1
documentum-dfc,documentum-dfc,,1,1,0,2,11,2,16,1
wsman,wsman,,0,1,1,1,2,2,8,1
webpack-production,webpack-production,,2,6,2,8,6,10,1,200
persistence-manager,persistence-manager,,0,1,0,1,2,1,3,1
contenttemplateselector,contenttemplateselector,,1,0,1,1,1,2,8,1
cakephp-2.9,cakephp-2.9,,0,1,3,1,4,4,4,1
shinobi,shinobi,,1,0,0,1,2,1,13,1
perms,perms,,0,0,0,0,1,0,9,1
swapfile,swapfile,,0,0,1,0,5,1,9,1
geoext,geoext,,0,1,0,1,1,1,1,1
flashmedialiveencoder,flashmedialiveencoder,,0,1,0,1,2,1,13,1
gulp-print,gulp-print,,0,0,0,0,2,0,1,1
libtomcrypt,libtomcrypt,,1,0,3,1,3,4,9,1
javahl,javahl,,0,0,0,0,1,0,3,1
foundation-icon-fonts-3,foundation-icon-fonts-3,,0,0,0,0,1,0,1,1
3d-rendering,3d-rendering,,0,0,6,0,8,6,0,1
concourse-git-resource,concourse-git-resource,,8,2,5,10,13,15,6,1
gwt-2.8,gwt-2.8,,0,0,0,0,2,0,3,1
grunt-ssh,grunt-ssh,,0,0,0,0,1,0,1,1
copywithzone,copywithzone,,0,0,0,0,1,0,13,1
midi-instrument,midi-instrument,,0,0,3,0,2,3,0,1
laravel-datatables,laravel-datatables,,5,5,11,10,2,21,4,1
cfdocument,cfdocument,,1,0,2,1,3,3,4,1
basic-msi,basic-msi,,1,0,1,1,3,2,8,1
lossy-compression,lossy-compression,,3,2,2,5,3,7,0,1
defaultview,defaultview,,0,0,3,0,1,3,8,1
scales-xml,scales-xml,,0,0,0,0,1,0,0,1
turnjs,turnjs,,0,0,2,0,4,2,1,1
r-table,r-table,,1,0,1,1,4,2,0,1
jsr-275,jsr-275,,0,0,1,0,1,1,3,1
txr,txr,,0,0,0,0,1,0,9,1
3dr,3dr,,1,0,1,1,3,2,0,1
complex-networks,complex-networks,,2,0,2,2,5,4,0,1
openbugs,openbugs,,1,3,3,4,3,7,0,200
django-filebrowser,django-filebrowser,,0,1,5,1,3,6,0,1
navigation-timing-api,navigation-timing-api,,2,1,4,3,2,7,1,1
hugin,hugin,,0,0,0,0,1,0,9,1
heap-profiling,heap-profiling,,2,1,5,3,3,8,9,1
google-prediction,google-prediction,,1,2,2,3,6,5,0,100
ws4j,ws4j,,0,0,0,0,3,0,3,1
puid,puid,,0,0,0,0,1,0,8,1
invokescript,invokescript,,0,0,1,0,2,1,8,1
colormatrix,colormatrix,,5,1,1,6,7,7,8,1
system.drawing.imaging,system.drawing.imaging,,4,0,0,4,5,4,8,1
paymentwall,paymentwall,,0,0,1,0,1,1,8,1
thread-specific-storage,thread-specific-storage,,0,0,0,0,2,0,9,1
gstring,gstring,,1,1,1,2,5,3,3,1
pardiso,pardiso,,1,2,1,3,1,4,0,100
iris-recognition,iris-recognition,,1,1,0,2,6,2,0,1
relative-date,relative-date,,1,0,0,1,1,1,4,1
formatr,formatr,,0,0,0,0,2,0,0,1
python-nvd3,python-nvd3,,0,0,2,0,3,2,1,1
trusted-execution-environment,trusted-execution-environment,,0,0,2,0,1,2,3,1
ethercat,ethercat,,2,1,2,3,1,5,9,1
primefaces-push,primefaces-push,,0,0,1,0,1,1,3,1
seqhmm,seqhmm,,0,1,3,1,2,4,0,1
interface-injection,interface-injection,,0,0,0,0,1,0,8,1
web-thread,web-thread,,1,1,0,2,3,2,13,1
dspace-ecu,dspace-ecu,,3,1,1,4,2,5,0,1
phantomjs-maven-plugin,phantomjs-maven-plugin,,0,0,0,0,1,0,3,1
sizehint,sizehint,,0,0,0,0,2,0,0,1
qidentityproxymodel,qidentityproxymodel,,0,0,1,0,2,1,0,1
boost-function,boost-function,,0,0,2,0,1,2,9,1
aweber,aweber,,0,2,1,2,7,3,4,100
topaz-signatures,topaz-signatures,,0,0,5,0,1,5,8,1
go-micro,go-micro,,1,3,11,4,10,15,6,200
radosgw,radosgw,,1,3,6,4,3,10,6,200
google-code,google-code,,1,3,1,4,3,5,3,200
samsung-galaxy-camera,samsung-galaxy-camera,,0,0,1,0,1,1,3,1
mysql2psql-gem,mysql2psql-gem,,0,0,0,0,1,0,6,1
iphone-accessory,iphone-accessory,,0,0,0,0,1,0,13,1
methodaccessexception,methodaccessexception,,0,0,1,0,2,1,8,1
google-protocol-buffer,google-protocol-buffer,,15,7,20,22,15,42,6,1
sly-scroller,sly-scroller,,0,0,2,0,1,2,1,1
openstack-api,openstack-api,,0,1,1,1,3,2,6,1
pluggable-database,pluggable-database,,1,1,2,2,2,4,4,1
gated-recurrent-unit,gated-recurrent-unit,,6,10,10,16,6,26,0,66.666667
angularjs-infdig,angularjs-infdig,,1,0,1,1,3,2,1,1
juel,juel,,0,0,3,0,2,3,3,1
allow-modals,allow-modals,,0,1,0,1,1,1,1,1
app-launcher,app-launcher,,1,1,7,2,5,9,3,1
jaotc,jaotc,,1,2,0,3,5,3,3,100
undelete,undelete,,0,0,1,0,2,1,9,1
inputbinding,inputbinding,,1,1,6,2,3,8,8,1
hfs+,hfs+,,3,1,3,4,3,7,13,1
circular-permutations,circular-permutations,,1,2,0,3,2,3,0,100
blacklight,blacklight,,1,0,1,1,1,2,12,1
asdf-vm,asdf-vm,,1,2,8,3,4,11,2,100
embedded-sql,embedded-sql,,1,1,2,2,11,4,4,1
stdhash,stdhash,,0,0,0,0,3,0,9,1
grounddb,grounddb,,0,0,0,0,1,0,1,1
thinktecture,thinktecture,,0,0,0,0,1,0,8,1
weakmap,weakmap,,1,0,3,1,6,4,1,1
web-maker,web-maker,,0,0,0,0,2,0,1,1
aws-elb,aws-elb,,13,12,26,25,35,51,6,1
dart-shelf,dart-shelf,,0,0,0,0,1,0,13,1
platypus,platypus,,6,1,4,7,6,11,0,1
principalsearcher,principalsearcher,,2,0,0,2,3,2,8,1
fastpdfkit,fastpdfkit,,0,0,0,0,1,0,13,1
package-manager-console,package-manager-console,,4,2,10,6,8,16,8,1
fiddle,fiddle,,0,2,0,2,9,2,12,100
kohana-3.2,kohana-3.2,,0,0,0,0,1,0,4,1
reportunit,reportunit,,0,0,1,0,1,1,3,1
phpagi,phpagi,,4,2,0,6,2,6,13,1
vsta,vsta,,1,1,0,2,4,2,4,1
regional,regional,,0,0,0,0,3,0,6,1
mt,mt,,1,1,1,2,2,3,9,1
federated,federated,,5,5,4,10,9,14,4,1
kraken.js,kraken.js,,1,0,0,1,3,1,1,1
executeprocesstask,executeprocesstask,,1,3,4,4,1,8,4,200
collabnet,collabnet,,0,3,5,3,5,8,6,200
go-sqlite3,go-sqlite3,,1,3,1,4,3,5,6,200
quadruple-precision,quadruple-precision,,0,0,1,0,2,1,9,1
yii2-urlmanager,yii2-urlmanager,,2,1,5,3,7,8,4,1
microsoft-graph-edu,microsoft-graph-edu,,1,1,9,2,10,11,8,1
grunt-string-replace,grunt-string-replace,,0,0,0,0,2,0,1,1
go-nsq,go-nsq,,0,0,0,0,1,0,6,1
vertical-sync,vertical-sync,,0,0,0,0,1,0,1,1
ibm-cloud-private-for-data,ibm-cloud-private-for-data,,0,0,4,0,1,4,6,1
cobol85,cobol85,,0,1,1,1,2,2,4,1
data-exchange,data-exchange,,0,1,1,1,3,2,4,1
uniwebview,uniwebview,,0,2,2,2,1,4,13,100
unchecked-conversion,unchecked-conversion,,1,0,2,1,4,3,3,1
redux-router,redux-router,,2,0,1,2,6,3,1,1
install-name-tool,install-name-tool,,2,0,0,2,3,2,13,1
dividebyzeroexception,dividebyzeroexception,,1,1,1,2,3,3,0,1
asp.net-4.6,asp.net-4.6,,2,0,1,2,6,3,8,1
stampit.js,stampit.js,,0,0,0,0,2,0,1,1
misaka,misaka,,0,0,2,0,3,2,0,1
django-hvad,django-hvad,,1,0,1,1,3,2,0,1
wacom,wacom,,0,1,7,1,15,8,1,1
sharpssh,sharpssh,,0,0,0,0,1,0,9,1
a2lix-translation,a2lix-translation,,0,1,1,1,1,2,4,1
assembly-resolution,assembly-resolution,,2,1,2,3,4,5,8,1
gesturelistener,gesturelistener,,0,0,1,0,1,1,3,1
smslib,smslib,,2,1,4,3,1,7,3,1
nsscroller,nsscroller,,2,0,0,2,3,2,13,1
gulp-if,gulp-if,,0,0,2,0,6,2,1,1
gulp-tap,gulp-tap,,0,0,0,0,1,0,1,1
respondstoselector,respondstoselector,,0,1,0,1,2,1,13,1
pysipp,pysipp,,0,1,0,1,1,1,13,1
libcmtd,libcmtd,,0,0,0,0,1,0,9,1
cassandra-jdbc,cassandra-jdbc,,0,0,2,0,1,2,2,1
csv-import,csv-import,,4,6,11,10,19,21,4,50
svn-api,svn-api,,0,0,0,0,1,0,8,1
signedness,signedness,,0,2,1,2,4,3,9,100
gradlefx,gradlefx,,0,0,1,0,1,1,13,1
voluptuous,voluptuous,,1,1,0,2,2,2,0,1
gpu-cooperative-groups,gpu-cooperative-groups,,0,0,3,0,2,3,0,1
kolab,kolab,,0,1,0,1,1,1,4,1
mongodb-mms,mongodb-mms,,0,0,1,0,2,1,1,1
unmanagedresources,unmanagedresources,,1,1,2,2,2,4,8,1
unrealscript,unrealscript,,1,0,0,1,1,1,3,1
focusable,focusable,,0,2,1,2,6,3,3,100
buttonbar,buttonbar,,0,0,1,0,1,1,1,1
qwebkit,qwebkit,,0,0,2,0,2,2,0,1
site.master,site.master,,0,1,3,1,3,4,8,1
duffs-device,duffs-device,,0,0,1,0,1,1,9,1
ssrf,ssrf,,1,1,1,2,1,3,3,1
sca,sca,,3,4,2,7,3,9,3,33.333333
deployment-descriptor,deployment-descriptor,,1,0,3,1,2,4,3,1
komodoedit,komodoedit,,0,0,5,0,4,5,0,1
radpdf,radpdf,,0,0,0,0,1,0,8,1
ogr2ogr,ogr2ogr,,1,8,7,9,11,16,0,700
social-tables,social-tables,,0,0,0,0,1,0,14,1
referential,referential,,0,1,0,1,2,1,0,1
tournament,tournament,,2,1,2,3,7,5,9,1
msitools,msitools,,0,0,0,0,3,0,8,1
buffer-overrun,buffer-overrun,,1,2,0,3,2,3,9,100
bluetoothadapter,bluetoothadapter,,1,2,3,3,2,6,3,100
bluetoothlescanner,bluetoothlescanner,,2,3,1,5,3,6,3,50
hp-nonstop,hp-nonstop,,2,1,6,3,6,9,3,1
tandem,tandem,,2,0,5,2,2,7,3,1
ibm-data-catalog,ibm-data-catalog,,0,0,0,0,1,0,0,1
xcglogger,xcglogger,,1,0,1,1,1,2,13,1
titanium-proxy,titanium-proxy,,0,0,0,0,1,0,8,1
facial-identification,facial-identification,,5,17,14,22,14,36,0,240
kendo-timepicker,kendo-timepicker,,1,0,3,1,3,4,1,1
max-pool-size,max-pool-size,,2,1,0,3,3,3,3,1
idbcommand,idbcommand,,0,0,0,0,1,0,4,1
wayfinder,wayfinder,,0,0,0,0,3,0,4,1
iotivity,iotivity,,1,1,3,2,2,5,13,1
siri-remote,siri-remote,,1,0,0,1,1,1,13,1
dbms-metadata,dbms-metadata,,3,1,0,4,2,4,4,1
facebook-tabs,facebook-tabs,,0,1,1,1,3,2,13,1
deepzoom,deepzoom,,1,0,3,1,2,4,1,1
seadragon,seadragon,,0,0,0,0,2,0,1,1
jaxb2-annotate-plugin,jaxb2-annotate-plugin,,2,0,0,2,3,2,3,1
xsoup,xsoup,,0,0,0,0,2,0,3,1
swiftycam,swiftycam,,0,1,2,1,5,3,13,1
in-call,in-call,,0,2,2,2,2,4,3,100
kapow,kapow,,1,1,0,2,1,2,8,1
multi-source-replication,multi-source-replication,,1,0,1,1,2,2,4,1
photoshop-sdk,photoshop-sdk,,0,0,1,0,1,1,1,1
ssms-17,ssms-17,,1,0,4,1,4,5,4,1
flexmojos,flexmojos,,1,0,0,1,4,1,13,1
flex-mojos,flex-mojos,,0,0,0,0,2,0,13,1
androidjunitrunner,androidjunitrunner,,1,2,2,3,3,5,3,100
xtemplate,xtemplate,,0,0,2,0,2,2,1,1
sakai,sakai,,4,0,2,4,4,6,3,1
pixel-shading,pixel-shading,,0,0,1,0,1,1,9,1
autodispose,autodispose,,0,0,1,0,1,1,3,1
react-redux-i18n,react-redux-i18n,,1,0,1,1,5,2,1,1
jquery-ui-timepicker,jquery-ui-timepicker,,0,0,0,0,2,0,1,1
option-infer,option-infer,,0,0,1,0,1,1,8,1
urlread,urlread,,0,0,0,0,1,0,0,1
jpath,jpath,,2,0,2,2,2,4,1,1
68hc11,68hc11,,1,1,0,2,1,2,9,1
config.json,config.json,,0,0,0,0,4,0,1,1
drf-haystack,drf-haystack,,1,1,0,2,2,2,0,1
happy,happy,,1,1,0,2,9,2,2,1
nscollectionviewflowlayout,nscollectionviewflowlayout,,0,0,1,0,3,1,13,1
android-enterprise,android-enterprise,,6,7,6,13,4,19,3,16.666667
netdatacontractserializer,netdatacontractserializer,,1,1,0,2,3,2,8,1
rapidfire-gem,rapidfire-gem,,0,0,0,0,1,0,12,1
setuservisiblehint,setuservisiblehint,,0,0,0,0,2,0,3,1
skimr,skimr,,1,1,1,2,4,3,0,1
swift4.1,swift4.1,,2,4,42,6,164,48,13,100
network-partitioning,network-partitioning,,1,0,3,1,2,4,0,1
deltaspike-jpa,deltaspike-jpa,,2,1,2,3,3,5,3,1
pynacl,pynacl,,4,0,4,4,1,8,0,1
abstract-action,abstract-action,,0,0,1,0,2,1,3,1
qgraphicsrectitem,qgraphicsrectitem,,1,0,4,1,7,5,9,1
callgrind,callgrind,,1,2,7,3,4,10,9,100
isomorphic-relay,isomorphic-relay,,0,0,0,0,1,0,1,1
mpns,mpns,,0,0,0,0,1,0,8,1
serverless-webpack-plugin,serverless-webpack-plugin,,0,1,5,1,6,6,6,1
ntpd,ntpd,,0,2,1,2,5,3,9,100
aptible,aptible,,0,0,1,0,4,1,6,1
associate,associate,,1,0,3,1,2,4,3,1
dojox.grid,dojox.grid,,4,1,6,5,11,11,1,1
likwid,likwid,,0,0,0,0,1,0,9,1
react-test-renderer,react-test-renderer,,12,8,16,20,14,36,1,1
gquery,gquery,,0,0,0,0,1,0,6,1
spark-checkpoint,spark-checkpoint,,3,5,2,8,5,10,2,66.666667
oci-java-sdk,oci-java-sdk,,15,1,0,16,6,16,4,1
fortran-coarrays,fortran-coarrays,,0,1,3,1,4,4,9,1
samd10,samd10,,0,0,0,0,2,0,9,1
mysqlupgrade,mysqlupgrade,,1,1,0,2,4,2,4,1
frozen-columns,frozen-columns,,1,0,1,1,3,2,1,1
jstatd,jstatd,,2,2,1,4,2,5,3,1
slim-pdo,slim-pdo,,0,0,0,0,2,0,4,1
mercurialeclipse,mercurialeclipse,,0,0,2,0,4,2,3,1
shared-primary-key,shared-primary-key,,0,0,2,0,1,2,4,1
google-email-settings-api,google-email-settings-api,,1,1,3,2,3,5,5,1
contextio,contextio,,0,0,0,0,2,0,4,1
genie,genie,,1,0,0,1,5,1,9,1
c++builder-xe6,c++builder-xe6,,0,0,1,0,2,1,9,1
eggplant,eggplant,,2,1,0,3,2,3,0,1
qtime,qtime,,0,1,2,1,3,3,9,1
achartengine,achartengine,,0,0,3,0,4,3,3,1
rackspace-cloudfiles,rackspace-cloudfiles,,2,3,1,5,3,6,4,50
columnattribute,columnattribute,,0,0,1,0,1,1,8,1
uimenuitem,uimenuitem,,1,2,2,3,3,5,13,100
gcc4.9,gcc4.9,,4,0,1,4,2,5,9,1
c-treeace,c-treeace,,0,0,1,0,8,1,4,1
faircom,faircom,,0,0,1,0,3,1,4,1
ctree,ctree,,3,2,10,5,10,15,0,1
terraform-provider-openstack,terraform-provider-openstack,,4,2,7,6,7,13,6,1
system-views,system-views,,1,1,2,2,5,4,4,1
pvpython,pvpython,,2,0,2,2,1,4,0,1
inproc,inproc,,0,1,1,1,2,2,8,1
nsenumerator,nsenumerator,,1,0,0,1,2,1,13,1
memory-overcommitment,memory-overcommitment,,0,2,2,2,2,4,9,100
estbeaconmanager,estbeaconmanager,,0,0,0,0,1,0,3,1
pf-datatable,pf-datatable,,0,2,7,2,11,9,3,100
oracle-ords,oracle-ords,,3,4,10,7,15,17,4,33.333333
security-scoped-bookmarks,security-scoped-bookmarks,,0,2,4,2,2,6,13,100
icedtea,icedtea,,0,3,5,3,1,8,3,200
thruway,thruway,,1,0,0,1,3,1,4,1
a-records,a-records,,1,4,8,5,5,13,4,300
serial-processing,serial-processing,,0,0,0,0,1,0,0,1
android-sdk-2.1,android-sdk-2.1,,1,1,0,2,4,2,3,1
soap-extension,soap-extension,,0,0,1,0,1,1,8,1
backgroundtaskidentifier,backgroundtaskidentifier,,1,0,0,1,1,1,13,1
jitsi-meet,jitsi-meet,,5,5,11,10,8,21,13,1
android-timer,android-timer,,4,1,5,5,9,10,3,1
kendo-dataviz,kendo-dataviz,,0,0,2,0,1,2,1,1
eel,eel,,5,5,0,10,1,10,0,1
microclimate,microclimate,,0,0,2,0,5,2,6,1
ibm-pcomm,ibm-pcomm,,1,2,1,3,3,4,8,100
grumpy,grumpy,,0,0,0,0,1,0,6,1
horizontallist,horizontallist,,1,1,2,2,5,4,13,1
knockout-binding-handlers,knockout-binding-handlers,,1,0,1,1,2,2,1,1
jconnect,jconnect,,4,2,3,6,3,9,3,1
requests-futures,requests-futures,,0,0,2,0,3,2,0,1
scripting-bridge,scripting-bridge,,2,2,0,4,2,4,13,1
demosaicing,demosaicing,,1,1,3,2,3,5,0,1
rc-shell,rc-shell,,1,0,1,1,1,2,9,1
mysql-error-2003,mysql-error-2003,,0,0,1,0,4,1,4,1
google-scholar,google-scholar,,6,5,5,11,8,16,0,1
subrepos,subrepos,,0,1,1,1,2,2,6,1
wcf-library,wcf-library,,0,1,0,1,1,1,8,1
boost-random,boost-random,,0,0,1,0,2,1,9,1
react-native-collapsible,react-native-collapsible,,2,1,3,3,1,6,1,1
nhibernate.search,nhibernate.search,,0,0,0,0,1,0,8,1
register-allocation,register-allocation,,0,0,7,0,4,7,9,1
cancelanimationframe,cancelanimationframe,,1,1,2,2,1,4,1,1
urlspan,urlspan,,0,1,1,1,3,2,3,1
gw-basic,gw-basic,,2,0,5,2,1,7,5,1
rentrez,rentrez,,1,1,2,2,4,4,0,1
methodinfo,methodinfo,,2,1,2,3,2,5,8,1
test-double,test-double,,1,1,1,2,1,3,3,1
circuit-diagram,circuit-diagram,,3,1,7,4,3,11,0,1
network-conduit,network-conduit,,1,0,1,1,2,2,2,1
docker-repository,docker-repository,,4,1,8,5,4,13,6,1
fcitx,fcitx,,0,0,2,0,2,2,9,1
build-variant,build-variant,,3,5,8,8,12,16,3,66.666667
disposable,disposable,,2,2,1,4,2,5,3,1
vue2-dropzone,vue2-dropzone,,1,3,7,4,8,11,1,200
fbjs,fbjs,,0,0,0,0,2,0,1,1
idx,idx,,2,0,4,2,3,6,4,1
custom-contextmenu,custom-contextmenu,,0,1,1,1,2,2,9,1
msvcr100.dll,msvcr100.dll,,0,0,0,0,2,0,8,1
msvcr120.dll,msvcr120.dll,,0,1,1,1,1,2,8,1
tablib,tablib,,1,2,2,3,3,5,0,100
colgroup,colgroup,,0,0,1,0,1,1,1,1
bluno,bluno,,2,0,0,2,4,2,3,1
self-healing,self-healing,,0,0,0,0,1,0,6,1
xml-1.1,xml-1.1,,0,0,0,0,2,0,3,1
patricia-trie,patricia-trie,,2,0,1,2,3,3,0,1
formats,formats,,0,0,0,0,3,0,8,1
location-based,location-based,,0,0,1,0,1,1,8,1
content-based-retrieval,content-based-retrieval,,0,0,2,0,2,2,0,1
neurolab,neurolab,,0,0,0,0,4,0,0,1
keter,keter,,0,0,3,0,2,3,2,1
informat,informat,,0,0,0,0,6,0,0,1
phped,phped,,0,0,0,0,2,0,6,1
ps3,ps3,,0,0,2,0,2,2,8,1
nsproxy,nsproxy,,0,1,0,1,3,1,13,1
typescript-linq,typescript-linq,,0,0,0,0,1,0,1,1
rdoc,rdoc,,0,0,0,0,8,0,12,1
django-leaflet,django-leaflet,,2,2,3,4,4,7,0,1
axacropdf,axacropdf,,2,1,1,3,3,4,8,1
recorder.js,recorder.js,,2,1,3,3,3,6,1,1
c++builder-6,c++builder-6,,5,3,4,8,13,12,9,1
batch-query,batch-query,,0,1,0,1,3,1,12,1
referenceproperty,referenceproperty,,0,0,0,0,1,0,6,1
tlf,tlf,,0,0,0,0,2,0,13,1
winsockets,winsockets,,2,2,0,4,6,4,9,1
swissqrbill,swissqrbill,,0,0,0,0,1,0,8,1
flutter-sliver,flutter-sliver,,38,41,54,79,29,133,13,7.894737
yii-form,yii-form,,0,0,0,0,4,0,4,1
nsis-plugin,nsis-plugin,,0,0,0,0,2,0,9,1
google-sites-2016,google-sites-2016,,1,2,9,3,4,12,1,100
website-payment-pro,website-payment-pro,,0,0,0,0,2,0,4,1
abide,abide,,1,1,2,2,2,4,1,1
foundation-abide,foundation-abide,,1,1,0,2,2,2,1,1
libsourcey,libsourcey,,1,0,2,1,4,3,9,1
restbed,restbed,,2,1,2,3,6,5,9,1
containerd,containerd,,1,2,8,3,6,11,6,100
tao-framework,tao-framework,,0,1,0,1,1,1,9,1
gamepad-api,gamepad-api,,4,1,6,5,4,11,8,1
region-ranging,region-ranging,,0,0,1,0,1,1,3,1
commonsware,commonsware,,0,0,0,0,2,0,3,1
google-api-objc-client,google-api-objc-client,,1,0,0,1,4,1,13,1
bespoke.js,bespoke.js,,0,0,0,0,1,0,4,1
whatwg-streams-api,whatwg-streams-api,,0,0,3,0,2,3,1,1
watchmaker,watchmaker,,0,0,0,0,3,0,9,1
plasmoid,plasmoid,,0,2,5,2,4,7,9,100
google-profiles-api,google-profiles-api,,1,0,0,1,4,1,5,1
rumbda,rumbda,,0,0,0,0,1,0,12,1
mendix,mendix,,8,3,2,11,3,13,1,1
ableton-live,ableton-live,,2,1,1,3,2,4,0,1
function-invocation,function-invocation,,0,0,0,0,1,0,1,1
vt100,vt100,,1,2,6,3,5,9,9,100
avvideocomposition,avvideocomposition,,2,3,8,5,10,13,13,50
plsql-package,plsql-package,,10,8,24,18,18,42,4,1
oracle-osm,oracle-osm,,0,0,0,0,1,0,3,1
introsort,introsort,,0,0,2,0,1,2,0,1
triangle-count,triangle-count,,0,0,3,0,2,3,9,1
raw-pointer,raw-pointer,,3,3,7,6,3,13,9,1
framebusting,framebusting,,0,0,2,0,2,2,1,1
reference-library,reference-library,,0,0,0,0,2,0,3,1
cocoonjs,cocoonjs,,1,0,1,1,2,2,1,1
silverlight-3.0,silverlight-3.0,,0,0,3,0,1,3,8,1
silverlight-toolkit,silverlight-toolkit,,0,0,1,0,2,1,8,1
mozrepl,mozrepl,,0,0,0,0,1,0,1,1
drupal-exposed-filter,drupal-exposed-filter,,0,1,1,1,1,2,4,1
swallowed-exceptions,swallowed-exceptions,,0,2,1,2,1,3,3,100
qt5.2,qt5.2,,0,0,0,0,2,0,9,1
hung,hung,,2,0,1,2,5,3,3,1
ng2-date-countdown,ng2-date-countdown,,0,0,0,0,1,0,1,1
fast-vector-highlighter,fast-vector-highlighter,,0,0,0,0,1,0,2,1
mpf,mpf,,0,1,1,1,2,2,8,1
qaxobject,qaxobject,,0,0,2,0,2,2,9,1
mdadm,mdadm,,0,1,3,1,2,4,9,1
kubernetes-deployment,kubernetes-deployment,,10,13,19,23,17,42,6,30
watson-studio,watson-studio,,14,11,26,25,34,51,6,1
ksort,ksort,,0,2,4,2,4,6,4,100
ansible-lint,ansible-lint,,0,1,1,1,2,2,6,1
tun-tap,tun-tap,,1,2,3,3,3,6,9,100
smallcaps,smallcaps,,0,0,0,0,2,0,3,1
qkeysequence,qkeysequence,,2,1,1,3,2,4,0,1
datecreated,datecreated,,0,0,2,0,2,2,4,1
vscode-debugger,vscode-debugger,,78,88,120,166,68,286,9,12.820513
ora-00942,ora-00942,,0,0,2,0,5,2,4,1
fileprovider-extension,fileprovider-extension,,3,0,15,3,7,18,13,1
enlive,enlive,,0,0,0,0,2,0,2,1
hydrotsm,hydrotsm,,0,0,0,0,3,0,0,1
mongodb.driver,mongodb.driver,,3,1,1,4,6,5,1,1
std-call-once,std-call-once,,1,2,1,3,1,4,9,100
epublib,epublib,,1,1,2,2,1,4,3,1
typehandler,typehandler,,1,0,1,1,2,2,3,1
dapper-fastcrud,dapper-fastcrud,,0,0,4,0,2,4,8,1
containable,containable,,0,0,1,0,2,1,4,1
chicagoboss,chicagoboss,,0,0,1,0,2,1,2,1
vaadin-upload,vaadin-upload,,1,1,3,2,1,5,1,1
uitextrange,uitextrange,,1,0,1,1,1,2,13,1
jasperstarter,jasperstarter,,1,1,0,2,1,2,3,1
ansible-pull,ansible-pull,,1,1,0,2,1,2,6,1
asp.net-core-logging,asp.net-core-logging,,2,1,1,3,5,4,8,1
hfs,hfs,,0,1,0,1,5,1,13,1
sbt-docker,sbt-docker,,0,0,1,0,2,1,2,1
swift-string,swift-string,,0,4,0,4,3,4,13,300
pynco,pynco,,0,1,2,1,2,3,0,1
shfileoperation,shfileoperation,,0,0,0,0,2,0,9,1
angular-component-life-cycle,angular-component-life-cycle,,1,5,2,6,8,8,1,400
kubernetes-ingress,kubernetes-ingress,,153,148,276,301,243,577,6,1
yii-validation,yii-validation,,0,0,0,0,2,0,4,1
pvclust,pvclust,,0,1,3,1,3,4,0,1
databags,databags,,3,1,2,4,8,6,12,1
devel-nytprof,devel-nytprof,,0,0,0,0,1,0,9,1
rxvt,rxvt,,0,1,2,1,2,3,9,1
mutation-events,mutation-events,,0,1,1,1,1,2,1,1
git-reflog,git-reflog,,2,1,3,3,8,6,6,1
drupal-contextual-filters,drupal-contextual-filters,,0,0,3,0,4,3,4,1
hardware-wallet,hardware-wallet,,0,0,0,0,4,0,6,1
ledger-nano-s,ledger-nano-s,,1,1,2,2,3,4,6,1
zset,zset,,1,0,1,1,2,2,3,1
skbio,skbio,,2,0,0,2,2,2,0,1
collection-radio-buttons,collection-radio-buttons,,0,2,0,2,2,2,12,100
kubernetes-statefulset,kubernetes-statefulset,,10,16,19,26,16,45,6,60
seven-segment-display,seven-segment-display,,0,3,3,3,4,6,9,200
perlapp,perlapp,,0,0,0,0,1,0,9,1
payout,payout,,3,1,8,4,5,12,4,1
namespace-organisation,namespace-organisation,,0,0,0,0,3,0,1,1
grav-plugin,grav-plugin,,0,0,0,0,1,0,4,1
rawbytestring,rawbytestring,,0,0,0,0,1,0,1,1
tilestache,tilestache,,0,1,0,1,2,1,1,1
maxby,maxby,,0,1,1,1,1,2,1,1
hxt,hxt,,0,0,3,0,7,3,2,1
invokeall,invokeall,,0,1,0,1,2,1,3,1
fastnetmon,fastnetmon,,0,0,0,0,1,0,6,1
parameter-list,parameter-list,,2,2,0,4,2,4,9,1
oniguruma,oniguruma,,2,2,2,4,2,6,0,1
ultracart,ultracart,,0,0,0,0,1,0,6,1
agora.io,agora.io,,12,20,24,32,7,56,3,66.666667
javonet,javonet,,0,0,0,0,2,0,3,1
wpf-4.5,wpf-4.5,,0,0,1,0,1,1,8,1
spherical-kmeans,spherical-kmeans,,2,2,1,4,1,5,0,1
getlatest,getlatest,,0,0,0,0,6,0,4,1
cakephp-routing,cakephp-routing,,1,1,1,2,3,3,4,1
covr,covr,,0,2,1,2,3,3,0,100
expectj,expectj,,1,1,0,2,1,2,3,1
system.web.http,system.web.http,,3,0,1,3,1,4,8,1
numeric-keypad,numeric-keypad,,1,2,0,3,5,3,13,100
dart-io,dart-io,,4,2,4,6,5,10,13,1
minimumosversion,minimumosversion,,0,1,0,1,1,1,13,1
angular-resolver,angular-resolver,,9,10,16,19,25,35,1,11.111111
peer-dependencies,peer-dependencies,,2,5,9,7,6,16,1,150
tfs-web-access,tfs-web-access,,0,0,1,0,2,1,8,1
data-segment,data-segment,,1,0,3,1,3,4,9,1
simple-authentication,simple-authentication,,0,0,1,0,1,1,12,1
emacs-jedi,emacs-jedi,,1,0,2,1,1,3,9,1
liquid-xml,liquid-xml,,0,1,2,1,3,3,3,1
azure-site-recovery,azure-site-recovery,,3,4,7,7,2,14,8,33.333333
predef,predef,,0,0,0,0,1,0,2,1
firepad,firepad,,1,0,7,1,3,8,13,1
duplicate-symbol,duplicate-symbol,,1,1,2,2,5,4,9,1
google-toolbox-for-mac,google-toolbox-for-mac,,0,0,0,0,3,0,13,1
daypilot,daypilot,,1,0,2,1,2,3,1,1
defaultifempty,defaultifempty,,1,1,2,2,2,4,8,1
hdc,hdc,,3,0,1,3,2,4,9,1
visual-studio-2008-sp1,visual-studio-2008-sp1,,0,1,3,1,2,4,8,1
custom-build-step,custom-build-step,,2,1,4,3,3,7,8,1
multi-instance-deployment,multi-instance-deployment,,3,0,1,3,1,4,8,1
codeplex,codeplex,,1,0,0,1,3,1,8,1
mvchtmlstring,mvchtmlstring,,0,1,1,1,2,2,8,1
fabric-answers,fabric-answers,,1,1,8,2,4,10,3,1
automation-for-jira,automation-for-jira,,0,0,0,0,1,0,6,1
postcss-cli,postcss-cli,,0,0,1,0,3,1,1,1
geoviews,geoviews,,3,6,5,9,7,14,0,100
facebook-custom-audience,facebook-custom-audience,,1,3,2,4,1,6,13,200
pstree,pstree,,0,0,4,0,1,4,9,1
texttrimming,texttrimming,,1,0,1,1,5,2,8,1
websphere-6.1,websphere-6.1,,0,0,0,0,1,0,3,1
unusernotification,unusernotification,,0,2,3,2,14,5,13,100
stripes,stripes,,2,1,0,3,4,3,3,1
realview,realview,,0,0,0,0,1,0,9,1
webauthn,webauthn,,15,14,18,29,5,47,6,1
episerver-10,episerver-10,,0,1,1,1,2,2,8,1
log-viewer,log-viewer,,0,2,0,2,3,2,4,100
u3d,u3d,,0,0,0,0,2,0,8,1
rawrepresentable,rawrepresentable,,1,0,1,1,3,2,13,1
ruby-style-guide,ruby-style-guide,,0,0,0,0,1,0,12,1
fuzz-testing,fuzz-testing,,1,0,1,1,2,2,9,1
gremlinjs,gremlinjs,,0,2,1,2,1,3,2,100
matisse,matisse,,2,0,0,2,3,2,3,1
nemerle,nemerle,,0,0,0,0,1,0,8,1
skinny-war,skinny-war,,0,0,0,0,2,0,3,1
mutating-function,mutating-function,,2,1,2,3,4,5,13,1
metpy,metpy,,3,3,6,6,7,12,0,1
pyinsane,pyinsane,,0,1,1,1,1,2,3,1
django-mailgun,django-mailgun,,0,1,1,1,3,2,4,1
cordova-facebook,cordova-facebook,,1,1,1,2,3,3,1,1
excel-iribbonui,excel-iribbonui,,0,1,0,1,2,1,5,1
android-ktx,android-ktx,,5,1,4,6,6,10,3,1
acrcloud,acrcloud,,0,1,1,1,7,2,3,1
configurationsection,configurationsection,,1,0,1,1,6,2,8,1
xmlworkerhelper,xmlworkerhelper,,1,2,1,3,2,4,8,100
git-completion,git-completion,,0,0,1,0,1,1,9,1
ssim,ssim,,6,5,7,11,1,18,0,1
ubuntu-12.10,ubuntu-12.10,,0,0,0,0,1,0,6,1
mvn-repo,mvn-repo,,3,3,8,6,9,14,3,1
asp-net-mvc-1,asp-net-mvc-1,,1,1,2,2,2,4,8,1
bugfender,bugfender,,0,0,1,0,1,1,13,1
magento-collection,magento-collection,,1,0,0,1,1,1,4,1
operf,operf,,0,0,0,0,1,0,9,1
shadow-removal,shadow-removal,,2,0,0,2,1,2,0,1
makepdf,makepdf,,0,0,0,0,2,0,1,1
compcert,compcert,,0,0,0,0,2,0,2,1
flexy-pool,flexy-pool,,0,0,1,0,1,1,3,1
money-php,money-php,,0,0,1,0,2,1,4,1
vpd,vpd,,0,1,1,1,2,2,4,1
viewanimator,viewanimator,,0,0,2,0,1,2,3,1
upsizing,upsizing,,0,0,0,0,1,0,5,1
wickedpicker,wickedpicker,,0,1,0,1,1,1,1,1
bwidget,bwidget,,0,0,0,0,1,0,0,1
stl-format,stl-format,,7,1,4,8,7,12,0,1
cordovawebview,cordovawebview,,0,0,2,0,2,2,1,1
gedmo-tree,gedmo-tree,,0,1,3,1,4,4,4,1
language-binding,language-binding,,1,2,2,3,1,5,9,100
python-bob,python-bob,,0,0,1,0,3,1,0,1
pcapdotnet,pcapdotnet,,1,1,0,2,1,2,8,1
iaik-jce,iaik-jce,,1,1,3,2,5,5,3,1
qsa,qsa,,0,0,0,0,1,0,4,1
robotjs,robotjs,,2,1,3,3,4,6,1,1
mkmaprect,mkmaprect,,1,0,0,1,2,1,13,1
visualstategroup,visualstategroup,,0,1,2,1,1,3,8,1
webkit-animation,webkit-animation,,0,0,0,0,3,0,1,1
itunesconnect-analytics,itunesconnect-analytics,,0,2,3,2,5,5,13,100
cgi.pm,cgi.pm,,0,0,2,0,5,2,9,1
ucp,ucp,,6,1,7,7,8,14,3,1
nscfnumber,nscfnumber,,0,0,0,0,2,0,13,1
simplygon,simplygon,,0,0,1,0,3,1,4,1
sat4j,sat4j,,1,0,0,1,2,1,3,1
postgis-raster,postgis-raster,,1,2,1,3,1,4,4,100
ocsigen,ocsigen,,0,0,1,0,2,1,0,1
getconstructor,getconstructor,,0,0,0,0,3,0,3,1
deploying,deploying,,4,7,7,11,9,18,1,75
mysql-error-1067,mysql-error-1067,,0,0,1,0,1,1,4,1
mdanalysis,mdanalysis,,0,0,1,0,3,1,0,1
elasticsearch-percolate,elasticsearch-percolate,,0,3,1,3,7,4,6,200
maven-nar-plugin,maven-nar-plugin,,0,0,1,0,2,1,3,1
jasonette,jasonette,,4,3,5,7,8,12,3,1
ora-01422,ora-01422,,0,0,0,0,2,0,4,1
collectioneditor,collectioneditor,,0,1,3,1,3,4,8,1
custom-collection,custom-collection,,0,0,1,0,1,1,8,1
xemacs,xemacs,,0,0,0,0,1,0,9,1
jpbc,jpbc,,3,1,1,4,2,5,6,1
custom-server-controls,custom-server-controls,,0,0,0,0,1,0,1,1
btrieve,btrieve,,0,0,2,0,2,2,4,1
optionparser,optionparser,,0,1,3,1,5,4,0,1
ufront,ufront,,0,0,0,0,1,0,9,1
sve,sve,,0,0,2,0,1,2,9,1
thekofclient,thekofclient,,0,0,0,0,1,0,4,1
invokerequired,invokerequired,,0,2,1,2,1,3,8,100
static-allocation,static-allocation,,1,0,2,1,2,3,9,1
linkmovementmethod,linkmovementmethod,,1,0,1,1,5,2,3,1
servr,servr,,0,0,0,0,1,0,0,1
testing-support-library,testing-support-library,,0,0,0,0,1,0,3,1
propertysheet,propertysheet,,1,0,6,1,3,7,9,1
servlet-mapping,servlet-mapping,,1,0,5,1,5,6,3,1
cryptprotectdata,cryptprotectdata,,0,0,0,0,1,0,0,1
goose,goose,,0,1,3,1,5,4,0,1
highcharts-editor,highcharts-editor,,0,1,2,1,2,3,1,1
jcuda,jcuda,,1,3,3,4,4,7,3,200
preg-quote,preg-quote,,1,1,0,2,2,2,4,1
numeric-input,numeric-input,,3,1,2,4,4,6,0,1
threaded-comments,threaded-comments,,0,0,3,0,2,3,0,1
array-reverse,array-reverse,,2,0,1,2,2,3,4,1
flexible-type,flexible-type,,0,1,0,1,1,1,0,1
smart-quotes,smart-quotes,,0,0,0,0,1,0,13,1
readwritelock,readwritelock,,2,2,3,4,7,7,3,1
usb-flash-drive,usb-flash-drive,,1,2,7,3,3,10,9,100
echodot,echodot,,0,0,1,0,2,1,6,1
tnef,tnef,,0,0,1,0,1,1,5,1
xamgrid,xamgrid,,0,0,0,0,2,0,8,1
socketmobile,socketmobile,,1,3,2,4,2,6,3,200
sjson,sjson,,0,0,0,0,1,0,4,1
qaudiorecorder,qaudiorecorder,,1,0,0,1,1,1,9,1
nullablereferencetypes,nullablereferencetypes,,7,9,12,16,2,28,8,28.571429
gevent-socketio,gevent-socketio,,0,0,1,0,3,1,0,1
python-socketio,python-socketio,,2,10,4,12,6,16,0,400
ndde,ndde,,0,1,3,1,1,4,8,1
propertybag,propertybag,,0,0,0,0,2,0,8,1
coefplot,coefplot,,1,2,1,3,6,4,0,100
multicastdelegate,multicastdelegate,,0,2,0,2,2,2,13,100
jacl,jacl,,0,0,2,0,3,2,3,1
floating-action-menu,floating-action-menu,,0,2,0,2,3,2,3,100
lsb,lsb,,2,2,0,4,3,4,9,1
servicestack-auth,servicestack-auth,,1,0,0,1,5,1,8,1
hugo-logging,hugo-logging,,0,1,0,1,2,1,3,1
wsdl2php,wsdl2php,,0,0,0,0,1,0,4,1
datamatrix,datamatrix,,5,6,9,11,8,20,3,20
zohobooks,zohobooks,,3,1,1,4,3,5,4,1
system-dependent,system-dependent,,0,0,0,0,1,0,9,1
logary,logary,,0,0,0,0,2,0,8,1
upvar,upvar,,0,0,1,0,1,1,0,1
entrypointnotfoundexcept,entrypointnotfoundexcept,,0,0,1,0,1,1,8,1
schema-migration,schema-migration,,2,1,3,3,2,6,4,1
iad,iad,,0,0,1,0,1,1,13,1
stealjs,stealjs,,0,1,0,1,3,1,1,1
typescript2.7,typescript2.7,,0,0,1,0,5,1,1,1
detailtextlabel,detailtextlabel,,1,0,0,1,1,1,13,1
sqlite2,sqlite2,,1,0,0,1,1,1,1,1
boost-spirit-karma,boost-spirit-karma,,0,0,2,0,1,2,9,1
conf.d,conf.d,,0,0,1,0,1,1,6,1
com0com,com0com,,0,0,0,0,3,0,8,1
cassandra-node-driver,cassandra-node-driver,,0,0,1,0,1,1,2,1
autorelease,autorelease,,1,0,1,1,4,2,13,1
msscci,msscci,,0,0,0,0,2,0,8,1
cachedrowset,cachedrowset,,0,1,1,1,3,2,3,1
gradle-release-plugin,gradle-release-plugin,,2,2,4,4,8,8,3,1
system2,system2,,1,2,1,3,2,4,0,100
clair,clair,,0,5,4,5,5,9,6,400
linear-types,linear-types,,0,0,0,0,2,0,9,1
process-explorer,process-explorer,,0,4,3,4,1,7,9,300
read-replication,read-replication,,0,0,1,0,1,1,6,1
coveralls,coveralls,,4,3,9,7,10,16,6,1
kevent,kevent,,0,0,0,0,2,0,9,1
tryton,tryton,,0,4,0,4,3,4,6,300
sosex,sosex,,0,0,3,0,2,3,9,1
derbyjs,derbyjs,,0,0,1,0,1,1,1,1
racerjs,racerjs,,0,0,1,0,1,1,1,1
scatterview,scatterview,,0,0,0,0,1,0,8,1
merit-gem,merit-gem,,0,1,3,1,7,4,12,1
twilio-video,twilio-video,,6,11,17,17,14,34,13,83.333333
deep-web,deep-web,,0,0,0,0,1,0,2,1
websphere-9,websphere-9,,8,8,5,16,11,21,3,1
amp-mustache,amp-mustache,,1,1,6,2,8,8,1,1
tfs-analysis,tfs-analysis,,0,0,2,0,1,2,8,1
lejos-nxj,lejos-nxj,,2,0,7,2,1,9,3,1
rbtools,rbtools,,0,0,0,0,1,0,6,1
impressions,impressions,,1,1,2,2,2,4,3,1
hellosign,hellosign,,0,2,1,2,10,3,4,100
hellosign-api,hellosign-api,,0,1,3,1,9,4,4,1
grammar-kit,grammar-kit,,2,2,2,4,2,6,3,1
librt,librt,,1,1,0,2,1,2,9,1
procstat,procstat,,2,2,1,4,2,5,6,1
backbarbuttonitem,backbarbuttonitem,,0,0,4,0,3,4,13,1
ghostdoc,ghostdoc,,0,0,5,0,2,5,8,1
sbt-sonatype,sbt-sonatype,,0,1,2,1,2,3,2,1
scala-version-cross-build,scala-version-cross-build,,0,0,1,0,2,1,2,1
android-measure,android-measure,,0,1,1,1,3,2,3,1
srcsrv,srcsrv,,0,0,0,0,1,0,8,1
lazy-high-charts,lazy-high-charts,,1,0,1,1,2,2,12,1
fastscroll,fastscroll,,0,1,3,1,7,4,3,1
penetration-tools,penetration-tools,,2,3,2,5,8,7,4,50
programming-pearls,programming-pearls,,0,1,2,1,2,3,0,1
apiman,apiman,,4,1,4,5,3,9,3,1
access-synchronization,access-synchronization,,0,0,0,0,1,0,3,1
ssp,ssp,,0,2,2,2,2,4,4,100
js-routes,js-routes,,0,1,1,1,1,2,1,1
mentionapp,mentionapp,,0,0,0,0,1,0,13,1
eyecon-plugin,eyecon-plugin,,0,0,0,0,1,0,1,1
nsapptransportsecurity,nsapptransportsecurity,,2,0,1,2,5,3,13,1
data-transform,data-transform,,10,7,10,17,25,27,0,1
modbus-tk,modbus-tk,,0,0,3,0,3,3,0,1
xodus,xodus,,4,6,12,10,16,22,3,50
bimap,bimap,,1,1,2,2,6,4,9,1
git-mirror,git-mirror,,3,1,3,4,2,7,6,1
uisplitview,uisplitview,,1,1,0,2,2,2,13,1
odf,odf,,0,0,0,0,2,0,3,1
odftoolkit,odftoolkit,,0,1,2,1,3,3,3,1
hg-git,hg-git,,2,1,1,3,2,4,6,1
syncfx,syncfx,,0,0,1,0,1,1,8,1
javafx-packager,javafx-packager,,0,0,1,0,2,1,3,1
drupal-render,drupal-render,,0,0,0,0,1,0,4,1
defense4all,defense4all,,0,0,0,0,1,0,9,1
kadanes-algorithm,kadanes-algorithm,,1,0,5,1,6,6,0,1
opendocument,opendocument,,1,1,1,2,4,3,5,1
dockable-windows,dockable-windows,,0,0,0,0,1,0,8,1
dmx512,dmx512,,2,3,1,5,3,6,9,50
oracle-warehouse-builder,oracle-warehouse-builder,,0,0,0,0,2,0,4,1
ripplejs,ripplejs,,0,0,1,0,2,1,1,1
virtualstore,virtualstore,,0,0,0,0,1,0,8,1
nstextcontainer,nstextcontainer,,2,2,0,4,2,4,13,1
javac-compiler-plugin,javac-compiler-plugin,,0,0,0,0,1,0,3,1
kibana-6,kibana-6,,21,19,75,40,40,115,6,1
.net-standard-1.6,.net-standard-1.6,,0,0,0,0,1,0,8,1
128-bit,128-bit,,0,3,3,3,3,6,9,200
horizontallistview,horizontallistview,,0,1,0,1,1,1,13,1
.git-info-grafts,.git-info-grafts,,0,0,0,0,1,0,6,1
j8583,j8583,,1,0,2,1,3,3,3,1
command-query-separation,command-query-separation,,0,1,2,1,3,3,8,1
httpservice,httpservice,,2,0,3,2,5,5,1,1
devil,devil,,1,0,0,1,2,1,9,1
stb-image,stb-image,,3,4,7,7,9,14,9,33.333333
rogue-wave,rogue-wave,,1,0,1,1,1,2,9,1
spatialpack,spatialpack,,0,0,0,0,1,0,0,1
adhoc-polymorphism,adhoc-polymorphism,,0,4,3,4,2,7,2,300
instance-method,instance-method,,0,0,1,0,2,1,0,1
ios-app-signing,ios-app-signing,,1,0,2,1,3,3,13,1
unnamed-class,unnamed-class,,1,0,1,1,1,2,9,1
algorithm-animation,algorithm-animation,,6,0,0,6,1,6,0,1
formatdatetime,formatdatetime,,2,2,2,4,11,6,1,1
jqmigrate,jqmigrate,,0,0,0,0,3,0,1,1
rxcpp,rxcpp,,2,2,3,4,4,7,9,1
xml-editor,xml-editor,,0,0,3,0,3,3,3,1
playcanvas,playcanvas,,0,0,3,0,6,3,1,1
category-abstractions,category-abstractions,,6,2,1,8,3,9,2,1
rootpy,rootpy,,0,0,1,0,2,1,0,1
primeng-treetable,primeng-treetable,,3,3,19,6,12,25,1,1
scalajs-react,scalajs-react,,4,1,3,5,6,8,2,1
scngeometry,scngeometry,,1,2,2,3,3,5,13,100
kubernetes-apiserver,kubernetes-apiserver,,8,9,18,17,11,35,6,12.5
eda,eda,,1,5,1,6,6,7,0,400
angular-ui-tinymce,angular-ui-tinymce,,1,0,0,1,3,1,1,1
groebner-basis,groebner-basis,,0,0,0,0,1,0,0,1
gideros,gideros,,0,0,0,0,5,0,9,1
ri,ri,,0,0,0,0,2,0,12,1
kotlin-frontend,kotlin-frontend,,0,0,2,0,3,2,3,1
super-columns,super-columns,,0,0,0,0,1,0,2,1
facebook-graph-api-v2.6,facebook-graph-api-v2.6,,0,0,0,0,1,0,13,1
hopscotch,hopscotch,,0,0,1,0,2,1,1,1
gpu-overdraw,gpu-overdraw,,1,0,0,1,2,1,3,1
latte,latte,,1,0,0,1,2,1,1,1
w3m,w3m,,2,1,1,3,2,4,9,1
harvest,harvest,,1,1,1,2,6,3,0,1
cgcontextref,cgcontextref,,0,0,0,0,2,0,13,1
libnotify,libnotify,,0,1,1,1,3,2,9,1
pytest-selenium,pytest-selenium,,1,0,0,1,5,1,0,1
itanium,itanium,,2,0,0,2,2,2,9,1
baker-framework,baker-framework,,0,0,0,0,2,0,4,1
cson,cson,,0,1,1,1,4,2,0,1
clasp,clasp,,9,5,12,14,7,26,5,1
msal.js,msal.js,,14,23,30,37,18,67,8,64.285714
named-captures,named-captures,,3,0,2,3,2,5,0,1
cryptanalysis,cryptanalysis,,2,1,2,3,1,5,0,1
modifier-key,modifier-key,,2,0,3,2,5,5,13,1
pep448,pep448,,1,0,0,1,1,1,0,1
teigha,teigha,,0,0,0,0,2,0,8,1
gigaspaces,gigaspaces,,0,0,0,0,2,0,4,1
dvd-burning,dvd-burning,,1,2,2,3,2,5,8,100
cd-burning,cd-burning,,0,0,0,0,1,0,8,1
nstablerowview,nstablerowview,,0,1,1,1,3,2,13,1
perfino,perfino,,0,0,0,0,1,0,3,1
sonicmq,sonicmq,,0,0,0,0,1,0,3,1
sonic,sonic,,0,0,0,0,1,0,3,1
autoflush,autoflush,,1,1,0,2,3,2,3,1
brill-tagger,brill-tagger,,0,0,0,0,2,0,0,1
d3.js-lasso,d3.js-lasso,,0,0,1,0,3,1,1,1
hbase-shell,hbase-shell,,3,1,7,4,6,11,2,1
deltaxml,deltaxml,,0,0,0,0,2,0,3,1
root-node,root-node,,0,1,3,1,4,4,13,1
systemjs-builder,systemjs-builder,,0,0,3,0,2,3,1,1
elastislide,elastislide,,0,0,0,0,1,0,1,1
automoc,automoc,,0,1,1,1,1,2,9,1
ora-03113,ora-03113,,0,1,1,1,1,2,4,1
ora-03114,ora-03114,,0,0,0,0,1,0,4,1
wkb,wkb,,0,2,7,2,1,9,0,100
stalestateexception,stalestateexception,,0,0,0,0,1,0,3,1
sage-line-50,sage-line-50,,1,0,1,1,1,2,0,1
gtkassistant,gtkassistant,,0,0,0,0,2,0,9,1
ebs-payment,ebs-payment,,0,0,0,0,1,0,3,1
aba,aba,,0,0,0,0,3,0,9,1
blaze-html,blaze-html,,0,0,1,0,2,1,2,1
question-answering,question-answering,,9,3,5,12,13,17,0,1
splice-machine,splice-machine,,0,3,1,3,1,4,2,200
papermill,papermill,,10,3,3,13,1,16,0,1
winrt-component,winrt-component,,0,5,2,5,7,7,8,400
dirty-data,dirty-data,,0,0,2,0,3,2,3,1
grover,grover,,1,0,0,1,1,1,0,1
netfs,netfs,,0,0,0,0,1,0,9,1
nchar,nchar,,0,1,3,1,3,4,0,1
thawte,thawte,,0,0,0,0,1,0,13,1
shen,shen,,0,0,0,0,1,0,2,1
bigloo,bigloo,,0,0,0,0,1,0,0,1
angular-dynamic-components,angular-dynamic-components,,19,15,37,34,12,71,1,1
.net-core-logging,.net-core-logging,,2,0,1,2,5,3,8,1
excelbuilder.js,excelbuilder.js,,0,0,0,0,3,0,1,1
stack-machine,stack-machine,,0,1,0,1,2,1,9,1
common-controls,common-controls,,3,3,4,6,2,10,9,1
vue-rx,vue-rx,,1,1,1,2,2,3,1,1
nest-thermostat,nest-thermostat,,2,0,2,2,1,4,4,1
whirlpool,whirlpool,,0,0,0,0,1,0,6,1
url-fragment,url-fragment,,0,1,4,1,2,5,4,1
implicit-class,implicit-class,,0,1,0,1,4,1,2,1
disclosure,disclosure,,1,1,0,2,1,2,13,1
google-cloud-dlp,google-cloud-dlp,,2,1,4,3,15,7,6,1
zen-cart,zen-cart,,3,0,5,3,2,8,4,1
spring-security-saml2,spring-security-saml2,,10,6,7,16,14,23,3,1
mpmediaquery,mpmediaquery,,1,4,7,5,5,12,13,300
tilde-expansion,tilde-expansion,,0,0,3,0,3,3,9,1
npm-debug,npm-debug,,3,1,1,4,2,5,6,1
typescript2.3,typescript2.3,,0,0,0,0,2,0,1,1
speechsynthesizer,speechsynthesizer,,3,1,4,4,3,8,8,1
pay-per-click,pay-per-click,,1,0,0,1,2,1,4,1
opacitymask,opacitymask,,1,0,3,1,3,4,8,1
nsnetservice,nsnetservice,,1,0,1,1,5,2,13,1
runtime-type,runtime-type,,1,0,0,1,2,1,3,1
valet,valet,,7,12,16,19,11,35,4,71.428571
audiobuffer,audiobuffer,,3,4,1,7,8,8,13,33.333333
toisostring,toisostring,,0,1,0,1,2,1,1,1
google-groups-settings,google-groups-settings,,0,1,1,1,3,2,5,1
freezegun,freezegun,,4,1,1,5,3,6,0,1
expired-cookies,expired-cookies,,0,2,2,2,1,4,4,100
bb-messenger,bb-messenger,,0,0,1,0,1,1,13,1
enduro.js,enduro.js,,0,0,2,0,4,2,1,1
black-box,black-box,,1,3,4,4,4,8,0,200
management-pack,management-pack,,0,0,0,0,3,0,8,1
act,act,,0,0,0,0,2,0,8,1
pry-rails,pry-rails,,1,0,2,1,5,3,12,1
pylatex,pylatex,,4,5,6,9,4,15,0,25
elasticsearch-phonetic,elasticsearch-phonetic,,0,2,2,2,1,4,6,100
jmeter-analysis-maven-plugin,jmeter-analysis-maven-plugin,,0,0,0,0,1,0,3,1
screen-grab,screen-grab,,0,0,2,0,2,2,3,1
htmltidy,htmltidy,,0,1,3,1,6,4,0,1
android-virtual-keyboard,android-virtual-keyboard,,1,3,1,4,2,5,3,200
toeplitz,toeplitz,,1,2,0,3,1,3,0,100
split-screen-multitasking,split-screen-multitasking,,2,2,1,4,4,5,3,1
haskero,haskero,,0,0,1,0,3,1,2,1
angular-dart-routing,angular-dart-routing,,2,2,9,4,10,13,13,1
cordova-windows,cordova-windows,,1,2,1,3,3,4,1,100
cocoa-design-patterns,cocoa-design-patterns,,0,0,1,0,4,1,13,1
continuation-local-storag,continuation-local-storag,,0,0,1,0,3,1,1,1
blackboard,blackboard,,4,1,4,5,3,9,4,1
xdocreport,xdocreport,,3,3,5,6,5,11,3,1
ruby-saml,ruby-saml,,0,2,1,2,3,3,8,100
bert-toolkit,bert-toolkit,,1,2,0,3,9,3,5,100
d-star,d-star,,0,2,0,2,2,2,0,100
vbc,vbc,,0,0,0,0,2,0,8,1
boost-format,boost-format,,1,0,2,1,1,3,9,1
makefile-project,makefile-project,,1,2,3,3,7,6,9,100
amp-stories,amp-stories,,2,3,2,5,10,7,1,50
force-ide,force-ide,,0,0,1,0,2,1,14,1
winbugs14,winbugs14,,0,1,2,1,5,3,0,1
dx,dx,,2,2,4,4,4,8,3,1
regexkitlite,regexkitlite,,0,1,0,1,1,1,13,1
visualworks,visualworks,,2,0,0,2,7,2,13,1
significant-terms,significant-terms,,0,2,1,2,3,3,6,100
android-actionbaractivity,android-actionbaractivity,,1,0,1,1,2,2,3,1
index-sequence,index-sequence,,0,1,0,1,2,1,9,1
lookbackapi,lookbackapi,,1,1,2,2,4,4,3,1
drupal-views-relationship,drupal-views-relationship,,0,1,0,1,2,1,4,1
catch-all,catch-all,,1,2,0,3,2,3,3,100
banshee,banshee,,1,0,0,1,1,1,9,1
hocr,hocr,,0,4,2,4,3,6,0,300
kcachegrind,kcachegrind,,2,2,3,4,2,7,9,1
libsoup,libsoup,,0,0,1,0,1,1,6,1
websharper.ui.next,websharper.ui.next,,1,0,1,1,3,2,8,1
boost-pool,boost-pool,,1,0,0,1,3,1,9,1
treq,treq,,0,0,0,0,1,0,0,1
langohr,langohr,,0,0,1,0,1,1,3,1
nodist,nodist,,0,2,0,2,1,2,1,100
gcc-4.2,gcc-4.2,,0,0,0,0,1,0,9,1
ora-00905,ora-00905,,1,0,0,1,2,1,4,1
o365rwsclient,o365rwsclient,,1,0,3,1,2,4,8,1
samd21,samd21,,0,0,4,0,4,4,9,1
structure-packing,structure-packing,,0,1,1,1,2,2,9,1
qlocalsocket,qlocalsocket,,1,0,1,1,1,2,9,1
apprequests,apprequests,,0,2,2,2,4,4,4,100
shouldly,shouldly,,0,0,2,0,3,2,8,1
reflex-dom,reflex-dom,,1,4,2,5,5,7,2,300
jaggery-js,jaggery-js,,0,0,0,0,3,0,14,1
apache-shindig,apache-shindig,,1,0,0,1,1,1,14,1
logged,logged,,0,2,6,2,7,8,4,100
angular-errorhandler,angular-errorhandler,,6,0,7,6,12,13,1,1
easyadmin,easyadmin,,24,9,35,33,21,68,4,1
visual-studio-2019,visual-studio-2019,,379,538,38,917,3,955,8,41.952507
cookie-path,cookie-path,,0,0,0,0,3,0,4,1
couchdbkit,couchdbkit,,0,0,0,0,2,0,0,1
jsc3d,jsc3d,,0,0,0,0,1,0,0,1
superview,superview,,2,0,5,2,4,7,13,1
heideltime,heideltime,,1,0,0,1,1,1,3,1
hyperbolic-function,hyperbolic-function,,2,2,1,4,1,5,0,1
versioninfo,versioninfo,,1,1,2,2,2,4,9,1
audit.net,audit.net,,8,3,12,11,11,23,8,1
histogrammar,histogrammar,,0,0,0,0,1,0,2,1
snap-to-grid,snap-to-grid,,1,0,1,1,1,2,1,1
project-layout,project-layout,,2,1,0,3,1,3,3,1
appirater,appirater,,0,0,0,0,1,0,13,1
sicstus-prolog,sicstus-prolog,,1,6,3,7,1,10,0,500
default-implementation,default-implementation,,0,0,3,0,3,3,9,1
atata,atata,,2,3,4,5,12,9,8,50
rsvg,rsvg,,5,2,2,7,4,9,0,1
azure-public-ip,azure-public-ip,,1,1,3,2,6,5,8,1
programdata,programdata,,0,0,2,0,3,2,8,1
semantic-zoom,semantic-zoom,,0,1,1,1,2,2,8,1
generic.xaml,generic.xaml,,0,1,1,1,2,2,8,1
funq,funq,,0,0,1,0,2,1,8,1
reader-macro,reader-macro,,1,0,1,1,2,2,0,1
niagara-ax,niagara-ax,,0,1,1,1,2,2,3,1
osmbonuspack,osmbonuspack,,5,3,5,8,4,13,3,1
pyad,pyad,,3,2,5,5,6,10,0,1
merge-base,merge-base,,0,1,0,1,3,1,6,1
reloadrows,reloadrows,,0,2,1,2,5,3,13,100
rose-diagram,rose-diagram,,0,1,1,1,4,2,0,1
qwidgetaction,qwidgetaction,,0,1,1,1,2,2,0,1
tigris,tigris,,0,2,5,2,4,7,0,100
security-context-token,security-context-token,,0,0,0,0,1,0,4,1
plotly.js,plotly.js,,38,43,62,81,49,143,0,13.157895
jawt,jawt,,0,0,0,0,1,0,3,1
bankers-rounding,bankers-rounding,,0,0,0,0,3,0,0,1
ui4j,ui4j,,2,1,0,3,1,3,3,1
osmnx,osmnx,,26,21,32,47,11,79,0,1
sttwitter,sttwitter,,0,0,0,0,1,0,13,1
rangeseekbar,rangeseekbar,,2,0,0,2,4,2,3,1
mixlib-shellout,mixlib-shellout,,0,0,0,0,2,0,12,1
hkdf,hkdf,,2,0,0,2,2,2,6,1
indefinite,indefinite,,0,1,1,1,2,2,0,1
uml-eclipse-plugin,uml-eclipse-plugin,,0,0,0,0,1,0,3,1
glrotate,glrotate,,1,0,1,1,1,2,9,1
dto-mapping,dto-mapping,,0,0,0,0,1,0,1,1
exponential-distribution,exponential-distribution,,2,1,3,3,7,6,0,1
react-final-form-arrays,react-final-form-arrays,,2,4,7,6,5,13,1,100
step-into,step-into,,2,0,0,2,1,2,5,1
page-setup,page-setup,,3,1,3,4,2,7,5,1
apache-httpclient-5.x,apache-httpclient-5.x,,2,0,5,2,6,7,3,1
oracle-rac,oracle-rac,,0,1,8,1,1,9,4,1
jobintentservice,jobintentservice,,16,7,23,23,30,46,3,1
netbeans-8.1,netbeans-8.1,,0,0,0,0,2,0,3,1
perfview,perfview,,2,4,4,6,4,10,8,100
activity-tracing,activity-tracing,,0,0,0,0,2,0,8,1
aikau,aikau,,0,3,1,3,4,4,3,200
sqlcode,sqlcode,,5,1,4,6,2,10,4,1
alexa-for-business,alexa-for-business,,0,0,2,0,2,2,6,1
fabricator,fabricator,,1,0,0,1,2,1,12,1
libcurl.net,libcurl.net,,0,0,1,0,1,1,4,1
contentproviderclient,contentproviderclient,,0,0,1,0,1,1,3,1
suppressfinalize,suppressfinalize,,0,0,0,0,1,0,8,1
integrated-security,integrated-security,,0,0,1,0,4,1,4,1
html-components,html-components,,0,0,0,0,1,0,1,1
zero-initialization,zero-initialization,,1,0,2,1,2,3,9,1
360-panorama-viewer,360-panorama-viewer,,1,0,2,1,2,3,8,1
unbox,unbox,,1,2,1,3,1,4,6,100
reasonml,reasonml,,0,0,0,0,6,0,9,1
xmodmap,xmodmap,,2,0,2,2,3,4,9,1
jwindow,jwindow,,0,1,1,1,2,2,3,1
moquette,moquette,,0,1,1,1,3,2,6,1
data-dump,data-dump,,0,0,1,0,1,1,4,1
wcf-wshttpbinding,wcf-wshttpbinding,,0,0,1,0,2,1,8,1
android-jetpack,android-jetpack,,149,108,260,257,199,517,3,1
gettickcount,gettickcount,,0,0,0,0,1,0,9,1
dll-search-path,dll-search-path,,0,0,1,0,1,1,8,1
tlistbox,tlistbox,,0,0,1,0,3,1,9,1
idataobject,idataobject,,1,0,0,1,3,1,8,1
webworldwind,webworldwind,,0,1,0,1,3,1,1,1
microsoft-graph-security,microsoft-graph-security,,1,2,9,3,5,12,8,100
webwork,webwork,,1,1,1,2,1,3,3,1
ecpg,ecpg,,0,2,1,2,1,3,4,100
rails-event-store,rails-event-store,,0,3,0,3,1,3,12,200
pfuser,pfuser,,2,0,2,2,6,4,13,1
netflix-servo,netflix-servo,,0,0,1,0,1,1,3,1
customcolumn,customcolumn,,2,1,4,3,4,7,4,1
iview,iview,,3,1,16,4,10,20,1,1
waitforimages,waitforimages,,0,0,1,0,1,1,1,1
speex,speex,,1,0,2,1,4,3,3,1
promiscuous-mode,promiscuous-mode,,1,0,2,1,2,3,9,1
python-jsonschema,python-jsonschema,,9,4,9,13,8,22,1,1
textstyle,textstyle,,1,2,4,3,2,7,1,100
angular-moment-picker,angular-moment-picker,,0,1,1,1,2,2,1,1
readeventlog,readeventlog,,0,0,2,0,3,2,8,1
python-standalone,python-standalone,,1,1,6,2,5,8,0,1
ntag21x,ntag21x,,0,0,0,0,1,0,3,1
sceditor,sceditor,,0,3,0,3,2,3,4,200
customer-account-data-api,customer-account-data-api,,0,0,0,0,1,0,4,1
cardslib,cardslib,,0,0,1,0,2,1,3,1
wofstream,wofstream,,2,0,0,2,4,2,9,1
kvnprogress,kvnprogress,,0,0,0,0,2,0,13,1
lametric,lametric,,0,0,0,0,2,0,8,1
anonymous-delegates,anonymous-delegates,,0,0,2,0,1,2,8,1
stocator,stocator,,0,0,1,0,2,1,2,1
post-build,post-build,,5,4,6,9,8,15,6,1
lark-parser,lark-parser,,6,3,4,9,13,13,0,1
btahl7,btahl7,,0,0,0,0,1,0,8,1
passthru,passthru,,1,4,3,5,4,8,4,300
enumset,enumset,,3,1,1,4,3,5,3,1
wyam,wyam,,1,0,0,1,1,1,8,1
multimarkdown,multimarkdown,,0,3,3,3,1,6,0,200
pixiedust,pixiedust,,2,1,2,3,2,5,0,1
alphabetic,alphabetic,,0,0,0,0,6,0,0,1
itrs,itrs,,0,0,1,0,3,1,9,1
sqlhelper,sqlhelper,,0,0,2,0,1,2,4,1
red-gate-sql-prompt,red-gate-sql-prompt,,1,1,1,2,2,3,4,1
zend-form-fieldset,zend-form-fieldset,,1,0,1,1,6,2,4,1
plugin-pattern,plugin-pattern,,0,0,0,0,1,0,1,1
f#-3.0,f#-3.0,,0,1,7,1,2,8,8,1
asp.net-web-api-filters,asp.net-web-api-filters,,1,1,2,2,2,4,8,1
automationpeer,automationpeer,,1,0,1,1,2,2,8,1
chrome-debugging,chrome-debugging,,8,11,10,19,10,29,1,37.5
seleno,seleno,,0,0,0,0,1,0,3,1
fdmemtable,fdmemtable,,2,0,1,2,2,3,9,1
scalafix,scalafix,,1,1,3,2,1,5,2,1
semanticdb,semanticdb,,0,2,2,2,1,4,2,100
type.js,type.js,,0,0,0,0,1,0,4,1
debug-information,debug-information,,1,0,1,1,2,2,9,1
nolearn,nolearn,,0,0,1,0,1,1,0,1
cyrus,cyrus,,2,1,2,3,1,5,4,1
jrubyfx,jrubyfx,,0,0,0,0,2,0,12,1
nightly-build,nightly-build,,1,1,1,2,3,3,6,1
linq-extensions,linq-extensions,,0,0,0,0,2,0,8,1
random-testing,random-testing,,1,1,2,2,1,4,3,1
pryr,pryr,,0,0,2,0,1,2,0,1
serena,serena,,1,1,2,2,2,4,4,1
xcconfig,xcconfig,,1,3,10,4,6,14,13,200
redirecttoroute,redirecttoroute,,0,1,1,1,1,2,8,1
cfzip,cfzip,,0,0,1,0,1,1,4,1
uploadifive,uploadifive,,0,0,0,0,2,0,1,1
bootstrap-themes,bootstrap-themes,,3,2,1,5,5,6,1,1
llvm-cov,llvm-cov,,1,2,2,3,4,5,9,100
analytics-for-apache-hdp,analytics-for-apache-hdp,,0,0,0,0,1,0,2,1
ddoc,ddoc,,0,0,0,0,1,0,9,1
srs,srs,,3,1,0,4,2,4,4,1
fare,fare,,0,2,1,2,1,3,0,100
mdb2,mdb2,,1,0,2,1,5,3,4,1
copy-initialization,copy-initialization,,0,1,1,1,5,2,9,1
iplots,iplots,,0,0,3,0,2,3,0,1
character-spacing,character-spacing,,0,0,0,0,1,0,8,1
tac,tac,,2,1,3,3,3,6,9,1
datebox,datebox,,1,4,1,5,5,6,1,300
sysv,sysv,,0,5,4,5,5,9,9,400
configureawait,configureawait,,4,1,5,5,5,10,8,1
sticky-broadcast,sticky-broadcast,,0,0,2,0,1,2,3,1
comparevalidator,comparevalidator,,0,0,0,0,1,0,8,1
pod,pod,,35,33,69,68,41,137,13,1
jmtp,jmtp,,0,0,0,0,1,0,9,1
synchronizationcontext,synchronizationcontext,,4,2,5,6,13,11,8,1
needle.js,needle.js,,2,0,1,2,2,3,1,1
foq,foq,,1,0,0,1,1,1,1,1
fastadapter,fastadapter,,1,0,6,1,8,7,3,1
svgwrite,svgwrite,,0,1,2,1,4,3,1,1
fsharp.data.sqlclient,fsharp.data.sqlclient,,0,0,4,0,1,4,8,1
lager,lager,,2,1,0,3,2,3,2,1
origen-sdk,origen-sdk,,0,0,0,0,1,0,9,1
jaxp,jaxp,,1,3,5,4,5,9,3,200
haskell-vector,haskell-vector,,0,1,1,1,1,2,2,1
limited-user,limited-user,,0,1,0,1,2,1,9,1
react-native-video,react-native-video,,23,16,45,39,17,84,1,1
homepod,homepod,,0,0,1,0,2,1,13,1
polkit,polkit,,0,1,3,1,2,4,9,1
mobilefirst-bluemix,mobilefirst-bluemix,,0,0,0,0,1,0,13,1
riot-games-api,riot-games-api,,3,0,6,3,4,9,1,1
nsoutputstream,nsoutputstream,,1,0,1,1,3,2,13,1
adsutil.vbs,adsutil.vbs,,0,0,0,0,1,0,5,1
seaglass,seaglass,,0,0,0,0,1,0,3,1
fluentscheduler,fluentscheduler,,1,0,1,1,3,2,8,1
checkboxradio,checkboxradio,,0,0,0,0,1,0,1,1
jquery-ias,jquery-ias,,0,2,0,2,2,2,1,100
openssl-net,openssl-net,,0,0,2,0,2,2,6,1
react-native-tools,react-native-tools,,0,2,1,2,3,3,1,100
connector-j,connector-j,,2,4,5,6,6,11,3,100
profunctor,profunctor,,1,0,1,1,2,2,2,1
jquery-mobile-collapsible,jquery-mobile-collapsible,,1,0,2,1,3,3,1,1
node.js-connect,node.js-connect,,0,0,1,0,2,1,1,1
webkit-transition,webkit-transition,,0,0,0,0,1,0,1,1
ios-urlsheme,ios-urlsheme,,0,0,0,0,3,0,13,1
pywhois,pywhois,,0,3,1,3,1,4,0,200
react-native-xml2js,react-native-xml2js,,0,0,0,0,2,0,1,1
delete-keyword,delete-keyword,,0,1,1,1,2,2,9,1
django-organizations,django-organizations,,0,0,3,0,1,3,0,1
link-tag,link-tag,,1,0,0,1,1,1,1,1
vaadin10,vaadin10,,19,10,53,29,45,82,3,1
vaadin-flow,vaadin-flow,,55,35,61,90,30,151,3,1
assetslibrary,assetslibrary,,0,0,1,0,1,1,9,1
autoshrink,autoshrink,,0,1,2,1,2,3,13,1
android-thumbnail,android-thumbnail,,0,1,0,1,2,1,3,1
centos5,centos5,,1,0,2,1,7,3,9,1
lxc-docker,lxc-docker,,1,1,1,2,1,3,6,1
gamlss,gamlss,,2,4,5,6,6,11,0,100
reaction-commerce,reaction-commerce,,1,2,6,3,7,9,1,100
groovy-spread,groovy-spread,,0,0,0,0,1,0,3,1
deep-dream,deep-dream,,1,1,2,2,6,4,0,1
xrc,xrc,,0,0,1,0,1,1,0,1
apache-chainsaw,apache-chainsaw,,0,0,0,0,1,0,3,1
physicsjs,physicsjs,,0,0,0,0,2,0,1,1
logical-and,logical-and,,2,1,3,3,4,6,0,1
vue-timeago,vue-timeago,,0,0,0,0,1,0,1,1
django-statistics,django-statistics,,0,0,0,0,1,0,0,1
fuelcms,fuelcms,,0,1,1,1,2,2,4,1
gold-parser,gold-parser,,0,0,1,0,1,1,0,1
evo,evo,,0,2,0,2,2,2,13,100
ant-junit,ant-junit,,0,0,0,0,1,0,3,1
windows-phone-emulator,windows-phone-emulator,,0,0,1,0,2,1,8,1
jester,jester,,0,0,1,0,2,1,9,1
recvmmsg,recvmmsg,,0,0,1,0,1,1,9,1
dataform,dataform,,2,1,1,3,2,4,1,1
r1soft,r1soft,,0,0,0,0,2,0,4,1
backupmanager,backupmanager,,0,0,2,0,1,2,3,1
encase,encase,,0,0,0,0,1,0,9,1
opencv-features2d,opencv-features2d,,0,0,1,0,3,1,0,1
sqltools,sqltools,,3,1,0,4,2,4,4,1
.net-cf-3.5,.net-cf-3.5,,2,2,3,4,4,7,8,1
veracrypt,veracrypt,,0,2,8,2,3,10,9,100
automapping,automapping,,2,1,2,3,4,5,8,1
app-hub,app-hub,,0,0,0,0,1,0,1,1
spring-cloud-gateway,spring-cloud-gateway,,33,37,74,70,51,144,3,12.121212
build-environment,build-environment,,1,0,2,1,1,3,9,1
mongodb-scala,mongodb-scala,,2,1,2,3,2,5,1,1
json-value,json-value,,4,1,3,5,3,8,4,1
pandaboard,pandaboard,,0,0,0,0,1,0,9,1
dynamic-featured-image,dynamic-featured-image,,1,1,1,2,7,3,4,1
apple-help,apple-help,,0,0,2,0,1,2,13,1
label-control,label-control,,0,0,0,0,1,0,8,1
custom-react-scripts,custom-react-scripts,,0,1,0,1,3,1,1,1
native-sql,native-sql,,1,1,5,2,3,7,3,1
modified-date,modified-date,,0,0,0,0,2,0,8,1
flee,flee,,0,0,0,0,4,0,8,1
sdl-1.2,sdl-1.2,,1,0,1,1,3,2,9,1
battlenet-api,battlenet-api,,1,0,2,1,3,3,4,1
faces-config,faces-config,,1,2,4,3,3,7,3,100
rootkit,rootkit,,1,1,4,2,3,6,9,1
microsoft-sal,microsoft-sal,,0,0,0,0,1,0,4,1
jpamodelgen,jpamodelgen,,0,1,1,1,2,2,3,1
nbuilder,nbuilder,,0,0,1,0,3,1,8,1
phassetcollection,phassetcollection,,2,2,2,4,4,6,13,1
sqlite-cipher,sqlite-cipher,,1,0,1,1,3,2,3,1
printqueue,printqueue,,1,0,0,1,4,1,8,1
webresourcerequest,webresourcerequest,,0,0,0,0,2,0,3,1
binary-diff,binary-diff,,0,0,0,0,1,0,9,1
postgresql-9.0,postgresql-9.0,,0,1,3,1,3,4,4,1
ant-media-server,ant-media-server,,2,6,1,8,10,9,13,200
yoga-x1,yoga-x1,,0,0,2,0,3,2,1,1
backup-agent,backup-agent,,0,0,0,0,1,0,3,1
sessionend,sessionend,,0,0,0,0,1,0,8,1
scriptprocessor,scriptprocessor,,0,0,1,0,3,1,1,1
netflix-hollow,netflix-hollow,,0,2,0,2,1,2,3,100
selectinputdate,selectinputdate,,1,0,0,1,2,1,0,1
liveedit,liveedit,,0,0,1,0,5,1,3,1
nscursor,nscursor,,2,0,3,2,3,5,13,1
uigraphicsrenderer,uigraphicsrenderer,,1,2,2,3,3,5,13,100
flask-graphql,flask-graphql,,2,2,3,4,2,7,1,1
redistogo,redistogo,,0,1,0,1,2,1,1,1
value-constructor,value-constructor,,0,1,0,1,2,1,2,1
web3swift,web3swift,,1,0,1,1,6,2,13,1
aqua-data-studio,aqua-data-studio,,0,0,1,0,3,1,4,1
external-js,external-js,,4,4,0,8,4,8,1,1
server-explorer,server-explorer,,1,0,5,1,3,6,8,1
edit-in-place,edit-in-place,,0,0,2,0,6,2,12,1
gcc8,gcc8,,4,4,14,8,10,22,9,1
jenkins-github-plugin,jenkins-github-plugin,,2,2,8,4,13,12,6,1
isolatedstoragefile,isolatedstoragefile,,0,0,1,0,1,1,8,1
hierarchical-trees,hierarchical-trees,,0,1,0,1,3,1,2,1
aasa,aasa,,1,1,2,2,2,4,13,1
vb4android,vb4android,,1,3,3,4,2,7,3,200
vimium,vimium,,0,0,2,0,1,2,1,1
kingsoft,kingsoft,,0,0,2,0,1,2,5,1
cptxygraph,cptxygraph,,0,0,0,0,1,0,13,1
busy-cursor,busy-cursor,,0,0,0,0,1,0,8,1
notification-bar,notification-bar,,0,0,0,0,1,0,3,1
pyqtdeploy,pyqtdeploy,,3,3,3,6,2,9,0,1
buildout,buildout,,1,2,3,3,7,6,0,100
chef12.0,chef12.0,,0,0,0,0,1,0,12,1
wash-out,wash-out,,0,0,0,0,5,0,12,1
itmstransporter,itmstransporter,,1,2,3,3,2,6,13,100
onmeasure,onmeasure,,2,2,6,4,3,10,3,1
css-friendly,css-friendly,,0,0,0,0,1,0,8,1
request-queueing,request-queueing,,0,2,5,2,2,7,3,100
white-box-testing,white-box-testing,,1,0,4,1,10,5,3,1
double-byte,double-byte,,1,1,0,2,1,2,1,1
jsp-fragments,jsp-fragments,,0,0,2,0,1,2,3,1
optimizer-statistics,optimizer-statistics,,0,0,0,0,3,0,4,1
google-natural-language,google-natural-language,,6,4,17,10,25,27,6,1
path-traversal,path-traversal,,1,0,1,1,2,2,8,1
tink,tink,,6,5,9,11,6,20,6,1
select-into-outfile,select-into-outfile,,2,0,1,2,4,3,4,1
ci-server,ci-server,,0,0,0,0,1,0,13,1
ember-cli-pods,ember-cli-pods,,0,0,1,0,1,1,1,1
verilator,verilator,,0,0,5,0,2,5,9,1
tframe,tframe,,1,0,0,1,2,1,9,1
grunt-contrib-qunit,grunt-contrib-qunit,,0,0,1,0,1,1,1,1
sharedelementcallback,sharedelementcallback,,3,1,4,4,1,8,3,1
enterpriseone,enterpriseone,,0,0,0,0,1,0,4,1
wtsapi32,wtsapi32,,1,0,2,1,3,3,8,1
sdata,sdata,,2,0,0,2,1,2,4,1
supersocket.net,supersocket.net,,1,4,1,5,1,6,8,300
nosuchmethod,nosuchmethod,,0,0,2,0,2,2,3,1
angular-routerlink,angular-routerlink,,16,14,26,30,24,56,1,1
noise-words,noise-words,,0,1,0,1,1,1,4,1
neoscms,neoscms,,1,1,2,2,5,4,4,1
pclose,pclose,,0,0,1,0,2,1,9,1
html-tableextract,html-tableextract,,0,1,1,1,3,2,1,1
mixing,mixing,,4,4,4,8,6,12,13,1
columndefinition,columndefinition,,2,0,4,2,1,6,1,1
movies,movies,,1,0,1,1,3,2,0,1
tcm,tcm,,0,0,1,0,1,1,9,1
verifone,verifone,,0,2,3,2,7,5,9,100
java-11,java-11,,224,173,453,397,35,850,3,1
fieldinfo,fieldinfo,,0,0,4,0,1,4,8,1
mailenable,mailenable,,0,0,2,0,1,2,4,1
error-recovery,error-recovery,,0,0,2,0,1,2,9,1
dashboard-designer,dashboard-designer,,0,0,0,0,2,0,4,1
translate3d,translate3d,,3,1,6,4,4,10,1,1
script-tag,script-tag,,6,5,18,11,21,29,1,1
arrow-kt,arrow-kt,,7,7,9,14,8,23,3,1
infinidb,infinidb,,0,1,1,1,2,2,4,1
rhc,rhc,,0,0,0,0,1,0,12,1
terraform-provider-aws,terraform-provider-aws,,98,150,147,248,98,395,6,53.061224
python-language-server,python-language-server,,3,3,4,6,1,10,0,1
ijkplayer,ijkplayer,,0,5,2,5,3,7,3,400
softhsm,softhsm,,4,4,6,8,8,14,6,1
jnotify,jnotify,,0,0,0,0,1,0,2,1
data-linking,data-linking,,0,1,1,1,2,2,5,1
parboiled2,parboiled2,,0,0,0,0,1,0,2,1
at-sign,at-sign,,0,0,0,0,1,0,9,1
clr-module-initializer,clr-module-initializer,,0,0,0,0,1,0,8,1
speech-recognition-api,speech-recognition-api,,0,0,2,0,4,2,6,1
houdini,houdini,,5,2,9,7,5,16,0,1
karabiner,karabiner,,1,0,5,1,1,6,13,1
resuming-training,resuming-training,,1,2,3,3,4,6,0,100
gmsgroundoverlay,gmsgroundoverlay,,2,0,3,2,3,5,1,1
tilt,tilt,,3,1,0,4,1,4,12,1
microsoft-visual-c++,microsoft-visual-c++,,2,3,3,5,8,8,9,50
email-formats,email-formats,,1,0,1,1,2,2,4,1
jstilemap,jstilemap,,0,0,0,0,3,0,13,1
release-notes,release-notes,,0,2,1,2,3,3,6,100
android-gnss,android-gnss,,0,0,3,0,1,3,3,1
scannable-code,scannable-code,,0,0,0,0,1,0,0,1
cloudbreak,cloudbreak,,1,0,3,1,3,4,2,1
git-non-bare-repository,git-non-bare-repository,,0,0,0,0,2,0,6,1
uikeyinput,uikeyinput,,0,0,1,0,2,1,13,1
code-statistics,code-statistics,,1,0,2,1,2,3,13,1
episerver-6,episerver-6,,0,0,0,0,3,0,8,1
episerver-8,episerver-8,,0,1,1,1,7,2,8,1
query-help,query-help,,0,0,0,0,2,0,4,1
nmath,nmath,,0,0,0,0,1,0,8,1
automated-deploy,automated-deploy,,1,2,1,3,6,4,12,100
realproxy,realproxy,,1,1,1,2,2,3,8,1
senchatouch-2.4,senchatouch-2.4,,0,0,0,0,1,0,1,1
vash,vash,,0,0,0,0,1,0,1,1
writablebitmap,writablebitmap,,1,1,2,2,2,4,8,1
querypath,querypath,,0,0,1,0,1,1,4,1
full-table-scan,full-table-scan,,1,0,0,1,4,1,4,1
bbc-tal,bbc-tal,,0,0,2,0,3,2,3,1
countdownevent,countdownevent,,1,0,0,1,1,1,3,1
reporttools,reporttools,,0,0,0,0,1,0,0,1
jms2,jms2,,0,0,3,0,1,3,3,1
fmp4,fmp4,,0,0,15,0,5,15,13,1
drawingml,drawingml,,0,0,0,0,1,0,0,1
tethne,tethne,,0,0,0,0,1,0,0,1
spring-xd,spring-xd,,0,2,5,2,3,7,3,100
system-on-chip,system-on-chip,,0,0,0,0,1,0,9,1
rails-generate,rails-generate,,0,0,1,0,2,1,12,1
urlrewriter.net,urlrewriter.net,,0,0,0,0,1,0,8,1
r-mosaic,r-mosaic,,0,2,1,2,2,3,0,100
sslerrorhandler,sslerrorhandler,,2,0,4,2,3,6,3,1
source-server,source-server,,0,0,1,0,2,1,8,1
web-stomp,web-stomp,,2,0,2,2,2,4,3,1
formatted-text,formatted-text,,3,2,2,5,5,7,1,1
lattice-diamond,lattice-diamond,,4,3,2,7,9,9,9,1
qcamera,qcamera,,0,1,3,1,6,4,9,1
acquisition,acquisition,,0,1,1,1,3,2,3,1
amzi-prolog,amzi-prolog,,0,0,0,0,1,0,0,1
seam3-coredata,seam3-coredata,,0,0,0,0,1,0,13,1
vaadin-date-picker,vaadin-date-picker,,0,0,1,0,1,1,1,1
postmortem-debugging,postmortem-debugging,,1,4,4,5,5,9,9,300
nose2,nose2,,2,1,2,3,3,5,0,1
keychainitemwrapper,keychainitemwrapper,,0,1,5,1,2,6,13,1
hmaccessory,hmaccessory,,0,0,0,0,1,0,13,1
msdropdown,msdropdown,,0,0,0,0,1,0,1,1
canutils,canutils,,1,3,2,4,1,6,9,200
quickbase,quickbase,,2,0,1,2,3,3,1,1
ed25519,ed25519,,3,6,2,9,8,11,6,100
quercus,quercus,,1,0,2,1,2,3,4,1
terraform-provider-gcp,terraform-provider-gcp,,36,26,27,62,12,89,6,1
nnapi,nnapi,,0,4,5,4,4,9,0,300
django-custom-field,django-custom-field,,4,0,2,4,2,6,0,1
liipfunctionaltestbundle,liipfunctionaltestbundle,,1,0,3,1,3,4,4,1
code-visualization,code-visualization,,0,0,2,0,2,2,9,1
spring-gem,spring-gem,,0,0,0,0,1,0,12,1
uls,uls,,0,0,0,0,1,0,8,1
boost-xpressive,boost-xpressive,,8,1,0,9,3,9,9,1
mysql-error-2002,mysql-error-2002,,1,0,1,1,3,2,4,1
grails-constraints,grails-constraints,,0,0,0,0,1,0,3,1
file-organization,file-organization,,0,0,2,0,5,2,6,1
regexserde,regexserde,,1,0,1,1,4,2,2,1
tcombobox,tcombobox,,2,1,3,3,4,6,9,1
google-provisioning-api,google-provisioning-api,,1,0,0,1,1,1,5,1
opnsense,opnsense,,1,1,4,2,3,6,9,1
kohana-orm,kohana-orm,,0,0,1,0,1,1,4,1
hp-service-manager,hp-service-manager,,0,0,0,0,1,0,8,1
spring-kotlin,spring-kotlin,,2,0,0,2,4,2,3,1
unnotificationattachment,unnotificationattachment,,1,1,2,2,2,4,13,1
androidsvg,androidsvg,,4,0,3,4,2,7,3,1
overlay-view,overlay-view,,0,0,0,0,1,0,1,1
overloaded-strings,overloaded-strings,,2,0,0,2,2,2,2,1
vwo,vwo,,1,0,1,1,3,2,13,1
multipleselectionmodel,multipleselectionmodel,,0,0,0,0,1,0,3,1
clcircularregion,clcircularregion,,0,0,1,0,2,1,13,1
domain-forwarding,domain-forwarding,,2,0,1,2,5,3,4,1
elevatr,elevatr,,0,0,1,0,1,1,0,1
listlabel,listlabel,,2,0,1,2,4,3,4,1
high-traffic,high-traffic,,0,0,1,0,2,1,4,1
react-native-textinput,react-native-textinput,,4,11,17,15,6,32,1,175
xmlstreamwriter,xmlstreamwriter,,0,1,1,1,2,2,3,1
dcevm,dcevm,,0,3,2,3,4,5,3,200
nsuinteger,nsuinteger,,0,0,0,0,3,0,13,1
multi-factor-authentication,multi-factor-authentication,,8,10,12,18,19,30,8,25
swift1-2,swift1-2,,0,0,0,0,1,0,13,1
camus,camus,,0,0,3,0,3,3,2,1
nunit-2.6,nunit-2.6,,0,0,1,0,1,1,8,1
frameless,frameless,,2,0,2,2,1,4,2,1
angular-seo,angular-seo,,1,1,7,2,3,9,1,1
asp.net-core-cli,asp.net-core-cli,,3,3,2,6,4,8,8,1
dust-helpers,dust-helpers,,0,0,1,0,2,1,1,1
redhat-sso,redhat-sso,,3,3,7,6,6,13,3,1
insightly,insightly,,0,1,1,1,2,2,4,1
jquery-ui-spinner,jquery-ui-spinner,,0,1,0,1,4,1,1,1
tablegateway,tablegateway,,1,0,2,1,3,3,4,1
options-menu,options-menu,,0,0,0,0,1,0,3,1
canjs,canjs,,2,2,4,4,7,8,1,1
rxpermissions,rxpermissions,,1,1,1,2,1,3,3,1
twilio-programmable-voice,twilio-programmable-voice,,7,9,16,16,20,32,13,28.571429
xmlupdate,xmlupdate,,1,0,1,1,1,2,3,1
von-neumann,von-neumann,,0,0,2,0,2,2,9,1
opshub,opshub,,0,0,0,0,3,0,8,1
flite,flite,,0,2,0,2,5,2,3,100
segment-io,segment-io,,0,2,4,2,3,6,5,100
pandas-profiling,pandas-profiling,,4,8,8,12,3,20,0,100
hadoop-lzo,hadoop-lzo,,0,0,0,0,1,0,0,1
imgui,imgui,,1,6,4,7,3,11,9,500
lumia,lumia,,0,0,1,0,2,1,8,1
pixelmed,pixelmed,,0,0,0,0,2,0,3,1
messagekit,messagekit,,5,14,20,19,4,39,13,180
setscripttimeout,setscripttimeout,,0,0,0,0,1,0,3,1
sskeychain,sskeychain,,0,0,0,0,1,0,13,1
node-save,node-save,,0,0,0,0,1,0,4,1
high-volume,high-volume,,0,1,1,1,1,2,3,1
splitpanel,splitpanel,,0,0,0,0,1,0,3,1
fortran-common-block,fortran-common-block,,2,1,1,3,2,4,9,1
crashrpt,crashrpt,,0,0,0,0,1,0,9,1
mobaxterm,mobaxterm,,8,8,18,16,6,34,9,1
react-native-stripe-api,react-native-stripe-api,,0,1,1,1,1,2,3,1
react-fragment,react-fragment,,1,0,1,1,5,2,1,1
mod-include,mod-include,,1,1,0,2,3,2,4,1
sci-java,sci-java,,0,0,1,0,1,1,3,1
react-native-animatable,react-native-animatable,,12,5,12,17,12,29,1,1
drupal-navigation,drupal-navigation,,0,0,1,0,4,1,4,1
ca2000,ca2000,,0,0,0,0,1,0,8,1
google-product-search,google-product-search,,1,3,1,4,1,5,5,200
wkhtmltoimage,wkhtmltoimage,,0,5,9,5,11,14,8,400
grib-api,grib-api,,0,0,1,0,2,1,0,1
docker-proxy,docker-proxy,,0,3,1,3,3,4,6,200
django-sphinx,django-sphinx,,0,1,0,1,1,1,0,1
export-csv,export-csv,,5,10,15,15,20,30,8,100
nscfstring,nscfstring,,1,0,0,1,1,1,13,1
watchapp,watchapp,,1,0,1,1,2,2,13,1
wijmo-grid,wijmo-grid,,1,1,1,2,3,3,1,1
optimistic-ui,optimistic-ui,,1,1,2,2,4,4,1,1
graphical-interaction,graphical-interaction,,2,0,0,2,1,2,4,1
hex-pm,hex-pm,,0,0,3,0,2,3,2,1
symfony-config-component,symfony-config-component,,0,0,2,0,5,2,4,1
recorder,recorder,,2,2,10,4,5,14,3,1
outlook-object-model,outlook-object-model,,1,1,1,2,2,3,8,1
ng2-redux,ng2-redux,,0,0,0,0,3,0,1,1
.aspxauth,.aspxauth,,1,0,0,1,4,1,8,1
mde,mde,,0,1,2,1,2,3,3,1
pairing-heap,pairing-heap,,0,0,0,0,1,0,9,1
azure-servicebus-subscriptions,azure-servicebus-subscriptions,,8,7,11,15,4,26,8,1
sysinfo,sysinfo,,0,0,2,0,2,2,9,1
jul-to-slf4j,jul-to-slf4j,,0,2,1,2,1,3,3,100
external-url,external-url,,0,2,2,2,2,4,4,100
mysql-udf,mysql-udf,,1,3,1,4,3,5,4,200
dev-null,dev-null,,0,1,4,1,7,5,9,1
redux-logic,redux-logic,,1,3,1,4,1,5,1,200
jazzy,jazzy,,0,2,2,2,3,4,13,100
dynamics-gp-api,dynamics-gp-api,,0,0,2,0,2,2,8,1
neuroph,neuroph,,0,3,2,3,4,5,0,200
struct.pack,struct.pack,,0,0,3,0,3,3,0,1
bim,bim,,7,3,8,10,13,18,14,1
tabbed-browsing,tabbed-browsing,,0,0,0,0,1,0,13,1
matlab-stem,matlab-stem,,0,0,0,0,1,0,0,1
django-grappelli,django-grappelli,,1,3,0,4,1,4,0,200
apache-spark-2.1.1,apache-spark-2.1.1,,0,1,2,1,7,3,2,1
redstone.dart,redstone.dart,,0,0,0,0,2,0,13,1
qwerty,qwerty,,1,1,0,2,1,2,13,1
embedded-container,embedded-container,,0,0,0,0,1,0,3,1
nuget-console,nuget-console,,0,0,1,0,3,1,8,1
zurb-reveal,zurb-reveal,,1,1,2,2,2,4,1,1
overheating,overheating,,0,0,1,0,2,1,1,1
drupal-themes,drupal-themes,,1,1,3,2,3,5,4,1
lint-staged,lint-staged,,5,8,6,13,5,19,6,60
lustre,lustre,,3,4,1,7,2,8,9,33.333333
pahole,pahole,,0,0,1,0,1,1,9,1
introduction,introduction,,2,0,3,2,7,5,3,1
pythonqt,pythonqt,,1,1,0,2,3,2,0,1
rethinkdbdash,rethinkdbdash,,0,0,5,0,3,5,1,1
inequalities,inequalities,,1,0,3,1,4,4,0,1
coproc,coproc,,0,0,1,0,1,1,0,1
pvts,pvts,,0,0,0,0,1,0,4,1
engine.io,engine.io,,3,1,3,4,3,7,1,1
passport.socketio,passport.socketio,,0,0,1,0,2,1,1,1
quart,quart,,6,10,11,16,6,27,0,66.666667
goblin,goblin,,1,0,1,1,5,2,2,1
inext,inext,,0,0,1,0,2,1,0,1
mongodb-roles,mongodb-roles,,0,1,2,1,1,3,1,1
angularjs-ng-class,angularjs-ng-class,,1,0,0,1,6,1,1,1
mapxtreme,mapxtreme,,0,0,0,0,1,0,8,1
exchange-management-shell,exchange-management-shell,,2,0,2,2,6,4,8,1
state-saving,state-saving,,1,1,2,2,2,4,3,1
hs-err,hs-err,,0,1,0,1,2,1,3,1
cert-manager,cert-manager,,20,14,20,34,7,54,6,1
kube-lego,kube-lego,,0,2,0,2,2,2,6,100
weakly-typed,weakly-typed,,0,0,0,0,1,0,13,1
untyped-variables,untyped-variables,,0,0,2,0,1,2,13,1
concrete-inheritance,concrete-inheritance,,0,0,0,0,1,0,9,1
sshj,sshj,,1,1,7,2,7,9,3,1
2captcha,2captcha,,4,1,7,5,3,12,3,1
eventtocommand,eventtocommand,,1,0,1,1,3,2,8,1
boa-constructor,boa-constructor,,0,0,0,0,1,0,0,1
fieldlist,fieldlist,,3,0,1,3,2,4,0,1
tatsu,tatsu,,0,1,3,1,4,4,0,1
udpipe,udpipe,,1,1,8,2,7,10,0,1
cheyenne,cheyenne,,0,0,0,0,1,0,4,1
remoteexception,remoteexception,,0,0,1,0,2,1,2,1
eric-ide,eric-ide,,0,0,2,0,5,2,0,1
lightgraphs,lightgraphs,,1,0,1,1,4,2,0,1
qt-mobility,qt-mobility,,0,0,0,0,1,0,9,1
seam-carving,seam-carving,,0,0,1,0,2,1,0,1
pg-node,pg-node,,1,0,1,1,3,2,1,1
mapinfo,mapinfo,,0,1,1,1,3,2,8,1
map-basic,map-basic,,0,0,2,0,2,2,8,1
memoryimagesource,memoryimagesource,,0,0,0,0,1,0,3,1
class-validator,class-validator,,8,9,9,17,4,26,1,12.5
class-transformer,class-transformer,,3,2,5,5,2,10,1,1
joomla3.7,joomla3.7,,0,0,0,0,1,0,1,1
do-notation,do-notation,,11,10,9,21,11,30,2,1
miniupnpc,miniupnpc,,0,0,0,0,1,0,9,1
pi4j,pi4j,,4,2,2,6,1,8,3,1
sap-xi,sap-xi,,0,2,1,2,1,3,5,100
sll,sll,,0,0,2,0,1,2,9,1
content-for,content-for,,0,0,0,0,2,0,12,1
cieluv,cieluv,,2,0,0,2,3,2,0,1
mvvm-toolkit,mvvm-toolkit,,0,0,0,0,1,0,8,1
superscalar,superscalar,,1,0,1,1,4,2,9,1
round-rect,round-rect,,0,0,0,0,1,0,1,1
swift-guard,swift-guard,,0,0,0,0,1,0,13,1
platform-builder,platform-builder,,1,0,1,1,1,2,8,1
mqtt-vernemq,mqtt-vernemq,,2,4,8,6,7,14,6,100
sharethis,sharethis,,2,1,3,3,5,6,1,1
properties.settings,properties.settings,,0,1,1,1,2,2,8,1
greendao-generator,greendao-generator,,0,1,0,1,2,1,3,1
evosuite,evosuite,,7,4,11,11,5,22,3,1
aiql,aiql,,0,0,0,0,2,0,8,1
exchange-server-2003,exchange-server-2003,,0,0,0,0,1,0,8,1
appjar,appjar,,7,2,4,9,1,13,0,1
.net-core-authorization,.net-core-authorization,,1,3,3,4,2,7,8,200
chunk-templates,chunk-templates,,1,0,1,1,1,2,3,1
pyvimeo,pyvimeo,,0,1,1,1,2,2,0,1
drupal-cache,drupal-cache,,0,0,1,0,1,1,4,1
grafana-alerts,grafana-alerts,,5,10,11,15,7,26,6,100
restartmanager,restartmanager,,0,0,1,0,5,1,8,1
prophecy,prophecy,,2,2,8,4,4,12,4,1
weixinjsbridge,weixinjsbridge,,0,0,0,0,2,0,1,1
memory-graph-debugger,memory-graph-debugger,,2,2,1,4,1,5,13,1
go-map,go-map,,3,0,4,3,7,7,6,1
itemspanel,itemspanel,,0,0,0,0,1,0,8,1
implicitwait,implicitwait,,4,4,3,8,2,11,3,1
cmake-modules,cmake-modules,,9,7,14,16,9,30,9,1
identicon,identicon,,0,0,0,0,1,0,1,1
pytorctl,pytorctl,,0,0,1,0,1,1,0,1
benchmarkdotnet,benchmarkdotnet,,4,4,5,8,6,13,8,1
pathogen,pathogen,,0,0,3,0,2,3,9,1
latex-suite,latex-suite,,0,1,0,1,1,1,9,1
excel.application,excel.application,,1,1,4,2,1,6,5,1
react-ga,react-ga,,5,8,6,13,9,19,1,60
sacct,sacct,,0,1,1,1,3,2,0,1
nervana-neon,nervana-neon,,0,0,0,0,1,0,0,1
if-this-then-that,if-this-then-that,,0,0,1,0,3,1,5,1
winhttpcertcfg,winhttpcertcfg,,0,0,1,0,2,1,9,1
cassandra-stress,cassandra-stress,,6,1,3,7,6,10,2,1
wix2,wix2,,0,0,0,0,1,0,8,1
disk-striping,disk-striping,,0,0,0,0,1,0,6,1
watson-ml,watson-ml,,1,3,0,4,2,4,6,200
line.me,line.me,,0,0,1,0,2,1,8,1
row-polymorphism,row-polymorphism,,0,0,1,0,2,1,2,1
prism-7,prism-7,,7,4,12,11,7,23,8,1
postgres-ext,postgres-ext,,0,0,0,0,1,0,12,1
zurb-joyride,zurb-joyride,,1,0,0,1,1,1,1,1
android-gpuimageview,android-gpuimageview,,0,0,0,0,1,0,3,1
mesh-collider,mesh-collider,,2,0,6,2,4,8,8,1
post-quantum-cryptography,post-quantum-cryptography,,3,0,3,3,2,6,6,1
datastax-studio,datastax-studio,,2,0,0,2,2,2,2,1
concurrent-ruby,concurrent-ruby,,0,1,2,1,1,3,12,1
erl-interface,erl-interface,,0,0,0,0,1,0,2,1
cnode,cnode,,0,0,0,0,1,0,2,1
python-simple-crypt,python-simple-crypt,,0,0,0,0,1,0,9,1
jotform,jotform,,1,0,6,1,6,7,1,1
min.js,min.js,,1,1,0,2,1,2,1,1
django-intermediate-table,django-intermediate-table,,2,0,0,2,2,2,0,1
force-touch,force-touch,,1,0,2,1,3,3,13,1
externalinterface,externalinterface,,0,1,1,1,1,2,13,1
switchvox,switchvox,,0,0,0,0,1,0,13,1
pcspim,pcspim,,0,1,0,1,2,1,9,1
easerver,easerver,,1,0,0,1,1,1,8,1
apropos,apropos,,1,0,0,1,1,1,9,1
nvrtc,nvrtc,,0,0,3,0,3,3,0,1
symfony-eventdispatcher,symfony-eventdispatcher,,2,1,0,3,6,3,4,1
audiobufferlist,audiobufferlist,,0,0,1,0,4,1,13,1
omemo,omemo,,3,0,2,3,2,5,3,1
asus-xtion,asus-xtion,,0,2,2,2,3,4,0,100
warp-scheduler,warp-scheduler,,0,0,0,0,1,0,0,1
spmd,spmd,,0,0,3,0,6,3,0,1
speclj,speclj,,0,0,0,0,2,0,2,1
boost-msm,boost-msm,,1,0,5,1,9,6,9,1
smoothstate.js,smoothstate.js,,2,1,5,3,6,8,1,1
bootstrap-affix,bootstrap-affix,,0,3,3,3,6,6,1,200
mytoolkit,mytoolkit,,1,0,1,1,1,2,8,1
corporate-policy,corporate-policy,,2,0,2,2,1,4,6,1
advanced-query-tool,advanced-query-tool,,0,1,0,1,3,1,4,1
optaweb-employee-rostering,optaweb-employee-rostering,,0,1,2,1,8,3,3,1
prototype-scope,prototype-scope,,0,0,1,0,1,1,3,1
stackalloc,stackalloc,,2,0,3,2,3,5,8,1
postbackurl,postbackurl,,0,0,1,0,1,1,4,1
android-vitals,android-vitals,,4,3,2,7,5,9,3,1
headerdoc,headerdoc,,0,0,0,0,1,0,13,1
invite,invite,,3,2,5,5,6,10,3,1
dynamic-links,dynamic-links,,1,2,3,3,5,6,13,100
non-renewing-subscription,non-renewing-subscription,,0,0,1,0,3,1,13,1
resource-editor,resource-editor,,1,1,1,2,2,3,8,1
sass-globbing,sass-globbing,,0,1,0,1,1,1,1,1
pyrex,pyrex,,0,0,0,0,1,0,0,1
toplink-essentials,toplink-essentials,,0,0,0,0,1,0,3,1
wordlift,wordlift,,0,0,3,0,2,3,4,1
jsonnet,jsonnet,,1,1,6,2,7,8,6,1
pygradle,pygradle,,1,0,1,1,1,2,3,1
rateyo,rateyo,,2,0,2,2,5,4,1,1
cookieless,cookieless,,0,1,4,1,4,5,8,1
txtwrite,txtwrite,,0,0,0,0,1,0,8,1
kdcircularprogress,kdcircularprogress,,0,0,0,0,2,0,13,1
dial-up,dial-up,,0,1,0,1,2,1,8,1
git-fast-import,git-fast-import,,0,0,2,0,3,2,6,1
uiactivityitemprovider,uiactivityitemprovider,,0,1,0,1,1,1,13,1
appcloud,appcloud,,0,0,0,0,1,0,8,1
facescontext,facescontext,,2,0,3,2,2,5,3,1
ddt,ddt,,0,0,3,0,2,3,0,1
libserial,libserial,,0,0,1,0,1,1,9,1
capture-list,capture-list,,0,2,2,2,4,4,13,100
strong-reference-cycle,strong-reference-cycle,,0,1,2,1,3,3,13,1
ngredux,ngredux,,1,1,6,2,6,8,1,1
ionic-cloud,ionic-cloud,,0,0,0,0,1,0,1,1
angular-ngrx-data,angular-ngrx-data,,0,7,1,7,1,8,1,600
uigravitybehavior,uigravitybehavior,,1,0,1,1,1,2,13,1
text-normalization,text-normalization,,0,0,0,0,2,0,0,1
unaccent,unaccent,,1,3,1,4,4,5,4,200
resgen,resgen,,0,0,0,0,1,0,8,1
amazon-workdocs,amazon-workdocs,,0,1,0,1,4,1,6,1
two-legged,two-legged,,0,0,0,0,2,0,4,1
wct,wct,,1,5,6,6,5,12,1,400
angularjs-view,angularjs-view,,0,0,0,0,1,0,1,1
uitoolbarposition,uitoolbarposition,,0,0,0,0,1,0,13,1
viewrendering,viewrendering,,2,1,1,3,1,4,8,1
attachevent,attachevent,,0,1,2,1,1,3,1,1
jsr250,jsr250,,0,0,0,0,1,0,3,1
boost-unordered,boost-unordered,,0,0,0,0,3,0,9,1
excon,excon,,1,1,0,2,1,2,12,1
tomcat7-maven-plugin,tomcat7-maven-plugin,,2,1,2,3,3,5,3,1
tagfile,tagfile,,0,0,0,0,2,0,3,1
mvw,mvw,,0,0,0,0,2,0,8,1
python-requests-html,python-requests-html,,17,20,31,37,14,68,0,17.647059
datakey,datakey,,2,0,0,2,2,2,1,1
qpointer,qpointer,,1,1,0,2,2,2,9,1
actionmode,actionmode,,1,2,2,3,2,5,3,100
sbt-aspectj,sbt-aspectj,,0,0,0,0,1,0,3,1
xapian,xapian,,1,0,2,1,3,3,9,1
facebook-instant-games,facebook-instant-games,,13,9,23,22,33,45,13,1
inertia,inertia,,2,3,1,5,3,6,1,50
java-war,java-war,,0,1,0,1,1,1,3,1
linkedin-plugins,linkedin-plugins,,1,0,1,1,2,2,4,1
cls-compliant,cls-compliant,,1,0,1,1,1,2,8,1
fixed-size-types,fixed-size-types,,0,0,0,0,6,0,9,1
powerpoint-interop,powerpoint-interop,,1,2,1,3,2,4,8,100
rbar,rbar,,0,2,0,2,2,2,4,100
kubernetes-mongodb-sidecar,kubernetes-mongodb-sidecar,,2,0,0,2,1,2,6,1
jstockchart,jstockchart,,0,4,2,4,1,6,1,300
hardening,hardening,,3,2,5,5,2,10,4,1
qvt,qvt,,0,0,0,0,1,0,3,1
shinytree,shinytree,,1,1,0,2,4,2,0,1
audiovideoplayback,audiovideoplayback,,1,0,2,1,2,3,13,1
apple-speech,apple-speech,,0,0,1,0,2,1,13,1
xendesktop,xendesktop,,0,0,0,0,3,0,8,1
anydac,anydac,,1,0,2,1,4,3,9,1
browser-feature-detection,browser-feature-detection,,0,3,1,3,2,4,1,200
datapager,datapager,,0,0,2,0,1,2,8,1
clojuresque,clojuresque,,0,0,0,0,1,0,2,1
syndication-feed,syndication-feed,,1,0,2,1,4,3,8,1
fnfilter,fnfilter,,0,0,0,0,1,0,1,1
ajax-forms,ajax-forms,,0,0,0,0,4,0,4,1
lfsr,lfsr,,1,1,1,2,3,3,0,1
xml-generation,xml-generation,,0,2,0,2,3,2,3,100
pagerfanta,pagerfanta,,1,1,4,2,5,6,4,1
ionic-plugins,ionic-plugins,,5,4,9,9,5,18,1,1
kapua,kapua,,0,1,0,1,1,1,3,1
bonobo-etl,bonobo-etl,,2,1,3,3,10,6,0,1
wedeploy,wedeploy,,0,0,0,0,1,0,4,1
pootle,pootle,,0,0,0,0,1,0,6,1
git-am,git-am,,2,1,3,3,4,6,6,1
impresspages,impresspages,,0,0,2,0,1,2,4,1
compound-key,compound-key,,1,0,1,1,3,2,3,1
approval-tests,approval-tests,,0,1,1,1,2,2,8,1
tikv,tikv,,3,1,2,4,6,6,4,1
pd,pd,,2,2,2,4,14,6,0,1
powershell-studio,powershell-studio,,1,2,0,3,2,3,8,100
.net-client-profile,.net-client-profile,,0,1,0,1,1,1,8,1
underarmour,underarmour,,0,0,0,0,1,0,0,1
concrete5-5.6,concrete5-5.6,,0,0,0,0,1,0,4,1
servicestack-autoquery,servicestack-autoquery,,2,2,2,4,3,6,8,1
wkhttpcookiestore,wkhttpcookiestore,,4,1,0,5,6,5,13,1
touchablewithoutfeedback,touchablewithoutfeedback,,1,2,4,3,6,7,1,100
anonymous-access,anonymous-access,,0,1,1,1,1,2,3,1
sharpnlp,sharpnlp,,0,0,0,0,1,0,0,1
symfony-dependency-injection,symfony-dependency-injection,,1,1,5,2,3,7,4,1
sqldb,sqldb,,0,1,4,1,4,5,8,1
kendo-splitter,kendo-splitter,,1,1,1,2,1,3,1,1
qnx-neutrino,qnx-neutrino,,3,2,7,5,7,12,9,1
blackberry-qnx,blackberry-qnx,,0,0,0,0,2,0,9,1
angular-activatedroute,angular-activatedroute,,10,9,18,19,16,37,1,1
wsgiserver,wsgiserver,,1,1,1,2,2,3,0,1
tcomb,tcomb,,1,0,0,1,7,1,1,1
python-responses,python-responses,,3,1,3,4,5,7,0,1
opengl-2.0,opengl-2.0,,1,1,3,2,3,5,9,1
snoopy,snoopy,,1,0,1,1,1,2,4,1
nsstringencoding,nsstringencoding,,2,0,2,2,5,4,13,1
touch-typing,touch-typing,,0,0,0,0,1,0,8,1
quine,quine,,2,1,3,3,3,6,9,1
django-treebeard,django-treebeard,,1,1,0,2,5,2,0,1
vue-events,vue-events,,6,2,14,8,8,22,1,1
verifiable-c,verifiable-c,,0,0,0,0,1,0,2,1
dsml,dsml,,0,0,0,0,1,0,8,1
sunburnt,sunburnt,,0,0,0,0,2,0,1,1
c#-1.2,c#-1.2,,0,0,1,0,1,1,8,1
crouton-os,crouton-os,,0,0,1,0,1,1,9,1
activityunittestcase,activityunittestcase,,0,0,0,0,1,0,8,1
apache-xml-graphics,apache-xml-graphics,,1,0,1,1,6,2,3,1
system.messaging,system.messaging,,0,0,0,0,1,0,8,1
webmethods-caf,webmethods-caf,,0,0,1,0,2,1,3,1
ios-web-app,ios-web-app,,0,1,4,1,2,5,13,1
oprofile,oprofile,,0,1,0,1,1,1,9,1
apartment-state,apartment-state,,0,1,0,1,1,1,8,1
edmonds-karp,edmonds-karp,,1,0,2,1,2,3,0,1
drawbitmap,drawbitmap,,1,2,3,3,3,6,3,100
spring-cxf,spring-cxf,,0,0,1,0,1,1,3,1
pass-by-const-reference,pass-by-const-reference,,1,0,0,1,2,1,9,1
range-types,range-types,,0,1,1,1,2,2,4,1
test-project,test-project,,0,0,0,0,1,0,8,1
windowinsets,windowinsets,,0,3,3,3,5,6,3,200
qmutex,qmutex,,0,1,2,1,2,3,9,1
protogen,protogen,,1,0,2,1,3,3,8,1
memo,memo,,3,5,4,8,3,12,1,66.666667
ip-protocol,ip-protocol,,0,0,0,0,1,0,9,1
smartmatch,smartmatch,,0,0,1,0,1,1,9,1
native-executable,native-executable,,0,0,0,0,1,0,9,1
cocosbuilder,cocosbuilder,,0,0,1,0,1,1,3,1
sst,sst,,1,0,2,1,2,3,0,1
task-switching,task-switching,,0,0,0,0,1,0,9,1
bootstrap-cards,bootstrap-cards,,0,12,1,12,2,13,1,1100
php-stream-wrappers,php-stream-wrappers,,2,1,4,3,4,7,4,1
grunt-angular-gettext,grunt-angular-gettext,,0,1,0,1,1,1,1,1
string-math,string-math,,0,0,0,0,1,0,0,1
pausing-execution,pausing-execution,,0,1,1,1,2,2,0,1
setwindowlong,setwindowlong,,0,0,1,0,1,1,8,1
flutter-dependencies,flutter-dependencies,,159,118,172,277,88,449,13,1
launching,launching,,1,1,5,2,1,7,3,1
behind,behind,,0,2,1,2,2,3,1,100
forown,forown,,0,0,0,0,2,0,1,1
sparkapi,sparkapi,,0,1,2,1,1,3,2,1
qscopedpointer,qscopedpointer,,0,0,0,0,2,0,9,1
typed-memory-views,typed-memory-views,,0,1,4,1,6,5,0,1
sharejs,sharejs,,0,0,1,0,2,1,1,1
drupal-form-submission,drupal-form-submission,,0,2,0,2,2,2,4,100
hyperapp,hyperapp,,1,1,3,2,4,5,1,1
listpicker,listpicker,,0,1,0,1,1,1,1,1
ebxml,ebxml,,0,0,2,0,4,2,3,1
non-modal,non-modal,,0,1,0,1,4,1,8,1
chronological,chronological,,2,0,1,2,3,3,1,1
custom-cursor,custom-cursor,,0,2,0,2,6,2,1,100
sqldbtype,sqldbtype,,0,0,0,0,2,0,8,1
canexecute,canexecute,,0,1,1,1,4,2,8,1
ioremap,ioremap,,0,0,3,0,1,3,9,1
online-forms,online-forms,,0,0,1,0,2,1,5,1
processors,processors,,0,1,1,1,3,2,3,1
precompiled-binaries,precompiled-binaries,,0,0,0,0,1,0,3,1
mentionsinput.js,mentionsinput.js,,0,0,0,0,2,0,1,1
nsdialogs,nsdialogs,,0,0,0,0,2,0,9,1
exponentjs,exponentjs,,0,0,0,0,2,0,1,1
aeron,aeron,,0,0,2,0,4,2,3,1
lockdown,lockdown,,1,1,2,2,2,4,13,1
cloo,cloo,,0,1,2,1,2,3,0,1
liveview,liveview,,0,1,0,1,3,1,13,1
testfairy,testfairy,,1,0,3,1,4,4,13,1
dart-polymer,dart-polymer,,0,1,0,1,1,1,13,1
ctl,ctl,,2,2,3,4,5,7,4,1
railsapps,railsapps,,0,0,3,0,5,3,12,1
pelias,pelias,,0,0,0,0,1,0,1,1
system.array,system.array,,0,0,1,0,2,1,8,1
aksequencer,aksequencer,,1,1,5,2,9,7,13,1
survivejs,survivejs,,0,0,2,0,2,2,1,1
avrcp,avrcp,,0,1,5,1,5,6,3,1
junit-toolbox,junit-toolbox,,0,0,1,0,3,1,3,1
virtual-file,virtual-file,,1,2,1,3,3,4,9,100
brain.js,brain.js,,11,6,5,17,12,22,0,1
system.type,system.type,,2,0,0,2,5,2,8,1
scala.rx,scala.rx,,1,1,2,2,1,4,2,1
adobe-extension,adobe-extension,,1,0,2,1,3,3,1,1
axuielement,axuielement,,0,1,1,1,2,2,13,1
pyevolve,pyevolve,,0,0,0,0,1,0,0,1
fhs,fhs,,1,0,2,1,1,3,9,1
ecobee,ecobee,,0,0,0,0,2,0,13,1
ecobee-api,ecobee-api,,2,1,0,3,2,3,13,1
ghcjs-dom,ghcjs-dom,,0,0,1,0,1,1,2,1
igbinary,igbinary,,0,0,0,0,1,0,9,1
keyword-spotting,keyword-spotting,,0,0,1,0,1,1,6,1
pyzo,pyzo,,1,1,3,2,1,5,0,1
dns-sd,dns-sd,,2,5,5,7,5,12,9,150
rdo,rdo,,3,1,0,4,2,4,6,1
subst,subst,,3,0,0,3,1,3,0,1
ozone,ozone,,0,0,1,0,2,1,0,1
green-threads,green-threads,,1,0,0,1,2,1,9,1
sqlmap,sqlmap,,1,4,3,5,7,8,4,300
metalanguage,metalanguage,,1,1,2,2,2,4,2,1
classwizard,classwizard,,0,1,0,1,1,1,8,1
congestion-control,congestion-control,,2,1,4,3,4,7,9,1
rollout,rollout,,0,2,5,2,3,7,3,100
expressionvisitor,expressionvisitor,,1,0,4,1,6,5,8,1
dynamic-language-runtime,dynamic-language-runtime,,1,0,1,1,3,2,8,1
redislabs,redislabs,,2,1,1,3,3,4,3,1
tetrahedra,tetrahedra,,0,1,4,1,2,5,0,1
webob,webob,,1,1,0,2,1,2,6,1
magnifier.js,magnifier.js,,1,1,0,2,2,2,4,1
kantu,kantu,,8,9,8,17,2,25,3,12.5
bit.ly,bit.ly,,4,3,5,7,9,12,4,1
gae-module,gae-module,,0,1,3,1,4,4,6,1
eyeglass,eyeglass,,1,0,0,1,1,1,1,1
spatial-regression,spatial-regression,,2,2,1,4,1,5,0,1
webhttpbinding,webhttpbinding,,1,1,3,2,1,5,8,1
parse-sdk-android,parse-sdk-android,,3,1,5,4,2,9,3,1
nsrunningapplication,nsrunningapplication,,1,2,3,3,1,6,13,100
gnash,gnash,,0,0,0,0,1,0,9,1
google-search-appliance,google-search-appliance,,0,1,1,1,2,2,1,1
bitmapeffect,bitmapeffect,,0,1,0,1,2,1,8,1
artificial-life,artificial-life,,3,3,2,6,1,8,0,1
linkedmdb,linkedmdb,,0,0,0,0,1,0,2,1
mmix,mmix,,0,0,1,0,2,1,0,1
instant-run,instant-run,,0,0,4,0,7,4,3,1
failonerror,failonerror,,0,0,1,0,1,1,3,1
status-update-notification,status-update-notification,,1,0,1,1,2,2,13,1
excel-template,excel-template,,1,1,1,2,4,3,5,1
libtiff.net,libtiff.net,,2,2,6,4,6,10,8,1
hwid,hwid,,1,2,2,3,1,5,9,100
jsvc,jsvc,,1,1,3,2,4,5,3,1
empty-class,empty-class,,0,1,1,1,1,2,9,1
zpanel,zpanel,,0,0,0,0,2,0,4,1
tessel,tessel,,0,0,0,0,2,0,9,1
single-source,single-source,,1,0,0,1,2,1,3,1
photran,photran,,0,0,2,0,1,2,3,1
pyobjc,pyobjc,,2,5,8,7,5,15,13,150
paper-dialog,paper-dialog,,2,0,2,2,4,4,1,1
google-play-protect,google-play-protect,,2,2,4,4,5,8,3,1
angular-cli-ghpages,angular-cli-ghpages,,0,1,4,1,6,5,1,1
tablesaw,tablesaw,,0,2,1,2,2,3,3,100
robocode,robocode,,0,1,1,1,2,2,3,1
py-postgresql,py-postgresql,,0,0,1,0,1,1,4,1
eyeshot,eyeshot,,5,4,5,9,5,14,8,1
database-cluster,database-cluster,,3,0,1,3,3,4,4,1
squib,squib,,0,1,1,1,1,2,12,1
polylineoptions,polylineoptions,,2,0,0,2,4,2,1,1
wx.html2,wx.html2,,0,0,1,0,1,1,1,1
method-dispatch,method-dispatch,,3,0,0,3,2,3,0,1
qformlayout,qformlayout,,0,1,3,1,3,4,0,1
haskell-prelude,haskell-prelude,,4,0,2,4,1,6,2,1
tensorflow-gradient,tensorflow-gradient,,4,0,6,4,12,10,0,1
tinytex,tinytex,,6,6,4,12,7,16,0,1
program-structure,program-structure,,0,0,2,0,2,2,9,1
neo4j-javascript,neo4j-javascript,,1,0,0,1,2,1,2,1
python-cursor,python-cursor,,0,0,0,0,3,0,0,1
geogebra,geogebra,,1,0,4,1,1,5,0,1
mousekeyhook,mousekeyhook,,3,0,1,3,1,4,8,1
3d-texture,3d-texture,,0,2,0,2,2,2,9,100
arangoimp,arangoimp,,0,0,1,0,5,1,2,1
workgroup,workgroup,,3,1,2,4,5,6,8,1
drupal-database,drupal-database,,0,0,1,0,6,1,4,1
kubernetes-container,kubernetes-container,,0,2,2,2,3,4,6,100
amazon-s3-select,amazon-s3-select,,5,8,9,13,14,22,6,60
reportviewer2008,reportviewer2008,,0,0,2,0,3,2,8,1
mellanox,mellanox,,1,1,4,2,2,6,9,1
srl,srl,,1,0,1,1,1,2,0,1
kompose,kompose,,4,2,4,6,7,10,6,1
libreadline,libreadline,,5,1,5,6,2,11,0,1
http-status-code-411,http-status-code-411,,0,0,0,0,3,0,4,1
git-sign,git-sign,,0,1,0,1,2,1,6,1
r-library,r-library,,2,0,3,2,5,5,0,1
mysql-5.0,mysql-5.0,,1,1,1,2,2,3,4,1
hoodie,hoodie,,0,0,0,0,1,0,1,1
pagepiling.js,pagepiling.js,,0,1,4,1,4,5,1,1
skylark,skylark,,2,0,3,2,4,5,9,1
partial-response,partial-response,,0,1,1,1,2,2,3,1
express-cassandra,express-cassandra,,3,1,7,4,5,11,2,1
html.textbox,html.textbox,,1,0,0,1,1,1,8,1
unimrcp,unimrcp,,3,1,2,4,2,6,13,1
shouldautorotate,shouldautorotate,,2,0,2,2,2,4,13,1
datadetectortypes,datadetectortypes,,0,0,1,0,3,1,13,1
resulttransformer,resulttransformer,,1,0,0,1,2,1,3,1
documentum6.5,documentum6.5,,1,1,2,2,10,4,16,1
mcollective,mcollective,,1,0,0,1,1,1,6,1
sentence-synthesis,sentence-synthesis,,0,0,1,0,1,1,0,1
location-based-service,location-based-service,,3,1,3,4,1,7,3,1
zend-controller-plugin,zend-controller-plugin,,0,0,1,0,1,1,4,1
wm-touch,wm-touch,,0,0,0,0,1,0,9,1
mysql-error-1451,mysql-error-1451,,0,0,0,0,1,0,4,1
unattend-file,unattend-file,,1,4,2,5,2,7,8,300
gdbm,gdbm,,0,0,2,0,2,2,0,1
apple-touch-icon,apple-touch-icon,,0,1,2,1,1,3,1,1
ngxs,ngxs,,28,30,45,58,51,103,1,7.142857
sdsf,sdsf,,0,0,0,0,1,0,4,1
java-ee-web-profile,java-ee-web-profile,,1,2,1,3,2,4,3,100
customtool,customtool,,0,0,2,0,3,2,8,1
alanning-roles,alanning-roles,,0,0,1,0,3,1,1,1
mrv2,mrv2,,0,0,1,0,2,1,2,1
ms-access-data-macro,ms-access-data-macro,,1,1,3,2,5,5,5,1
android-app-ops,android-app-ops,,0,0,1,0,1,1,3,1
illegal-instruction,illegal-instruction,,2,0,7,2,5,9,0,1
synpdf,synpdf,,0,0,0,0,2,0,9,1
pyranges,pyranges,,0,1,0,1,1,1,0,1
.net-core-2.1,.net-core-2.1,,18,3,88,21,48,109,8,1
yardoc,yardoc,,0,0,1,0,1,1,12,1
record-count,record-count,,0,1,1,1,2,2,4,1
facetime,facetime,,0,2,1,2,2,3,13,100
haskell-streaming,haskell-streaming,,4,0,0,4,5,4,2,1
pygmaps,pygmaps,,0,0,1,0,2,1,0,1
html-5.2,html-5.2,,0,0,0,0,1,0,1,1
jcommander,jcommander,,1,2,1,3,3,4,3,100
common-data-service,common-data-service,,3,4,5,7,4,12,8,33.333333
scriptella,scriptella,,0,0,2,0,1,2,3,1
sharpkml,sharpkml,,0,0,0,0,1,0,8,1
sensorthings,sensorthings,,0,0,0,0,2,0,1,1
jquery-layout,jquery-layout,,1,1,3,2,1,5,1,1
qgraphicswidget,qgraphicswidget,,1,1,2,2,9,4,9,1
user-information-list,user-information-list,,0,0,0,0,3,0,4,1
oracle-agile-plm,oracle-agile-plm,,0,0,0,0,3,0,3,1
scriptignore,scriptignore,,0,0,0,0,1,0,8,1
asp.net-development-serv,asp.net-development-serv,,0,0,1,0,1,1,8,1
kafka-cluster,kafka-cluster,,3,6,3,9,6,12,2,100
tbl-properties,tbl-properties,,0,0,0,0,2,0,2,1
fluentautomation,fluentautomation,,0,0,0,0,1,0,1,1
jukito,jukito,,1,0,1,1,1,2,3,1
designmode,designmode,,0,3,4,3,3,7,5,200
aaa-security-protocol,aaa-security-protocol,,2,0,1,2,2,3,8,1
nspec,nspec,,0,0,2,0,1,2,8,1
cybersource,cybersource,,8,7,11,15,9,26,4,1
slate,slate,,5,3,7,8,5,15,1,1
tbl,tbl,,0,3,1,3,4,4,0,200
intellij-inspections,intellij-inspections,,4,2,7,6,6,13,3,1
gocb,gocb,,1,0,1,1,2,2,6,1
zend-form-collection,zend-form-collection,,0,0,1,0,1,1,4,1
windows-embedded-8,windows-embedded-8,,0,0,0,0,2,0,8,1
stagewebview,stagewebview,,0,0,0,0,1,0,13,1
stagewebviewbridge,stagewebviewbridge,,0,0,0,0,1,0,13,1
liquid-haskell,liquid-haskell,,6,1,7,7,3,14,2,1
vrvideoview,vrvideoview,,3,2,2,5,3,7,3,1
overthere,overthere,,0,0,0,0,1,0,9,1
quartz.net-3.0,quartz.net-3.0,,3,2,2,5,5,7,8,1
read-committed-snapshot,read-committed-snapshot,,0,0,1,0,3,1,4,1
webnms,webnms,,0,0,0,0,2,0,9,1
dtd-parsing,dtd-parsing,,0,1,1,1,3,2,3,1
shutterstock,shutterstock,,2,0,1,2,2,3,4,1
snowballanalyzer,snowballanalyzer,,0,0,0,0,1,0,3,1
snowball-stemmer,snowball-stemmer,,0,0,2,0,2,2,0,1
telerik-datepicker,telerik-datepicker,,1,0,0,1,1,1,8,1
code-assist,code-assist,,2,2,1,4,3,5,3,1
epilogue,epilogue,,1,2,0,3,2,3,1,100
dkms,dkms,,0,1,3,1,1,4,6,1
xslcompiledtransform,xslcompiledtransform,,1,0,3,1,2,4,3,1
fftpack,fftpack,,0,0,0,0,2,0,0,1
visual-leak-detector,visual-leak-detector,,2,0,1,2,3,3,9,1
driveinfo,driveinfo,,0,1,0,1,1,1,8,1
xvcg,xvcg,,0,0,0,0,1,0,9,1
persona,persona,,0,1,3,1,1,4,3,1
clique-problem,clique-problem,,2,1,3,3,3,6,0,1
soap-serialization,soap-serialization,,0,0,0,0,2,0,8,1
audiostreamer,audiostreamer,,0,0,2,0,1,2,1,1
ews-javascript-api,ews-javascript-api,,2,1,0,3,7,3,8,1
scopt,scopt,,2,1,0,3,1,3,2,1
handhelddevice,handhelddevice,,0,0,2,0,2,2,8,1
domainexpiration,domainexpiration,,0,0,0,0,2,0,4,1
filebuf,filebuf,,1,1,0,2,3,2,9,1
nginx-log,nginx-log,,0,0,3,0,2,3,6,1
cognos-determinants,cognos-determinants,,0,0,0,0,1,0,4,1
akoperationgenerator,akoperationgenerator,,0,0,0,0,5,0,13,1
zend-hydrator,zend-hydrator,,2,0,1,2,2,3,4,1
jsxhint,jsxhint,,0,0,0,0,1,0,1,1
fxg,fxg,,0,0,0,0,1,0,13,1
vaapi,vaapi,,9,1,4,10,3,14,13,1
pstats,pstats,,2,0,0,2,2,2,0,1
wiki.js,wiki.js,,0,0,1,0,3,1,6,1
pfloginviewcontroller,pfloginviewcontroller,,2,0,0,2,1,2,13,1
lrs,lrs,,1,2,2,3,3,5,8,100
learning-locker,learning-locker,,0,2,4,2,2,6,8,100
motorola-droid,motorola-droid,,1,0,0,1,1,1,3,1
lightopenid,lightopenid,,0,0,0,0,1,0,13,1
foxit,foxit,,1,1,6,2,13,8,8,1
foxit-reader,foxit-reader,,2,0,2,2,3,4,8,1
open-nfc,open-nfc,,0,0,1,0,1,1,3,1
lanczos,lanczos,,1,0,1,1,5,2,0,1
wcf-client,wcf-client,,2,2,4,4,6,8,8,1
mbrola,mbrola,,0,0,1,0,2,1,0,1
verlet-integration,verlet-integration,,0,2,0,2,2,2,8,100
webtrends,webtrends,,1,0,2,1,2,3,13,1
symfit,symfit,,6,2,4,8,2,12,0,1
mocha-phantomjs,mocha-phantomjs,,0,0,0,0,3,0,1,1
pure-js,pure-js,,1,1,3,2,5,5,1,1
aem-touch-ui,aem-touch-ui,,5,0,5,5,7,10,3,1
private-bower,private-bower,,0,0,2,0,1,2,1,1
identity-operator,identity-operator,,0,1,2,1,1,3,0,1
wevtutil,wevtutil,,0,0,1,0,1,1,8,1
object-identity,object-identity,,0,0,0,0,3,0,0,1
mongo-go,mongo-go,,14,14,19,28,7,47,1,1
autonumeric.js,autonumeric.js,,0,3,2,3,1,5,1,200
translate-toolkit,translate-toolkit,,0,0,1,0,1,1,4,1
topendialog,topendialog,,0,0,0,0,1,0,9,1
amazon-kinesis-agent,amazon-kinesis-agent,,7,1,1,8,3,9,6,1
annotatorjs,annotatorjs,,0,1,3,1,1,4,1,1
ruby-2.5,ruby-2.5,,4,6,6,10,14,16,12,50
send-port,send-port,,1,0,0,1,1,1,8,1
jquery-jscrollpane,jquery-jscrollpane,,0,1,0,1,1,1,1,1
twilio-studio,twilio-studio,,11,14,15,25,9,40,13,27.272727
fnmatch,fnmatch,,0,3,1,3,1,4,0,200
formalchemy,formalchemy,,0,0,0,0,2,0,0,1
display-suite,display-suite,,0,0,0,0,1,0,2,1
stepic,stepic,,0,0,0,0,1,0,0,1
datapersistance,datapersistance,,3,0,3,3,3,6,3,1
background-repeat,background-repeat,,0,0,2,0,3,2,1,1
mobilefirst-analytics,mobilefirst-analytics,,0,0,0,0,2,0,13,1
repository-design,repository-design,,1,0,1,1,3,2,8,1
function-template,function-template,,0,0,0,0,1,0,9,1
worker-process,worker-process,,7,6,3,13,4,16,8,1
luacheck,luacheck,,0,1,2,1,1,3,9,1
conditional-types,conditional-types,,16,11,22,27,22,49,1,1
typescript2.8,typescript2.8,,0,0,4,0,17,4,1,1
nlp-compromise,nlp-compromise,,0,1,1,1,1,2,1,1
phidgets,phidgets,,0,1,0,1,2,1,8,1
spring-faces,spring-faces,,0,0,2,0,1,2,3,1
ide-customization,ide-customization,,0,0,1,0,1,1,4,1
p4java,p4java,,0,0,3,0,4,3,6,1
bixolon-printer,bixolon-printer,,0,3,0,3,4,3,3,200
nullaway,nullaway,,0,0,2,0,2,2,3,1
skmaps,skmaps,,0,2,1,2,4,3,13,100
vue-slider-component,vue-slider-component,,2,2,0,4,3,4,1,1
android-overscoll,android-overscoll,,0,0,0,0,1,0,3,1
unstated,unstated,,5,1,6,6,5,12,1,1
unordered-multimap,unordered-multimap,,0,1,1,1,1,2,9,1
uimotioneffect,uimotioneffect,,0,0,2,0,1,2,13,1
precompiled-templates,precompiled-templates,,0,0,1,0,1,1,9,1
pallet,pallet,,1,0,0,1,1,1,0,1
apache-spark-function,apache-spark-function,,1,1,0,2,2,2,2,1
sonarqube7,sonarqube7,,0,1,4,1,7,5,3,1
sitefinity-feather,sitefinity-feather,,1,0,0,1,3,1,8,1
mido,mido,,2,2,5,4,2,9,0,1
click-counting,click-counting,,0,0,4,0,1,4,1,1
sql-server-2016-sp1,sql-server-2016-sp1,,0,1,1,1,7,2,4,1
cantera,cantera,,0,1,1,1,3,2,0,1
widestring,widestring,,0,0,4,0,5,4,9,1
berkeley-db-xml,berkeley-db-xml,,0,0,1,0,2,1,9,1
domtokenlist,domtokenlist,,0,0,0,0,2,0,1,1
revoke,revoke,,3,3,4,6,6,10,4,1
ampscript,ampscript,,3,5,7,8,8,15,14,66.666667
xact-abort,xact-abort,,0,0,1,0,2,1,4,1
android-9.0-pie,android-9.0-pie,,131,111,179,242,104,421,3,1
fbsdkappinvitecontent,fbsdkappinvitecontent,,0,0,0,0,1,0,13,1
observium,observium,,0,0,0,0,1,0,9,1
radhtmlchart,radhtmlchart,,1,1,2,2,1,4,8,1
tdataset,tdataset,,3,1,1,4,4,5,9,1
bitmapdata,bitmapdata,,2,4,1,6,7,7,8,100
eclipse-mat,eclipse-mat,,1,1,2,2,1,4,3,1
running-object-table,running-object-table,,1,1,3,2,1,5,8,1
hotfolder,hotfolder,,2,0,2,2,1,4,4,1
role-based,role-based,,3,1,3,4,3,7,4,1
qftp,qftp,,0,0,0,0,1,0,9,1
photologue,photologue,,1,1,0,2,1,2,6,1
heartrate,heartrate,,7,3,6,10,9,16,3,1
comdlg32,comdlg32,,0,0,0,0,1,0,9,1
gnu-arm,gnu-arm,,1,2,1,3,5,4,9,100
wp-rewrite,wp-rewrite,,1,0,1,1,1,2,4,1
datascript,datascript,,0,0,0,0,2,0,2,1
modelmetadataprovider,modelmetadataprovider,,0,0,0,0,2,0,8,1
monetjs,monetjs,,1,0,0,1,3,1,2,1
processor-architecture,processor-architecture,,1,0,0,1,2,1,8,1
cfinvoke,cfinvoke,,0,2,1,2,1,3,4,100
tcanvas,tcanvas,,0,3,1,3,2,4,9,200
window-messages,window-messages,,2,1,1,3,2,4,9,1
qactiongroup,qactiongroup,,0,0,0,0,1,0,9,1
fp-ts,fp-ts,,3,0,3,3,4,6,2,1
megabyte,megabyte,,1,0,0,1,2,1,0,1
jemmy,jemmy,,1,0,1,1,2,2,3,1
geojson.net,geojson.net,,0,0,0,0,2,0,8,1
facebook-requests,facebook-requests,,0,0,1,0,1,1,13,1
footprint,footprint,,1,1,1,2,2,3,3,1
seyren,seyren,,0,0,0,0,2,0,6,1
adsense-anchor-ads,adsense-anchor-ads,,1,2,0,3,2,3,3,100
gearvrcontroller,gearvrcontroller,,0,1,0,1,1,1,8,1
android-p-developer-preview,android-p-developer-preview,,0,0,0,0,2,0,3,1
datalength,datalength,,1,0,0,1,2,1,4,1
rsm,rsm,,0,0,1,0,2,1,0,1
graphql-tools,graphql-tools,,12,6,11,18,20,29,1,1
maven-plugin-development,maven-plugin-development,,1,0,0,1,1,1,3,1
2dsphere,2dsphere,,0,1,2,1,3,3,1,1
slashdb,slashdb,,1,0,1,1,6,2,3,1
touchesmoved,touchesmoved,,2,0,3,2,9,5,13,1
sendgrid-rails,sendgrid-rails,,0,0,1,0,2,1,4,1
visual-studio-setup,visual-studio-setup,,0,2,1,2,3,3,8,100
tag-it,tag-it,,1,1,2,2,5,4,1,1
jquery-blockui,jquery-blockui,,1,2,2,3,5,5,1,100
rotten-tomatoes,rotten-tomatoes,,0,0,0,0,1,0,0,1
moleculer,moleculer,,10,7,4,17,1,21,1,1
vim-snipmate,vim-snipmate,,0,1,0,1,1,1,9,1
gtkscrolledwindow,gtkscrolledwindow,,0,0,2,0,2,2,9,1
bamboo-specs,bamboo-specs,,0,0,4,0,2,4,6,1
new-object,new-object,,2,1,2,3,5,5,8,1
indic,indic,,1,0,1,1,1,2,1,1
tcp-port,tcp-port,,0,0,2,0,1,2,3,1
undef,undef,,0,2,2,2,2,4,9,100
etetoolkit,etetoolkit,,0,1,0,1,2,1,0,1
window-load,window-load,,1,1,1,2,1,3,1,1
ungit,ungit,,0,0,1,0,1,1,6,1
optical-mark-recognition,optical-mark-recognition,,0,3,0,3,3,3,0,200
perl-ipc-run,perl-ipc-run,,0,0,0,0,2,0,9,1
gpflow,gpflow,,7,7,3,14,4,17,0,1
dropdownchecklist,dropdownchecklist,,0,0,1,0,1,1,1,1
stompjs,stompjs,,0,5,8,5,4,13,3,400
centralized,centralized,,2,1,2,3,6,5,3,1
sharepoint-listtemplate,sharepoint-listtemplate,,0,1,0,1,1,1,8,1
framemaker,framemaker,,0,0,2,0,2,2,3,1
micro-frontend,micro-frontend,,9,12,17,21,2,38,1,33.333333
system.configuration,system.configuration,,2,1,3,3,3,6,8,1
jump-list,jump-list,,1,3,1,4,3,5,8,200
node-pre-gyp,node-pre-gyp,,4,3,5,7,5,12,1,1
bcdstore,bcdstore,,0,0,0,0,1,0,9,1
featuretools,featuretools,,11,17,29,28,12,57,0,54.545455
completion-stage,completion-stage,,3,2,8,5,9,13,3,1
spring-nature,spring-nature,,0,0,0,0,1,0,3,1
directory-permissions,directory-permissions,,1,1,2,2,2,4,4,1
blast.js,blast.js,,0,0,3,0,2,3,1,1
dimension-reduction,dimension-reduction,,1,4,4,5,2,9,0,300
gameplay3d,gameplay3d,,0,0,0,0,1,0,9,1
skeleton-code,skeleton-code,,2,0,0,2,3,2,1,1
dc,dc,,0,0,0,0,3,0,9,1
lepl,lepl,,0,0,0,0,1,0,0,1
xmerl,xmerl,,0,0,0,0,1,0,2,1
interlocked-increment,interlocked-increment,,0,0,0,0,2,0,8,1
django-drf-renderer,django-drf-renderer,,0,1,1,1,2,2,0,1
javax.swing.text,javax.swing.text,,0,0,0,0,1,0,3,1
haskell-mode,haskell-mode,,1,2,1,3,2,4,9,100
uap,uap,,0,0,0,0,3,0,8,1
aether,aether,,3,1,2,4,6,6,3,1
mvapich2,mvapich2,,0,1,3,1,2,4,9,1
angular-material-theming,angular-material-theming,,3,2,7,5,6,12,1,1
batch-fetching,batch-fetching,,1,0,0,1,2,1,3,1
evolution-cms,evolution-cms,,1,0,0,1,1,1,4,1
flutter-desktop,flutter-desktop,,3,11,2,14,1,16,13,266.666667
comadmin,comadmin,,0,0,0,0,1,0,8,1
powershell-sdk,powershell-sdk,,4,0,1,4,2,5,8,1
android-4.0-ice-cream-sandwich,android-4.0-ice-cream-sandwich,,0,0,0,0,2,0,3,1
hibernate.cfg.xml,hibernate.cfg.xml,,1,0,3,1,3,4,3,1
pffile,pffile,,0,1,6,1,2,7,13,1
kafka-rest,kafka-rest,,12,9,12,21,9,33,2,1
motion-blur,motion-blur,,1,0,1,1,1,2,0,1
luainterface,luainterface,,0,0,0,0,1,0,8,1
nscollectionviewlayout,nscollectionviewlayout,,0,1,2,1,2,3,13,1
pasteboard,pasteboard,,1,0,2,1,2,3,13,1
name-matching,name-matching,,2,0,0,2,1,2,0,1
lifx,lifx,,3,1,1,4,3,5,13,1
broadband,broadband,,0,0,1,0,1,1,3,1
ternary-tree,ternary-tree,,2,0,0,2,1,2,0,1
pyrocms-lex,pyrocms-lex,,0,0,0,0,1,0,4,1
plistbuddy,plistbuddy,,1,2,0,3,4,3,13,100
jquery-ui-map,jquery-ui-map,,0,0,0,0,1,0,1,1
cefglue,cefglue,,0,0,2,0,1,2,8,1
svg-morphing,svg-morphing,,0,2,0,2,1,2,1,100
windows-explorer-integration,windows-explorer-integration,,1,1,0,2,1,2,9,1
sciruby,sciruby,,0,0,5,0,1,5,12,1
commons-compress,commons-compress,,0,0,0,0,1,0,3,1
jsr330,jsr330,,1,0,3,1,6,4,3,1
xpce,xpce,,1,1,1,2,2,3,0,1
systemmenu,systemmenu,,1,0,0,1,1,1,8,1
nomachine,nomachine,,1,0,2,1,1,3,13,1
modality,modality,,1,0,2,1,3,3,3,1
synchronized-block,synchronized-block,,0,1,1,1,6,2,3,1
grunt-contrib-requirejs,grunt-contrib-requirejs,,0,0,1,0,1,1,1,1
qmediacontent,qmediacontent,,0,1,1,1,1,2,9,1
sane,sane,,1,0,4,1,2,5,0,1
appliance,appliance,,1,0,2,1,2,3,0,1
typedjs,typedjs,,1,0,0,1,3,1,1,1
appium-desktop,appium-desktop,,16,19,36,35,30,71,3,18.75
algebraic-number,algebraic-number,,0,0,0,0,1,0,0,1
transducer-machines,transducer-machines,,0,1,0,1,1,1,0,1
service-composition,service-composition,,0,0,0,0,1,0,3,1
web-safe-colors,web-safe-colors,,0,0,0,0,1,0,1,1
webix-treetable,webix-treetable,,1,0,1,1,2,2,1,1
swoole,swoole,,2,6,7,8,9,15,4,200
react-canvas,react-canvas,,0,1,1,1,2,2,1,1
autogrow,autogrow,,0,0,0,0,2,0,1,1
microsoft-graph-batch,microsoft-graph-batch,,0,1,2,1,2,3,8,1
ilgenerator,ilgenerator,,0,0,4,0,3,4,8,1
office-online-server,office-online-server,,2,2,4,4,5,8,8,1
ios-settings-bundle,ios-settings-bundle,,1,0,0,1,3,1,13,1
kendo-slider,kendo-slider,,0,0,0,0,2,0,1,1
re-python,re-python,,1,0,3,1,4,4,0,1
getpicture,getpicture,,0,0,0,0,2,0,1,1
link-checking,link-checking,,0,0,0,0,1,0,4,1
android-highcharts,android-highcharts,,0,0,0,0,2,0,3,1
mopidy,mopidy,,1,0,1,1,2,2,6,1
winium,winium,,12,10,24,22,11,46,3,1
multiple-cursor,multiple-cursor,,2,2,2,4,3,6,4,1
dotcmis,dotcmis,,1,0,0,1,3,1,3,1
jquery-tags-input,jquery-tags-input,,1,2,0,3,3,3,1,100
dask.distributed,dask.distributed,,0,0,0,0,6,0,0,1
dask-kubernetes,dask-kubernetes,,1,2,1,3,2,4,0,100
dupfinder,dupfinder,,0,0,0,0,1,0,8,1
learn-ruby-on-rails,learn-ruby-on-rails,,0,0,0,0,1,0,12,1
performance-measuring,performance-measuring,,2,2,1,4,2,5,0,1
merge-strategy,merge-strategy,,4,0,0,4,2,4,6,1
maven-frontend-plugin,maven-frontend-plugin,,3,1,3,4,2,7,3,1
ios-targets,ios-targets,,0,1,3,1,4,4,13,1
mouse-hook,mouse-hook,,1,1,3,2,3,5,8,1
pageant,pageant,,0,2,2,2,1,4,9,100
mod-expires,mod-expires,,2,1,4,3,4,7,4,1
nzsql,nzsql,,0,2,4,2,3,6,4,100
uidocumentmenuviewcontroller,uidocumentmenuviewcontroller,,0,0,4,0,2,4,13,1
akoperation,akoperation,,0,0,0,0,2,0,13,1
weblog,weblog,,1,0,7,1,2,8,3,1
systimestamp,systimestamp,,2,0,0,2,3,2,4,1
ettercap,ettercap,,1,0,2,1,1,3,6,1
powerpoint-2007,powerpoint-2007,,1,0,0,1,1,1,5,1
datalore,datalore,,1,0,0,1,1,1,0,1
moonapns,moonapns,,0,0,0,0,2,0,8,1
dart-http,dart-http,,1,10,5,11,6,16,13,900
appsdk2,appsdk2,,0,0,0,0,2,0,3,1
zend-framework-modules,zend-framework-modules,,0,0,0,0,2,0,4,1
ara,ara,,1,0,1,1,1,2,4,1
raw-loader,raw-loader,,2,2,1,4,5,5,1,1
filewalker,filewalker,,1,0,0,1,1,1,1,1
jpf,jpf,,1,0,1,1,1,2,3,1
visual-c++-2005,visual-c++-2005,,0,0,0,0,1,0,9,1
device-compatibility,device-compatibility,,2,1,0,3,1,3,3,1
graphengine,graphengine,,0,0,0,0,2,0,3,1
3cx,3cx,,1,1,1,2,3,3,8,1
httpinvoker,httpinvoker,,3,0,2,3,1,5,3,1
spectra,spectra,,3,2,2,5,5,7,0,1
flesch-kincaid,flesch-kincaid,,0,0,0,0,3,0,0,1
custom-configuration,custom-configuration,,0,1,4,1,1,5,8,1
uibarbuttonitemstyle,uibarbuttonitemstyle,,0,0,1,0,1,1,13,1
loginstatus,loginstatus,,0,0,0,0,2,0,1,1
sharpcompress,sharpcompress,,2,0,0,2,5,2,8,1
ember-2.0.0,ember-2.0.0,,1,0,2,1,5,3,1,1
fma,fma,,2,4,3,6,4,9,9,100
notorm,notorm,,1,0,1,1,1,2,4,1
slidingexpiration,slidingexpiration,,0,0,0,0,2,0,8,1
sqlmx,sqlmx,,1,0,1,1,2,2,3,1
language-recognition,language-recognition,,1,0,2,1,2,3,0,1
form-editing,form-editing,,0,0,0,0,2,0,8,1
cxprovider,cxprovider,,2,0,2,2,2,4,13,1
spdlog,spdlog,,2,4,9,6,4,15,9,100
refile,refile,,3,1,4,4,2,8,12,1
external-process,external-process,,0,1,5,1,3,6,0,1
paradox-scripting,paradox-scripting,,0,0,0,0,1,0,0,1
javafx-webview,javafx-webview,,2,2,7,4,5,11,3,1
django-project-architect,django-project-architect,,0,0,2,0,1,2,0,1
embedded-browser,embedded-browser,,0,1,2,1,4,3,9,1
powerbi-mobile,powerbi-mobile,,0,0,4,0,3,4,5,1
speakeasy,speakeasy,,0,0,1,0,2,1,1,1
texture1d,texture1d,,0,0,0,0,2,0,9,1
azure-service-runtime,azure-service-runtime,,0,1,2,1,1,3,8,1
scalameter,scalameter,,0,0,1,0,1,1,2,1
skos,skos,,1,0,0,1,5,1,2,1
http-signature,http-signature,,0,0,0,0,1,0,1,1
webcontext,webcontext,,1,0,1,1,1,2,1,1
python-visual,python-visual,,1,0,0,1,1,1,0,1
swift-nio,swift-nio,,0,4,2,4,3,6,13,300
exceptionfilterattribute,exceptionfilterattribute,,0,1,4,1,4,5,8,1
group-project,group-project,,0,0,0,0,1,0,9,1
word-style,word-style,,3,0,4,3,4,7,5,1
smart-punctuation,smart-punctuation,,0,0,0,0,1,0,0,1
ion-navbar,ion-navbar,,0,1,2,1,2,3,1,1
php-toolkit,php-toolkit,,1,1,2,2,4,4,14,1
uisearchdisplaycontroller,uisearchdisplaycontroller,,1,2,0,3,1,3,13,100
chrome-profile,chrome-profile,,1,4,2,5,2,7,3,300
snowflake-schema,snowflake-schema,,1,4,5,5,4,10,4,300
stylebot,stylebot,,0,0,1,0,1,1,1,1
clusterize,clusterize,,1,2,3,3,2,6,1,100
ixmldomelement,ixmldomelement,,0,0,1,0,5,1,3,1
relative-addressing,relative-addressing,,0,0,0,0,2,0,1,1
vegas-viz,vegas-viz,,1,0,3,1,6,4,2,1
remoteserviceexception,remoteserviceexception,,0,1,2,1,5,3,3,1
insertion-order,insertion-order,,0,0,1,0,2,1,3,1
phonenumberutils,phonenumberutils,,0,1,2,1,2,3,3,1
laravel-filters,laravel-filters,,0,0,1,0,2,1,4,1
prototype-chosen,prototype-chosen,,0,0,0,0,1,0,1,1
preferredsize,preferredsize,,0,1,0,1,2,1,3,1
getresponsestream,getresponsestream,,0,0,1,0,1,1,8,1
postgres-9.6,postgres-9.6,,10,6,13,16,18,29,4,1
lifecycle-hook,lifecycle-hook,,2,1,6,3,9,9,1,1
rgs,rgs,,0,0,0,0,1,0,9,1
tinkergraph,tinkergraph,,1,3,6,4,4,10,2,200
average-precision,average-precision,,2,1,4,3,1,7,0,1
resilience4j,resilience4j,,4,9,7,13,2,20,3,125
out-of-process,out-of-process,,1,3,1,4,2,5,8,200
resharper-c++,resharper-c++,,0,0,1,0,3,1,9,1
micrium,micrium,,0,1,0,1,1,1,9,1
changetype,changetype,,0,0,1,0,2,1,4,1
handle-leak,handle-leak,,1,0,0,1,1,1,8,1
stdbool,stdbool,,0,1,0,1,2,1,9,1
isinrole,isinrole,,0,0,1,0,3,1,8,1
phonegap-gmaps-plugin,phonegap-gmaps-plugin,,1,0,0,1,1,1,1,1
jamaicavm,jamaicavm,,0,0,1,0,1,1,3,1
solr4j,solr4j,,0,0,0,0,1,0,2,1
synchronizing,synchronizing,,0,1,1,1,2,2,3,1
jquery-ui-progressbar,jquery-ui-progressbar,,1,0,0,1,2,1,1,1
greybox,greybox,,1,0,1,1,1,2,3,1
double-brace-initialize,double-brace-initialize,,1,0,0,1,1,1,3,1
bootstrap-form-helper,bootstrap-form-helper,,1,1,3,2,2,5,1,1
yamlbeans,yamlbeans,,0,0,3,0,1,3,3,1
dta,dta,,0,2,1,2,2,3,0,100
pact-go,pact-go,,0,1,1,1,1,2,3,1
operational-transform,operational-transform,,0,0,0,0,2,0,0,1
usage-tracking,usage-tracking,,0,0,0,0,2,0,3,1
aspose.barcode,aspose.barcode,,0,0,0,0,1,0,8,1
polarization,polarization,,0,0,0,0,1,0,0,1
doxywizard,doxywizard,,0,0,2,0,4,2,9,1
symfony-2.5,symfony-2.5,,1,0,2,1,3,3,4,1
running-other-programs,running-other-programs,,0,1,0,1,1,1,0,1
memory-pool,memory-pool,,1,1,3,2,6,5,9,1
cloudflare-workers,cloudflare-workers,,8,8,10,16,12,26,4,1
nsrangeexception,nsrangeexception,,0,2,3,2,3,5,13,100
haskell-linear,haskell-linear,,0,0,0,0,1,0,2,1
embedded-osgi,embedded-osgi,,0,2,3,2,1,5,3,100
ratecard-api,ratecard-api,,2,0,0,2,4,2,8,1
implicit-typing,implicit-typing,,0,0,1,0,1,1,13,1
moveit,moveit,,4,4,6,8,9,14,9,1
vmt,vmt,,0,0,2,0,1,2,9,1
eris,eris,,2,1,0,3,2,3,1,1
launchdagent,launchdagent,,0,0,0,0,2,0,13,1
ionicsecurity,ionicsecurity,,0,1,0,1,1,1,13,1
heroku-ssl,heroku-ssl,,1,0,1,1,3,2,1,1
pygmo,pygmo,,0,2,4,2,3,6,0,100
oshi,oshi,,1,1,1,2,2,3,3,1
gitlab-8,gitlab-8,,0,0,1,0,5,1,6,1
clint,clint,,0,0,0,0,2,0,0,1
cognito,cognito,,0,0,3,0,50,3,6,1
aws-userpools,aws-userpools,,14,12,30,26,34,56,6,1
microsoft.bcl,microsoft.bcl,,0,0,0,0,1,0,8,1
boost-tuples,boost-tuples,,0,0,0,0,2,0,9,1
mime-filter,mime-filter,,0,0,0,0,1,0,2,1
nutch2,nutch2,,1,3,7,4,11,11,2,200
manageiq,manageiq,,2,1,3,3,3,6,12,1
cachestorage,cachestorage,,3,3,11,6,5,17,1,1
sencha-cmd5,sencha-cmd5,,0,0,0,0,1,0,1,1
apache-cloudstack,apache-cloudstack,,3,1,2,4,5,6,3,1
signpost,signpost,,0,1,2,1,2,3,4,1
cvi,cvi,,0,1,2,1,1,3,9,1
composite-index,composite-index,,5,1,0,6,5,6,4,1
kubernetes-secrets,kubernetes-secrets,,14,15,20,29,14,49,6,7.142857
livegraph,livegraph,,0,1,5,1,4,6,0,1
member-enumeration,member-enumeration,,2,0,1,2,1,3,8,1
locationmatch,locationmatch,,0,1,1,1,2,2,4,1
message-type,message-type,,0,0,0,0,1,0,4,1
nvp,nvp,,0,0,1,0,4,1,4,1
uiactivitycontroller,uiactivitycontroller,,2,0,2,2,1,4,13,1
operational,operational,,0,1,0,1,2,1,3,1
system.version,system.version,,0,0,0,0,1,0,8,1
alignas,alignas,,0,3,3,3,2,6,9,200
seq2seq,seq2seq,,39,39,55,78,51,133,0,1
jsystem,jsystem,,0,0,1,0,4,1,3,1
annox,annox,,0,0,0,0,1,0,3,1
confluent-platform,confluent-platform,,2,10,2,12,3,14,2,400
rook,rook,,5,5,0,10,2,10,6,1
nhibernate-burrow,nhibernate-burrow,,0,0,0,0,1,0,8,1
ubuntu-18.04,ubuntu-18.04,,379,356,596,735,256,1331,9,1
gutter,gutter,,2,1,4,3,7,7,1,1
simplefilevisitor,simplefilevisitor,,1,0,0,1,1,1,3,1
beyondcompare3,beyondcompare3,,0,0,1,0,1,1,6,1
trepan,trepan,,0,1,0,1,1,1,0,1
authenticity-token,authenticity-token,,1,2,3,3,5,6,12,100
ngx-bootstrap-popover,ngx-bootstrap-popover,,0,2,0,2,2,2,1,100
terr,terr,,0,2,2,2,9,4,0,100
akoscillator,akoscillator,,0,0,0,0,2,0,13,1
dlradiobutton,dlradiobutton,,1,2,1,3,1,4,13,100
pycxx,pycxx,,1,0,0,1,1,1,0,1
pycxsimulator,pycxsimulator,,0,0,0,0,1,0,0,1
qtdbus,qtdbus,,1,2,3,3,2,6,9,100
model-mommy,model-mommy,,1,1,3,2,2,5,0,1
alarms,alarms,,0,0,0,0,4,0,3,1
exit-intent,exit-intent,,0,0,0,0,2,0,1,1
login-attempts,login-attempts,,0,0,1,0,4,1,4,1
trollop,trollop,,0,0,0,0,1,0,12,1
pngquant,pngquant,,2,2,1,4,4,5,1,1
rfnoc,rfnoc,,0,0,0,0,1,0,0,1
create-react-kotlin-app,create-react-kotlin-app,,1,0,3,1,3,4,3,1
entityresolver,entityresolver,,2,1,1,3,2,4,8,1
systemmanagement,systemmanagement,,0,1,0,1,1,1,8,1
yesod-julius,yesod-julius,,0,0,0,0,1,0,2,1
netmon,netmon,,1,0,0,1,1,1,6,1
wsaasyncselect,wsaasyncselect,,0,0,0,0,1,0,9,1
avmetadataitem,avmetadataitem,,0,0,1,0,1,1,13,1
rfc2616,rfc2616,,0,2,0,2,2,2,3,100
evaluation-function,evaluation-function,,0,0,0,0,1,0,0,1
infopath-forms-services,infopath-forms-services,,1,1,3,2,1,5,8,1
yajsw,yajsw,,0,1,1,1,2,2,3,1
nested-controls,nested-controls,,0,0,2,0,1,2,8,1
dynamodb-queries,dynamodb-queries,,67,72,83,139,41,222,6,7.462687
react-native-tabnavigator,react-native-tabnavigator,,5,15,16,20,24,36,1,200
mediadevices,mediadevices,,9,12,11,21,6,32,1,33.333333
jwt-simple,jwt-simple,,1,0,1,1,3,2,1,1
richpush,richpush,,0,2,1,2,4,3,13,100
ng2-image-upload,ng2-image-upload,,0,0,1,0,1,1,1,1
github-linguist,github-linguist,,2,1,4,3,4,7,6,1
mysqlrouter,mysqlrouter,,0,1,0,1,2,1,4,1
amp-list,amp-list,,7,4,9,11,19,20,1,1
icingaweb,icingaweb,,0,0,1,0,2,1,6,1
cycript,cycript,,1,2,1,3,1,4,13,100
helmfile,helmfile,,1,4,5,5,2,10,6,300
magento-1.9.2.1,magento-1.9.2.1,,0,0,1,0,1,1,4,1
qdbusxml2cpp,qdbusxml2cpp,,0,0,0,0,1,0,9,1
css-print,css-print,,5,3,8,8,5,16,1,1
lua-ngx-module,lua-ngx-module,,3,0,1,3,2,4,6,1
tbucketlist,tbucketlist,,0,0,0,0,1,0,6,1
attoparsec,attoparsec,,1,1,2,2,9,4,2,1
communication-diagram,communication-diagram,,0,1,0,1,2,1,3,1
map-force,map-force,,1,0,3,1,2,4,3,1
hyperon,hyperon,,0,0,0,0,2,0,3,1
pangocairo,pangocairo,,1,1,1,2,3,3,9,1
coderunner,coderunner,,2,1,3,3,5,6,0,1
twitter-bootstrap-rails,twitter-bootstrap-rails,,0,0,1,0,2,1,12,1
armclang,armclang,,0,1,2,1,3,3,9,1
evil-dicom,evil-dicom,,1,1,2,2,1,4,8,1
codesmith,codesmith,,1,2,2,3,3,5,8,100
.nettiers,.nettiers,,0,1,2,1,1,3,8,1
azure-machine-learning-service,azure-machine-learning-service,,19,30,5,49,1,54,8,57.894737
http-unit,http-unit,,0,1,3,1,3,4,3,1
vyper,vyper,,0,2,1,2,3,3,6,100
ethereumclassic,ethereumclassic,,1,2,0,3,1,3,6,100
angular2-bootstrapping,angular2-bootstrapping,,0,0,0,0,1,0,1,1
zigzag,zigzag,,2,0,2,2,3,4,0,1
processmodel,processmodel,,0,0,2,0,1,2,8,1
c++builder-xe4,c++builder-xe4,,0,0,0,0,1,0,9,1
mvxlistview,mvxlistview,,0,1,1,1,2,2,8,1
io-socket,io-socket,,0,1,6,1,3,7,1,1
spark-ui,spark-ui,,7,1,4,8,7,12,2,1
ubikloadpack,ubikloadpack,,0,0,0,0,5,0,3,1
openpdf,openpdf,,3,5,5,8,2,13,8,66.666667
geo-replication,geo-replication,,2,0,3,2,3,5,8,1
pdf2data,pdf2data,,0,0,1,0,1,1,8,1
contactsui,contactsui,,0,2,1,2,2,3,13,100
pivotal-tc,pivotal-tc,,1,1,1,2,2,3,3,1
azure-web-app-firewall,azure-web-app-firewall,,1,1,4,2,3,6,8,1
djcelery,djcelery,,1,1,9,2,3,11,0,1
xpcom,xpcom,,1,3,0,4,3,4,1,200
inherited-widget,inherited-widget,,5,2,11,7,6,18,13,1
trusted-web-activity,trusted-web-activity,,14,19,7,33,4,40,3,35.714286
sharpspring,sharpspring,,0,1,0,1,1,1,1,1
nuget-package-explorer,nuget-package-explorer,,2,2,2,4,3,6,8,1
radmenu,radmenu,,0,0,1,0,1,1,8,1
pkce,pkce,,5,6,7,11,3,18,4,20
lstlisting,lstlisting,,0,1,0,1,3,1,0,1
custom-search-provider,custom-search-provider,,0,1,0,1,2,1,9,1
android-mms,android-mms,,1,2,4,3,2,7,3,100
gameanalytics,gameanalytics,,1,2,2,3,1,5,13,100
brushes,brushes,,0,0,0,0,1,0,1,1
appscale,appscale,,1,0,1,1,2,2,6,1
rpgmakermv,rpgmakermv,,1,4,3,5,2,8,1,300
defaultmutabletreenode,defaultmutabletreenode,,1,1,0,2,3,2,3,1
fastjsonapi,fastjsonapi,,8,2,10,10,3,20,12,1
login-config.xml,login-config.xml,,0,0,0,0,1,0,3,1
aws-parameter-store,aws-parameter-store,,9,8,14,17,4,31,6,1
transformation-matrix,transformation-matrix,,4,1,2,5,2,7,13,1
hyperledger-fabric-ca,hyperledger-fabric-ca,,19,31,70,50,46,120,6,63.157895
bitmap-index,bitmap-index,,0,0,1,0,2,1,4,1
link-grammar,link-grammar,,0,0,0,0,1,0,4,1
dynamictype,dynamictype,,1,4,3,5,3,8,9,300
flutter-layout,flutter-layout,,494,529,604,1023,350,1627,13,7.08502
lua-resty-openidc,lua-resty-openidc,,2,2,0,4,2,4,6,1
editline,editline,,0,1,5,1,4,6,0,1
dynamicparameters,dynamicparameters,,0,2,5,2,5,7,8,100
angular-httpclient-interceptors,angular-httpclient-interceptors,,3,4,4,7,7,11,1,33.333333
snapshot-isolation,snapshot-isolation,,2,1,3,3,2,6,4,1
shopify-template,shopify-template,,32,29,48,61,40,109,1,1
scntechnique,scntechnique,,2,0,3,2,2,5,13,1
motion-game,motion-game,,0,0,0,0,1,0,13,1
javaquery,javaquery,,2,1,0,3,1,3,1,1
viewvc,viewvc,,1,0,0,1,1,1,6,1
google-identity-toolkit,google-identity-toolkit,,0,6,2,6,4,8,13,500
mpeg-la,mpeg-la,,0,0,0,0,1,0,13,1
critical-region,critical-region,,0,0,0,0,1,0,9,1
appannie,appannie,,0,0,1,0,1,1,4,1
linpack,linpack,,1,0,0,1,1,1,0,1
streamline,streamline,,2,1,1,3,2,4,0,1
routedevent,routedevent,,0,0,0,0,1,0,3,1
angular-formbuilder,angular-formbuilder,,13,12,31,25,24,56,1,1
redisgraph,redisgraph,,8,2,4,10,2,14,2,1
mpmediaplayercontroller,mpmediaplayercontroller,,0,1,5,1,2,6,13,1
eto,eto,,0,2,3,2,3,5,8,100
library-design,library-design,,1,3,1,4,6,5,9,200
software-update,software-update,,3,2,0,5,2,5,13,1
jetbrains-toolbox,jetbrains-toolbox,,1,1,2,2,1,4,3,1
astro,astro,,0,0,0,0,1,0,0,1
jreddit,jreddit,,0,0,0,0,1,0,0,1
redditkit,redditkit,,0,1,0,1,1,1,0,1
entityobject,entityobject,,0,1,0,1,2,1,8,1
fxsl,fxsl,,0,0,0,0,1,0,3,1
flightphp,flightphp,,0,0,1,0,4,1,4,1
mindmapping,mindmapping,,0,0,1,0,2,1,0,1
mindmeister,mindmeister,,0,0,0,0,1,0,0,1
gethostbyaddr,gethostbyaddr,,1,0,2,1,2,3,9,1
statusline,statusline,,0,2,0,2,1,2,9,100
chrome-remote-desktop,chrome-remote-desktop,,1,1,1,2,1,3,8,1
drake,drake,,2,3,2,5,4,7,9,50
angular-ui-pagination,angular-ui-pagination,,0,0,1,0,1,1,1,1
commission-junction,commission-junction,,2,0,1,2,1,3,4,1
cj,cj,,0,0,0,0,1,0,4,1
p3p,p3p,,0,1,0,1,1,1,4,1
activerecord-jdbc,activerecord-jdbc,,0,0,1,0,1,1,12,1
xpub,xpub,,0,0,0,0,2,0,6,1
quagga,quagga,,1,3,5,4,1,9,9,200
omnithreadlibrary,omnithreadlibrary,,1,1,3,2,2,5,9,1
slim-2,slim-2,,0,0,1,0,3,1,4,1
reliable-dictionary,reliable-dictionary,,2,0,3,2,3,5,8,1
split-function,split-function,,0,1,0,1,1,1,0,1
struct-member-alignment,struct-member-alignment,,1,3,1,4,2,5,9,200
custom-event,custom-event,,0,0,0,0,1,0,1,1
fallocate,fallocate,,0,1,1,1,2,2,9,1
memory-warning,memory-warning,,1,0,0,1,2,1,13,1
itemcontainerstyle,itemcontainerstyle,,3,0,1,3,2,4,8,1
dtplyr,dtplyr,,0,1,0,1,2,1,0,1
node-java,node-java,,0,0,2,0,3,2,1,1
deferred-loading,deferred-loading,,3,3,10,6,6,16,1,1
uniformgrid,uniformgrid,,3,1,3,4,4,7,8,1
libmemcache,libmemcache,,2,1,0,3,2,3,4,1
dynamic-invoke,dynamic-invoke,,0,0,2,0,2,2,8,1
font-embedding,font-embedding,,0,0,2,0,2,2,8,1
yarn-workspaces,yarn-workspaces,,11,20,25,31,20,56,1,81.818182
eggdrop,eggdrop,,3,1,3,4,2,7,0,1
e57,e57,,0,0,1,0,1,1,9,1
iis-handlers,iis-handlers,,0,0,0,0,1,0,8,1
conservation-laws,conservation-laws,,0,0,0,0,1,0,0,1
slowmotion,slowmotion,,2,0,5,2,3,7,13,1
nextlevel,nextlevel,,0,0,1,0,1,1,13,1
webdrivereventlistener,webdrivereventlistener,,0,1,1,1,2,2,3,1
open-array-parameters,open-array-parameters,,0,0,0,0,2,0,9,1
http-pipelining,http-pipelining,,0,0,1,0,3,1,3,1
thunar,thunar,,0,1,3,1,2,4,9,1
havok,havok,,0,0,0,0,2,0,8,1
xml-error,xml-error,,0,1,0,1,1,1,3,1
assertraises,assertraises,,1,0,1,1,1,2,0,1
http-0.9,http-0.9,,0,0,0,0,1,0,4,1
liberator,liberator,,1,1,1,2,1,3,2,1
xsd-1.0,xsd-1.0,,1,0,5,1,2,6,3,1
ngcomponentrouter,ngcomponentrouter,,0,0,0,0,1,0,1,1
gwt-elemental,gwt-elemental,,0,2,0,2,3,2,3,100
opkg,opkg,,2,4,4,6,3,10,9,100
fmodf,fmodf,,0,0,0,0,1,0,0,1
fill-parent,fill-parent,,1,0,0,1,1,1,3,1
ngdoc,ngdoc,,1,0,3,1,2,4,1,1
ruby-std,ruby-std,,0,0,0,0,1,0,12,1
color-coding,color-coding,,0,2,1,2,2,3,5,100
activemq-cpp,activemq-cpp,,2,1,0,3,5,3,3,1
weak-entity,weak-entity,,0,1,2,1,3,3,4,1
er-modeling,er-modeling,,0,0,1,0,1,1,4,1
countelements,countelements,,0,0,0,0,2,0,0,1
aplpy,aplpy,,0,0,3,0,1,3,0,1
kernel-methods,kernel-methods,,0,0,1,0,2,1,0,1
jquery-2.0,jquery-2.0,,0,0,2,0,1,2,1,1
word-2007,word-2007,,0,1,1,1,1,2,5,1
opencomputers,opencomputers,,2,1,2,3,2,5,9,1
google-maps-drawing,google-maps-drawing,,0,1,0,1,1,1,1,1
event-wait-handle,event-wait-handle,,2,0,0,2,1,2,8,1
form-processing,form-processing,,1,1,1,2,1,3,1,1
wordpress-4.9,wordpress-4.9,,0,0,2,0,1,2,4,1
toybox,toybox,,1,0,1,1,2,2,9,1
webresource.axd,webresource.axd,,0,1,4,1,4,5,8,1
scriptresource.axd,scriptresource.axd,,0,1,1,1,1,2,8,1
ptrdiff-t,ptrdiff-t,,2,0,0,2,2,2,9,1
knox-amazon-s3-client,knox-amazon-s3-client,,0,0,1,0,3,1,6,1
xml-declaration,xml-declaration,,1,0,4,1,1,5,3,1
ora-01735,ora-01735,,0,0,0,0,1,0,4,1
spelevaluationexception,spelevaluationexception,,0,0,0,0,1,0,3,1
luasec,luasec,,0,1,1,1,1,2,9,1
oxid,oxid,,1,1,1,2,1,3,4,1
log4net-filter,log4net-filter,,0,1,3,1,2,4,8,1
gridx,gridx,,1,0,0,1,4,1,1,1
json-native-library,json-native-library,,0,0,0,0,1,0,9,1
aspmenu,aspmenu,,0,0,0,0,2,0,8,1
scikit-plot,scikit-plot,,2,1,1,3,2,4,0,1
ajaxmin,ajaxmin,,1,1,2,2,2,4,8,1
id3-tag,id3-tag,,1,3,4,4,4,8,13,200
repl.it,repl.it,,10,13,22,23,14,45,0,30
ipad-2,ipad-2,,0,0,1,0,1,1,13,1
rethinkdb-ruby,rethinkdb-ruby,,0,0,0,0,1,0,1,1
yup,yup,,45,38,45,83,17,128,1,1
react-native-sectionlist,react-native-sectionlist,,13,16,22,29,19,51,1,23.076923
filehash,filehash,,0,0,0,0,3,0,12,1
ioloop,ioloop,,2,0,3,2,2,5,0,1
basecamp,basecamp,,3,2,7,5,3,12,4,1
extreact,extreact,,3,1,5,4,22,9,1,1
tiles-3,tiles-3,,1,0,3,1,5,4,3,1
upsurge,upsurge,,0,0,0,0,1,0,13,1
mobile-emulator,mobile-emulator,,0,0,1,0,4,1,3,1
periscope,periscope,,0,1,1,1,2,2,13,1
webcontent,webcontent,,0,0,0,0,4,0,5,1
rockmongo,rockmongo,,1,0,0,1,2,1,1,1
nag-fortran,nag-fortran,,0,1,2,1,1,3,9,1
javapolicy,javapolicy,,0,0,1,0,2,1,3,1
sentora,sentora,,0,0,1,0,2,1,4,1
android-sql,android-sql,,1,0,0,1,7,1,3,1
marpa,marpa,,0,0,0,0,4,0,9,1
uclibc,uclibc,,0,2,1,2,8,3,9,100
aem-developer-tools,aem-developer-tools,,0,0,0,0,1,0,8,1
zip-operator,zip-operator,,0,0,1,0,1,1,3,1
napa,napa,,0,1,0,1,1,1,1,1
android-scrollable-tabs,android-scrollable-tabs,,0,0,1,0,4,1,3,1
luminance,luminance,,0,0,2,0,2,2,0,1
perceptual-sdk,perceptual-sdk,,0,0,0,0,1,0,0,1
mxunit,mxunit,,0,0,0,0,1,0,1,1
imagebackground,imagebackground,,8,3,10,11,6,21,1,1
dbclient,dbclient,,1,0,0,1,2,1,9,1
asp.net-placeholder,asp.net-placeholder,,0,0,1,0,2,1,8,1
font-scaling,font-scaling,,2,0,2,2,1,4,1,1
ion-nav,ion-nav,,0,1,1,1,1,2,1,1
shopizer,shopizer,,0,0,0,0,1,0,3,1
dibs,dibs,,0,1,0,1,1,1,1,1
agiletoolkit,agiletoolkit,,0,0,0,0,1,0,3,1
canopy-web-testing,canopy-web-testing,,0,0,1,0,3,1,8,1
appcontainer,appcontainer,,2,1,2,3,1,5,1,1
o365-flow,o365-flow,,0,1,5,1,2,6,8,1
angular-ngfor,angular-ngfor,,7,2,3,9,5,12,1,1
delivery-pipeline,delivery-pipeline,,0,1,1,1,3,2,6,1
android-picture-in-picture,android-picture-in-picture,,6,11,10,17,1,27,3,83.333333
neo4j-traversal-api,neo4j-traversal-api,,0,0,0,0,1,0,2,1
prepareforreuse,prepareforreuse,,2,1,2,3,6,5,13,1
osisoft,osisoft,,4,2,3,6,3,9,5,1
skygear,skygear,,0,0,0,0,3,0,1,1
renesas-rx,renesas-rx,,1,4,2,5,2,7,9,300
nstouch,nstouch,,0,0,0,0,1,0,13,1
strong-named-key,strong-named-key,,0,0,0,0,2,0,8,1
openjpa-maven-plugin,openjpa-maven-plugin,,0,1,0,1,1,1,3,1
isalive,isalive,,0,0,0,0,2,0,9,1
exceptionless,exceptionless,,0,0,0,0,1,0,8,1
cppsqlite,cppsqlite,,0,0,0,0,1,0,6,1
adm-zip,adm-zip,,1,1,0,2,4,2,1,1
arc-diagram,arc-diagram,,0,0,0,0,1,0,0,1
cluster-mode,cluster-mode,,2,1,1,3,3,4,2,1
formattablestring,formattablestring,,0,1,1,1,1,2,8,1
ion-header,ion-header,,0,0,0,0,2,0,1,1
video-gallery,video-gallery,,0,1,0,1,1,1,4,1
software-product-lines,software-product-lines,,0,0,1,0,2,1,6,1
tracd,tracd,,1,0,0,1,1,1,4,1
sitecore-social-connected,sitecore-social-connected,,0,0,0,0,1,0,8,1
runpy,runpy,,0,3,0,3,1,3,0,200
knife-solo,knife-solo,,0,1,0,1,1,1,12,1
windows-2003-webserver,windows-2003-webserver,,0,0,1,0,2,1,8,1
nodevalue,nodevalue,,0,0,1,0,2,1,5,1
mobx-react-form,mobx-react-form,,2,0,3,2,4,5,1,1
redis-ha,redis-ha,,0,0,1,0,1,1,6,1
quay.io,quay.io,,1,1,1,2,2,3,6,1
jscharts,jscharts,,2,0,1,2,4,3,1,1
createtextnode,createtextnode,,1,0,2,1,3,3,1,1
grunt-istanbul,grunt-istanbul,,0,0,0,0,1,0,1,1
csvfix,csvfix,,0,0,0,0,1,0,9,1
geektool,geektool,,0,1,1,1,1,2,13,1
stream-compaction,stream-compaction,,0,0,3,0,1,3,2,1
truestudio,truestudio,,10,4,8,14,10,22,9,1
boost-timer,boost-timer,,0,0,0,0,1,0,9,1
http-status-code-200,http-status-code-200,,3,3,2,6,6,8,4,1
typo3-6.1.x,typo3-6.1.x,,0,0,2,0,3,2,4,1
sharepoint-deployment,sharepoint-deployment,,1,0,1,1,1,2,8,1
webpack-serve,webpack-serve,,1,0,1,1,12,2,1,1
code-templates,code-templates,,1,4,4,5,3,9,3,300
responsetext,responsetext,,0,2,2,2,4,4,1,100
pointcuts,pointcuts,,0,0,0,0,2,0,3,1
hubflow,hubflow,,0,0,0,0,2,0,6,1
vscode-eslint,vscode-eslint,,0,1,1,1,1,2,9,1
paperdb,paperdb,,0,0,0,0,1,0,3,1
process-monitor,process-monitor,,0,1,0,1,2,1,9,1
notesview,notesview,,0,0,0,0,4,0,5,1
spdf,spdf,,2,0,0,2,2,2,0,1
ngx-modal,ngx-modal,,1,1,2,2,5,4,1,1
epicor10,epicor10,,1,0,2,1,4,3,4,1
ldap-client,ldap-client,,1,0,1,1,2,2,8,1
source-filter,source-filter,,0,0,0,0,1,0,13,1
dotnet-core-pack,dotnet-core-pack,,1,1,6,2,5,8,8,1
xcplayground,xcplayground,,2,1,2,3,3,5,13,1
ti-dsp,ti-dsp,,0,0,0,0,1,0,9,1
webpack-splitchunks,webpack-splitchunks,,13,16,21,29,6,50,1,23.076923
clearcanvas,clearcanvas,,1,0,0,1,3,1,0,1
pushstream,pushstream,,0,0,0,0,1,0,3,1
sfml.net,sfml.net,,1,1,3,2,4,5,8,1
dynamic-ip,dynamic-ip,,1,1,2,2,4,4,9,1
vehicle-routing,vehicle-routing,,10,13,16,23,4,39,0,30
background-transfer,background-transfer,,0,0,1,0,2,1,8,1
vue-validator,vue-validator,,0,0,0,0,2,0,1,1
fluid-images,fluid-images,,0,0,2,0,1,2,1,1
page-fragments,page-fragments,,1,0,0,1,1,1,3,1
foxitembeddedsdk,foxitembeddedsdk,,0,0,2,0,1,2,8,1
gamut,gamut,,0,1,0,1,1,1,0,1
dbms-crypto,dbms-crypto,,1,0,2,1,4,3,4,1
snk,snk,,1,0,4,1,2,5,8,1
openprocess,openprocess,,0,1,1,1,3,2,9,1
acts-as-list,acts-as-list,,2,0,4,2,2,6,12,1
prestashop-helper-classes,prestashop-helper-classes,,1,0,2,1,2,3,4,1
optimizer-hints,optimizer-hints,,0,1,0,1,1,1,4,1
paramquery,paramquery,,2,0,3,2,4,5,1,1
tracking.js,tracking.js,,1,0,8,1,1,9,1,1
speed-dial,speed-dial,,1,0,0,1,1,1,3,1
android-firmware,android-firmware,,0,0,2,0,5,2,3,1
figma-api,figma-api,,2,2,0,4,1,4,1,1
dbgeography,dbgeography,,3,0,1,3,6,4,8,1
document-based-database,document-based-database,,0,0,1,0,1,1,8,1
acumos,acumos,,2,1,4,3,2,7,0,1
rendered-attribute,rendered-attribute,,0,0,2,0,2,2,3,1
fromjson,fromjson,,3,3,4,6,2,10,3,1
gcj,gcj,,0,0,0,0,4,0,9,1
qwraps2,qwraps2,,2,2,4,4,1,8,0,1
yank,yank,,0,0,1,0,3,1,9,1
nodobjc,nodobjc,,0,0,0,0,1,0,13,1
apache-commons-dateutils,apache-commons-dateutils,,1,0,0,1,2,1,3,1
fudge,fudge,,0,0,0,0,1,0,0,1
flowable,flowable,,17,6,10,23,9,33,3,1
x-tag,x-tag,,0,0,0,0,1,0,1,1
unetstack,unetstack,,3,5,1,8,1,9,3,66.666667
annotatedtimeline,annotatedtimeline,,0,0,0,0,1,0,1,1
h.323,h.323,,0,0,3,0,1,3,13,1
thunderbird-addon,thunderbird-addon,,6,3,7,9,3,16,4,1
datadesign,datadesign,,1,0,0,1,1,1,9,1
opengts,opengts,,0,0,1,0,1,1,6,1
documentum-dfs,documentum-dfs,,0,2,0,2,10,2,16,100
documentum7.3,documentum7.3,,0,0,3,0,7,3,16,1
kiwi,kiwi,,2,0,7,2,2,9,6,1
gs1-datamatrix,gs1-datamatrix,,3,2,5,5,2,10,3,1
android-applicationrecord,android-applicationrecord,,0,0,0,0,2,0,3,1
cloveretl,cloveretl,,0,2,1,2,3,3,4,100
skobbler-maps,skobbler-maps,,1,1,0,2,2,2,13,1
koa-session,koa-session,,1,1,0,2,3,2,1,1
robotframework-sshlibrary,robotframework-sshlibrary,,0,0,3,0,7,3,3,1
historical-db,historical-db,,3,0,5,3,4,8,4,1
netmodules,netmodules,,1,0,0,1,1,1,8,1
pushbots,pushbots,,0,0,1,0,1,1,1,1
sweet.js,sweet.js,,1,0,2,1,2,3,1,1
angularjs-apply,angularjs-apply,,0,0,0,0,1,0,1,1
heic,heic,,6,3,8,9,7,17,13,1
rexcel,rexcel,,0,0,0,0,2,0,5,1
filenet-ce-sql,filenet-ce-sql,,0,0,2,0,2,2,15,1
fiware-poi,fiware-poi,,0,0,0,0,1,0,6,1
powershell-jobs,powershell-jobs,,2,2,1,4,5,5,8,1
targetinvocationexception,targetinvocationexception,,0,1,2,1,4,3,8,1
texmaker,texmaker,,2,0,4,2,4,6,0,1
johnsnowlabs-spark-nlp,johnsnowlabs-spark-nlp,,0,3,5,3,2,8,2,200
graph-sharp,graph-sharp,,0,1,3,1,1,4,8,1
eventsetter,eventsetter,,0,0,1,0,3,1,8,1
csvtotable,csvtotable,,0,0,3,0,2,3,1,1
databinder,databinder,,0,0,1,0,2,1,8,1
uibinder,uibinder,,2,1,4,3,7,7,3,1
adaption,adaption,,0,0,0,0,1,0,6,1
lpcxpresso,lpcxpresso,,1,1,0,2,2,2,9,1
space-efficiency,space-efficiency,,1,1,0,2,1,2,0,1
nachos,nachos,,0,1,0,1,1,1,13,1
ngrx-router-store,ngrx-router-store,,5,3,12,8,12,20,1,1
junit-rule,junit-rule,,1,0,3,1,4,4,3,1
viennacl,viennacl,,0,0,1,0,2,1,0,1
testkit,testkit,,0,1,0,1,3,1,2,1
unstage,unstage,,1,0,0,1,1,1,6,1
react-context,react-context,,72,87,95,159,54,254,1,20.833333
react-state-management,react-state-management,,27,23,52,50,43,102,1,1
dfply,dfply,,0,1,0,1,6,1,0,1
push-technology,push-technology,,0,0,1,0,1,1,3,1
ibm-cloud-monitoring,ibm-cloud-monitoring,,0,2,2,2,2,4,6,100
ruby-debug-ide,ruby-debug-ide,,1,0,2,1,1,3,12,1
javascript-interop,javascript-interop,,0,1,0,1,1,1,8,1
keypreview,keypreview,,0,0,0,0,1,0,1,1
templatefield,templatefield,,1,0,2,1,6,3,8,1
tcomponent,tcomponent,,0,0,0,0,1,0,9,1
facebox,facebox,,0,0,0,0,1,0,1,1
known-folders,known-folders,,5,1,2,6,1,8,8,1
vte,vte,,1,1,2,2,1,4,9,1
natural-key,natural-key,,0,0,1,0,4,1,4,1
fake-repositories,fake-repositories,,0,0,0,0,1,0,4,1
oauth.io,oauth.io,,0,1,1,1,1,2,1,1
superdesk,superdesk,,0,0,1,0,2,1,6,1
addslashes,addslashes,,1,0,2,1,4,3,4,1
radtreelist,radtreelist,,0,0,0,0,1,0,8,1
base-tag,base-tag,,1,0,0,1,3,1,3,1
gprbuild,gprbuild,,5,1,6,6,2,12,9,1
capedwarf,capedwarf,,0,0,0,0,5,0,3,1
ocpjp,ocpjp,,1,0,1,1,2,2,3,1
klout,klout,,0,0,0,0,3,0,4,1
biological-neural-network,biological-neural-network,,1,1,1,2,1,3,0,1
worker-processes,worker-processes,,1,0,0,1,2,1,8,1
skfieldnode,skfieldnode,,0,0,1,0,1,1,13,1
navit,navit,,0,0,1,0,2,1,0,1
visual-studio-app-center-test,visual-studio-app-center-test,,4,2,4,6,3,10,8,1
bunifu,bunifu,,2,4,4,6,9,10,8,100
lambda-architecture,lambda-architecture,,2,0,4,2,1,6,6,1
outputdebugstring,outputdebugstring,,1,0,1,1,1,2,8,1
prometheus-alertmanager,prometheus-alertmanager,,21,22,57,43,26,100,6,4.761905
catmull-rom-curve,catmull-rom-curve,,0,0,2,0,4,2,0,1
user-access-manager,user-access-manager,,0,0,3,0,1,3,4,1
cadence-virtuoso,cadence-virtuoso,,0,1,3,1,3,4,9,1
probot,probot,,7,3,5,10,7,15,6,1
rapidsvn,rapidsvn,,0,0,0,0,1,0,6,1
visitors,visitors,,0,1,1,1,1,2,4,1
go-graceful,go-graceful,,0,0,1,0,2,1,6,1
debug-print,debug-print,,0,1,0,1,1,1,5,1
power-off,power-off,,0,1,4,1,2,5,9,1
hermione,hermione,,0,1,0,1,1,1,1,1
flashmessenger,flashmessenger,,0,0,0,0,1,0,4,1
grunt-contrib-connect,grunt-contrib-connect,,0,1,2,1,3,3,1,1
hmatrix,hmatrix,,0,0,0,0,2,0,0,1
joern,joern,,0,0,0,0,1,0,2,1
sfcalendar,sfcalendar,,0,0,1,0,2,1,13,1
ruby-gnome2,ruby-gnome2,,0,0,0,0,4,0,9,1
mmf,mmf,,2,0,0,2,1,2,9,1
jprobe,jprobe,,0,0,0,0,2,0,9,1
rugged,rugged,,1,2,4,3,1,7,6,100
isl,isl,,0,0,0,0,1,0,0,1
syntax-object,syntax-object,,0,0,0,0,1,0,1,1
spectre.css,spectre.css,,0,0,2,0,2,2,1,1
kqueue,kqueue,,2,0,2,2,4,4,9,1
beginreceive,beginreceive,,0,1,1,1,3,2,9,1
jsend,jsend,,1,0,3,1,2,4,3,1
jocl,jocl,,1,0,2,1,1,3,3,1
google-flexible,google-flexible,,0,0,3,0,4,3,6,1
ibm-mobilefirst-windows,ibm-mobilefirst-windows,,0,0,2,0,1,2,13,1
chromium-portable,chromium-portable,,0,0,0,0,1,0,1,1
site24x7,site24x7,,0,1,0,1,2,1,1,1
x-callback-url,x-callback-url,,0,2,2,2,2,4,13,100
highcharts-boost,highcharts-boost,,0,0,4,0,4,4,1,1
tao,tao,,0,1,0,1,3,1,9,1
command-line-parser,command-line-parser,,2,2,1,4,4,5,8,1
tuxedo,tuxedo,,2,1,3,3,3,6,3,1
mysql-proxy,mysql-proxy,,1,0,1,1,2,2,4,1
affiliates,affiliates,,0,0,0,0,1,0,4,1
non-equi-join,non-equi-join,,1,0,0,1,4,1,0,1
rhinoceros,rhinoceros,,1,1,0,2,2,2,8,1
zen,zen,,2,0,3,2,1,5,9,1
pdfpage,pdfpage,,1,1,2,2,1,4,13,1
arc-lisp,arc-lisp,,0,0,0,0,1,0,0,1
hdl-coder,hdl-coder,,1,0,1,1,3,2,0,1
amazon-directory-services,amazon-directory-services,,0,1,1,1,1,2,6,1
owin.security,owin.security,,1,0,1,1,4,2,8,1
exclusionpath,exclusionpath,,4,2,1,6,1,7,13,1
netlist,netlist,,0,1,5,1,1,6,9,1
service-name,service-name,,0,2,1,2,1,3,4,100
webpack-externals,webpack-externals,,1,2,1,3,3,4,1,100
xtext-gradle-plugin,xtext-gradle-plugin,,0,0,2,0,1,2,3,1
ably-realtime,ably-realtime,,0,1,3,1,18,4,9,1
nuxeo-js-client,nuxeo-js-client,,0,0,0,0,2,0,3,1
fosjsroutingbundle,fosjsroutingbundle,,2,3,6,5,6,11,4,50
django-livereload-server,django-livereload-server,,1,0,0,1,1,1,0,1
pipfile,pipfile,,6,4,11,10,8,21,0,1
cliopatria,cliopatria,,1,0,0,1,1,1,2,1
secondary-live-tile,secondary-live-tile,,0,0,0,0,2,0,8,1
teamcity-6,teamcity-6,,0,0,0,0,1,0,9,1
ios-restrictions,ios-restrictions,,0,0,1,0,1,1,13,1
kenlm,kenlm,,2,0,0,2,5,2,0,1
aurelia-di,aurelia-di,,0,0,0,0,1,0,1,1
tkinter-menu,tkinter-menu,,5,4,9,9,8,18,0,1
nsprintpanel,nsprintpanel,,0,1,0,1,1,1,13,1
nsutf8encoding,nsutf8encoding,,0,0,2,0,2,2,13,1
canoo,canoo,,0,0,0,0,1,0,3,1
canoo-webtest,canoo-webtest,,0,0,0,0,1,0,3,1
winamp,winamp,,0,0,0,0,1,0,9,1
ibm-jvm,ibm-jvm,,1,0,1,1,1,2,3,1
motionbuilder,motionbuilder,,1,0,0,1,3,1,0,1
c5,c5,,0,1,0,1,2,1,8,1
ocean,ocean,,0,3,4,3,1,7,6,200
gnu-sed,gnu-sed,,2,3,1,5,3,6,9,50
react-native-calendars,react-native-calendars,,1,8,13,9,7,22,1,700
android-hardware-keyboard,android-hardware-keyboard,,0,0,4,0,1,4,3,1
mail-queue,mail-queue,,0,1,0,1,1,1,4,1
skipper,skipper,,0,0,2,0,1,2,1,1
omnicomplete,omnicomplete,,0,1,0,1,1,1,9,1
countdownjs.js,countdownjs.js,,2,0,0,2,2,2,1,1
gmaven-plugin,gmaven-plugin,,0,1,1,1,2,2,3,1
p-np,p-np,,2,0,0,2,1,2,8,1
adapt,adapt,,0,1,2,1,2,3,1,1
easyquery,easyquery,,0,0,0,0,3,0,4,1
python-pex,python-pex,,1,0,0,1,2,1,0,1
coderef,coderef,,0,0,1,0,1,1,0,1
tinyurl,tinyurl,,0,0,2,0,1,2,4,1
castcompanionlibrary,castcompanionlibrary,,0,0,0,0,1,0,13,1
badboy,badboy,,0,0,2,0,1,2,3,1
naked-objects,naked-objects,,0,0,0,0,1,0,8,1
parameter-spoofing,parameter-spoofing,,0,0,0,0,1,0,4,1
pspell,pspell,,0,0,0,0,1,0,4,1
abyss,abyss,,1,1,2,2,1,4,9,1
commanded,commanded,,0,0,3,0,2,3,8,1
sql-server-identity,sql-server-identity,,0,0,1,0,1,1,4,1
hostent,hostent,,0,0,1,0,1,1,9,1
h2o4gpu,h2o4gpu,,3,1,7,4,10,11,0,1
nsslider,nsslider,,1,2,3,3,4,6,13,100
xmeans,xmeans,,0,0,0,0,1,0,0,1
jbytearray,jbytearray,,0,0,1,0,2,1,3,1
b2,b2,,5,6,5,11,5,16,9,20
jung2,jung2,,1,1,4,2,6,6,3,1
convnetsharp,convnetsharp,,0,0,2,0,1,2,0,1
intellij-idea-2018,intellij-idea-2018,,2,0,17,2,20,19,3,1
file-dependancy,file-dependancy,,1,2,0,3,1,3,3,100
windows-look-and-feel,windows-look-and-feel,,1,0,0,1,2,1,3,1
reroute,reroute,,2,1,0,3,4,3,3,1
douglas-peucker,douglas-peucker,,0,1,2,1,2,3,0,1
drupal-domain-access,drupal-domain-access,,0,0,0,0,1,0,4,1
minidumpwritedump,minidumpwritedump,,0,0,2,0,1,2,9,1
prose-mirror,prose-mirror,,1,2,2,3,3,5,1,100
event-drops,event-drops,,0,1,1,1,3,2,1,1
google-blockly,google-blockly,,6,7,6,13,9,19,1,16.666667
video-ads,video-ads,,1,2,2,3,2,5,3,100
security.framework,security.framework,,1,0,0,1,1,1,13,1
externalizing,externalizing,,1,0,0,1,1,1,3,1
visualbrush,visualbrush,,2,2,3,4,2,7,8,1
style-transfer,style-transfer,,6,1,7,7,4,14,0,1
ora-00911,ora-00911,,1,0,0,1,3,1,4,1
unity-web-player,unity-web-player,,0,0,0,0,1,0,8,1
akka-tcp,akka-tcp,,0,0,0,0,2,0,2,1
openser,openser,,0,2,0,2,1,2,13,100
reportmanager,reportmanager,,2,0,2,2,1,4,4,1
word-table,word-table,,3,5,7,8,2,15,5,66.666667
automocking,automocking,,2,3,2,5,2,7,8,50
openjscad,openjscad,,1,1,2,2,2,4,1,1
icmpv6,icmpv6,,4,0,1,4,2,5,9,1
drawellipse,drawellipse,,3,1,0,4,4,4,8,1
two.js,two.js,,1,0,6,1,3,7,1,1
logbook,logbook,,0,3,0,3,1,3,0,200
dsl-tools,dsl-tools,,0,2,1,2,1,3,8,100
lintian,lintian,,0,0,0,0,1,0,9,1
shift-reduce,shift-reduce,,0,0,2,0,2,2,0,1
datasourcecontrol,datasourcecontrol,,1,0,0,1,1,1,6,1
object-sharing,object-sharing,,0,0,2,0,1,2,9,1
j9,j9,,0,0,2,0,1,2,3,1
struts2-json-plugin,struts2-json-plugin,,0,0,1,0,2,1,3,1
struts2-jquery-plugin,struts2-jquery-plugin,,2,1,0,3,2,3,3,1
asp.net-session,asp.net-session,,1,5,2,6,3,8,8,400
devpi,devpi,,3,1,6,4,5,10,0,1
mod-proxy-html,mod-proxy-html,,0,1,0,1,1,1,4,1
ml-lex,ml-lex,,0,0,0,0,1,0,2,1
shelveset,shelveset,,0,0,1,0,7,1,8,1
ibexpert,ibexpert,,4,2,3,6,3,9,4,1
jquery-minicolors,jquery-minicolors,,0,0,1,0,2,1,1,1
maven-mojo,maven-mojo,,0,0,0,0,2,0,3,1
select-xml,select-xml,,0,0,0,0,2,0,8,1
websphere-traditional,websphere-traditional,,0,0,1,0,1,1,3,1
core-authentication,core-authentication,,2,1,1,3,1,4,8,1
ranch,ranch,,0,0,2,0,1,2,2,1
dynamics-ax-xpo,dynamics-ax-xpo,,0,0,0,0,1,0,8,1
mxbean,mxbean,,0,0,0,0,3,0,3,1
auth0-lock,auth0-lock,,7,8,16,15,19,31,4,14.285714
beginthread,beginthread,,0,0,2,0,4,2,9,1
typelist,typelist,,0,1,1,1,2,2,9,1
signalr.net-client,signalr.net-client,,0,0,0,0,2,0,8,1
google-maps-styled,google-maps-styled,,0,0,3,0,3,3,1,1
disable-caching,disable-caching,,0,0,0,0,1,0,8,1
entity-bean,entity-bean,,0,0,2,0,1,2,3,1
ringout,ringout,,1,1,1,2,4,3,3,1
csvtoarray,csvtoarray,,0,0,4,0,4,4,1,1
batman.js,batman.js,,0,0,0,0,1,0,13,1
mali,mali,,3,5,4,8,4,12,3,66.666667
qxmlquery,qxmlquery,,2,0,5,2,2,7,4,1
colocation,colocation,,0,0,0,0,1,0,6,1
cassette,cassette,,0,0,1,0,1,1,8,1
pax-runner,pax-runner,,0,0,2,0,1,2,3,1
android-d8,android-d8,,2,3,9,5,7,14,3,50
android-r8,android-r8,,8,3,1,11,2,12,3,1
setstring,setstring,,0,1,2,1,1,3,4,1
member-pointers,member-pointers,,0,1,1,1,2,2,9,1
anaconda-cluster,anaconda-cluster,,0,0,1,0,1,1,0,1
uitextinput,uitextinput,,1,1,2,2,1,4,13,1
uitextposition,uitextposition,,0,0,1,0,1,1,13,1
nsdraggingdestination,nsdraggingdestination,,0,0,1,0,1,1,13,1
eclipse-sphinx,eclipse-sphinx,,0,0,0,0,1,0,3,1
entityspaces,entityspaces,,0,0,0,0,2,0,8,1
openrave,openrave,,0,0,0,0,1,0,9,1
stacktrace.js,stacktrace.js,,1,0,0,1,1,1,1,1
drupal-blocks,drupal-blocks,,4,0,2,4,4,6,4,1
adts,adts,,0,0,2,0,2,2,13,1
crnk,crnk,,0,2,2,2,8,4,3,100
buildr,buildr,,0,0,0,0,2,0,3,1
kdevelop4,kdevelop4,,0,0,0,0,1,0,0,1
content-expiration,content-expiration,,2,0,0,2,1,2,3,1
drake-r-package,drake-r-package,,8,4,6,12,6,18,0,1
jsgauge,jsgauge,,0,1,1,1,1,2,1,1
color-tracking,color-tracking,,0,0,1,0,2,1,0,1
persistence-provider,persistence-provider,,0,1,0,1,1,1,3,1
bare-metal-server,bare-metal-server,,6,4,6,10,2,16,6,1
android-query,android-query,,1,1,2,2,3,4,3,1
html-formatting,html-formatting,,0,1,0,1,1,1,9,1
files.app,files.app,,0,0,0,0,1,0,13,1
column-chooser,column-chooser,,0,0,0,0,1,0,1,1
gameboy,gameboy,,5,1,5,6,7,11,9,1
csound,csound,,2,1,4,3,1,7,0,1
radvd,radvd,,0,0,0,0,1,0,9,1
iipimage,iipimage,,0,0,0,0,1,0,0,1
docker-trusted-registry,docker-trusted-registry,,0,0,2,0,1,2,6,1
wcf-extensions,wcf-extensions,,0,0,0,0,2,0,8,1
qdir,qdir,,1,3,7,4,4,11,9,200
qstandardpaths,qstandardpaths,,0,0,0,0,1,0,9,1
vcftools,vcftools,,2,1,1,3,3,4,9,1
android-cts,android-cts,,0,0,2,0,4,2,3,1
cpn-tools,cpn-tools,,0,2,1,2,1,3,2,100
mdls,mdls,,0,0,1,0,4,1,9,1
xcode9.3,xcode9.3,,0,1,9,1,126,10,13,1
tensorflow-model-analysis,tensorflow-model-analysis,,4,1,4,5,3,9,0,1
web-manifest,web-manifest,,1,1,4,2,2,6,1,1
ember-power-select,ember-power-select,,1,3,4,4,4,8,1,200
ghostdriver,ghostdriver,,2,0,2,2,4,4,3,1
good-dynamics,good-dynamics,,0,0,3,0,2,3,13,1
blackberry-dynamics,blackberry-dynamics,,1,1,5,2,1,7,13,1
tizen-certificate,tizen-certificate,,0,0,0,0,1,0,13,1
android-gradle-3.1.0,android-gradle-3.1.0,,0,1,3,1,12,4,3,1
powercfg,powercfg,,1,2,1,3,2,4,9,100
cordys-opentext,cordys-opentext,,0,0,0,0,1,0,8,1
accounting.js,accounting.js,,1,1,0,2,2,2,1,1
passthrough-attributes,passthrough-attributes,,0,0,0,0,1,0,3,1
fxforms,fxforms,,0,0,0,0,1,0,13,1
qmail,qmail,,0,1,2,1,2,3,9,1
openbadge,openbadge,,0,0,1,0,1,1,4,1
head.js,head.js,,0,0,1,0,1,1,1,1
maven-wagon-plugin,maven-wagon-plugin,,1,2,5,3,3,8,3,100
amazon-javascript-sdk,amazon-javascript-sdk,,1,1,0,2,2,2,6,1
waitone,waitone,,0,0,1,0,1,1,8,1
remote-connections,remote-connections,,0,0,0,0,2,0,4,1
html-react-parser,html-react-parser,,2,0,0,2,2,2,1,1
google-cloud-http-load-balancer,google-cloud-http-load-balancer,,2,2,0,4,1,4,6,1
database-management,database-management,,2,3,7,5,4,12,4,50
preferslargetitles,preferslargetitles,,4,5,7,9,8,16,13,25
derelict3,derelict3,,0,0,0,0,1,0,9,1
nibabel,nibabel,,9,5,7,14,3,21,0,1
nilearn,nilearn,,2,0,1,2,2,3,0,1
neuro-image,neuro-image,,1,1,0,2,2,2,0,1
nsfilecoordinator,nsfilecoordinator,,0,1,1,1,3,2,13,1
fsi,fsi,,1,1,3,2,1,5,8,1
ngtools,ngtools,,1,2,3,3,4,6,1,100
special-variables,special-variables,,0,0,3,0,1,3,9,1
switchcontrol,switchcontrol,,0,0,0,0,3,0,13,1
servicebehavior,servicebehavior,,0,0,1,0,1,1,8,1
libresolv,libresolv,,2,0,0,2,1,2,4,1
oracle18c,oracle18c,,34,12,16,46,3,62,4,1
dapper-fluentmap,dapper-fluentmap,,2,2,1,4,3,5,8,1
nsxmlnode,nsxmlnode,,0,0,1,0,1,1,3,1
jpasswordfield,jpasswordfield,,0,0,1,0,5,1,3,1
code-patching,code-patching,,0,0,0,0,1,0,4,1
pivot-without-aggregate,pivot-without-aggregate,,0,0,0,0,1,0,4,1
pylast,pylast,,0,1,1,1,2,2,0,1
azerothcore,azerothcore,,8,13,15,21,2,36,9,62.5
common-project-system,common-project-system,,1,0,1,1,2,2,8,1
roslyn-project-system,roslyn-project-system,,0,0,1,0,2,1,8,1
java.library.path,java.library.path,,1,2,5,3,5,8,3,100
ebtables,ebtables,,0,0,1,0,3,1,9,1
discord-jda,discord-jda,,14,19,15,33,7,48,3,35.714286
audiosession,audiosession,,0,0,3,0,1,3,13,1
atomineer,atomineer,,0,0,0,0,1,0,8,1
swift-for-tensorflow,swift-for-tensorflow,,7,0,0,7,2,7,13,1
visual-studio-package,visual-studio-package,,0,1,3,1,1,4,8,1
image-translation,image-translation,,1,3,3,4,2,7,0,200
no-response,no-response,,2,2,4,4,5,8,13,1
dependent-name,dependent-name,,0,2,2,2,5,4,9,100
iphelper,iphelper,,2,0,0,2,2,2,9,1
closedir,closedir,,1,0,0,1,1,1,9,1
geiser,geiser,,1,0,2,1,1,3,0,1
newsstand-kit,newsstand-kit,,0,1,0,1,1,1,13,1
pgu,pgu,,0,0,0,0,2,0,0,1
octobercms-builder,octobercms-builder,,1,0,0,1,2,1,4,1
plumbum,plumbum,,1,2,1,3,5,4,0,100
excel4node,excel4node,,2,4,5,6,7,11,1,100
one-time-pad,one-time-pad,,1,0,3,1,2,4,6,1
go-pg,go-pg,,2,0,5,2,5,7,6,1
fire-sharp,fire-sharp,,5,1,4,6,4,10,13,1
microsoft-band,microsoft-band,,0,0,0,0,1,0,8,1
google-benchmark,google-benchmark,,4,4,3,8,6,11,9,1
fdopen,fdopen,,0,0,2,0,3,2,9,1
publishing-site,publishing-site,,0,0,0,0,2,0,8,1
apple-expose,apple-expose,,0,0,0,0,1,0,13,1
testdriven.net,testdriven.net,,0,0,0,0,1,0,8,1
viewflow,viewflow,,0,0,1,0,1,1,0,1
cgpdfcontext,cgpdfcontext,,0,0,2,0,2,2,13,1
vue-styleguidist,vue-styleguidist,,0,2,1,2,1,3,1,100
passport-jwt,passport-jwt,,14,15,17,29,16,46,1,7.142857
r-forge,r-forge,,0,0,0,0,2,0,0,1
ppapi,ppapi,,0,0,2,0,2,2,1,1
nsundomanager,nsundomanager,,4,5,6,9,3,15,13,25
net-standard-2.1,net-standard-2.1,,0,1,0,1,1,1,8,1
dialog-preference,dialog-preference,,1,0,1,1,3,2,3,1
tree-rotation,tree-rotation,,0,0,1,0,1,1,0,1
base36,base36,,1,0,1,1,1,2,0,1
audiobus,audiobus,,0,0,1,0,5,1,13,1
bcftools,bcftools,,1,1,1,2,3,3,0,1
vcbuild,vcbuild,,0,0,0,0,2,0,8,1
waveoutwrite,waveoutwrite,,0,0,0,0,1,0,9,1
computational-finance,computational-finance,,1,1,6,2,3,8,0,1
mixamo,mixamo,,1,2,1,3,1,4,8,100
zftool2,zftool2,,0,0,0,0,1,0,4,1
azure-functions-core-tools,azure-functions-core-tools,,13,19,46,32,27,78,8,46.153846
dbcommand,dbcommand,,0,0,0,0,2,0,8,1
cloaking,cloaking,,2,0,1,2,2,3,4,1
easyhtmlreport,easyhtmlreport,,0,0,1,0,1,1,12,1
sql-server-mobile,sql-server-mobile,,1,0,0,1,1,1,4,1
powerform,powerform,,0,0,4,0,3,4,8,1
wadslogtable,wadslogtable,,0,0,0,0,1,0,8,1
pagertitlestrip,pagertitlestrip,,0,0,0,0,2,0,3,1
mapfish,mapfish,,2,1,2,3,1,5,1,1
meta-inf,meta-inf,,1,4,4,5,6,9,3,300
angular-event-emitter,angular-event-emitter,,15,15,22,30,21,52,1,1
airplane,airplane,,0,1,4,1,3,5,3,1
nssegmentedcontrol,nssegmentedcontrol,,1,1,1,2,1,3,13,1
crow,crow,,1,0,0,1,3,1,9,1
spring-logback,spring-logback,,16,20,35,36,16,71,3,25
xtype,xtype,,0,1,0,1,2,1,8,1
jdwp,jdwp,,2,2,8,4,5,12,3,1
dom-node,dom-node,,2,2,3,4,4,7,1,1
graph-layout,graph-layout,,0,0,5,0,2,5,0,1
rmr2,rmr2,,0,1,1,1,1,2,2,1
msmqintegrationbinding,msmqintegrationbinding,,0,0,0,0,2,0,8,1
mini-css-extract-plugin,mini-css-extract-plugin,,13,16,42,29,30,71,1,23.076923
makehuman,makehuman,,0,1,2,1,3,3,8,1
avassetresourceloaderdelegate,avassetresourceloaderdelegate,,0,2,1,2,3,3,13,100
rdrand,rdrand,,2,0,2,2,1,4,9,1
hql-hive,hql-hive,,0,0,0,0,6,0,2,1
angular-arrays,angular-arrays,,2,1,1,3,6,4,1,1
crouton,crouton,,0,0,2,0,1,2,9,1
subquery-factoring,subquery-factoring,,0,0,0,0,1,0,4,1
dart-2,dart-2,,8,1,27,9,15,36,13,1
react-rating,react-rating,,0,0,0,0,2,0,1,1
instance-eval,instance-eval,,0,0,0,0,1,0,12,1
behaviorspace,behaviorspace,,1,2,4,3,4,7,0,100
rmongodb,rmongodb,,1,0,0,1,2,1,0,1
assemblyversions,assemblyversions,,0,1,2,1,3,3,8,1
msix,msix,,1,5,5,6,1,11,8,400
dutch-national-flag-problem,dutch-national-flag-problem,,1,1,0,2,5,2,0,1
phpstorm-2018.1,phpstorm-2018.1,,3,0,8,3,24,11,4,1
smtpproxy,smtpproxy,,0,0,0,0,1,0,12,1
ultracombo,ultracombo,,0,0,0,0,1,0,8,1
fancyurlopener,fancyurlopener,,0,0,3,0,2,3,0,1
grails-services,grails-services,,0,2,0,2,3,2,3,100
sqlite-shell,sqlite-shell,,0,0,0,0,1,0,3,1
endly,endly,,0,0,2,0,8,2,3,1
android-pdf-api,android-pdf-api,,0,1,9,1,1,10,3,1
treemaps,treemaps,,0,0,0,0,1,0,3,1
wordbasic,wordbasic,,0,0,0,0,1,0,5,1
sp.js,sp.js,,0,1,1,1,1,2,8,1
trinitycore,trinitycore,,0,2,4,2,1,6,9,100
lsh,lsh,,7,4,7,11,5,18,2,1
multitrigger,multitrigger,,2,1,1,3,2,4,8,1
result-object,result-object,,0,0,0,0,1,0,4,1
multiple-mice,multiple-mice,,0,0,4,0,3,4,0,1
koin,koin,,27,33,49,60,8,109,3,22.222222
bambora,bambora,,0,0,0,0,2,0,4,1
uglifyjs-webpack-plugin,uglifyjs-webpack-plugin,,2,1,1,3,7,4,1,1
editortemplates,editortemplates,,1,1,1,2,1,3,8,1
cayley,cayley,,1,1,0,2,1,2,0,1
ggtitle,ggtitle,,2,0,2,2,1,4,0,1
aurelia-bundling,aurelia-bundling,,0,0,1,0,1,1,1,1
project-flogo,project-flogo,,0,0,0,0,1,0,6,1
adhoc-queries,adhoc-queries,,1,1,1,2,2,3,4,1
gkminmaxstrategist,gkminmaxstrategist,,3,0,0,3,1,3,13,1
interchange,interchange,,0,0,2,0,2,2,1,1
recommenderlab,recommenderlab,,5,3,6,8,9,14,0,1
maven-plugin-testing-harness,maven-plugin-testing-harness,,0,0,0,0,1,0,3,1
memory-size,memory-size,,1,0,3,1,2,4,9,1
android-cards,android-cards,,0,1,0,1,2,1,3,1
grunt-contrib-htmlmin,grunt-contrib-htmlmin,,0,0,0,0,1,0,1,1
errorplacement,errorplacement,,0,0,1,0,2,1,1,1
system-restore,system-restore,,0,0,3,0,1,3,8,1
dsquery,dsquery,,0,0,2,0,2,2,8,1
acsl,acsl,,0,0,2,0,7,2,9,1
rails-generators,rails-generators,,4,1,6,5,2,11,12,1
interface-metric,interface-metric,,0,0,0,0,1,0,8,1
vliw,vliw,,0,0,0,0,1,0,9,1
angelscript,angelscript,,0,0,2,0,1,2,9,1
angularjs-3rd-party,angularjs-3rd-party,,4,1,4,5,10,9,1,1
hama,hama,,0,0,0,0,1,0,2,1
xml-database,xml-database,,1,0,1,1,2,2,3,1
uniquery,uniquery,,1,2,2,3,1,5,9,100
azure-cosmosdb-mongoapi,azure-cosmosdb-mongoapi,,17,34,55,51,30,106,8,100
avassetdownloadstoragemanager,avassetdownloadstoragemanager,,0,0,0,0,2,0,13,1
quadrilaterals,quadrilaterals,,0,1,3,1,1,4,0,1
powergui,powergui,,0,0,0,0,1,0,0,1
androidappsonchromeos,androidappsonchromeos,,4,1,4,5,5,9,3,1
curry,curry,,1,0,6,1,3,7,2,1
multiple-date-picker,multiple-date-picker,,0,0,1,0,2,1,1,1
binary-deserialization,binary-deserialization,,0,0,0,0,3,0,8,1
tensorflow.js,tensorflow.js,,92,74,137,166,106,303,0,1
database-cursor,database-cursor,,27,23,51,50,36,101,4,1
recursivetask,recursivetask,,0,0,1,0,2,1,3,1
agens-graph,agens-graph,,8,9,24,17,5,41,2,12.5
method-declaration,method-declaration,,1,0,0,1,1,1,1,1
pypputeer,pypputeer,,0,0,1,0,1,1,0,1
wcf-configuration,wcf-configuration,,0,0,0,0,1,0,8,1
maxdb,maxdb,,0,0,0,0,1,0,4,1
indesign-server,indesign-server,,0,1,3,1,2,4,1,1
azure-android-sdk,azure-android-sdk,,0,1,0,1,3,1,8,1
system.linq.dynamic,system.linq.dynamic,,2,1,6,3,2,9,8,1
installr,installr,,1,1,1,2,1,3,0,1
readdirectorychangesw,readdirectorychangesw,,1,2,1,3,3,4,9,100
faulted,faulted,,0,0,0,0,1,0,8,1
docker-datacenter,docker-datacenter,,0,1,7,1,1,8,6,1
angular-pwa,angular-pwa,,8,12,14,20,10,34,1,50
loginview,loginview,,4,0,4,4,1,8,0,1
d2xx,d2xx,,1,2,1,3,2,4,9,100
conditional-execution,conditional-execution,,1,2,2,3,1,5,9,100
aws-lex,aws-lex,,21,17,27,38,21,65,6,1
google-map-react,google-map-react,,5,9,8,14,4,22,1,80
spoof,spoof,,0,0,0,0,2,0,9,1
ddev,ddev,,9,11,15,20,33,35,4,22.222222
ideamart,ideamart,,0,0,0,0,1,0,4,1
django-sitetree,django-sitetree,,0,0,0,0,3,0,0,1
javacameraview,javacameraview,,2,2,2,4,4,6,3,1
alt.js,alt.js,,0,0,0,0,1,0,1,1
qjsengine,qjsengine,,2,3,4,5,3,9,9,50
shipitjs,shipitjs,,2,0,1,2,3,3,1,1
google-cloud-profiler,google-cloud-profiler,,1,1,0,2,3,2,6,1
pingaccess,pingaccess,,0,0,1,0,2,1,3,1
memberinfo,memberinfo,,0,0,1,0,1,1,8,1
invalid-object-name,invalid-object-name,,2,1,0,3,2,3,4,1
zigzag-encoding,zigzag-encoding,,0,0,0,0,2,0,6,1
qstatemachine,qstatemachine,,2,1,2,3,2,5,9,1
dbproviderfactories,dbproviderfactories,,0,1,0,1,3,1,8,1
getschema,getschema,,2,0,2,2,2,4,4,1
servicem8,servicem8,,1,0,3,1,4,4,8,1
kallithea,kallithea,,0,0,0,0,1,0,6,1
ytplayer,ytplayer,,3,2,4,5,2,9,5,1
new-expression,new-expression,,0,1,1,1,3,2,9,1
postmates,postmates,,2,0,2,2,3,4,1,1
dbimport,dbimport,,0,0,1,0,1,1,6,1
nssecurecoding,nssecurecoding,,0,1,5,1,3,6,13,1
transactiontoolargeexception,transactiontoolargeexception,,3,3,2,6,4,8,3,1
activeresource,activeresource,,2,3,5,5,2,10,12,50
php-node,php-node,,0,0,0,0,1,0,4,1
underscore.string.js,underscore.string.js,,0,0,0,0,2,0,1,1
botdetect,botdetect,,1,2,2,3,6,5,4,100
ionic-material,ionic-material,,0,0,0,0,2,0,1,1
buffalo,buffalo,,3,6,8,9,9,17,6,100
java-custom-serialization,java-custom-serialization,,1,0,1,1,4,2,3,1
dot-emacs,dot-emacs,,1,2,2,3,3,5,9,100
chatkit,chatkit,,7,4,6,11,7,17,1,1
piranha-cms,piranha-cms,,1,0,4,1,1,5,8,1
ios8-extension,ios8-extension,,0,0,0,0,1,0,13,1
librsync,librsync,,1,0,3,1,2,4,9,1
amf,amf,,1,0,3,1,2,4,3,1
solrconfig,solrconfig,,4,1,5,5,4,10,2,1
picocli,picocli,,4,8,13,12,2,25,3,100
zip.js,zip.js,,1,0,2,1,1,3,1,1
evaluation-strategy,evaluation-strategy,,0,0,0,0,2,0,0,1
rabbitmq-management,rabbitmq-management,,1,2,4,3,5,7,3,100
icr,icr,,0,1,2,1,2,3,0,1
google-api-timezone,google-api-timezone,,0,0,0,0,1,0,6,1
kiicloud,kiicloud,,0,0,0,0,1,0,3,1
recoverymodel,recoverymodel,,1,0,0,1,2,1,4,1
pickler,pickler,,0,0,0,0,1,0,0,1
inputmethodmanager,inputmethodmanager,,2,0,2,2,4,4,3,1
ntt,ntt,,0,0,1,0,1,1,0,1
oqgraph,oqgraph,,0,0,0,0,1,0,4,1
powerpacks,powerpacks,,0,1,2,1,3,3,8,1
river-crossing-puzzle,river-crossing-puzzle,,0,0,1,0,1,1,0,1
node-mocks-http,node-mocks-http,,1,0,0,1,1,1,1,1
webimage,webimage,,0,0,1,0,4,1,13,1
django-webpack-loader,django-webpack-loader,,1,2,8,3,4,11,0,100
jargo,jargo,,0,0,0,0,1,0,9,1
sigqueue,sigqueue,,0,0,0,0,1,0,9,1
default-document,default-document,,0,0,0,0,2,0,8,1
chop,chop,,0,0,0,0,2,0,0,1
non-thread-safe,non-thread-safe,,0,0,0,0,2,0,3,1
sdiff,sdiff,,0,0,5,0,1,5,9,1
cronofy,cronofy,,0,0,0,0,1,0,0,1
texinfo,texinfo,,1,1,0,2,2,2,9,1
typo3-9.x,typo3-9.x,,137,113,164,250,12,414,4,1
settings-bundle,settings-bundle,,0,0,0,0,2,0,13,1
boost-bjam,boost-bjam,,0,1,3,1,3,4,9,1
installshield-2009,installshield-2009,,0,0,0,0,1,0,8,1
rmstore,rmstore,,1,0,1,1,3,2,13,1
angular2-validators,angular2-validators,,0,0,1,0,2,1,1,1
angularjs-light-grid,angularjs-light-grid,,0,0,0,0,1,0,1,1
angular2-form-validation,angular2-form-validation,,4,5,16,9,11,25,1,25
editorformodel,editorformodel,,0,1,0,1,3,1,8,1
swifter,swifter,,2,2,4,4,3,8,0,1
nchan,nchan,,0,2,0,2,1,2,6,100
ejabberd-auth,ejabberd-auth,,2,0,2,2,7,4,3,1
angular2-flashmessages,angular2-flashmessages,,0,0,0,0,2,0,1,1
postgres-plus,postgres-plus,,0,0,1,0,1,1,4,1
os-detection,os-detection,,0,0,0,0,2,0,9,1
node-sass-chokidar,node-sass-chokidar,,0,1,3,1,3,4,1,1
pdp,pdp,,2,3,0,5,4,5,4,50
speechkit,speechkit,,0,0,1,0,1,1,13,1
wfp,wfp,,10,1,4,11,3,15,9,1
paymill,paymill,,0,0,1,0,3,1,8,1
gulp-usemin,gulp-usemin,,0,0,0,0,2,0,1,1
ietf,ietf,,1,0,4,1,1,5,9,1
mod-lua,mod-lua,,1,0,1,1,1,2,4,1
dedupeplugin,dedupeplugin,,0,1,0,1,2,1,0,1
nsdocktile,nsdocktile,,0,0,0,0,1,0,13,1
kinto,kinto,,0,0,0,0,2,0,6,1
mat-table,mat-table,,76,61,65,137,1,202,1,1
zoneminder,zoneminder,,0,0,1,0,1,1,9,1
scrolledwindow,scrolledwindow,,1,0,1,1,2,2,0,1
dynatree,dynatree,,1,0,1,1,3,2,1,1
trx,trx,,1,0,5,1,3,6,8,1
brew-python,brew-python,,0,0,0,0,1,0,0,1
netwire,netwire,,0,0,0,0,1,0,2,1
db-browser-sqlite,db-browser-sqlite,,4,2,22,6,9,28,3,1
pssnapin,pssnapin,,1,1,2,2,4,4,8,1
mycouch,mycouch,,0,0,1,0,2,1,8,1
pybee,pybee,,0,0,1,0,1,1,0,1
skip-take,skip-take,,0,0,1,0,2,1,4,1
point-of-interest,point-of-interest,,1,3,2,4,3,6,3,200
jnaerator,jnaerator,,0,0,0,0,3,0,3,1
bridj,bridj,,1,0,0,1,1,1,3,1
ramdirectory,ramdirectory,,0,0,1,0,1,1,2,1
halo,halo,,1,0,0,1,1,1,0,1
electron.net,electron.net,,2,1,2,3,6,5,8,1
certificate-signing-request,certificate-signing-request,,0,1,3,1,3,4,6,1
facesservlet,facesservlet,,0,0,1,0,1,1,3,1
qclipboard,qclipboard,,1,1,0,2,2,2,0,1
matlabcontrol,matlabcontrol,,0,0,0,0,1,0,3,1
oorexx,oorexx,,0,1,0,1,3,1,9,1
pandas-styles,pandas-styles,,4,6,6,10,4,16,0,50
flutter-animation,flutter-animation,,98,105,133,203,44,336,13,7.142857
operadriver,operadriver,,0,1,2,1,1,3,3,1
web-architecture,web-architecture,,1,0,1,1,6,2,3,1
macromedia,macromedia,,0,0,1,0,1,1,13,1
telligent,telligent,,0,0,2,0,1,2,8,1
velocity-template-language,velocity-template-language,,2,1,5,3,5,8,3,1
powerbi-desktop,powerbi-desktop,,121,160,211,281,123,492,5,32.231405
binarystream,binarystream,,1,0,1,1,2,2,3,1
oleview,oleview,,0,1,0,1,1,1,8,1
land-of-lisp,land-of-lisp,,1,0,0,1,1,1,0,1
moditect,moditect,,0,1,2,1,4,3,3,1
plcrashreporter,plcrashreporter,,2,0,1,2,2,3,13,1
jquery-textillate,jquery-textillate,,0,0,1,0,1,1,1,1
applescript-studio,applescript-studio,,0,0,0,0,1,0,13,1
appcfg,appcfg,,0,2,0,2,2,2,6,100
pbiviz,pbiviz,,2,2,3,4,1,7,5,1
ganon,ganon,,0,0,0,0,1,0,1,1
adobe-cc,adobe-cc,,0,0,0,0,1,0,1,1
toast-ui-editor,toast-ui-editor,,1,1,1,2,1,3,1,1
managedobjectcontext,managedobjectcontext,,0,0,2,0,1,2,13,1
real-time-systems,real-time-systems,,0,0,0,0,1,0,9,1
balloon-tip,balloon-tip,,1,0,2,1,2,3,8,1
rostering,rostering,,0,0,2,0,1,2,3,1
srv-record,srv-record,,1,2,1,3,1,4,6,100
wxmpl,wxmpl,,2,0,1,2,1,3,0,1
imagekit,imagekit,,2,0,0,2,1,2,0,1
mog,mog,,1,0,1,1,2,2,0,1
flaui,flaui,,0,0,1,0,1,1,8,1
rosters,rosters,,0,1,7,1,2,8,13,1
sa-mp,sa-mp,,0,1,0,1,2,1,4,1
bless,bless,,0,0,0,0,1,0,9,1
opentaps,opentaps,,0,0,0,0,1,0,3,1
kal,kal,,0,0,0,0,1,0,4,1
initial-scale,initial-scale,,0,0,0,0,1,0,1,1
facebook-canvas,facebook-canvas,,0,0,2,0,2,2,13,1
app-globalresources,app-globalresources,,1,0,3,1,2,4,8,1
pos,pos,,29,21,73,50,45,123,3,1
googleweblight,googleweblight,,0,0,0,0,1,0,1,1
google-auth-library-ruby,google-auth-library-ruby,,1,1,1,2,1,3,5,1
spookyjs,spookyjs,,0,0,0,0,3,0,3,1
internal-link,internal-link,,1,1,0,2,2,2,4,1
pushe,pushe,,0,0,1,0,1,1,3,1
uiprogressbar,uiprogressbar,,3,0,3,3,2,6,13,1
ebay-mip,ebay-mip,,0,0,0,0,1,0,9,1
reactabular,reactabular,,0,0,2,0,1,2,1,1
private-cloud,private-cloud,,1,0,2,1,2,3,6,1
lockout,lockout,,1,0,1,1,3,2,4,1
widdershins,widdershins,,0,0,0,0,2,0,3,1
tso,tso,,1,0,3,1,1,4,4,1
semmle-ql,semmle-ql,,0,0,0,0,1,0,9,1
driving-directions,driving-directions,,1,1,5,2,2,7,0,1
capacitor,capacitor,,38,61,40,99,15,139,1,60.526316
backing,backing,,0,0,0,0,1,0,3,1
documentclient,documentclient,,2,4,4,6,7,10,6,100
sqlobject,sqlobject,,1,1,0,2,1,2,0,1
snare,snare,,0,0,0,0,1,0,0,1
capstone,capstone,,0,0,4,0,2,4,9,1
nested-types,nested-types,,0,0,1,0,3,1,6,1
asp.net-validators,asp.net-validators,,1,0,3,1,5,4,8,1
ijetty,ijetty,,0,0,0,0,1,0,3,1
moma,moma,,0,0,0,0,1,0,8,1
embedded-framework,embedded-framework,,0,0,0,0,1,0,13,1
fixnum,fixnum,,0,1,1,1,1,2,12,1
ora-00933,ora-00933,,0,0,7,0,3,7,4,1
nginx-config,nginx-config,,157,142,232,299,35,531,6,1
git-credential-manager,git-credential-manager,,4,1,13,5,4,18,6,1
react-pdf,react-pdf,,9,9,7,18,4,25,1,1
backgrounding,backgrounding,,0,2,5,2,2,7,8,100
javaexe,javaexe,,0,0,0,0,1,0,3,1
twirp,twirp,,0,1,1,1,2,2,6,1
yarp,yarp,,0,0,0,0,2,0,3,1
embark,embark,,0,1,0,1,3,1,6,1
wsrp,wsrp,,0,0,0,0,1,0,3,1
configuration-profile,configuration-profile,,0,2,3,2,1,5,13,100
wifi-assist,wifi-assist,,0,0,0,0,2,0,13,1
designtime-attributes,designtime-attributes,,0,0,0,0,1,0,8,1
sesam,sesam,,0,0,0,0,1,0,1,1
baduk,baduk,,0,0,0,0,1,0,0,1
.net-core-rc2,.net-core-rc2,,0,0,0,0,1,0,9,1
lpwstr,lpwstr,,0,0,1,0,2,1,9,1
boltdb,boltdb,,4,2,6,6,3,12,6,1
payment-integration,payment-integration,,3,0,5,3,2,8,4,1
.net-security,.net-security,,0,1,6,1,3,7,8,1
writers,writers,,0,0,0,0,1,0,3,1
zarr,zarr,,4,5,2,9,2,11,0,25
validateset,validateset,,2,0,1,2,2,3,8,1
redaction,redaction,,2,1,5,3,7,8,8,1
html5sortable,html5sortable,,0,0,2,0,1,2,1,1
pf4j,pf4j,,0,0,4,0,2,4,3,1
raiseevent,raiseevent,,1,0,3,1,2,4,8,1
codesourcery,codesourcery,,0,1,0,1,1,1,9,1
hapi-auth-cookie,hapi-auth-cookie,,1,0,1,1,1,2,1,1
routetable,routetable,,1,1,2,2,6,4,6,1
microprofile,microprofile,,12,19,25,31,12,56,3,58.333333
go-build,go-build,,3,5,5,8,7,13,6,66.666667
go-packages,go-packages,,2,2,2,4,3,6,6,1
optics-algorithm,optics-algorithm,,0,3,2,3,1,5,0,200
coordination,coordination,,0,0,1,0,1,1,2,1
non-web,non-web,,0,0,0,0,1,0,9,1
session-per-request,session-per-request,,0,0,0,0,1,0,8,1
venn.js,venn.js,,0,0,1,0,1,1,1,1
ipl,ipl,,0,0,0,0,2,0,3,1
bounds-checker,bounds-checker,,0,0,0,0,1,0,0,1
azure-iot-central,azure-iot-central,,11,7,11,18,6,29,8,1
xbim,xbim,,0,4,0,4,6,4,14,300
hook-wordpress,hook-wordpress,,2,0,7,2,5,9,4,1
socklen-t,socklen-t,,0,0,0,0,1,0,9,1
papaya,papaya,,1,0,0,1,9,1,1,1
deadobjectexception,deadobjectexception,,2,1,3,3,1,6,3,1
fxaa,fxaa,,0,0,0,0,1,0,9,1
mysql-parameter,mysql-parameter,,1,1,0,2,4,2,8,1
xmltextwriter,xmltextwriter,,1,0,1,1,3,2,8,1
windows-search,windows-search,,1,0,6,1,1,7,8,1
notification-area,notification-area,,1,0,0,1,4,1,8,1
angular-ui-tabset,angular-ui-tabset,,1,2,1,3,3,4,1,100
controlcollection,controlcollection,,1,0,2,1,1,3,8,1
azure-compute-emulator,azure-compute-emulator,,1,0,0,1,3,1,8,1
summarytools,summarytools,,4,5,2,9,2,11,0,25
plugin.xml,plugin.xml,,0,0,0,0,4,0,3,1
datasift-python,datasift-python,,0,0,0,0,1,0,13,1
radscheduler,radscheduler,,0,1,1,1,2,2,8,1
textx,textx,,3,1,5,4,1,9,0,1
facebook-target-audience,facebook-target-audience,,0,1,2,1,1,3,13,1
actorsystem,actorsystem,,1,0,3,1,2,4,2,1
oracle-http-server,oracle-http-server,,1,2,8,3,2,11,4,100
image.createimage,image.createimage,,1,0,1,1,3,2,4,1
tensorflow-hub,tensorflow-hub,,22,27,36,49,19,85,0,22.727273
grails-validation,grails-validation,,0,0,1,0,2,1,3,1
recent-screens,recent-screens,,0,0,1,0,3,1,3,1
schemaspy,schemaspy,,4,0,2,4,3,6,4,1
database-programming,database-programming,,0,0,1,0,2,1,4,1
soundmanager2,soundmanager2,,2,1,3,3,4,6,1,1
ng-sortable,ng-sortable,,0,0,0,0,1,0,1,1
significant-motion-sensor,significant-motion-sensor,,0,0,1,0,2,1,3,1
classy-prelude,classy-prelude,,0,1,2,1,1,3,2,1
remote-blob-store,remote-blob-store,,0,1,0,1,1,1,8,1
rust-actix,rust-actix,,11,18,32,29,10,61,9,63.636364
xstate,xstate,,2,4,3,6,1,9,1,100
kloudless,kloudless,,0,0,0,0,1,0,8,1
webpack-ignore-loader,webpack-ignore-loader,,0,0,1,0,1,1,1,1
cakephp-3.5,cakephp-3.5,,1,1,3,2,11,5,4,1
kotlin-maven-plugin,kotlin-maven-plugin,,0,1,2,1,1,3,3,1
mixed-authentication,mixed-authentication,,1,0,0,1,1,1,8,1
listview-selector,listview-selector,,0,0,1,0,1,1,3,1
embedded-kafka,embedded-kafka,,4,3,6,7,9,13,3,1
youtubeplayer,youtubeplayer,,6,13,9,19,11,28,3,116.666667
http-upload,http-upload,,1,0,3,1,1,4,3,1
is-uploaded-file,is-uploaded-file,,0,0,0,0,1,0,4,1
jfuzzylogic,jfuzzylogic,,0,2,1,2,2,3,0,100
setup.exe,setup.exe,,0,1,2,1,2,3,8,1
phoneme,phoneme,,5,2,0,7,2,7,6,1
box2dweb,box2dweb,,2,0,0,2,1,2,1,1
getdibits,getdibits,,0,0,0,0,2,0,9,1
popcornjs,popcornjs,,0,0,1,0,2,1,1,1
bootstrap-studio,bootstrap-studio,,3,6,5,9,5,14,1,100
drop-database,drop-database,,3,0,1,3,3,4,1,1
sarsa,sarsa,,4,0,6,4,4,10,0,1
configsource,configsource,,0,0,3,0,1,3,8,1
electron-vue,electron-vue,,14,3,6,17,8,23,1,1
perldoc,perldoc,,2,1,0,3,4,3,9,1
perl-core,perl-core,,0,0,1,0,1,1,9,1
sendy,sendy,,1,1,3,2,1,5,4,1
adwords-api-v201802,adwords-api-v201802,,3,4,16,7,15,23,5,33.333333
mapmyindia-api,mapmyindia-api,,2,2,2,4,5,6,3,1
syslog4j,syslog4j,,0,0,1,0,1,1,9,1
spree-upgrade,spree-upgrade,,0,2,1,2,2,3,12,100
sonarqube5.2,sonarqube5.2,,0,0,0,0,2,0,3,1
tiny-dnn,tiny-dnn,,0,0,1,0,1,1,0,1
sitecore-exm,sitecore-exm,,0,0,1,0,3,1,8,1
elcimagepickercontroller,elcimagepickercontroller,,0,0,1,0,1,1,13,1
tinymapper,tinymapper,,1,0,0,1,1,1,8,1
autoclass,autoclass,,0,0,0,0,3,0,0,1
aws-serverless,aws-serverless,,75,78,128,153,59,281,6,4
hardware-security-module,hardware-security-module,,0,0,1,0,1,1,6,1
worhp,worhp,,1,0,0,1,1,1,0,1
ibtool,ibtool,,0,0,0,0,1,0,8,1
aws-load-balancer,aws-load-balancer,,41,19,69,60,44,129,6,1
r-future,r-future,,0,2,16,2,3,18,0,100
silicon,silicon,,0,0,2,0,1,2,3,1
energysmart,energysmart,,0,0,0,0,2,0,0,1
colormatrixfilter,colormatrixfilter,,1,0,1,1,4,2,1,1
evp-cipher,evp-cipher,,3,4,4,7,1,11,6,33.333333
lenskit,lenskit,,0,0,2,0,1,2,3,1
chromephp,chromephp,,0,0,0,0,1,0,4,1
relaxng-compact,relaxng-compact,,1,0,3,1,1,4,3,1
ecobertura,ecobertura,,0,0,1,0,1,1,3,1
scan-build,scan-build,,2,1,2,3,1,5,9,1
inbound-security-rule,inbound-security-rule,,1,0,2,1,3,3,8,1
shazam,shazam,,0,0,1,0,2,1,13,1
tfs-to-tfs-migration-tool,tfs-to-tfs-migration-tool,,0,0,0,0,1,0,8,1
hit-highlighting,hit-highlighting,,0,1,2,1,1,3,8,1
gmcs,gmcs,,0,0,1,0,1,1,8,1
angularjs-ng-style,angularjs-ng-style,,0,0,0,0,1,0,1,1
twine-game-engine,twine-game-engine,,0,0,1,0,2,1,1,1
cryptolicensing,cryptolicensing,,0,0,0,0,1,0,8,1
question2answer,question2answer,,4,1,5,5,5,10,4,1
neo4j-driver,neo4j-driver,,2,7,3,9,10,12,2,250
r-mapview,r-mapview,,2,7,5,9,3,14,0,250
dataviewwebpart,dataviewwebpart,,0,0,1,0,1,1,8,1
spider-chart,spider-chart,,0,0,3,0,6,3,0,1
mergefield,mergefield,,3,3,0,6,3,6,5,1
postfile,postfile,,1,0,0,1,3,1,4,1
nestedlayout,nestedlayout,,0,0,1,0,1,1,3,1
hdfql,hdfql,,1,2,1,3,3,4,0,100
buildingblocks,buildingblocks,,0,0,0,0,1,0,4,1
js-test-driver,js-test-driver,,0,4,1,4,1,5,1,300
feature-tracking,feature-tracking,,1,2,0,3,1,3,0,100
pdk,pdk,,0,0,3,0,3,3,6,1
openide,openide,,0,0,0,0,1,0,3,1
fins,fins,,0,1,1,1,2,2,9,1
ios-contacts,ios-contacts,,0,2,2,2,3,4,13,100
hdiv,hdiv,,1,0,2,1,2,3,3,1
zend-autoloader,zend-autoloader,,1,0,0,1,2,1,4,1
aeroolib,aeroolib,,0,1,0,1,2,1,0,1
keyman,keyman,,0,0,1,0,2,1,13,1
keyman-developer,keyman-developer,,0,0,2,0,2,2,13,1
high-contrast,high-contrast,,2,1,5,3,4,8,8,1
sharedservices,sharedservices,,1,0,1,1,3,2,1,1
nl2br,nl2br,,0,1,2,1,4,3,4,1
vertical-rhythm,vertical-rhythm,,0,0,0,0,1,0,1,1
ed25519-donna,ed25519-donna,,0,0,1,0,1,1,6,1
runtimemodification,runtimemodification,,1,1,0,2,1,2,1,1
errorformat,errorformat,,1,1,1,2,1,3,9,1
psalm-php,psalm-php,,1,1,0,2,1,2,9,1
custom-tools,custom-tools,,0,0,0,0,1,0,8,1
simhash,simhash,,0,0,2,0,2,2,0,1
multiple-variable-return,multiple-variable-return,,1,1,1,2,1,3,4,1
ie7.js,ie7.js,,0,0,0,0,1,0,1,1
node-dev,node-dev,,0,0,1,0,1,1,1,1
videotexture,videotexture,,0,0,1,0,1,1,0,1
django-ratings,django-ratings,,1,0,0,1,1,1,0,1
dind,dind,,7,1,14,8,4,22,6,1
cloudflare-apps,cloudflare-apps,,4,0,3,4,3,7,4,1
lazy-propagation,lazy-propagation,,0,0,0,0,1,0,0,1
iap-hosted-content,iap-hosted-content,,0,0,1,0,2,1,13,1
traceswitch,traceswitch,,0,0,0,0,1,0,8,1
demangler,demangler,,1,0,2,1,1,3,9,1
alienvault,alienvault,,2,0,1,2,3,3,4,1
rxjs-pipeable-operators,rxjs-pipeable-operators,,26,20,39,46,19,85,1,1
java-canvas,java-canvas,,2,0,1,2,3,3,3,1
handyjson,handyjson,,0,0,1,0,1,1,13,1
msmessage,msmessage,,3,3,4,6,1,10,13,1
mfa,mfa,,14,30,20,44,8,64,6,114.285714
nettopologysuite,nettopologysuite,,4,8,5,12,7,17,8,100
emacs-prelude,emacs-prelude,,0,0,1,0,1,1,9,1
qgraphicspathitem,qgraphicspathitem,,0,0,1,0,2,1,0,1
microsoft-graph-excel,microsoft-graph-excel,,0,5,0,5,1,5,8,400
liquidcore,liquidcore,,1,0,0,1,1,1,3,1
django-dev-server,django-dev-server,,1,1,1,2,1,3,0,1
gomega,gomega,,3,1,2,4,2,6,6,1
avr-studio7,avr-studio7,,0,0,0,0,1,0,9,1
context-bound,context-bound,,0,2,0,2,3,2,2,100
google-openidconnect,google-openidconnect,,0,0,4,0,3,4,5,1
pythonce,pythonce,,0,0,0,0,3,0,0,1
puppetlabs-mysql,puppetlabs-mysql,,0,0,0,0,1,0,6,1
default.png,default.png,,0,1,0,1,1,1,0,1
react-native-meteor,react-native-meteor,,0,0,1,0,2,1,1,1
android-update-sdk,android-update-sdk,,0,1,0,1,2,1,3,1
jqueryi-ui-buttonset,jqueryi-ui-buttonset,,0,0,0,0,2,0,1,1
mutablelivedata,mutablelivedata,,21,36,33,57,12,90,3,71.428571
masterslider,masterslider,,1,0,2,1,1,3,4,1
comboboxex,comboboxex,,1,0,0,1,1,1,9,1
filesystem-access,filesystem-access,,0,0,1,0,2,1,3,1
text-to-html,text-to-html,,0,0,0,0,1,0,6,1
phpasn1,phpasn1,,0,0,0,0,1,0,4,1
kube-controller-manager,kube-controller-manager,,4,0,7,4,3,11,6,1
javax.validation,javax.validation,,5,12,11,17,9,28,3,140
apple-photos,apple-photos,,0,0,3,0,1,3,13,1
viewing,viewing,,0,0,1,0,1,1,1,1
wifstream,wifstream,,2,0,0,2,2,2,9,1
espocrm,espocrm,,1,0,0,1,3,1,4,1
control-structure,control-structure,,2,2,3,4,4,7,0,1
pgcc,pgcc,,1,0,0,1,2,1,0,1
monkeylearn,monkeylearn,,1,0,0,1,1,1,3,1
django-pandas,django-pandas,,1,0,0,1,2,1,0,1
wpf-interop,wpf-interop,,0,0,0,0,2,0,8,1
can,can,,0,0,0,0,1,0,9,1
selectoneradio,selectoneradio,,0,0,4,0,1,4,3,1
canjs-component,canjs-component,,0,1,0,1,2,1,1,1
j2ssh,j2ssh,,1,0,1,1,2,2,3,1
powerdns,powerdns,,2,3,3,5,5,8,4,50
ternjs,ternjs,,0,0,0,0,2,0,1,1
picos-api,picos-api,,0,0,0,0,1,0,0,1
fixup,fixup,,0,0,1,0,2,1,6,1
dendropy,dendropy,,0,0,1,0,2,1,0,1
pythonplotter,pythonplotter,,0,1,4,1,1,5,0,1
siberiancms,siberiancms,,0,0,2,0,1,2,4,1
django-activity-stream,django-activity-stream,,0,1,1,1,3,2,0,1
visual-studio-shell,visual-studio-shell,,0,0,0,0,2,0,9,1
asp.net-customcontrol,asp.net-customcontrol,,0,0,1,0,2,1,8,1
wkuserscript,wkuserscript,,2,0,0,2,2,2,13,1
generic-exception,generic-exception,,0,0,0,0,1,0,8,1
flash-player-11,flash-player-11,,0,0,1,0,1,1,3,1
ambar,ambar,,0,0,0,0,1,0,6,1
mscomm32,mscomm32,,0,0,3,0,3,3,5,1
node-repl,node-repl,,1,0,2,1,2,3,1,1
publify,publify,,0,0,0,0,1,0,6,1
grpc-web,grpc-web,,6,6,13,12,3,25,6,1
variable-selection,variable-selection,,4,0,3,4,5,7,0,1
uitabview,uitabview,,0,0,0,0,3,0,13,1
ios11.3,ios11.3,,0,0,3,0,24,3,13,1
igdatachart,igdatachart,,0,0,0,0,1,0,8,1
screenrc,screenrc,,0,0,1,0,1,1,9,1
httpapplicationstate,httpapplicationstate,,0,0,0,0,2,0,8,1
monocle,monocle,,0,1,0,1,1,1,2,1
interactive-mode,interactive-mode,,1,0,3,1,1,4,0,1
tatukgis,tatukgis,,0,1,0,1,1,1,4,1
multer-gridfs-storage,multer-gridfs-storage,,10,5,14,15,2,29,1,1
blktrace,blktrace,,1,0,2,1,1,3,6,1
jquery-cycle,jquery-cycle,,0,0,1,0,1,1,1,1
optimistic,optimistic,,4,0,0,4,2,4,1,1
paddle-paddle,paddle-paddle,,0,0,0,0,1,0,0,1
apple-business-chat,apple-business-chat,,2,0,4,2,1,6,13,1
r-devtools,r-devtools,,0,1,0,1,1,1,0,1
episerver-6-r2,episerver-6-r2,,0,0,0,0,1,0,8,1
git-fsck,git-fsck,,2,1,3,3,1,6,6,1
vuepress,vuepress,,17,21,25,38,26,63,1,23.529412
castle-windsor-3,castle-windsor-3,,1,0,0,1,1,1,8,1
scroll-lock,scroll-lock,,0,2,1,2,2,3,1,100
opengrok,opengrok,,1,0,8,1,1,9,9,1
templavoila,templavoila,,1,0,6,1,4,7,4,1
non-latin,non-latin,,2,0,1,2,3,3,0,1
log-ascii-standard,log-ascii-standard,,1,0,0,1,1,1,3,1
scayt,scayt,,0,0,1,0,2,1,1,1
arimageanchor,arimageanchor,,1,0,3,1,2,4,13,1
manifoldjs,manifoldjs,,0,0,3,0,1,3,1,1
formsy-material-ui,formsy-material-ui,,0,0,0,0,1,0,1,1
keepass,keepass,,1,6,4,7,2,11,8,500
open-webkit-sharp,open-webkit-sharp,,0,0,1,0,1,1,8,1
flex4.5,flex4.5,,0,0,2,0,2,2,13,1
sysbench,sysbench,,1,2,0,3,2,3,4,100
dragsort,dragsort,,0,0,0,0,1,0,1,1
cross-page-postback,cross-page-postback,,0,0,0,0,1,0,8,1
xaml-resources,xaml-resources,,0,0,0,0,2,0,8,1
acceptbutton,acceptbutton,,0,0,0,0,2,0,8,1
console.dir,console.dir,,0,0,0,0,1,0,1,1
winsock-lsp,winsock-lsp,,0,0,0,0,1,0,9,1
moose-technology,moose-technology,,0,0,0,0,1,0,13,1
opsgenie,opsgenie,,1,1,2,2,2,4,6,1
ebook-reader,ebook-reader,,0,1,0,1,1,1,13,1
gulp-jest,gulp-jest,,0,0,2,0,1,2,1,1
cupertinopicker,cupertinopicker,,0,1,3,1,2,4,13,1
jwebunit,jwebunit,,0,0,0,0,1,0,3,1
react-animations,react-animations,,6,6,11,12,7,23,1,1
libxlsxwriter,libxlsxwriter,,0,0,0,0,2,0,9,1
aws-secrets-manager,aws-secrets-manager,,15,37,21,52,17,73,6,146.666667
html.renderpartial,html.renderpartial,,0,2,2,2,3,4,8,100
ruby-daemons,ruby-daemons,,0,0,1,0,1,1,12,1
msmq-transaction,msmq-transaction,,0,0,0,0,1,0,8,1
structopt,structopt,,0,1,2,1,3,3,9,1
open-session-in-view,open-session-in-view,,2,0,1,2,1,3,3,1
innobackupex,innobackupex,,3,0,0,3,2,3,4,1
grpc-gateway,grpc-gateway,,1,3,7,4,5,11,6,200
adplus,adplus,,0,0,2,0,2,2,9,1
chrome-promise,chrome-promise,,0,0,1,0,1,1,1,1
fluentlenium,fluentlenium,,1,0,0,1,2,1,3,1
ovf,ovf,,0,1,2,1,5,3,6,1
tfignore,tfignore,,0,0,0,0,2,0,8,1
coldfire,coldfire,,1,0,1,1,1,2,9,1
azure-fluent-api,azure-fluent-api,,1,3,2,4,6,6,8,200
failable,failable,,0,0,0,0,1,0,13,1
batch-request,batch-request,,0,3,2,3,4,5,5,200
gcc-extensions,gcc-extensions,,0,1,6,1,3,7,9,1
hbase-filter,hbase-filter,,0,3,2,3,3,5,2,200
diffbot,diffbot,,0,0,0,0,2,0,0,1
checkjs,checkjs,,0,0,4,0,4,4,9,1
blender-2.67,blender-2.67,,1,0,3,1,1,4,0,1
angular2-inputs,angular2-inputs,,0,0,0,0,1,0,1,1
dbmigrator,dbmigrator,,1,0,0,1,1,1,8,1
angular-data,angular-data,,1,1,0,2,1,2,1,1
icon-language,icon-language,,0,0,0,0,1,0,2,1
opal,opal,,1,0,2,1,1,3,12,1
mapael,mapael,,1,1,3,2,3,5,1,1
k2-smartforms,k2-smartforms,,0,3,0,3,2,3,5,200
dictionary-attack,dictionary-attack,,0,1,4,1,1,5,6,1
pep8-assembly,pep8-assembly,,1,0,3,1,2,4,9,1
pyalsaaudio,pyalsaaudio,,2,2,0,4,2,4,0,1
jvcl,jvcl,,0,2,1,2,2,3,9,100
support-preference,support-preference,,0,0,0,0,1,0,3,1
spring-batch-job-monitoring,spring-batch-job-monitoring,,1,7,7,8,6,15,3,600
zig,zig,,1,2,0,3,1,3,9,100
getstate,getstate,,0,0,1,0,1,1,1,1
data-profiling,data-profiling,,0,1,5,1,3,6,4,1
datacite,datacite,,0,0,0,0,1,0,4,1
linked-data-platform,linked-data-platform,,0,0,0,0,1,0,2,1
clustal,clustal,,1,0,1,1,1,2,0,1
springlayout,springlayout,,2,0,1,2,2,3,3,1
tkentry,tkentry,,0,0,0,0,2,0,0,1
all-in-one-event-calendar,all-in-one-event-calendar,,0,1,0,1,1,1,4,1
csso,csso,,0,0,0,0,1,0,9,1
sygic,sygic,,0,1,6,1,2,7,13,1
treecellrenderer,treecellrenderer,,0,1,0,1,1,1,3,1
image-stabilization,image-stabilization,,2,1,1,3,3,4,0,1
junit3,junit3,,1,0,0,1,2,1,3,1
inference-engine,inference-engine,,1,2,5,3,3,8,0,100
specter,specter,,1,2,1,3,4,4,2,100
hadoop-2.7.2,hadoop-2.7.2,,0,0,2,0,2,2,2,1
hex-file,hex-file,,3,0,1,3,1,4,9,1
uglifycss,uglifycss,,0,0,0,0,1,0,4,1
lucene-filters,lucene-filters,,0,0,0,0,1,0,3,1
nsoftware,nsoftware,,0,0,0,0,1,0,8,1
option-explicit,option-explicit,,1,0,0,1,1,1,5,1
start-page,start-page,,1,1,1,2,1,3,1,1
ldapauth,ldapauth,,1,2,7,3,4,10,1,100
word-boundaries,word-boundaries,,0,0,2,0,1,2,0,1
wix-extension,wix-extension,,1,1,3,2,3,5,8,1
pinging,pinging,,0,0,0,0,1,0,9,1
kendo-menu,kendo-menu,,1,0,3,1,4,4,1,1
db2-woc,db2-woc,,0,0,0,0,4,0,6,1
ibm-cloud-platform,ibm-cloud-platform,,0,1,2,1,1,3,6,1
delphi-4,delphi-4,,0,0,0,0,1,0,9,1
squarify,squarify,,0,0,2,0,2,2,0,1
google-sheets-macros,google-sheets-macros,,34,42,45,76,35,121,5,23.529412
httpclientfactory,httpclientfactory,,8,12,20,20,15,40,8,50
android-controls,android-controls,,0,0,1,0,1,1,3,1
mono-posix,mono-posix,,0,0,0,0,1,0,8,1
tumbleweed,tumbleweed,,0,0,1,0,2,1,1,1
unit-type,unit-type,,0,0,0,0,2,0,9,1
angular-gridster2,angular-gridster2,,7,7,10,14,4,24,1,1
trinidad-gem,trinidad-gem,,0,0,0,0,1,0,12,1
inheriting-constructors,inheriting-constructors,,0,0,0,0,4,0,9,1
facebook-sdk-3.0,facebook-sdk-3.0,,1,1,6,2,5,8,13,1
jobjectformatter,jobjectformatter,,1,1,6,2,1,8,8,1
dingbats,dingbats,,0,0,1,0,1,1,13,1
pyalgotrade,pyalgotrade,,0,1,2,1,3,3,0,1
mknetworkkit,mknetworkkit,,0,0,0,0,1,0,13,1
spring-data-jdbc,spring-data-jdbc,,18,7,26,25,6,51,3,1
defaulted-functions,defaulted-functions,,1,0,1,1,1,2,9,1
sql-azure-alerts,sql-azure-alerts,,2,1,3,3,2,6,8,1
dojo2,dojo2,,0,0,0,0,3,0,1,1
uwamp,uwamp,,3,0,5,3,2,8,4,1
magento2.2.2,magento2.2.2,,0,0,4,0,2,4,4,1
magento2.2.3,magento2.2.3,,4,0,10,4,7,14,4,1
virtualdub,virtualdub,,0,0,0,0,4,0,9,1
archiverjs,archiverjs,,4,0,2,4,2,6,1,1
yui-calendar,yui-calendar,,0,0,0,0,1,0,1,1
mixed-programming,mixed-programming,,2,0,2,2,1,4,9,1
terraform-provider-cloudflare,terraform-provider-cloudflare,,0,0,1,0,3,1,6,1
event-queue,event-queue,,0,0,0,0,1,0,1,1
user-environment,user-environment,,0,0,1,0,1,1,0,1
slatejs,slatejs,,5,7,10,12,6,22,1,40
akka.net-networking,akka.net-networking,,0,0,3,0,4,3,8,1
adaptive-parallel-payment,adaptive-parallel-payment,,0,0,0,0,1,0,4,1
drupal-menu,drupal-menu,,0,0,2,0,2,2,4,1
micro,micro,,3,3,7,6,4,13,1,1
nl-classifier,nl-classifier,,0,0,3,0,1,3,6,1
chromebox,chromebox,,2,1,1,3,2,4,3,1
printqueuewatch,printqueuewatch,,0,0,1,0,1,1,8,1
ria,ria,,1,2,0,3,2,3,8,100
bizunit,bizunit,,0,0,0,0,1,0,8,1
team-city-10.0,team-city-10.0,,1,0,2,1,2,3,8,1
text-coloring,text-coloring,,1,1,2,2,3,4,0,1
numpy-stl,numpy-stl,,1,3,2,4,4,6,0,200
microsoft-commerce-server,microsoft-commerce-server,,0,0,0,0,1,0,8,1
bitdefender,bitdefender,,1,0,0,1,3,1,8,1
primesense,primesense,,0,0,1,0,2,1,0,1
ssis-data-flow,ssis-data-flow,,0,0,0,0,1,0,5,1
ora-00984,ora-00984,,0,0,0,0,2,0,4,1
arsoft.tools.net,arsoft.tools.net,,0,0,0,0,1,0,1,1
cptbarplot,cptbarplot,,0,0,1,0,1,1,0,1
findname,findname,,1,0,1,1,1,2,8,1
cfwheels,cfwheels,,0,0,0,0,1,0,8,1
helicon-ape,helicon-ape,,1,0,0,1,1,1,8,1
ltk,ltk,,2,1,2,3,2,5,0,1
jd-eclipse,jd-eclipse,,0,0,1,0,1,1,3,1
nsopenglview,nsopenglview,,0,0,4,0,2,4,13,1
mat-tab,mat-tab,,13,7,19,20,13,39,1,1
jnp,jnp,,0,0,0,0,2,0,3,1
entity-framework-4.1,entity-framework-4.1,,0,0,2,0,1,2,8,1
mutable-context-wrapper,mutable-context-wrapper,,0,0,0,0,1,0,3,1
abbr,abbr,,1,0,2,1,2,3,1,1
retire,retire,,0,0,0,0,1,0,3,1
django-baton,django-baton,,0,0,0,0,2,0,0,1
asp.net-spa,asp.net-spa,,0,0,1,0,2,1,8,1
nonclient-area,nonclient-area,,2,1,4,3,3,7,8,1
escp,escp,,0,0,2,0,2,2,3,1
parallel-apps,parallel-apps,,0,0,0,0,1,0,3,1
knockout-subscribe,knockout-subscribe,,0,0,1,0,1,1,1,1
odata4j,odata4j,,1,0,0,1,3,1,3,1
stayontop,stayontop,,0,0,0,0,2,0,0,1
sessionstate-timeout,sessionstate-timeout,,1,0,0,1,1,1,3,1
bsddb,bsddb,,1,0,3,1,1,4,0,1
ejabberd-saas,ejabberd-saas,,2,0,0,2,2,2,3,1
npm-cache,npm-cache,,3,0,0,3,6,3,1,1
pdp-10,pdp-10,,0,0,0,0,1,0,9,1
teco,teco,,0,0,0,0,1,0,9,1
incompatible-timesharing-system,incompatible-timesharing-system,,0,0,0,0,1,0,9,1
pytest-aiohttp,pytest-aiohttp,,1,1,4,2,2,6,0,1
pytest-asyncio,pytest-asyncio,,3,3,8,6,2,14,0,1
spring-bean-dsl,spring-bean-dsl,,0,2,0,2,1,2,3,100
pagingmenucontroller,pagingmenucontroller,,0,0,0,0,1,0,13,1
mrtk,mrtk,,36,33,5,69,2,74,8,1
xcp2.x,xcp2.x,,0,0,2,0,1,2,16,1
cakephp-search-plugin,cakephp-search-plugin,,0,0,0,0,1,0,4,1
sucker-punch,sucker-punch,,0,0,1,0,3,1,12,1
activepivot,activepivot,,0,0,1,0,2,1,4,1
radicale,radicale,,0,0,3,0,1,3,13,1
icefaces-1.8,icefaces-1.8,,0,1,1,1,1,2,3,1
bitpay-api,bitpay-api,,0,0,1,0,1,1,6,1
photo-upload,photo-upload,,0,1,2,1,2,3,1,1
tortoisecvs,tortoisecvs,,0,0,0,0,1,0,6,1
wxnotebook,wxnotebook,,0,1,1,1,1,2,0,1
xcache,xcache,,0,0,0,0,1,0,4,1
xdp,xdp,,0,3,2,3,1,5,8,200
cornice,cornice,,0,0,1,0,1,1,0,1
domainunload,domainunload,,0,0,0,0,2,0,8,1
map-matching,map-matching,,0,0,2,0,1,2,2,1
flysystem-google-drive,flysystem-google-drive,,8,3,11,11,1,22,5,1
empy,empy,,1,0,0,1,1,1,9,1
extract-value,extract-value,,3,0,3,3,1,6,4,1
rails-for-zombies,rails-for-zombies,,0,0,0,0,1,0,12,1
google-local-search,google-local-search,,0,0,0,0,1,0,0,1
sap-basis,sap-basis,,1,1,1,2,3,3,5,1
verdaccio,verdaccio,,6,4,8,10,1,18,1,1
timecategory,timecategory,,0,0,0,0,2,0,3,1
tiddlywiki,tiddlywiki,,1,2,3,3,2,6,1,100
redux-loop,redux-loop,,0,1,2,1,1,3,1,1
mirrorlink,mirrorlink,,0,2,0,2,2,2,6,100
pybinding,pybinding,,0,0,1,0,3,1,9,1
rro,rro,,0,0,0,0,1,0,3,1
dunn.test,dunn.test,,5,1,0,6,2,6,0,1
rational-unified-process,rational-unified-process,,0,0,1,0,1,1,3,1
google-analytics-v3,google-analytics-v3,,0,1,1,1,1,2,5,1
codexl,codexl,,1,0,2,1,3,3,0,1
arrowdb,arrowdb,,0,0,0,0,1,0,13,1
rtd,rtd,,6,2,10,8,4,18,5,1
twemproxy,twemproxy,,1,0,4,1,2,5,3,1
template-method-pattern,template-method-pattern,,2,0,5,2,3,7,3,1
oauth-provider,oauth-provider,,0,1,0,1,2,1,0,1
cbmc,cbmc,,0,2,1,2,2,3,9,100
pycall,pycall,,2,2,4,4,2,8,0,1
lpeg,lpeg,,1,0,1,1,1,2,9,1
eclipse-jee,eclipse-jee,,2,1,7,3,5,10,3,1
grunt-contrib-jade,grunt-contrib-jade,,1,0,0,1,1,1,1,1
nptl,nptl,,0,0,0,0,1,0,9,1
aor-embedded-array,aor-embedded-array,,0,0,0,0,2,0,12,1
admob-rewardedvideoad,admob-rewardedvideoad,,11,8,25,19,30,44,3,1
html5ever,html5ever,,0,0,0,0,1,0,9,1
symbian,symbian,,0,0,0,0,1,0,3,1
s60,s60,,0,0,0,0,1,0,3,1
pys60,pys60,,0,0,0,0,1,0,3,1
s60-3rd-edition,s60-3rd-edition,,0,0,0,0,1,0,3,1
kotlinpoet,kotlinpoet,,4,3,10,7,9,17,3,1
terragrunt,terragrunt,,5,10,7,15,5,22,6,100
boids,boids,,0,0,1,0,2,1,0,1
commodore,commodore,,0,1,3,1,4,4,9,1
nvidia-jetson,nvidia-jetson,,19,26,36,45,23,81,0,36.842105
filesplitting,filesplitting,,1,6,3,7,2,10,0,500
scriptable,scriptable,,1,0,1,1,1,2,8,1
luadec,luadec,,1,0,0,1,1,1,9,1
unluac,unluac,,0,0,0,0,1,0,9,1
docker-layer,docker-layer,,1,0,2,1,1,3,6,1
fpgrowth,fpgrowth,,5,5,10,10,8,20,2,1
compiler-directives,compiler-directives,,1,4,0,5,3,5,8,300
diaspora,diaspora,,0,0,0,0,1,0,4,1
android-side-navigation,android-side-navigation,,1,0,1,1,1,2,3,1
scalaz7,scalaz7,,2,0,3,2,1,5,2,1
oncloselistener,oncloselistener,,0,0,1,0,1,1,3,1
knx,knx,,2,0,2,2,2,4,8,1
aol,aol,,0,2,1,2,2,3,4,100
fctb,fctb,,0,1,0,1,1,1,8,1
dccp,dccp,,0,0,0,0,1,0,0,1
endless-os,endless-os,,0,0,0,0,1,0,4,1
project-panama,project-panama,,0,1,1,1,2,2,3,1
common-dialog,common-dialog,,2,3,4,5,1,9,9,50
xacml2,xacml2,,1,1,0,2,1,2,4,1
iranges,iranges,,4,1,2,5,2,7,0,1
realstudio,realstudio,,0,0,0,0,1,0,13,1
firebird-2.0,firebird-2.0,,0,0,0,0,2,0,4,1
scoped-model,scoped-model,,19,10,6,29,3,35,13,1
ask-cli,ask-cli,,4,5,8,9,6,17,6,25
encryptbykey,encryptbykey,,0,0,1,0,1,1,4,1
elastic-cache,elastic-cache,,7,11,19,18,10,37,3,57.142857
ansible-api,ansible-api,,1,0,1,1,2,2,6,1
insertonsubmit,insertonsubmit,,0,0,0,0,2,0,8,1
iwconfig,iwconfig,,1,0,2,1,3,3,9,1
fastagi,fastagi,,0,0,1,0,2,1,13,1
ieaddon,ieaddon,,0,1,1,1,4,2,8,1
springsource,springsource,,0,0,0,0,2,0,3,1
spork,spork,,0,0,0,0,1,0,12,1
aws-transcribe,aws-transcribe,,9,3,13,12,13,25,6,1
pidgin,pidgin,,2,1,3,3,2,6,3,1
libpurple,libpurple,,0,0,0,0,1,0,3,1
arrangeoverride,arrangeoverride,,0,0,0,0,2,0,8,1
controlling,controlling,,1,1,1,2,2,3,0,1
postgraphile,postgraphile,,3,9,8,12,1,20,1,200
transient-failure,transient-failure,,0,1,3,1,3,4,8,1
simplepie,simplepie,,1,3,6,4,5,10,4,200
gltools,gltools,,0,0,0,0,1,0,9,1
adabas,adabas,,1,0,0,1,2,1,4,1
apache-pig-grunt,apache-pig-grunt,,0,0,2,0,1,2,2,1
easywsdl,easywsdl,,0,0,0,0,1,0,3,1
direct-labels,direct-labels,,1,1,0,2,2,2,0,1
redux-beacon,redux-beacon,,1,1,1,2,3,3,1,1
insomnia,insomnia,,6,7,7,13,7,20,4,16.666667
plas.io,plas.io,,0,0,0,0,1,0,8,1
ora-01427,ora-01427,,0,1,0,1,3,1,4,1
ohhttpstubs,ohhttpstubs,,0,0,2,0,4,2,13,1
devkitpro,devkitpro,,0,0,4,0,3,4,9,1
ignite-ui-angular,ignite-ui-angular,,2,0,3,2,1,5,1,1
ca1001,ca1001,,0,0,0,0,1,0,8,1
editmode,editmode,,1,1,1,2,1,3,13,1
dcommit,dcommit,,0,0,0,0,1,0,6,1
handshaking,handshaking,,1,0,2,1,1,3,6,1
bootstrap-notify,bootstrap-notify,,0,1,1,1,1,2,1,1
oslc,oslc,,1,3,2,4,1,6,3,200
lyo,lyo,,0,0,0,0,1,0,3,1
windows-1251,windows-1251,,0,2,2,2,4,4,0,100
targetsdkversion,targetsdkversion,,1,2,9,3,7,12,3,100
half-precision-float,half-precision-float,,3,11,1,14,1,15,0,266.666667
actionviewhelper,actionviewhelper,,0,2,0,2,2,2,12,100
google-widget,google-widget,,0,0,0,0,1,0,1,1
enumerable.range,enumerable.range,,0,0,0,0,2,0,8,1
mysql-error-1066,mysql-error-1066,,0,0,1,0,1,1,4,1
filab,filab,,0,0,1,0,2,1,6,1
xctwaiter,xctwaiter,,0,0,0,0,2,0,13,1
parsing-error,parsing-error,,2,1,5,3,3,8,3,1
hyperfilesql,hyperfilesql,,0,0,0,0,1,0,4,1
custom-scheme-url,custom-scheme-url,,1,0,1,1,2,2,3,1
genericprincipal,genericprincipal,,0,0,0,0,1,0,3,1
applicationpoolidentity,applicationpoolidentity,,0,0,7,0,1,7,8,1
pgmagick,pgmagick,,0,0,0,0,2,0,0,1
stat-density2d,stat-density2d,,0,0,4,0,8,4,0,1
grails-plugin-rabbitmq,grails-plugin-rabbitmq,,0,1,0,1,1,1,3,1
foogallery,foogallery,,0,0,1,0,1,1,4,1
document-template,document-template,,0,1,0,1,1,1,8,1
isolate-scope,isolate-scope,,0,0,1,0,3,1,1,1
file-sorting,file-sorting,,0,0,0,0,1,0,0,1
statspack,statspack,,0,0,0,0,1,0,4,1
listrowpresenter,listrowpresenter,,0,0,1,0,2,1,3,1
lightweight-stream-api,lightweight-stream-api,,2,1,0,3,1,3,3,1
buildfarm,buildfarm,,0,0,0,0,1,0,9,1
gud,gud,,0,0,0,0,2,0,9,1
unreliable-connection,unreliable-connection,,0,1,0,1,3,1,3,1
inline-namespaces,inline-namespaces,,1,0,0,1,2,1,9,1
ruby-object-mapper,ruby-object-mapper,,0,0,1,0,1,1,12,1
roxy-fileman,roxy-fileman,,0,0,3,0,2,3,1,1
chef-windows,chef-windows,,0,1,1,1,2,2,12,1
arena-simulation,arena-simulation,,1,1,5,2,1,7,0,1
logster,logster,,1,0,0,1,1,1,12,1
pitch-tracking,pitch-tracking,,0,1,1,1,1,2,0,1
openmx,openmx,,1,0,2,1,1,3,9,1
snowsql,snowsql,,2,1,6,3,3,9,4,1
dynamodb-utilization,dynamodb-utilization,,0,0,6,0,3,6,6,1
xcode9.4-beta,xcode9.4-beta,,0,0,0,0,2,0,13,1
shutter,shutter,,0,2,0,2,1,2,3,100
melonjs,melonjs,,1,0,1,1,1,2,1,1
google-reader,google-reader,,0,0,0,0,1,0,1,1
nested-exceptions,nested-exceptions,,0,0,1,0,2,1,9,1
xshell,xshell,,1,1,0,2,2,2,9,1
qtembedded,qtembedded,,0,0,0,0,1,0,9,1
wac,wac,,0,1,1,1,1,2,3,1
python-bytearray,python-bytearray,,1,2,6,3,3,9,0,100
count-unique,count-unique,,0,3,0,3,3,3,5,200
orient-sql,orient-sql,,0,0,0,0,1,0,2,1
goconvey,goconvey,,1,0,0,1,2,1,6,1
afas-online,afas-online,,0,1,1,1,1,2,12,1
roslynator,roslynator,,0,0,1,0,1,1,8,1
laravel-ioc,laravel-ioc,,0,0,0,0,2,0,4,1
git-repo,git-repo,,2,1,5,3,6,8,6,1
glitch-framework,glitch-framework,,1,4,6,5,3,11,1,300
neblio,neblio,,0,0,0,0,1,0,0,1
php-packages,php-packages,,1,0,0,1,2,1,4,1
gentics-mesh,gentics-mesh,,0,0,0,0,4,0,6,1
adsf,adsf,,1,0,0,1,1,1,8,1
tml,tml,,1,0,0,1,4,1,3,1
freetextbox,freetextbox,,1,0,1,1,1,2,8,1
mindsphere,mindsphere,,1,0,2,1,3,3,3,1
binance,binance,,10,18,33,28,27,61,0,80
accessorytype,accessorytype,,1,0,1,1,2,2,13,1
slim-js,slim-js,,0,0,1,0,1,1,1,1
gst-launch-1.0,gst-launch-1.0,,1,1,5,2,6,7,13,1
mysql-select-db,mysql-select-db,,0,1,2,1,2,3,4,1
errorcontrolsystem,errorcontrolsystem,,1,0,0,1,1,1,3,1
filter-validate-email,filter-validate-email,,0,0,0,0,2,0,4,1
json-web-signature,json-web-signature,,3,4,1,7,2,8,4,33.333333
yapf,yapf,,0,0,3,0,1,3,0,1
lupa,lupa,,0,0,0,0,2,0,9,1
parseobject,parseobject,,0,1,3,1,5,4,13,1
user-guide,user-guide,,0,0,0,0,2,0,3,1
react-native-git-upgrade,react-native-git-upgrade,,0,0,2,0,1,2,1,1
android-capture,android-capture,,1,1,1,2,1,3,3,1
simulacrum,simulacrum,,2,0,3,2,1,5,2,1
rtools,rtools,,3,2,14,5,11,19,0,1
relational-pouch,relational-pouch,,0,0,3,0,1,3,1,1
stackato,stackato,,0,0,0,0,1,0,3,1
vue-mc,vue-mc,,0,0,0,0,1,0,1,1
getclientrect,getclientrect,,1,0,0,1,1,1,1,1
heyzap,heyzap,,0,3,0,3,3,3,3,200
appsync-apollo-client,appsync-apollo-client,,6,1,12,7,1,19,6,1
cakephp-2.7,cakephp-2.7,,4,0,0,4,1,4,4,1
delegatecommand,delegatecommand,,1,2,2,3,3,5,8,100
system-setting,system-setting,,0,0,2,0,3,2,3,1
kxml2,kxml2,,1,0,0,1,1,1,3,1
kxml,kxml,,0,0,0,0,1,0,3,1
bsdtar,bsdtar,,0,0,1,0,1,1,9,1
selectedtext,selectedtext,,0,1,0,1,3,1,8,1
didreceivememorywarning,didreceivememorywarning,,1,0,0,1,1,1,13,1
three-way-merge,three-way-merge,,2,0,1,2,2,3,6,1
paw,paw,,0,1,1,1,1,2,3,1
defaultlistmodel,defaultlistmodel,,2,0,1,2,5,3,3,1
cfbundleidentifier,cfbundleidentifier,,2,1,1,3,4,4,13,1
objectaid,objectaid,,0,0,0,0,1,0,3,1
vssettings,vssettings,,0,0,3,0,1,3,8,1
android-log,android-log,,1,0,6,1,2,7,3,1
defects,defects,,0,2,4,2,1,6,6,100
jqxtreegrid,jqxtreegrid,,0,0,4,0,2,4,1,1
expected-condition,expected-condition,,5,6,5,11,2,16,3,20
graphql-spqr,graphql-spqr,,6,11,5,17,5,22,1,83.333333
mqx,mqx,,0,0,0,0,2,0,9,1
build-chain,build-chain,,0,1,1,1,2,2,8,1
ngit,ngit,,0,0,1,0,1,1,6,1
finite-group-theory,finite-group-theory,,3,0,3,3,1,6,0,1
didfailwitherror,didfailwitherror,,0,0,0,0,1,0,13,1
firebase-ab-testing,firebase-ab-testing,,5,8,26,13,7,39,13,60
vue-flickity,vue-flickity,,2,0,3,2,1,5,1,1
constrained-execution-reg,constrained-execution-reg,,0,0,0,0,1,0,0,1
psd2,psd2,,1,2,3,3,1,6,6,100
searchly,searchly,,0,0,1,0,1,1,6,1
taction,taction,,0,0,0,0,1,0,9,1
tactionlist,tactionlist,,1,0,0,1,1,1,9,1
ios-icons,ios-icons,,0,0,0,0,2,0,8,1
maxthon,maxthon,,0,0,0,0,1,0,3,1
azure-regions,azure-regions,,1,0,1,1,2,2,8,1
kotlinx.serialisation,kotlinx.serialisation,,5,8,10,13,5,23,3,60
tfs-security,tfs-security,,0,2,1,2,1,3,8,100
multi-value-dictionary,multi-value-dictionary,,1,0,1,1,1,2,0,1
anf,anf,,0,0,1,0,1,1,9,1
astyle,astyle,,0,0,0,0,2,0,9,1
actionable-notification,actionable-notification,,1,4,2,5,1,7,13,300
createoleobject,createoleobject,,1,0,4,1,2,5,5,1
source-address,source-address,,0,0,0,0,1,0,9,1
ruby-ffi,ruby-ffi,,0,2,1,2,2,3,12,100
firebird2.1,firebird2.1,,3,0,2,3,4,5,4,1
clist,clist,,0,0,0,0,1,0,4,1
quick-install-package,quick-install-package,,0,0,2,0,1,2,9,1
vue-paypal-check,vue-paypal-check,,0,0,1,0,1,1,4,1
reference-cycle,reference-cycle,,2,0,1,2,1,3,13,1
wkhtmltopdf-binary,wkhtmltopdf-binary,,3,0,4,3,5,7,12,1
high-order-component,high-order-component,,8,6,10,14,7,24,1,1
xrebel,xrebel,,1,0,1,1,1,2,3,1
tensorflow-android,tensorflow-android,,0,3,5,3,8,8,3,200
grunt-express-server,grunt-express-server,,0,0,1,0,1,1,1,1
tx-fluidcontent,tx-fluidcontent,,0,0,0,0,2,0,4,1
centos-6.9,centos-6.9,,0,0,3,0,6,3,9,1
method-names,method-names,,0,0,1,0,1,1,0,1
jquery.panzoom,jquery.panzoom,,0,1,7,1,3,8,1,1
pushstreamcontent,pushstreamcontent,,2,0,3,2,1,5,8,1
php4,php4,,0,1,4,1,5,5,4,1
uri.js,uri.js,,0,0,0,0,1,0,1,1
sqlkata,sqlkata,,7,5,6,12,5,18,8,1
requestify,requestify,,0,1,2,1,2,3,1,1
editorfortemplate,editorfortemplate,,0,0,1,0,1,1,8,1
sktransition,sktransition,,0,0,0,0,1,0,13,1
setuserinteractionenabled,setuserinteractionenabled,,0,0,2,0,3,2,13,1
stickynote,stickynote,,1,1,0,2,1,2,9,1
social-media-like,social-media-like,,1,1,0,2,1,2,4,1
redeploy,redeploy,,0,0,1,0,4,1,6,1
hangfire-console,hangfire-console,,0,1,0,1,2,1,8,1
wildfly-12,wildfly-12,,4,4,14,8,10,22,3,1
cgimagesource,cgimagesource,,1,0,0,1,2,1,13,1
datatip,datatip,,0,1,0,1,2,1,0,1
talos,talos,,5,6,3,11,3,14,0,20
siege,siege,,1,1,4,2,2,6,6,1
stringcollection,stringcollection,,1,0,0,1,2,1,8,1
azure-database-mysql,azure-database-mysql,,4,3,4,7,5,11,8,1
assertthat,assertthat,,0,1,1,1,3,2,3,1
ios12,ios12,,89,48,461,137,105,598,13,1
geoapi,geoapi,,1,0,0,1,3,1,8,1
mysql-error-1267,mysql-error-1267,,0,0,0,0,2,0,4,1
spid,spid,,0,0,2,0,2,2,4,1
shingles,shingles,,2,1,1,3,2,4,6,1
pact-ruby,pact-ruby,,0,0,0,0,1,0,3,1
wtx,wtx,,0,0,0,0,2,0,4,1
photutils,photutils,,0,0,1,0,2,1,0,1
guix,guix,,0,0,0,0,1,0,0,1
sentimentr,sentimentr,,3,5,4,8,2,12,0,66.666667
ngx-share,ngx-share,,0,1,2,1,1,3,1,1
ichat,ichat,,0,0,0,0,1,0,4,1
orbbec,orbbec,,0,0,9,0,1,9,0,1
tectonic-coreos,tectonic-coreos,,0,1,1,1,1,2,6,1
stratio,stratio,,0,2,1,2,3,3,2,100
irql,irql,,0,0,0,0,2,0,9,1
odk-xform,odk-xform,,1,0,0,1,2,1,6,1
mat-card,mat-card,,2,3,5,5,5,10,1,50
bitcount,bitcount,,0,0,0,0,2,0,9,1
population-count,population-count,,1,0,0,1,1,1,9,1
ipad-3,ipad-3,,1,1,0,2,1,2,13,1
massivejs,massivejs,,0,0,2,0,2,2,4,1
jcurses,jcurses,,0,0,0,0,1,0,3,1
char16-t,char16-t,,0,1,1,1,1,2,9,1
char32-t,char32-t,,0,0,0,0,1,0,9,1
libvpx,libvpx,,1,2,4,3,2,7,13,100
covering-index,covering-index,,1,3,0,4,3,4,4,200
magnification-api,magnification-api,,0,0,1,0,2,1,9,1
sidekit,sidekit,,4,0,3,4,2,7,0,1
yandex-tank,yandex-tank,,0,1,2,1,1,3,3,1
cubes,cubes,,2,4,2,6,4,8,4,100
jscep,jscep,,1,1,1,2,1,3,6,1
testcasesource,testcasesource,,0,2,0,2,2,2,8,100
http-1.0,http-1.0,,0,0,1,0,1,1,3,1
galaxy-nexus,galaxy-nexus,,0,0,0,0,1,0,3,1
jasper-plugin,jasper-plugin,,1,2,1,3,2,4,3,100
spweb,spweb,,0,1,0,1,2,1,8,1
react-jsonschema-forms,react-jsonschema-forms,,3,5,13,8,1,21,1,66.666667
smmry,smmry,,0,0,2,0,1,2,3,1
soappy,soappy,,0,1,0,1,1,1,3,1
packet-injection,packet-injection,,2,0,4,2,1,6,9,1
perl-critic,perl-critic,,1,0,0,1,2,1,9,1
github-api-v3,github-api-v3,,10,4,26,14,6,40,6,1
twig.js,twig.js,,2,0,3,2,1,5,4,1
combining-marks,combining-marks,,2,0,2,2,1,4,1,1
ufo,ufo,,0,0,0,0,1,0,1,1
modeless,modeless,,0,1,2,1,3,3,5,1
clickdimension,clickdimension,,0,0,3,0,1,3,8,1
pjl,pjl,,1,0,0,1,2,1,3,1
cgrectmake,cgrectmake,,1,0,1,1,2,2,13,1
react-ace,react-ace,,8,3,6,11,4,17,1,1
caller-id,caller-id,,3,2,4,5,11,9,3,1
restclientbuilder,restclientbuilder,,2,0,1,2,2,3,3,1
odfpy,odfpy,,1,0,0,1,1,1,0,1
recarray,recarray,,0,0,6,0,2,6,0,1
wkrefreshbackgroundtask,wkrefreshbackgroundtask,,0,0,1,0,1,1,13,1
imagedecoder,imagedecoder,,0,1,3,1,1,4,3,1
iserializable,iserializable,,2,0,3,2,3,5,8,1
postgresapp,postgresapp,,0,0,3,0,3,3,4,1
biojava,biojava,,0,0,1,0,1,1,3,1
viewhandler,viewhandler,,0,0,0,0,1,0,3,1
zuora,zuora,,0,1,4,1,1,5,3,1
gallium,gallium,,0,0,1,0,3,1,0,1
spring-projections,spring-projections,,3,1,2,4,3,6,3,1
realbasic,realbasic,,1,0,1,1,1,2,13,1
gen-fsm,gen-fsm,,0,0,0,0,1,0,2,1
py-amqplib,py-amqplib,,0,0,0,0,1,0,3,1
librabbitmq,librabbitmq,,0,0,1,0,1,1,3,1
design-data,design-data,,1,0,0,1,2,1,8,1
pyspin,pyspin,,3,3,1,6,1,7,0,1
flopy,flopy,,3,0,4,3,2,7,0,1
tree-nodes,tree-nodes,,0,0,0,0,2,0,1,1
arity,arity,,2,4,4,6,2,10,9,100
urlrewriting.net,urlrewriting.net,,0,0,0,0,1,0,8,1
mysql-error-2006,mysql-error-2006,,0,0,0,0,1,0,4,1
raintpl,raintpl,,0,2,0,2,1,2,4,100
im4java,im4java,,1,2,4,3,2,7,12,100
quirks-mode,quirks-mode,,0,2,1,2,1,3,1,100
fishbowl,fishbowl,,0,0,5,0,1,5,4,1
perl6-junction,perl6-junction,,1,0,0,1,2,1,9,1
jsl,jsl,,0,1,2,1,2,3,4,1
agile-processes,agile-processes,,0,1,3,1,1,4,6,1
sumproduct,sumproduct,,21,24,9,45,1,54,5,14.285714
live-update,live-update,,2,1,1,3,3,4,8,1
pgraphics,pgraphics,,0,0,2,0,1,2,1,1
zinnia,zinnia,,0,0,3,0,1,3,0,1
hol,hol,,2,1,0,3,4,3,2,1
relu,relu,,10,12,11,22,12,33,0,20
get-satisfaction,get-satisfaction,,0,0,0,0,1,0,6,1
google-cloud-composer,google-cloud-composer,,42,53,118,95,53,213,0,26.190476
build-impl.xml,build-impl.xml,,0,0,0,0,1,0,3,1
lambda-authorizer,lambda-authorizer,,10,8,15,18,2,33,6,1
arithabort,arithabort,,0,0,0,0,1,0,4,1
network-efficiency,network-efficiency,,1,2,0,3,2,3,0,100
tracepoint,tracepoint,,2,3,1,5,2,6,9,50
ipod,ipod,,0,0,3,0,2,3,13,1
dangerous-request,dangerous-request,,0,1,0,1,1,1,9,1
ora-00001,ora-00001,,0,1,1,1,1,2,4,1
comboboxmodel,comboboxmodel,,0,0,0,0,1,0,0,1
rollover-effect,rollover-effect,,0,1,0,1,2,1,3,1
withings,withings,,1,2,1,3,1,4,4,100
ls-remote,ls-remote,,1,0,1,1,3,2,6,1
clbeaconregion,clbeaconregion,,0,0,2,0,2,2,13,1
vsjitdebugger,vsjitdebugger,,0,0,0,0,1,0,8,1
kismet-udk,kismet-udk,,0,0,0,0,1,0,9,1
lorem-ipsum,lorem-ipsum,,1,1,0,2,2,2,3,1
xmetal,xmetal,,0,0,1,0,1,1,8,1
google-cloud-memorystore,google-cloud-memorystore,,5,10,14,15,12,29,6,100
wikitext,wikitext,,1,0,0,1,1,1,4,1
git-gc,git-gc,,1,1,3,2,1,5,6,1
mappath,mappath,,0,0,0,0,2,0,8,1
apache-commons-imaging,apache-commons-imaging,,1,0,0,1,1,1,3,1
metafile,metafile,,1,3,2,4,6,6,8,200
nolio,nolio,,0,0,1,0,1,1,6,1
fmpp,fmpp,,0,0,2,0,1,2,3,1
tearing,tearing,,0,0,3,0,1,3,8,1
jrun,jrun,,0,0,0,0,1,0,3,1
drawinrect,drawinrect,,0,0,1,0,1,1,13,1
binomial-cdf,binomial-cdf,,1,0,4,1,3,5,0,1
createremotethread,createremotethread,,0,3,3,3,2,6,9,200
kata-containers,kata-containers,,1,0,2,1,1,3,6,1
gvisor,gvisor,,0,3,0,3,1,3,6,200
maven-scr-plugin,maven-scr-plugin,,0,0,1,0,2,1,3,1
window.closed,window.closed,,0,1,2,1,1,3,1,1
libz,libz,,0,2,0,2,1,2,9,100
react-with-styles,react-with-styles,,3,3,2,6,4,8,1,1
policy-server,policy-server,,2,0,0,2,1,2,8,1
notepad2,notepad2,,0,0,0,0,1,0,9,1
cen-xfs,cen-xfs,,0,4,1,4,3,5,9,300
automotive,automotive,,4,10,10,14,3,24,9,150
automotive-grade-linux,automotive-grade-linux,,0,0,2,0,1,2,9,1
misfire-instruction,misfire-instruction,,0,0,0,0,2,0,3,1
amazon-dynamodb-index,amazon-dynamodb-index,,8,11,17,19,5,36,6,37.5
html-dataset,html-dataset,,0,0,2,0,1,2,1,1
wamp3,wamp3,,0,0,0,0,1,0,4,1
swscale,swscale,,1,0,1,1,2,2,13,1
bea,bea,,0,0,4,0,1,4,3,1
libtool-xcode,libtool-xcode,,1,1,1,2,1,3,9,1
fbsdklikebutton,fbsdklikebutton,,1,0,0,1,1,1,1,1
way2sms,way2sms,,0,0,2,0,2,2,0,1
webconfigurationmanager,webconfigurationmanager,,0,0,0,0,2,0,8,1
moinmoin,moinmoin,,0,3,1,3,1,4,0,200
wpflocalizationextension,wpflocalizationextension,,1,0,0,1,2,1,8,1
wcf-callbacks,wcf-callbacks,,2,0,1,2,1,3,8,1
casl,casl,,1,3,6,4,3,10,1,200
snips,snips,,3,1,3,4,1,7,0,1
delphi.net,delphi.net,,0,0,1,0,1,1,9,1
aws4c,aws4c,,0,0,0,0,1,0,6,1
jfif,jfif,,1,1,1,2,2,3,0,1
application-role,application-role,,0,0,1,0,1,1,4,1
telosys,telosys,,1,0,2,1,2,3,3,1
shinysky,shinysky,,0,0,0,0,2,0,0,1
angular2-compiler,angular2-compiler,,0,0,0,0,1,0,1,1
kendo-contextmenu,kendo-contextmenu,,1,1,0,2,1,2,1,1
service-fabric-remoting,service-fabric-remoting,,1,0,2,1,6,3,8,1
andmore,andmore,,0,0,0,0,3,0,3,1
bootstrap-wysiwyg,bootstrap-wysiwyg,,0,0,1,0,2,1,1,1
jar-with-dependencies,jar-with-dependencies,,0,0,1,0,1,1,3,1
applicationsettingsbase,applicationsettingsbase,,0,0,1,0,1,1,8,1
outline-view,outline-view,,0,1,3,1,2,4,3,1
toad-scripting,toad-scripting,,0,0,0,0,1,0,3,1
arcgis-online,arcgis-online,,0,0,1,0,3,1,3,1
dockerrun.aws.json,dockerrun.aws.json,,1,2,3,3,1,6,6,100
vb-like-operator,vb-like-operator,,3,0,1,3,1,4,5,1
vuexfire,vuexfire,,1,1,3,2,4,5,1,1
bitmovin-player,bitmovin-player,,0,0,3,0,2,3,3,1
rst2html.py,rst2html.py,,0,0,1,0,1,1,0,1
sn,sn,,1,0,1,1,1,2,8,1
masonite,masonite,,1,2,9,3,4,12,0,100
jquery-1.8,jquery-1.8,,0,0,0,0,1,0,4,1
srgs,srgs,,0,0,1,0,2,1,6,1
aspect-fit,aspect-fit,,1,0,2,1,2,3,13,1
erlangweb,erlangweb,,0,0,0,0,1,0,2,1
ibm-data-refinery,ibm-data-refinery,,1,0,0,1,2,1,6,1
gramex,gramex,,2,0,0,2,1,2,0,1
jsonunit,jsonunit,,0,0,1,0,1,1,3,1
chartjs-plugin-zoom,chartjs-plugin-zoom,,3,8,5,11,1,16,1,166.666667
resource-utilization,resource-utilization,,3,1,1,4,1,5,6,1
current-time,current-time,,6,3,5,9,8,14,0,1
iterator-range,iterator-range,,0,1,1,1,1,2,9,1
adexchange,adexchange,,0,1,0,1,1,1,3,1
btree-gist,btree-gist,,0,0,0,0,2,0,4,1
glyphrun,glyphrun,,0,0,0,0,2,0,8,1
rxjs-compat,rxjs-compat,,1,1,1,2,4,3,1,1
multiple-bounds,multiple-bounds,,0,0,1,0,1,1,3,1
.net-4.7.2,.net-4.7.2,,17,14,30,31,21,61,8,1
telerik-window,telerik-window,,1,0,0,1,1,1,8,1
android-percent-layout,android-percent-layout,,0,0,0,0,1,0,3,1
handlersocket,handlersocket,,0,0,0,0,1,0,9,1
java.time,java.time,,27,21,23,48,1,71,3,1
synset,synset,,4,1,4,5,3,9,0,1
jooby,jooby,,2,1,5,3,2,8,3,1
dbd-pg,dbd-pg,,0,0,1,0,2,1,9,1
nibble,nibble,,2,1,1,3,4,4,9,1
lando,lando,,2,5,6,7,6,13,6,150
sips,sips,,0,0,2,0,2,2,9,1
tpanel,tpanel,,0,0,1,0,2,1,9,1
mvcrazor,mvcrazor,,1,1,0,2,2,2,8,1
magic-string,magic-string,,1,0,0,1,2,1,0,1
ookii,ookii,,0,0,1,0,1,1,8,1
torchtext,torchtext,,10,6,13,16,8,29,0,1
bale-messenger,bale-messenger,,0,0,2,0,14,2,8,1
code-climate-cli,code-climate-cli,,0,0,1,0,2,1,6,1
keybase,keybase,,0,0,3,0,2,3,9,1
angular-cli-v6,angular-cli-v6,,16,5,85,21,168,106,1,1
layouttransform,layouttransform,,0,1,2,1,1,3,8,1
stream-django,stream-django,,0,0,1,0,1,1,6,1
smtpd,smtpd,,1,0,1,1,1,2,4,1
rinsim,rinsim,,0,0,0,0,10,0,3,1
adsapi-php.ini,adsapi-php.ini,,2,1,2,3,2,5,4,1
nth-element,nth-element,,0,0,0,0,1,0,9,1
flask-principal,flask-principal,,0,1,0,1,1,1,0,1
wxgo,wxgo,,0,0,0,0,2,0,9,1
dmx-ssas,dmx-ssas,,0,0,3,0,1,3,4,1
popmotion,popmotion,,8,3,9,11,3,20,1,1
angular-renderer2,angular-renderer2,,5,6,12,11,10,23,1,20
sigprocmask,sigprocmask,,1,0,1,1,2,2,9,1
classifier4j,classifier4j,,0,1,1,1,1,2,0,1
ravendb-http,ravendb-http,,0,1,1,1,2,2,8,1
vagrant-share,vagrant-share,,1,0,0,1,1,1,4,1
c++builder-5,c++builder-5,,0,0,0,0,2,0,9,1
lit-element,lit-element,,64,66,58,130,13,188,1,3.125
synedit,synedit,,0,0,1,0,1,1,9,1
adp,adp,,1,2,0,3,1,3,5,100
priority-inversion,priority-inversion,,3,1,4,4,1,8,9,1
adornerdecorator,adornerdecorator,,0,1,0,1,1,1,8,1
jsajaxfileuploader,jsajaxfileuploader,,3,0,3,3,1,6,8,1
custom-sections,custom-sections,,2,1,3,3,1,6,13,1
kin,kin,,3,1,1,4,2,5,1,1
openimaj,openimaj,,3,1,2,4,1,6,3,1
id3lib,id3lib,,0,0,1,0,1,1,9,1
swampy,swampy,,0,0,2,0,1,2,0,1
benfords-law,benfords-law,,0,0,0,0,1,0,0,1
cljs-ajax,cljs-ajax,,1,1,0,2,3,2,2,1
binomial-heap,binomial-heap,,0,0,1,0,2,1,0,1
tubular,tubular,,0,0,2,0,1,2,1,1
google-cloud-save,google-cloud-save,,0,0,0,0,2,0,8,1
drawtobitmap,drawtobitmap,,0,0,1,0,1,1,8,1
object-diagram,object-diagram,,0,0,0,0,3,0,3,1
astc,astc,,0,1,0,1,2,1,9,1
nssharingservice,nssharingservice,,1,1,2,2,2,4,13,1
least-common-ancestor,least-common-ancestor,,0,1,1,1,1,2,0,1
load-generator,load-generator,,0,0,0,0,1,0,3,1
jad,jad,,0,0,1,0,1,1,3,1
jadclipse,jadclipse,,0,0,0,0,1,0,3,1
bitbucket-aws-code-deploy,bitbucket-aws-code-deploy,,1,3,5,4,9,9,6,200
ejabberd-module,ejabberd-module,,13,5,16,18,14,34,3,1
constructor-reference,constructor-reference,,0,0,1,0,1,1,3,1
pivotaltracker,pivotaltracker,,1,0,1,1,1,2,4,1
swiftmessages,swiftmessages,,0,0,6,0,1,6,13,1
qtserial,qtserial,,1,0,1,1,1,2,9,1
intense-debate,intense-debate,,0,0,0,0,1,0,12,1
worker-loader,worker-loader,,1,4,6,5,3,11,1,300
cartocss,cartocss,,0,1,0,1,4,1,1,1
hygieia,hygieia,,0,1,3,1,3,4,6,1
jsr305,jsr305,,0,0,2,0,1,2,3,1
show-sql,show-sql,,0,0,2,0,1,2,3,1
usb4java,usb4java,,1,2,2,3,5,5,3,100
jam,jam,,1,0,6,1,1,7,9,1
cmattitude,cmattitude,,1,1,1,2,1,3,13,1
fedora-28,fedora-28,,2,0,5,2,8,7,9,1
xcode-template,xcode-template,,0,0,4,0,3,4,13,1
php-resque,php-resque,,0,0,0,0,2,0,4,1
ekg,ekg,,0,0,0,0,1,0,2,1
udl2,udl2,,0,0,0,0,2,0,0,1
django-2.1,django-2.1,,75,19,166,94,18,260,0,1
safari9,safari9,,0,0,1,0,1,1,1,1
simplejdbcinsert,simplejdbcinsert,,0,0,1,0,2,1,3,1
automount,automount,,1,3,1,4,2,5,9,200
offline.js,offline.js,,0,0,0,0,1,0,1,1
trustedconnection,trustedconnection,,0,0,0,0,1,0,4,1
rx-blocking,rx-blocking,,1,0,0,1,2,1,13,1
django-push-notifications,django-push-notifications,,4,2,3,6,2,9,0,1
laravel-stripe,laravel-stripe,,1,1,0,2,1,2,4,1
c#-7.3,c#-7.3,,5,10,18,15,14,33,8,100
spring-batch-excel,spring-batch-excel,,1,1,2,2,6,4,3,1
mvcroutehandler,mvcroutehandler,,0,2,2,2,2,4,8,100
gtm-oauth2,gtm-oauth2,,1,0,0,1,2,1,5,1
database-integrity,database-integrity,,2,0,2,2,3,4,4,1
buildaction,buildaction,,0,0,1,0,2,1,8,1
flask-caching,flask-caching,,0,3,0,3,3,3,0,200
google-website-optimizer,google-website-optimizer,,1,1,1,2,3,3,4,1
node-vm2,node-vm2,,1,1,8,2,3,10,1,1
facebook-business-sdk,facebook-business-sdk,,11,4,4,15,1,19,13,1
avcapturephotooutput,avcapturephotooutput,,1,1,3,2,1,5,13,1
mule-connector,mule-connector,,0,0,3,0,2,3,14,1
sqlj,sqlj,,0,0,0,0,1,0,3,1
quake,quake,,0,1,0,1,1,1,1,1
weak-events,weak-events,,1,1,0,2,1,2,8,1
weakeventmanager,weakeventmanager,,1,1,2,2,1,4,8,1
eunit,eunit,,0,0,1,0,3,1,2,1
jsonreststore,jsonreststore,,1,0,0,1,3,1,1,1
ios-library,ios-library,,1,1,1,2,2,3,13,1
qif,qif,,1,0,1,1,1,2,1,1
money-format,money-format,,1,2,6,3,4,9,4,100
emacs-ediff,emacs-ediff,,0,0,0,0,1,0,9,1
kepler,kepler,,0,0,1,0,1,1,0,1
heroku-redis,heroku-redis,,2,2,2,4,2,6,1,1
mbprogresshud,mbprogresshud,,5,1,3,6,2,9,13,1
simevents,simevents,,0,1,0,1,1,1,0,1
aerospike-ce,aerospike-ce,,1,1,3,2,3,5,3,1
qgraphicseffect,qgraphicseffect,,0,0,0,0,2,0,0,1
executiontimeout,executiontimeout,,0,1,0,1,1,1,8,1
ruby-debug,ruby-debug,,0,0,0,0,2,0,12,1
azure-elasticpool,azure-elasticpool,,8,2,4,10,3,14,8,1
touch-feedback,touch-feedback,,0,0,1,0,1,1,3,1
select-until,select-until,,0,0,0,0,2,0,4,1
html.listboxfor,html.listboxfor,,1,0,1,1,1,2,8,1
oracle-olap,oracle-olap,,0,0,1,0,2,1,4,1
ssis-development,ssis-development,,0,0,1,0,1,1,4,1
plr,plr,,1,0,4,1,4,5,4,1
print-style,print-style,,1,0,1,1,3,2,1,1
ios7-statusbar,ios7-statusbar,,0,1,0,1,1,1,13,1
samsung-dex,samsung-dex,,0,1,2,1,1,3,3,1
azure-maps,azure-maps,,18,9,23,27,14,50,8,1
mpplayablecontentdelegate,mpplayablecontentdelegate,,0,1,1,1,1,2,13,1
srilm,srilm,,1,2,0,3,1,3,0,100
karma-babel-preprocessor,karma-babel-preprocessor,,0,1,0,1,1,1,1,1
karma-typescript,karma-typescript,,1,2,6,3,4,9,1,100
popup-balloons,popup-balloons,,0,0,0,0,2,0,9,1
programmatic-config,programmatic-config,,1,0,0,1,1,1,3,1
hibernate-postgresql,hibernate-postgresql,,0,0,0,0,1,0,4,1
igtree,igtree,,1,0,0,1,1,1,8,1
cycle-sort,cycle-sort,,0,0,0,0,1,0,0,1
arrayiterator,arrayiterator,,2,0,0,2,1,2,1,1
this-pointer,this-pointer,,3,3,12,6,6,18,9,1
ksonnet,ksonnet,,0,0,4,0,6,4,6,1
pattern-mining,pattern-mining,,4,1,2,5,4,7,0,1
hangfire-unity,hangfire-unity,,0,0,0,0,2,0,8,1
hangfire-sql,hangfire-sql,,2,4,2,6,3,8,8,100
ihttpmodule,ihttpmodule,,3,0,1,3,2,4,8,1
grunt-contrib-jshint,grunt-contrib-jshint,,0,0,0,0,1,0,1,1
lockbox-3,lockbox-3,,2,0,1,2,1,3,9,1
showdown,showdown,,2,2,3,4,2,7,1,1
xperf,xperf,,0,0,3,0,2,3,9,1
mongojack,mongojack,,1,0,2,1,1,3,1,1
bing-webmaster-tools,bing-webmaster-tools,,0,0,1,0,2,1,4,1
wxhtmlwindow,wxhtmlwindow,,0,0,0,0,2,0,9,1
ml.net,ml.net,,34,41,62,75,21,137,8,20.588235
react-player,react-player,,6,5,9,11,2,20,1,1
gradle-cache,gradle-cache,,0,1,1,1,2,2,3,1
sql-server-data-project,sql-server-data-project,,0,3,0,3,1,3,4,200
elm-architecture,elm-architecture,,3,1,7,4,7,11,1,1
ehostunreach,ehostunreach,,0,0,3,0,1,3,3,1
firebase-mlkit,firebase-mlkit,,92,74,118,166,74,284,3,1
openfaces,openfaces,,2,1,2,3,3,5,0,1
jquery-1.10,jquery-1.10,,0,0,2,0,1,2,1,1
qwindow,qwindow,,2,0,1,2,2,3,9,1
wpf-brushes,wpf-brushes,,0,1,1,1,1,2,8,1
esri-loader,esri-loader,,1,0,1,1,1,2,1,1
session-cache,session-cache,,0,1,0,1,1,1,6,1
indy-8,indy-8,,0,0,0,0,1,0,9,1
open-json,open-json,,8,11,9,19,2,28,4,37.5
cabbage,cabbage,,0,0,0,0,1,0,2,1
yahoo-boss-api,yahoo-boss-api,,0,0,0,0,1,0,4,1
compatibility-level,compatibility-level,,2,1,2,3,1,5,4,1
invocationhandler,invocationhandler,,1,0,2,1,1,3,3,1
softaculous,softaculous,,1,0,1,1,2,2,4,1
yii2-active-records,yii2-active-records,,0,1,0,1,5,1,4,1
sigils,sigils,,1,0,0,1,1,1,2,1
cgcontextdrawimage,cgcontextdrawimage,,1,1,0,2,1,2,13,1
signalr-service,signalr-service,,5,1,6,6,2,12,8,1
grep-indesign,grep-indesign,,0,2,0,2,1,2,0,100
qpolygon,qpolygon,,0,0,1,0,1,1,9,1
systemeventlistener,systemeventlistener,,0,0,0,0,1,0,3,1
pvrtc,pvrtc,,0,0,0,0,1,0,13,1
sieve-language,sieve-language,,0,2,5,2,1,7,4,100
amo,amo,,0,1,0,1,1,1,8,1
wagon,wagon,,0,1,3,1,1,4,3,1
cro,cro,,0,1,6,1,7,7,9,1
pyramid-arima,pyramid-arima,,5,4,8,9,4,17,0,1
xcuiscreenshot,xcuiscreenshot,,1,0,2,1,2,3,13,1
statusbaritem,statusbaritem,,0,0,1,0,1,1,8,1
rti-dds,rti-dds,,0,0,1,0,4,1,9,1
lds,lds,,0,0,1,0,1,1,8,1
tfs-proxy,tfs-proxy,,0,0,1,0,1,1,8,1
auto-tuning,auto-tuning,,0,0,0,0,2,0,0,1
oracle-client,oracle-client,,0,0,0,0,1,0,8,1
integer-math,integer-math,,0,0,0,0,1,0,9,1
symfony-finder,symfony-finder,,0,0,1,0,1,1,4,1
android-architecture-navigation,android-architecture-navigation,,117,81,175,198,97,373,3,1
rebus-rabbitmq,rebus-rabbitmq,,2,1,4,3,3,7,8,1
metismenu,metismenu,,0,1,2,1,4,3,1,1
idle-processing,idle-processing,,1,0,2,1,2,3,1,1
ontime,ontime,,1,3,4,4,1,8,5,200
windows-restart-manager,windows-restart-manager,,1,0,0,1,3,1,8,1
appixia,appixia,,0,0,0,0,1,0,2,1
javascript-oscillator,javascript-oscillator,,2,0,1,2,1,3,1,1
qpdf,qpdf,,3,2,3,5,3,8,8,1
android-holo-everywhere,android-holo-everywhere,,0,0,1,0,1,1,3,1
android-workmanager,android-workmanager,,98,79,173,177,126,350,3,1
iso-8859-15,iso-8859-15,,0,1,2,1,1,3,0,1
android-studio-3.2,android-studio-3.2,,5,3,79,8,20,87,3,1
cfstoredproc,cfstoredproc,,0,0,0,0,2,0,4,1
test-and-set,test-and-set,,1,1,1,2,3,3,9,1
adobe-dtm,adobe-dtm,,3,3,12,6,3,18,1,1
pyeda,pyeda,,1,0,1,1,3,2,0,1
graphql-mutation,graphql-mutation,,2,5,1,7,5,8,1,150
rdiscount,rdiscount,,0,0,0,0,1,0,12,1
foundation-equalizer,foundation-equalizer,,0,0,1,0,1,1,1,1
scalate,scalate,,0,0,1,0,1,1,2,1
bell-curve,bell-curve,,1,0,0,1,2,1,0,1
client-templates,client-templates,,0,1,2,1,1,3,1,1
asianfonts,asianfonts,,0,2,1,2,1,3,5,100
service-object,service-object,,2,2,1,4,1,5,12,1
wordpresssharp,wordpresssharp,,0,0,1,0,1,1,4,1
visual-effects,visual-effects,,0,1,2,1,1,3,13,1
stackblitz,stackblitz,,10,20,39,30,17,69,1,100
powergrep,powergrep,,1,0,1,1,2,2,0,1
perl4,perl4,,0,0,0,0,1,0,9,1
ragdoll,ragdoll,,2,0,1,2,1,3,8,1
crowdflower,crowdflower,,0,1,0,1,2,1,1,1
spock-reports,spock-reports,,0,1,3,1,4,4,3,1
react-konva,react-konva,,12,15,20,27,2,47,1,25
hardware-traps,hardware-traps,,0,0,0,0,1,0,9,1
maxwell,maxwell,,0,1,0,1,1,1,2,1
ssl-security,ssl-security,,0,1,0,1,1,1,6,1
soft-references,soft-references,,1,1,4,2,5,6,3,1
piwiktracker,piwiktracker,,4,0,9,4,6,13,4,1
jquery-mobile-popup,jquery-mobile-popup,,1,0,1,1,1,2,1,1
mop,mop,,1,1,5,2,4,7,9,1
edaplayground,edaplayground,,0,2,1,2,5,3,9,100
perch,perch,,0,1,1,1,1,2,4,1
primary-constructor,primary-constructor,,0,0,2,0,2,2,9,1
hachoir-parser,hachoir-parser,,0,0,1,0,1,1,0,1
geom-col,geom-col,,6,6,6,12,9,18,0,1
module-build,module-build,,0,0,0,0,2,0,9,1
xpointer,xpointer,,0,0,0,0,2,0,3,1
mxe,mxe,,1,1,2,2,5,4,9,1
gcc4.6,gcc4.6,,0,0,0,0,1,0,9,1
gdm,gdm,,3,2,4,5,3,9,9,1
ivar,ivar,,0,0,2,0,1,2,13,1
fluentvalidation-2.0,fluentvalidation-2.0,,0,2,3,2,1,5,8,100
security-by-obscurity,security-by-obscurity,,0,0,1,0,1,1,3,1
python-3.8,python-3.8,,2,6,3,8,4,11,0,200
python-assignment-expression,python-assignment-expression,,1,0,0,1,4,1,0,1
conversationlearner,conversationlearner,,0,0,1,0,2,1,8,1
grid-computing,grid-computing,,2,2,1,4,2,5,0,1
selenium-ruby,selenium-ruby,,0,0,1,0,1,1,12,1
filestructure,filestructure,,0,0,1,0,2,1,9,1
application-scope,application-scope,,1,0,2,1,3,3,3,1
unapply,unapply,,2,0,3,2,1,5,2,1
yii-inheritance,yii-inheritance,,0,0,0,0,1,0,4,1
debhelper,debhelper,,1,0,3,1,2,4,9,1
gnu-indent,gnu-indent,,0,0,2,0,1,2,9,1
bare-domain,bare-domain,,0,0,0,0,1,0,6,1
appfabric-cache,appfabric-cache,,0,0,0,0,1,0,8,1
azure-appfabric,azure-appfabric,,0,0,1,0,1,1,8,1
barcode4j,barcode4j,,0,0,3,0,2,3,3,1
jquery-uniform,jquery-uniform,,0,0,0,0,1,0,4,1
jdownloader,jdownloader,,1,0,1,1,1,2,0,1
blackmagic-fusion,blackmagic-fusion,,0,0,1,0,2,1,13,1
e-ink,e-ink,,1,0,2,1,1,3,9,1
flocker,flocker,,0,0,1,0,1,1,6,1
zones,zones,,0,0,0,0,2,0,1,1
actionmenuview,actionmenuview,,1,0,0,1,1,1,3,1
cm,cm,,1,3,0,4,2,4,2,200
grpc-node,grpc-node,,4,5,18,9,8,27,6,25
rfc5646,rfc5646,,0,0,0,0,1,0,4,1
androidx,androidx,,230,422,411,652,80,1063,3,83.478261
binary-reproducibility,binary-reproducibility,,2,2,4,4,2,8,8,1
bgfx,bgfx,,1,0,0,1,1,1,8,1
npm-audit,npm-audit,,7,6,12,13,8,25,1,1
fiware-knowage,fiware-knowage,,2,2,4,4,4,8,3,1
glazedlists,glazedlists,,1,0,0,1,3,1,3,1
proof-obligation,proof-obligation,,0,0,0,0,1,0,2,1
website-deployment,website-deployment,,1,1,2,2,5,4,1,1
hammerdb,hammerdb,,1,0,2,1,1,3,4,1
rtl-sdr,rtl-sdr,,2,3,2,5,1,7,0,50
ashmem,ashmem,,0,0,0,0,2,0,3,1
vuikit,vuikit,,1,0,0,1,4,1,1,1
pebble,pebble,,1,1,3,2,2,5,3,1
ekrecurrencerule,ekrecurrencerule,,0,1,0,1,1,1,13,1
amazon-deeplens,amazon-deeplens,,4,1,4,5,4,9,6,1
form-layout,form-layout,,1,0,1,1,1,2,3,1
modulefile,modulefile,,0,2,0,2,3,2,9,100
gstreamer-sharp,gstreamer-sharp,,0,0,2,0,2,2,8,1
kadira,kadira,,0,0,0,0,1,0,1,1
deferred-shading,deferred-shading,,0,1,3,1,3,4,9,1
object-serialization,object-serialization,,1,2,0,3,2,3,3,100
wcf-serialization,wcf-serialization,,0,0,0,0,1,0,8,1
sqlanydb,sqlanydb,,0,0,1,0,1,1,4,1
android-app-bundle,android-app-bundle,,37,59,62,96,22,158,3,59.459459
fastr,fastr,,1,0,0,1,1,1,0,1
cp866,cp866,,0,0,0,0,2,0,0,1
mbcalendarkit,mbcalendarkit,,0,0,0,0,1,0,13,1
sonarqube-4.5,sonarqube-4.5,,0,1,1,1,1,2,3,1
openform,openform,,0,0,3,0,2,3,5,1
class-attribute,class-attribute,,0,0,0,0,3,0,0,1
magic-draw,magic-draw,,0,0,5,0,1,5,3,1
word-automation,word-automation,,2,6,4,8,3,12,8,200
spreadsheet-service,spreadsheet-service,,1,0,1,1,1,2,5,1
caliper,caliper,,1,3,0,4,1,4,6,200
hyperledger-indy,hyperledger-indy,,6,12,1,18,4,19,6,100
here-ios,here-ios,,0,1,0,1,1,1,13,1
appendfile,appendfile,,2,0,4,2,1,6,1,1
boo,boo,,0,0,0,0,1,0,5,1
bold,bold,,0,1,0,1,5,1,8,1
indy-9,indy-9,,0,0,1,0,1,1,9,1
react-routing,react-routing,,6,0,2,6,3,8,1,1
projectitem,projectitem,,0,0,1,0,1,1,8,1
monostate,monostate,,0,1,1,1,1,2,9,1
rails-5.1.6,rails-5.1.6,,1,0,2,1,9,3,12,1
r-recipes,r-recipes,,5,3,3,8,3,11,0,1
npm-config,npm-config,,1,1,3,2,5,5,1,1
dllreferenceplugin,dllreferenceplugin,,0,0,1,0,2,1,1,1
wpr,wpr,,0,0,0,0,1,0,9,1
n-ary-tree,n-ary-tree,,1,2,2,3,1,5,0,100
actionmailer.net,actionmailer.net,,0,0,0,0,2,0,8,1
nsxml,nsxml,,0,0,0,0,1,0,13,1
nsxmldocument,nsxmldocument,,0,0,0,0,1,0,13,1
adtf,adtf,,1,1,4,2,3,6,9,1
adtf3,adtf3,,0,0,2,0,2,2,9,1
nbug,nbug,,0,0,0,0,1,0,8,1
impromptu,impromptu,,0,1,0,1,1,1,4,1
pushpad,pushpad,,1,0,2,1,1,3,13,1
uialertsheet,uialertsheet,,0,0,0,0,1,0,13,1
cyclops-react,cyclops-react,,0,0,0,0,1,0,3,1
qq,qq,,3,0,3,3,2,6,0,1
blackbaud,blackbaud,,0,0,0,0,1,0,1,1
iis-express-10,iis-express-10,,1,2,4,3,7,7,8,100
mediawiki-installation,mediawiki-installation,,1,1,2,2,1,4,4,1
database-diagramming,database-diagramming,,1,0,0,1,1,1,4,1
ndk-stack,ndk-stack,,0,0,2,0,2,2,3,1
kube-apiserver,kube-apiserver,,6,10,15,16,4,31,6,66.666667
vue-instant-search,vue-instant-search,,5,3,2,8,5,10,4,1
sheepit,sheepit,,0,0,1,0,1,1,1,1
clang-query,clang-query,,1,1,1,2,3,3,9,1
gekko,gekko,,17,23,4,40,2,44,0,35.294118
npm-pack,npm-pack,,1,1,3,2,3,5,1,1
rosetta,rosetta,,0,0,1,0,1,1,0,1
senna.js,senna.js,,0,0,0,0,1,0,3,1
dvm,dvm,,0,0,0,0,2,0,3,1
pkzip,pkzip,,1,0,1,1,1,2,4,1
berrybrew,berrybrew,,0,0,0,0,1,0,8,1
salesforce-commerce-cloud,salesforce-commerce-cloud,,1,3,3,4,4,7,14,200
mailslot,mailslot,,0,0,0,0,1,0,8,1
blkid,blkid,,2,1,0,3,1,3,9,1
android-searchmanager,android-searchmanager,,2,0,2,2,2,4,3,1
node-persist,node-persist,,0,0,1,0,1,1,1,1
samesite,samesite,,5,5,5,10,5,15,4,1
visual-studio-app-center-distribute,visual-studio-app-center-distribute,,5,4,8,9,4,17,8,1
vscode-liveshare,vscode-liveshare,,2,2,4,4,2,8,9,1
abcl,abcl,,2,0,0,2,1,2,0,1
qulice,qulice,,0,0,0,0,1,0,3,1
data-controls,data-controls,,0,0,1,0,2,1,9,1
microsoft-document-viewer,microsoft-document-viewer,,0,1,1,1,1,2,13,1
self-modifying,self-modifying,,3,0,4,3,4,7,9,1
whateverable,whateverable,,0,0,0,0,2,0,9,1
grunt-ts,grunt-ts,,0,0,1,0,2,1,1,1
kendo-colorpicker,kendo-colorpicker,,0,0,0,0,1,0,1,1
biztalk2006r2,biztalk2006r2,,0,0,2,0,1,2,8,1
external-tools,external-tools,,0,0,2,0,2,2,0,1
smart-device-framework,smart-device-framework,,0,0,0,0,1,0,8,1
aris,aris,,0,0,0,0,2,0,4,1
infinitest,infinitest,,1,0,3,1,2,4,3,1
get-method,get-method,,0,0,0,0,2,0,4,1
chatops,chatops,,1,1,3,2,1,5,6,1
fakes3,fakes3,,0,0,0,0,1,0,2,1
argoproj,argoproj,,2,5,3,7,2,10,6,150
cbmpy,cbmpy,,0,0,0,0,5,0,0,1
initialization-order,initialization-order,,0,1,2,1,2,3,9,1
xamlx,xamlx,,0,0,0,0,1,0,8,1
cts-search,cts-search,,0,1,2,1,1,3,3,1
node-local-storage,node-local-storage,,0,0,0,0,2,0,1,1
miranda,miranda,,0,0,0,0,1,0,2,1
alios,alios,,0,0,0,0,1,0,3,1
multitouch-keyboard,multitouch-keyboard,,0,0,0,0,1,0,3,1
typeglob,typeglob,,0,0,0,0,2,0,9,1
css-purge,css-purge,,1,3,5,4,1,9,1,200
lance,lance,,0,0,1,0,1,1,1,1
loop-counter,loop-counter,,1,0,2,1,1,3,3,1
raml-1.0,raml-1.0,,1,2,3,3,3,6,14,100
moment-timezone,moment-timezone,,27,13,41,40,23,81,1,1
carbon-data,carbon-data,,2,0,1,2,1,3,2,1
gstreamer-0.10,gstreamer-0.10,,2,3,1,5,2,6,13,50
simple-web-token,simple-web-token,,0,0,0,0,1,0,4,1
react-os,react-os,,0,0,0,0,1,0,6,1
dynamic-code,dynamic-code,,1,0,2,1,1,3,8,1
cube-script,cube-script,,0,0,2,0,1,2,4,1
chokidar,chokidar,,4,4,17,8,7,25,1,1
protector,protector,,1,0,2,1,1,3,8,1
sonnet,sonnet,,0,1,2,1,1,3,0,1
signer,signer,,1,0,2,1,1,3,3,1
openargs,openargs,,1,0,0,1,1,1,5,1
zend-auth,zend-auth,,0,0,0,0,1,0,4,1
razorlight,razorlight,,0,1,0,1,1,1,8,1
timtowtdi,timtowtdi,,0,0,0,0,1,0,0,1
select-for-xml,select-for-xml,,0,0,1,0,1,1,4,1
multiple-inclusions,multiple-inclusions,,0,1,0,1,1,1,3,1
knockout-3.4,knockout-3.4,,0,0,1,0,5,1,1,1
matrixcursor,matrixcursor,,0,0,1,0,1,1,3,1
python-textfsm,python-textfsm,,1,2,2,3,7,5,0,100
arj,arj,,0,0,1,0,1,1,8,1
sourcekit,sourcekit,,0,1,2,1,1,3,13,1
keen-js,keen-js,,0,0,1,0,2,1,4,1
openrtsp,openrtsp,,0,2,1,2,3,3,13,100
faraday-oauth,faraday-oauth,,0,0,0,0,1,0,12,1
cron4j,cron4j,,1,0,1,1,2,2,3,1
zipmap,zipmap,,0,0,0,0,1,0,6,1
gmailr,gmailr,,1,2,0,3,1,3,0,100
google-source-repositories,google-source-repositories,,3,2,7,5,3,12,6,1
webdeploy-3.6,webdeploy-3.6,,1,0,1,1,1,2,8,1
spring-2.5,spring-2.5,,0,0,0,0,1,0,1,1
queryinterface,queryinterface,,1,0,0,1,1,1,12,1
unroll,unroll,,0,3,2,3,2,5,3,200
rightview,rightview,,0,0,0,0,1,0,13,1
d3tree,d3tree,,0,0,1,0,1,1,0,1
jscompress,jscompress,,0,0,0,0,1,0,0,1
v8js,v8js,,3,3,6,6,4,12,4,1
giteye,giteye,,0,0,0,0,2,0,6,1
microsoft-odata,microsoft-odata,,2,0,2,2,1,4,8,1
react-native-image-picker,react-native-image-picker,,17,30,28,47,8,75,1,76.470588
obr,obr,,0,0,0,0,1,0,3,1
paster,paster,,0,0,1,0,1,1,0,1
freeling,freeling,,1,1,0,2,2,2,0,1
spark-redis,spark-redis,,1,2,4,3,2,7,2,100
rx-netty,rx-netty,,1,0,0,1,1,1,3,1
wedge,wedge,,0,0,0,0,1,0,9,1
patreon,patreon,,1,0,3,1,4,4,4,1
icsharpcode,icsharpcode,,3,1,3,4,2,7,8,1
init-parameters,init-parameters,,0,1,0,1,1,1,3,1
gumstix,gumstix,,0,0,2,0,3,2,9,1
nstexttab,nstexttab,,0,1,0,1,1,1,13,1
fiware-cosmos,fiware-cosmos,,1,0,2,1,6,3,6,1
javaloader,javaloader,,0,0,1,0,1,1,4,1
objective-c-protocol,objective-c-protocol,,0,0,1,0,1,1,13,1
spire.xls,spire.xls,,0,1,5,1,4,6,8,1
vapi,vapi,,1,1,2,2,1,4,9,1
windows-rt,windows-rt,,1,0,1,1,1,2,8,1
ntsc,ntsc,,0,0,0,0,1,0,13,1
coypu,coypu,,0,0,2,0,2,2,3,1
cupertinotabbar,cupertinotabbar,,3,4,1,7,3,8,13,33.333333
comp-3,comp-3,,1,1,3,2,1,5,4,1
php-jwt,php-jwt,,0,1,1,1,2,2,4,1
saspy,saspy,,0,0,1,0,2,1,0,1
chrome-app-developer-tool,chrome-app-developer-tool,,0,0,2,0,2,2,1,1
android-3.1-honeycomb,android-3.1-honeycomb,,0,0,1,0,2,1,3,1
aws-data-pipeline,aws-data-pipeline,,10,5,16,15,6,31,6,1
hp-idol-ondemand,hp-idol-ondemand,,0,0,0,0,1,0,5,1
ladon,ladon,,0,1,0,1,1,1,0,1
opentools,opentools,,0,0,0,0,1,0,9,1
iso-19794,iso-19794,,0,0,0,0,1,0,3,1
sqljocky,sqljocky,,0,0,4,0,2,4,13,1
google-play-services-3.3.0,google-play-services-3.3.0,,1,0,1,1,3,2,3,1
weakhashmap,weakhashmap,,2,1,4,3,4,7,3,1
com4j,com4j,,1,0,1,1,1,2,3,1
smart-linkify,smart-linkify,,0,0,0,0,1,0,3,1
smart-text-selection,smart-text-selection,,1,0,0,1,1,1,3,1
drawingbrush,drawingbrush,,0,1,0,1,1,1,8,1
ubuntu-touch,ubuntu-touch,,0,0,3,0,2,3,9,1
mts,mts,,2,0,3,2,1,5,3,1
acceleo,acceleo,,3,0,2,3,3,5,3,1
azle,azle,,0,0,0,0,1,0,1,1
language-switching,language-switching,,1,0,4,1,1,5,4,1
postgis-installation,postgis-installation,,2,4,2,6,3,8,4,100
yt-project,yt-project,,0,0,0,0,1,0,0,1
wall-time,wall-time,,0,1,0,1,2,1,0,1
ffl,ffl,,0,0,1,0,7,1,0,1
anura,anura,,0,0,1,0,7,1,0,1
tpc,tpc,,0,0,4,0,2,4,6,1
cfnotification,cfnotification,,0,0,0,0,2,0,13,1
refined,refined,,0,0,4,0,1,4,2,1
torque3d,torque3d,,0,0,1,0,1,1,9,1
double-hashing,double-hashing,,0,0,2,0,2,2,0,1
wknavigationdelegate,wknavigationdelegate,,3,2,1,5,1,6,13,1
httpretty,httpretty,,0,0,1,0,1,1,0,1
quadratic-probing,quadratic-probing,,0,0,1,0,1,1,0,1
php-gmp,php-gmp,,0,0,0,0,2,0,4,1
parserelation,parserelation,,0,0,0,0,1,0,1,1
openglcontext,openglcontext,,0,1,1,1,1,2,9,1
parse4j,parse4j,,0,0,0,0,1,0,3,1
igmp,igmp,,1,2,3,3,2,6,9,100
nsfilepresenter,nsfilepresenter,,0,0,1,0,2,1,13,1
bind2nd,bind2nd,,0,0,0,0,2,0,9,1
protothread,protothread,,0,0,0,0,1,0,9,1
gprinstall,gprinstall,,0,0,0,0,1,0,9,1
password-generator,password-generator,,0,1,3,1,2,4,0,1
hyperledger-fabric-sdk-go,hyperledger-fabric-sdk-go,,9,8,8,17,7,25,6,1
user-registry,user-registry,,0,0,0,0,1,0,3,1
wiselinks,wiselinks,,0,0,0,0,1,0,12,1
hc-05,hc-05,,11,7,17,18,5,35,3,1
anko-component,anko-component,,1,2,4,3,1,7,3,100
ucos,ucos,,1,0,2,1,2,3,9,1
ejabberd-hooks,ejabberd-hooks,,2,1,9,3,6,12,3,1
updatedate,updatedate,,1,1,0,2,1,2,4,1
google-truth,google-truth,,1,1,2,2,2,4,3,1
opencv4ios,opencv4ios,,0,0,0,0,2,0,13,1
autossh,autossh,,0,3,1,3,2,4,9,200
reg-expressionvalidator,reg-expressionvalidator,,0,0,0,0,1,0,9,1
fluent-kit,fluent-kit,,0,0,0,0,7,0,1,1
rationale,rationale,,0,0,3,0,2,3,9,1
appzio,appzio,,0,0,0,0,1,0,3,1
silverlight-embedded,silverlight-embedded,,0,0,0,0,1,0,8,1
vue-chat-scroll,vue-chat-scroll,,0,0,0,0,1,0,1,1
drop-cap,drop-cap,,0,1,2,1,1,3,1,1
xwebview,xwebview,,0,0,0,0,1,0,13,1
responsestream,responsestream,,0,0,2,0,1,2,8,1
chip-dna-server,chip-dna-server,,0,0,0,0,1,0,4,1
maxrequestlength,maxrequestlength,,0,0,2,0,2,2,8,1
compilation-time,compilation-time,,1,0,3,1,1,4,9,1
nem,nem,,2,0,4,2,3,6,1,1
inheritance-prevention,inheritance-prevention,,0,0,0,0,1,0,9,1
blockdiag,blockdiag,,0,0,1,0,1,1,0,1
off-by-one,off-by-one,,3,2,2,5,2,7,9,1
video-memory,video-memory,,1,0,3,1,1,4,9,1
android-make,android-make,,0,2,1,2,7,3,3,100
wagtail-slugurl,wagtail-slugurl,,0,0,1,0,1,1,0,1
wagtail-pageurl,wagtail-pageurl,,2,1,3,3,3,6,0,1
realm-cloud,realm-cloud,,3,5,5,8,1,13,13,66.666667
sparse-checkout,sparse-checkout,,3,3,4,6,1,10,6,1
oxwall,oxwall,,0,0,0,0,2,0,4,1
microsoft.mshtml,microsoft.mshtml,,0,1,1,1,2,2,8,1
angular-state-managmement,angular-state-managmement,,4,1,3,5,1,8,1,1
winavr,winavr,,2,0,1,2,1,3,9,1
rxtest,rxtest,,1,3,2,4,2,6,13,200
database-dump,database-dump,,1,1,1,2,2,3,4,1
python-mro,python-mro,,0,1,0,1,1,1,0,1
azure-rm,azure-rm,,9,17,20,26,9,46,8,88.888889
sencha-touch-2.1,sencha-touch-2.1,,0,0,0,0,1,0,1,1
gcc4.5,gcc4.5,,0,0,0,0,1,0,9,1
rowmapper,rowmapper,,1,0,3,1,1,4,3,1
libchamplain,libchamplain,,0,0,0,0,1,0,9,1
xively,xively,,0,0,0,0,1,0,6,1
dynastyjs,dynastyjs,,0,0,1,0,1,1,6,1
jqzoom,jqzoom,,0,1,0,1,1,1,1,1
openshift-web-console,openshift-web-console,,0,1,3,1,4,4,6,1
aviary,aviary,,0,0,0,0,1,0,1,1
dbdeploy,dbdeploy,,0,0,0,0,1,0,4,1
qnx-ifs,qnx-ifs,,0,0,0,0,1,0,9,1
benchmark.js,benchmark.js,,0,0,1,0,1,1,1,1
plato,plato,,0,1,0,1,1,1,0,1
ora-29913,ora-29913,,0,0,0,0,1,0,4,1
css-houdini,css-houdini,,2,0,3,2,1,5,1,1
internet-options,internet-options,,1,1,1,2,2,3,9,1
cfbundledocumenttypes,cfbundledocumenttypes,,1,1,0,2,1,2,13,1
ordereddict,ordereddict,,11,7,18,18,7,36,0,1
doxygen-addtogroup,doxygen-addtogroup,,0,0,1,0,1,1,9,1
clojurescript-javascript-interop,clojurescript-javascript-interop,,4,4,5,8,5,13,2,1
heptio-contour,heptio-contour,,1,1,0,2,1,2,6,1
django-facebook,django-facebook,,1,0,0,1,1,1,0,1
export-to-image,export-to-image,,1,1,2,2,2,4,1,1
clsql,clsql,,0,0,0,0,3,0,0,1
beam-sql,beam-sql,,5,11,4,16,1,20,6,120
cartalyst,cartalyst,,0,2,1,2,2,3,4,100
gfycat,gfycat,,1,1,0,2,1,2,4,1
robocup,robocup,,0,0,1,0,1,1,0,1
windows-phone-voip,windows-phone-voip,,0,0,0,0,1,0,8,1
c++builder-2010,c++builder-2010,,2,2,2,4,2,6,9,1
duckduckgo,duckduckgo,,4,5,1,9,3,10,1,25
cdonts,cdonts,,0,0,0,0,1,0,4,1
c10k,c10k,,1,0,1,1,1,2,3,1
focus-engine,focus-engine,,2,0,3,2,2,5,13,1
longjmp,longjmp,,2,1,1,3,1,4,9,1
testimonials,testimonials,,1,0,2,1,3,3,4,1
createsend,createsend,,0,1,0,1,1,1,4,1
sitecore9,sitecore9,,12,25,20,37,6,57,8,108.333333
flutter-positioned,flutter-positioned,,2,2,2,4,3,6,13,1
handwriting,handwriting,,1,2,3,3,1,6,0,100
inkml,inkml,,1,1,1,2,2,3,8,1
git-assume-unchanged,git-assume-unchanged,,0,1,0,1,2,1,6,1
datamodule,datamodule,,0,0,0,0,1,0,4,1
buefy,buefy,,18,17,30,35,13,65,1,1
iasyncoperation,iasyncoperation,,0,1,2,1,1,3,8,1
libsox,libsox,,1,0,2,1,3,3,13,1
bing-custom-search,bing-custom-search,,3,1,0,4,1,4,8,1
nativedroid,nativedroid,,0,0,0,0,3,0,1,1
archunit,archunit,,2,1,4,3,2,7,3,1
active-relation,active-relation,,1,0,0,1,1,1,12,1
email-processing,email-processing,,0,0,1,0,3,1,5,1
v4-printer-driver,v4-printer-driver,,0,0,2,0,3,2,8,1
aws-lambda-go,aws-lambda-go,,0,1,3,1,5,4,6,1
ismouseover,ismouseover,,1,0,1,1,2,2,8,1
jnosql,jnosql,,0,0,0,0,2,0,3,1
distutils2,distutils2,,0,0,0,0,1,0,0,1
formcraft,formcraft,,0,0,0,0,1,0,1,1
oracle.manageddataaccess,oracle.manageddataaccess,,10,2,4,12,1,16,8,1
vcl-styles.-utils,vcl-styles.-utils,,0,1,0,1,1,1,9,1
sexpect,sexpect,,0,0,0,0,1,0,9,1
red-gate-data-compare,red-gate-data-compare,,0,0,2,0,1,2,4,1
sitescope,sitescope,,2,0,1,2,1,3,8,1
secsharedcredentials,secsharedcredentials,,0,0,1,0,1,1,13,1
locallib,locallib,,0,0,1,0,2,1,9,1
sqlmigrations,sqlmigrations,,0,0,0,0,1,0,4,1
ui5-library,ui5-library,,3,4,2,7,1,9,1,33.333333
smf-forum,smf-forum,,1,0,1,1,1,2,4,1
docklayoutpanel,docklayoutpanel,,0,0,0,0,1,0,8,1
list-template,list-template,,0,2,0,2,1,2,8,100
fixed-format,fixed-format,,0,0,0,0,1,0,0,1
twimlet,twimlet,,0,0,1,0,2,1,13,1
pytype,pytype,,1,2,0,3,1,3,0,100
antivirus-integration,antivirus-integration,,1,0,2,1,1,3,12,1
lbry,lbry,,0,0,0,0,1,0,9,1
azure-iot-hub-device-management,azure-iot-hub-device-management,,8,4,7,12,10,19,8,1
azure-postgresql,azure-postgresql,,2,6,4,8,7,12,8,200
sethash,sethash,,0,1,0,1,1,1,9,1
isinteger,isinteger,,0,1,0,1,1,1,0,1
xamarin.essentials,xamarin.essentials,,8,7,12,15,3,27,8,1
polymer-app-toolbox,polymer-app-toolbox,,0,0,0,0,1,0,1,1
bufferqueue,bufferqueue,,0,0,0,0,1,0,3,1
messagemedia,messagemedia,,0,0,0,0,2,0,3,1
paytabs,paytabs,,0,2,1,2,1,3,12,100
android-tradefederation,android-tradefederation,,1,0,2,1,1,3,3,1
upload-max-filesize,upload-max-filesize,,0,4,6,4,2,10,4,300
kotlin.notimplementederror,kotlin.notimplementederror,,0,1,0,1,1,1,3,1
wordpress-plugin-creation,wordpress-plugin-creation,,9,7,9,16,10,25,4,1
qt5.8,qt5.8,,2,0,0,2,1,2,9,1
ubuntu-cloud,ubuntu-cloud,,0,0,0,0,1,0,9,1
spsite,spsite,,1,0,0,1,1,1,8,1
dolby-audio-api,dolby-audio-api,,0,0,0,0,1,0,13,1
regioninfo,regioninfo,,2,1,3,3,2,6,8,1
typo3-flow,typo3-flow,,0,0,0,0,1,0,4,1
flow-framework,flow-framework,,0,0,1,0,1,1,4,1
android-slices,android-slices,,1,7,4,8,4,12,3,600
location-aware,location-aware,,0,0,0,0,1,0,3,1
docmosis,docmosis,,0,0,0,0,1,0,6,1
multipath,multipath,,0,0,3,0,3,3,6,1
baguettebox,baguettebox,,1,0,1,1,2,2,1,1
xmlformview,xmlformview,,0,0,0,0,1,0,0,1
azure-cosmosdb-sqlapi,azure-cosmosdb-sqlapi,,59,75,97,134,51,231,8,27.118644
error-list,error-list,,0,2,0,2,1,2,8,100
wordml,wordml,,1,1,3,2,1,5,3,1
tag-helpers,tag-helpers,,19,18,30,37,10,67,8,1
android-bottomappbar,android-bottomappbar,,14,6,38,20,10,58,3,1
maven-embedder,maven-embedder,,0,0,0,0,1,0,3,1
react-router-bootstrap,react-router-bootstrap,,1,1,5,2,5,7,1,1
qfuturewatcher,qfuturewatcher,,0,0,0,0,2,0,9,1
smalldatetime,smalldatetime,,2,0,1,2,3,3,4,1
openshift-env-variables,openshift-env-variables,,0,1,0,1,1,1,6,1
fastify,fastify,,14,15,11,29,2,40,1,7.142857
android-textview-autosize,android-textview-autosize,,3,4,3,7,2,10,3,33.333333
watson-text-to-speech,watson-text-to-speech,,1,1,8,2,1,10,6,1
react-infinite,react-infinite,,0,0,1,0,2,1,1,1
foundationdb,foundationdb,,2,3,2,5,2,7,3,50
mixed-type,mixed-type,,0,0,0,0,1,0,0,1
thesaurus,thesaurus,,0,2,2,2,1,4,4,100
smart-http,smart-http,,0,0,0,0,1,0,6,1
react-state,react-state,,26,32,35,58,1,93,1,23.076923
scanline,scanline,,1,1,0,2,1,2,0,1
qtdeclarative,qtdeclarative,,2,0,0,2,1,2,9,1
qt5.11,qt5.11,,2,0,7,2,1,9,9,1
document-store,document-store,,0,4,4,4,1,8,4,300
pitney-bowes,pitney-bowes,,0,0,0,0,1,0,6,1
applicationwillterminate,applicationwillterminate,,2,0,2,2,1,4,13,1
savant3,savant3,,0,0,0,0,1,0,4,1
apache-edgent,apache-edgent,,0,0,2,0,3,2,3,1
addon-domain,addon-domain,,1,4,6,5,3,11,4,300
rke,rke,,1,4,6,5,2,11,6,300
lingpipe,lingpipe,,0,0,0,0,1,0,9,1
stripe-invoices,stripe-invoices,,1,2,3,3,2,6,4,100
dijit.dialog,dijit.dialog,,0,0,1,0,2,1,1,1
omnios,omnios,,0,1,0,1,1,1,9,1
streamly,streamly,,0,0,1,0,2,1,2,1
tempdir,tempdir,,1,0,0,1,2,1,3,1
opentest,opentest,,2,2,5,4,1,9,3,1
naming-strategy,naming-strategy,,1,1,2,2,1,4,4,1
node-gcm,node-gcm,,0,0,3,0,2,3,1,1
logical-replication,logical-replication,,6,5,12,11,5,23,4,1
webextension-polyfill,webextension-polyfill,,1,1,1,2,2,3,1,1
playbin2,playbin2,,0,0,1,0,1,1,13,1
statistica,statistica,,0,0,0,0,1,0,5,1
at-job,at-job,,0,2,3,2,2,5,9,100
vesa,vesa,,2,1,1,3,3,4,9,1
dsdt,dsdt,,0,0,0,0,1,0,6,1
hpet,hpet,,0,0,0,0,1,0,6,1
windows2012rc,windows2012rc,,1,1,1,2,1,3,0,1
onresize,onresize,,2,0,0,2,1,2,1,1
reference-binding,reference-binding,,1,2,1,3,1,4,9,100
magnolia-scala,magnolia-scala,,0,0,0,0,1,0,2,1
colormath,colormath,,1,0,1,1,2,2,0,1
ecb-pattern,ecb-pattern,,0,0,1,0,1,1,3,1
jjaql,jjaql,,1,0,0,1,1,1,1,1
autoproxy,autoproxy,,1,0,0,1,1,1,3,1
meta-object-protocol,meta-object-protocol,,0,0,0,0,4,0,9,1
eer-model,eer-model,,0,0,1,0,1,1,4,1
dictation,dictation,,2,2,1,4,5,5,6,1
scrapy-item,scrapy-item,,2,0,2,2,1,4,0,1
icafe,icafe,,0,0,1,0,2,1,3,1
periodformatter,periodformatter,,0,0,0,0,1,0,3,1
shareactionprovider,shareactionprovider,,1,1,1,2,2,3,3,1
swingame,swingame,,0,0,0,0,1,0,9,1
commercial-application,commercial-application,,1,0,2,1,1,3,3,1
firebreath,firebreath,,0,0,1,0,1,1,8,1
reaper,reaper,,1,0,2,1,2,3,0,1
defold,defold,,0,1,2,1,3,3,9,1
pyppeteer,pyppeteer,,6,10,17,16,5,33,0,66.666667
default-selected,default-selected,,0,0,0,0,1,0,1,1
design-view,design-view,,0,1,2,1,2,3,3,1
fly,fly,,0,0,3,0,2,3,1,1
function-interposition,function-interposition,,0,0,0,0,1,0,9,1
powerbuilder-conversion,powerbuilder-conversion,,0,0,2,0,1,2,8,1
nsarchiving,nsarchiving,,0,1,2,1,1,3,13,1
lsusb,lsusb,,0,0,2,0,1,2,9,1
adobe-pdf-library,adobe-pdf-library,,0,0,1,0,1,1,8,1
servletconfig,servletconfig,,1,0,0,1,1,1,3,1
user-account-control,user-account-control,,1,1,3,2,1,5,8,1
fancyupload,fancyupload,,0,0,0,0,1,0,1,1
ironsource,ironsource,,2,1,2,3,2,5,3,1
jvm-codecache,jvm-codecache,,0,0,0,0,2,0,3,1
showwindow,showwindow,,1,1,2,2,1,4,8,1
qsys,qsys,,0,2,2,2,1,4,9,100
gipc,gipc,,0,0,0,0,1,0,1,1
python-onvif,python-onvif,,1,3,1,4,1,5,13,200
library-path,library-path,,1,2,3,3,4,6,9,100
boot-animation,boot-animation,,0,0,0,0,1,0,3,1
oracle-home,oracle-home,,2,0,0,2,2,2,4,1
dynamic-mapping,dynamic-mapping,,0,1,0,1,2,1,2,1
confidential,confidential,,0,0,0,0,1,0,8,1
midp,midp,,0,0,1,0,1,1,4,1
computercraft,computercraft,,4,4,9,8,4,17,9,1
material-components-android,material-components-android,,29,46,37,75,16,112,3,58.62069
staledataexception,staledataexception,,0,0,1,0,1,1,3,1
google-photos-api,google-photos-api,,23,17,55,40,27,95,5,1
flatpack,flatpack,,0,0,2,0,1,2,8,1
discrete-space,discrete-space,,0,0,0,0,1,0,0,1
aparapi,aparapi,,1,0,1,1,1,2,0,1
oracle-cursor,oracle-cursor,,0,0,2,0,1,2,4,1
multi-az,multi-az,,1,0,2,1,1,3,6,1
mkreversegeocoder,mkreversegeocoder,,1,0,0,1,1,1,13,1
jsonapiframework,jsonapiframework,,2,0,0,2,1,2,12,1
exploratory,exploratory,,0,0,3,0,1,3,0,1
boomerang,boomerang,,0,0,1,0,3,1,1,1
interactors,interactors,,0,0,1,0,3,1,13,1
versant-vod,versant-vod,,0,0,0,0,1,0,4,1
dis,dis,,2,1,1,3,2,4,0,1
controllercontext,controllercontext,,1,0,0,1,2,1,8,1
github-projects,github-projects,,1,1,2,2,2,4,6,1
struts2-spring-plugin,struts2-spring-plugin,,0,0,0,0,1,0,3,1
simplejmx,simplejmx,,0,0,0,0,1,0,3,1
gimple,gimple,,2,3,2,5,2,7,9,50
nssearchfield,nssearchfield,,3,1,4,4,1,8,13,1
bcm,bcm,,1,0,1,1,1,2,9,1
fast-ai,fast-ai,,27,29,31,56,3,87,0,7.407407
user-inactivity,user-inactivity,,2,1,7,3,2,10,4,1
pin-code,pin-code,,4,1,1,5,2,6,3,1
asis,asis,,0,0,0,0,5,0,9,1
mvcrecaptcha,mvcrecaptcha,,0,1,0,1,2,1,1,1
mps-format,mps-format,,0,0,0,0,1,0,0,1
passwordvault,passwordvault,,0,1,3,1,1,4,3,1
uielementcollection,uielementcollection,,0,1,0,1,1,1,3,1
htrace,htrace,,0,0,0,0,1,0,2,1
anonymousidentification,anonymousidentification,,0,0,0,0,1,0,8,1
ibm-eventstreams,ibm-eventstreams,,1,2,2,3,3,5,2,100
eclipse-rse,eclipse-rse,,0,0,3,0,2,3,3,1
thinktecture-ident-model,thinktecture-ident-model,,1,0,0,1,1,1,8,1
statamic,statamic,,2,1,4,3,3,7,4,1
webpack-isomorphic-tools,webpack-isomorphic-tools,,0,0,2,0,1,2,1,1
web-ext,web-ext,,3,0,5,3,2,8,1,1
jrmp,jrmp,,0,0,0,0,2,0,3,1
hslf,hslf,,0,0,1,0,1,1,3,1
itil,itil,,1,1,1,2,3,3,7,1
out-of-band,out-of-band,,0,0,0,0,2,0,3,1
django-static-precompiler,django-static-precompiler,,0,0,1,0,2,1,0,1
os.js,os.js,,0,0,0,0,1,0,6,1
simplekml,simplekml,,2,3,2,5,2,7,0,50
anamorphism,anamorphism,,2,1,1,3,2,4,2,1
billiards,billiards,,3,0,0,3,2,3,0,1
iozone,iozone,,1,0,0,1,2,1,9,1
oclif,oclif,,0,4,1,4,2,5,1,300
debian-buster,debian-buster,,3,20,5,23,2,28,9,566.666667
autoreconf,autoreconf,,0,0,3,0,2,3,9,1
cookie-policy,cookie-policy,,0,0,1,0,1,1,5,1
html5-apps,html5-apps,,0,0,1,0,1,1,1,1
lotus-designer,lotus-designer,,1,0,0,1,1,1,5,1
message-pump,message-pump,,0,0,1,0,1,1,8,1
kubeflow,kubeflow,,16,18,19,34,3,53,6,12.5
svnserve,svnserve,,0,0,2,0,1,2,6,1
bullet-span,bullet-span,,1,1,0,2,1,2,3,1
distributed-tracing,distributed-tracing,,8,9,6,17,6,23,3,12.5
unity-powerui,unity-powerui,,1,0,0,1,1,1,8,1
ctfont,ctfont,,0,1,0,1,1,1,13,1
ble-state-preservation,ble-state-preservation,,0,0,0,0,1,0,13,1
multi-model-forms,multi-model-forms,,0,1,1,1,1,2,0,1
aurelia-testing,aurelia-testing,,0,1,1,1,3,2,1,1
wildfly-maven-plugin,wildfly-maven-plugin,,0,0,5,0,2,5,3,1
helpndoc,helpndoc,,2,0,0,2,4,2,8,1
aurelia-store,aurelia-store,,1,1,4,2,4,6,1,1
pbo,pbo,,2,1,1,3,3,4,9,1
default-constraint,default-constraint,,2,1,1,3,3,4,4,1
iq,iq,,0,2,4,2,2,6,4,100
android-architecture-paging,android-architecture-paging,,0,0,3,0,2,3,3,1
chrome-canary,chrome-canary,,2,1,1,3,3,4,1,1
pydictionary,pydictionary,,0,1,1,1,3,2,0,1
android-tap-and-pay,android-tap-and-pay,,0,0,0,0,1,0,3,1
geronimo,geronimo,,1,1,2,2,1,4,3,1
independentsoft,independentsoft,,0,0,0,0,1,0,3,1
uno-platform,uno-platform,,3,4,3,7,4,10,8,33.333333
dgrams,dgrams,,1,2,3,3,1,6,1,100
fuchsia,fuchsia,,0,0,1,0,3,1,9,1
franca,franca,,0,0,0,0,1,0,9,1
vldb,vldb,,0,0,1,0,1,1,4,1
pt,pt,,1,1,2,2,1,4,4,1
hotpatching,hotpatching,,0,1,2,1,2,3,4,1
cperl-mode,cperl-mode,,1,0,0,1,1,1,9,1
nhibernate-projections,nhibernate-projections,,0,0,2,0,3,2,3,1
load-path,load-path,,1,1,0,2,1,2,12,1
deftype,deftype,,0,0,0,0,2,0,0,1
xtradb,xtradb,,1,1,0,2,2,2,4,1
http-status-code-408,http-status-code-408,,0,0,0,0,2,0,9,1
file-generation,file-generation,,1,1,3,2,1,5,5,1
umzug,umzug,,3,2,1,5,1,6,1,1
allegro-cl,allegro-cl,,0,0,0,0,1,0,0,1
ieframe.dll,ieframe.dll,,0,0,1,0,2,1,8,1
sap-ariba,sap-ariba,,2,0,3,2,2,5,3,1
aml-condition,aml-condition,,0,0,0,0,1,0,3,1
dynamic-assemblies,dynamic-assemblies,,0,2,1,2,1,3,8,100
json-path-expression,json-path-expression,,7,5,15,12,6,27,1,1
image-transcoding,image-transcoding,,0,1,0,1,1,1,8,1
react-bootstrap4-modal,react-bootstrap4-modal,,1,1,1,2,2,3,1,1
protostuff,protostuff,,0,1,2,1,1,3,6,1
adomd,adomd,,0,1,2,1,1,3,4,1
analysisservices,analysisservices,,4,4,10,8,6,18,4,1
structured-clone,structured-clone,,0,0,2,0,1,2,1,1
wix3.9,wix3.9,,0,0,3,0,1,3,8,1
hksamplequery,hksamplequery,,0,0,1,0,2,1,13,1
vsprops,vsprops,,2,0,1,2,2,3,8,1
touch-up-inside,touch-up-inside,,1,2,1,3,2,4,13,100
justinmind,justinmind,,0,0,0,0,1,0,1,1
application-close,application-close,,1,0,0,1,1,1,3,1
navigateuri,navigateuri,,0,0,0,0,1,0,8,1
steinberg-asio,steinberg-asio,,0,0,1,0,1,1,9,1
edi.net,edi.net,,1,0,0,1,1,1,8,1
kaleido,kaleido,,0,1,2,1,5,3,6,1
sidekiq-cron,sidekiq-cron,,3,0,4,3,2,7,12,1
azure-triggers,azure-triggers,,7,7,8,14,6,22,8,1
agal,agal,,0,0,0,0,1,0,13,1
jquery-dirtyforms,jquery-dirtyforms,,0,0,1,0,2,1,1,1
puppeteer-sharp,puppeteer-sharp,,7,6,7,13,6,20,8,1
angular-elements,angular-elements,,26,29,51,55,26,106,1,11.538462
yattag,yattag,,1,0,1,1,2,2,0,1
android-rendering,android-rendering,,0,1,0,1,1,1,3,1
id,id,,90,71,176,161,96,337,1,1
cifacefeature,cifacefeature,,0,0,0,0,1,0,13,1
quazip,quazip,,0,1,4,1,2,5,9,1
angularjs-authentication,angularjs-authentication,,1,0,0,1,1,1,1,1
material-ui-next,material-ui-next,,4,5,16,9,20,25,1,25
realm-js,realm-js,,7,7,14,14,5,28,13,1
vincent,vincent,,0,1,0,1,1,1,0,1
getderivedstatefromprops,getderivedstatefromprops,,4,3,6,7,7,13,1,1
cyclone,cyclone,,1,0,2,1,1,3,9,1
ora-01830,ora-01830,,0,0,0,0,3,0,4,1
webidl,webidl,,0,1,1,1,1,2,1,1
ectjs,ectjs,,0,0,0,0,1,0,1,1
django-anymail,django-anymail,,2,2,2,4,5,6,0,1
chatsdk,chatsdk,,0,1,0,1,5,1,3,1
msgrcv,msgrcv,,0,0,1,0,1,1,9,1
live-video,live-video,,2,1,8,3,4,11,13,1
github-integration,github-integration,,0,0,0,0,1,0,3,1
local-functions,local-functions,,2,1,2,3,5,5,8,1
register-keyword,register-keyword,,1,0,0,1,1,1,9,1
node-usb,node-usb,,0,2,3,2,1,5,3,100
silk-performer,silk-performer,,0,0,4,0,1,4,3,1
session-state-server,session-state-server,,2,1,0,3,1,3,8,1
micronaut,micronaut,,79,82,88,161,14,249,3,3.797468
sikuli-x,sikuli-x,,5,5,13,10,3,23,3,1
klepto,klepto,,2,1,1,3,2,4,0,1
sourcery,sourcery,,0,0,1,0,1,1,13,1
swift-stencil,swift-stencil,,1,0,0,1,2,1,13,1
flexform,flexform,,3,5,9,8,7,17,4,66.666667
webxr,webxr,,5,1,6,6,1,12,1,1
right-mouse-button,right-mouse-button,,0,0,0,0,2,0,8,1
addmodelerror,addmodelerror,,0,0,1,0,1,1,8,1
tgmath,tgmath,,0,0,0,0,1,0,4,1
ember-query-params,ember-query-params,,0,0,0,0,2,0,1,1
codesite,codesite,,0,1,0,1,1,1,0,1
biweekly,biweekly,,0,1,0,1,1,1,4,1
expressiveannotations,expressiveannotations,,0,3,2,3,1,5,8,200
cub,cub,,1,0,2,1,2,3,0,1
pia,pia,,0,1,1,1,1,2,8,1
bonecp,bonecp,,2,0,1,2,1,3,3,1
mercurial-commit,mercurial-commit,,0,0,1,0,1,1,6,1
nsentitydescription,nsentitydescription,,0,0,0,0,2,0,13,1
perforce-branch-spec,perforce-branch-spec,,0,1,0,1,2,1,6,1
mtrace,mtrace,,0,0,0,0,2,0,9,1
datedropper,datedropper,,0,0,1,0,1,1,1,1
bliki,bliki,,0,0,0,0,1,0,3,1
component.js,component.js,,0,0,1,0,1,1,1,1
react-native-gifted-chat,react-native-gifted-chat,,10,15,14,25,3,39,1,50
lparam,lparam,,0,0,0,0,1,0,9,1
mat-sidenav,mat-sidenav,,1,6,7,7,5,14,1,500
cgpdfdocument,cgpdfdocument,,1,0,1,1,1,2,13,1
delete-record,delete-record,,0,0,1,0,1,1,4,1
jdbc-postgres,jdbc-postgres,,2,1,2,3,4,5,3,1
tagless-final,tagless-final,,3,3,5,6,3,11,2,1
ijobfactory,ijobfactory,,0,0,0,0,1,0,8,1
stormrunner-load,stormrunner-load,,0,0,1,0,1,1,6,1
instaparse,instaparse,,0,0,3,0,1,3,2,1
text-services-framework,text-services-framework,,0,0,0,0,1,0,8,1
jenkins--x,jenkins--x,,8,6,21,14,7,35,6,1
enscript,enscript,,3,1,1,4,1,5,9,1
newforms,newforms,,1,1,1,2,1,3,8,1
boogie,boogie,,0,0,2,0,2,2,2,1
rxbluetooth,rxbluetooth,,3,0,3,3,2,6,3,1
optix,optix,,3,0,2,3,1,5,0,1
cactiverecord,cactiverecord,,0,0,1,0,1,1,4,1
emailrelay,emailrelay,,0,0,3,0,1,3,4,1
mockingoose,mockingoose,,1,0,1,1,1,2,1,1
instagramapi-mgp25,instagramapi-mgp25,,3,2,6,5,6,11,13,1
java-audio,java-audio,,1,0,1,1,2,2,3,1
hadoop-native-library,hadoop-native-library,,0,0,0,0,1,0,2,1
thinkphp,thinkphp,,2,3,1,5,1,6,4,50
xcode9.4,xcode9.4,,0,4,38,4,74,42,13,300
ragged,ragged,,4,0,2,4,1,6,0,1
enomem,enomem,,0,0,0,0,1,0,9,1
intacct,intacct,,0,0,0,0,1,0,4,1
cedar-bdd,cedar-bdd,,0,0,0,0,2,0,13,1
tmenuitem,tmenuitem,,0,0,1,0,2,1,9,1
hyperledger-iroha,hyperledger-iroha,,0,3,4,3,2,7,6,200
bitmapdrawable,bitmapdrawable,,1,0,2,1,3,3,3,1
wixlib,wixlib,,0,0,1,0,2,1,8,1
microsoft-live-connect,microsoft-live-connect,,0,0,1,0,1,1,8,1
typescript2.9,typescript2.9,,0,0,3,0,2,3,1,1
custom-button,custom-button,,3,4,4,7,1,11,8,33.333333
dart-analyzer,dart-analyzer,,2,3,1,5,4,6,13,50
ciscoconfparse,ciscoconfparse,,2,0,6,2,1,8,0,1
mysql-error-1142,mysql-error-1142,,0,0,0,0,1,0,4,1
react-native-navigation-v2,react-native-navigation-v2,,15,9,47,24,20,71,1,1
command-execution,command-execution,,0,0,0,0,1,0,9,1
configmap,configmap,,26,25,28,51,9,79,6,1
intercom.js,intercom.js,,0,0,4,0,2,4,1,1
broadcast-channel,broadcast-channel,,1,2,1,3,4,4,1,100
dsofile,dsofile,,0,1,1,1,1,2,8,1
revokeobjecturl,revokeobjecturl,,0,0,1,0,1,1,1,1
usdz,usdz,,6,12,23,18,8,41,13,100
ngx-restangular,ngx-restangular,,1,0,3,1,2,4,1,1
onnx,onnx,,23,26,28,49,7,77,0,13.043478
onnx-coreml,onnx-coreml,,1,1,5,2,3,7,0,1
auto-responder,auto-responder,,0,0,7,0,4,7,4,1
uiaccelerometer,uiaccelerometer,,0,0,0,0,1,0,13,1
transloadit,transloadit,,2,1,1,3,3,4,1,1
data-caching,data-caching,,1,0,0,1,2,1,8,1
cordova-8.0.0,cordova-8.0.0,,1,0,1,1,4,2,1,1
string-externalization,string-externalization,,0,0,3,0,1,3,3,1
toolstripstatuslabel,toolstripstatuslabel,,1,0,1,1,1,2,8,1
chirp,chirp,,4,7,3,11,2,14,13,75
electronic-direct-mail,electronic-direct-mail,,0,0,0,0,1,0,1,1
multicursorediting,multicursorediting,,0,1,1,1,3,2,9,1
here-olp,here-olp,,1,5,0,6,4,6,3,400
ordered-test,ordered-test,,0,0,3,0,3,3,8,1
nodemanager,nodemanager,,2,3,9,5,6,14,2,50
google-sso,google-sso,,4,2,3,6,2,9,8,1
swift4.2,swift4.2,,142,88,368,230,22,598,13,1
svnant,svnant,,0,0,0,0,1,0,3,1
mail-mime,mail-mime,,1,2,0,3,1,3,4,100
aceoledb,aceoledb,,0,2,3,2,1,5,4,100
autocompletebox,autocompletebox,,0,0,0,0,3,0,8,1
collaboration-diagram,collaboration-diagram,,0,1,0,1,1,1,3,1
unnotificationserviceextension,unnotificationserviceextension,,7,6,11,13,7,24,13,1
uudecode,uudecode,,0,1,1,1,1,2,9,1
primus,primus,,2,0,0,2,1,2,1,1
f#-4.0,f#-4.0,,0,0,0,0,1,0,8,1
rotator,rotator,,0,1,2,1,1,3,1,1
shoryuken,shoryuken,,1,0,3,1,2,4,6,1
prettytensor,prettytensor,,0,0,0,0,1,0,0,1
psmtabbarcontrol,psmtabbarcontrol,,0,0,0,0,1,0,13,1
balana,balana,,2,0,2,2,1,4,4,1
tiddlywiki5,tiddlywiki5,,1,1,3,2,1,5,1,1
jsforce,jsforce,,8,1,6,9,5,15,14,1
swift4.1.5,swift4.1.5,,0,0,0,0,7,0,13,1
haxeui,haxeui,,0,0,1,0,1,1,9,1
vue2-google-maps,vue2-google-maps,,5,4,12,9,8,21,1,1
ibm-iam,ibm-iam,,0,3,1,3,3,4,6,200
webpartpage,webpartpage,,1,0,0,1,1,1,8,1
cross-origin-read-blocking,cross-origin-read-blocking,,24,14,21,38,25,59,1,1
ftgl,ftgl,,0,0,2,0,2,2,9,1
refactorpro,refactorpro,,0,0,0,0,1,0,4,1
mpmovieplayer,mpmovieplayer,,0,0,0,0,1,0,13,1
activex-documents,activex-documents,,0,1,0,1,1,1,5,1
flowdocumentscrollviewer,flowdocumentscrollviewer,,1,0,0,1,1,1,8,1
android-project-template,android-project-template,,1,0,0,1,1,1,3,1
node-ftp,node-ftp,,1,3,1,4,1,5,1,200
zeroformatter,zeroformatter,,1,0,1,1,2,2,8,1
flatten-js,flatten-js,,0,0,0,0,1,0,1,1
webkit-appearance,webkit-appearance,,0,0,1,0,1,1,1,1
unified-automation-sdk,unified-automation-sdk,,0,1,1,1,5,2,8,1
at.js,at.js,,0,0,3,0,1,3,1,1
radmaskedtextbox,radmaskedtextbox,,0,0,0,0,1,0,0,1
docker-pull,docker-pull,,6,2,3,8,4,11,6,1
jsr349,jsr349,,0,0,1,0,1,1,3,1
stateserver,stateserver,,1,2,2,3,1,5,8,100
wx.textctrl,wx.textctrl,,0,0,2,0,1,2,0,1
cdash,cdash,,0,0,1,0,3,1,9,1
2-digit-year,2-digit-year,,1,3,0,4,1,4,3,200
php-7.0,php-7.0,,12,13,28,25,26,53,4,8.333333
harfbuzz,harfbuzz,,2,1,3,3,3,6,9,1
ooyala,ooyala,,0,1,0,1,1,1,4,1
select-options,select-options,,5,6,12,11,8,23,1,20
type-equivalence,type-equivalence,,0,0,2,0,1,2,2,1
leda,leda,,0,0,0,0,1,0,9,1
ef-core-2.1,ef-core-2.1,,34,47,263,81,114,344,8,38.235294
local-node-modules,local-node-modules,,2,1,3,3,1,6,1,1
network-storage,network-storage,,0,1,0,1,1,1,8,1
shacl,shacl,,2,1,5,3,5,8,2,1
h3,h3,,1,2,4,3,4,7,1,100
macos-mojave,macos-mojave,,165,169,464,334,39,798,13,2.424242
kepler.gl,kepler.gl,,3,5,7,8,3,15,1,66.666667
edirectory,edirectory,,0,0,1,0,1,1,8,1
createml,createml,,7,6,21,13,9,34,13,1
createmlui,createmlui,,1,2,2,3,1,5,13,100
function-constructor,function-constructor,,0,0,2,0,3,2,1,1
svn-client,svn-client,,1,0,1,1,1,2,6,1
dhis-2,dhis-2,,2,1,1,3,5,4,1,1
libjson,libjson,,0,0,3,0,2,3,9,1
windward,windward,,0,2,0,2,1,2,8,100
tagname,tagname,,0,0,1,0,2,1,1,1
javabuilders,javabuilders,,1,0,0,1,1,1,3,1
moosefs,moosefs,,0,0,1,0,1,1,9,1
malsup-ajax-form,malsup-ajax-form,,0,0,0,0,1,0,1,1
splunk-sum,splunk-sum,,0,0,0,0,1,0,6,1
first-level-cache,first-level-cache,,1,1,1,2,1,3,3,1
appendtext,appendtext,,0,1,2,1,1,3,8,1
hibernation,hibernation,,2,1,3,3,1,6,9,1
scsf,scsf,,0,0,0,0,1,0,8,1
starter-kits,starter-kits,,2,0,0,2,2,2,1,1
openkm,openkm,,4,0,1,4,1,5,3,1
rails-authorization,rails-authorization,,0,0,1,0,1,1,12,1
dynamic-rest,dynamic-rest,,0,0,8,0,1,8,0,1
sitefinity-8,sitefinity-8,,1,1,2,2,2,4,8,1
tag-handler,tag-handler,,0,0,2,0,1,2,3,1
qgenericmatrix,qgenericmatrix,,0,0,0,0,2,0,9,1
clockify,clockify,,1,7,9,8,2,17,4,600
epydoc,epydoc,,0,0,0,0,1,0,0,1
.net-rtf-writer,.net-rtf-writer,,0,0,0,0,1,0,8,1
pytest-qt,pytest-qt,,2,2,3,4,1,7,0,1
actioncontext,actioncontext,,0,0,0,0,2,0,8,1
hibernate-xml-mapping,hibernate-xml-mapping,,0,0,1,0,1,1,3,1
postgresql-8.0,postgresql-8.0,,1,0,2,1,3,3,4,1
oursql,oursql,,0,0,0,0,1,0,0,1
gitx,gitx,,0,0,1,0,1,1,13,1
power-tools-for-xml,power-tools-for-xml,,0,0,0,0,1,0,8,1
node-glob,node-glob,,0,0,0,0,1,0,0,1
wsdl.exe,wsdl.exe,,2,0,0,2,1,2,8,1
drupal-ajax,drupal-ajax,,1,0,0,1,1,1,4,1
dartson,dartson,,0,0,1,0,1,1,13,1
mysql4,mysql4,,0,1,0,1,1,1,4,1
reposurgeon,reposurgeon,,0,0,0,0,1,0,0,1
moment-range,moment-range,,1,0,1,1,3,2,1,1
react-testing-library,react-testing-library,,79,100,63,179,6,242,1,26.582278
pl-i,pl-i,,0,0,1,0,1,1,4,1
bfile,bfile,,0,1,1,1,1,2,4,1
focusin,focusin,,1,1,0,2,2,2,1,1
play-services-auth-base-license,play-services-auth-base-license,,0,1,0,1,2,1,3,1
hypercube,hypercube,,1,4,4,5,2,9,0,300
page-curl,page-curl,,4,1,1,5,1,6,13,1
wybuild,wybuild,,0,0,0,0,1,0,8,1
udb,udb,,1,0,0,1,1,1,4,1
alglib,alglib,,1,2,3,3,3,6,9,100
json2csv,json2csv,,4,7,8,11,3,19,1,75
zend-http-client,zend-http-client,,2,0,0,2,1,2,4,1
linkshare,linkshare,,0,0,0,0,1,0,5,1
edge-side-includes,edge-side-includes,,0,0,1,0,2,1,6,1
mercurial-phases,mercurial-phases,,0,0,0,0,1,0,6,1
dcc32,dcc32,,1,0,0,1,2,1,9,1
registry-virtualization,registry-virtualization,,0,0,0,0,1,0,9,1
raygun.io,raygun.io,,0,0,1,0,2,1,1,1
dblinq,dblinq,,0,0,0,0,1,0,8,1
tablerowsorter,tablerowsorter,,3,0,2,3,1,5,3,1
pivot4j,pivot4j,,0,0,1,0,1,1,2,1
matillion,matillion,,4,5,0,9,1,9,4,25
vmmap,vmmap,,0,1,2,1,1,3,9,1
dossier,dossier,,0,0,1,0,1,1,4,1
flash-cs3,flash-cs3,,0,0,0,0,1,0,13,1
badgerdb,badgerdb,,0,1,0,1,1,1,6,1
forfiles,forfiles,,9,11,5,20,1,25,9,22.222222
lwt,lwt,,0,0,4,0,2,4,2,1
scalaxb,scalaxb,,2,1,3,3,3,6,2,1
toco,toco,,4,3,10,7,5,17,0,1
dart-native-extension,dart-native-extension,,0,0,0,0,1,0,13,1
bootstrap-dialog,bootstrap-dialog,,1,0,1,1,3,2,1,1
glibmm,glibmm,,1,0,1,1,1,2,9,1
reset-button,reset-button,,2,0,0,2,1,2,5,1
desktop-search,desktop-search,,0,0,0,0,1,0,0,1
hmvc-codeigniter,hmvc-codeigniter,,1,1,1,2,10,3,4,1
node8.2,node8.2,,0,0,0,0,2,0,1,1
sdo,sdo,,1,2,0,3,1,3,3,100
networkinfo,networkinfo,,2,2,1,4,1,5,3,1
mainbundle,mainbundle,,0,0,1,0,2,1,13,1
camel-test,camel-test,,0,4,1,4,2,5,3,300
email-delivery,email-delivery,,0,0,1,0,3,1,4,1
docker-watchtower,docker-watchtower,,1,0,3,1,1,4,6,1
private-messaging,private-messaging,,0,0,1,0,3,1,1,1
dockerfile-maven-plugin,dockerfile-maven-plugin,,1,4,7,5,1,12,6,300
class-structure,class-structure,,0,0,1,0,1,1,9,1
partition-problem,partition-problem,,0,0,1,0,1,1,0,1
jiaozivideoplayer,jiaozivideoplayer,,0,0,1,0,1,1,3,1
hibernate-query,hibernate-query,,1,1,3,2,3,5,3,1
mmmagic,mmmagic,,0,0,0,0,1,0,1,1
mantle,mantle,,0,0,0,0,1,0,13,1
data-moshing,data-moshing,,0,0,0,0,1,0,13,1
datashape,datashape,,0,0,1,0,2,1,0,1
appcompatdialog,appcompatdialog,,1,0,0,1,1,1,3,1
aws-vpc-link,aws-vpc-link,,2,2,8,4,3,12,6,1
balebot,balebot,,0,0,3,0,5,3,8,1
anymote,anymote,,0,1,0,1,1,1,3,1
client-go,client-go,,11,13,14,24,5,38,6,18.181818
aopalliance,aopalliance,,0,0,0,0,2,0,3,1
multi-page-application,multi-page-application,,2,2,10,4,3,14,1,1
generalized-method-of-moments,generalized-method-of-moments,,1,3,3,4,3,7,0,200
icq,icq,,0,0,0,0,1,0,9,1
efl,efl,,0,2,0,2,2,2,13,100
superfeedr,superfeedr,,0,0,0,0,1,0,3,1
photoviewer,photoviewer,,0,0,2,0,3,2,1,1
rmongo,rmongo,,0,1,2,1,2,3,0,1
hyde,hyde,,2,0,1,2,1,3,0,1
tcolor,tcolor,,0,0,0,0,1,0,9,1
mpmedialibrary,mpmedialibrary,,3,1,3,4,2,7,13,1
string-replace-loader,string-replace-loader,,0,0,0,0,2,0,1,1
job-server,job-server,,0,0,0,0,1,0,2,1
drawingarea,drawingarea,,0,1,0,1,1,1,9,1
eraser,eraser,,2,2,2,4,1,6,1,1
jsonassert,jsonassert,,2,1,6,3,3,9,3,1
eclipse-hono,eclipse-hono,,0,6,3,6,1,9,6,500
webpack-3.5,webpack-3.5,,0,0,2,0,1,2,1,1
configurationproperties,configurationproperties,,1,2,6,3,5,9,3,100
axwebbrowser,axwebbrowser,,1,0,0,1,1,1,8,1
axhost,axhost,,0,0,0,0,1,0,8,1
tesselation,tesselation,,0,0,2,0,3,2,9,1
vscode-python,vscode-python,,8,4,3,12,1,15,9,1
tweetr,tweetr,,0,1,0,1,1,1,8,1
redux-offline,redux-offline,,6,1,7,7,4,14,1,1
fileitem,fileitem,,0,1,0,1,1,1,4,1
uniscribe,uniscribe,,0,0,1,0,2,1,9,1
custom-application,custom-application,,0,2,1,2,1,3,3,100
dbamp,dbamp,,1,1,2,2,2,4,4,1
realm-database,realm-database,,2,4,9,6,5,15,13,100
telerik-test-studio,telerik-test-studio,,0,1,2,1,2,3,3,1
gem-fury,gem-fury,,2,1,1,3,2,4,6,1
interpreter-pattern,interpreter-pattern,,1,0,0,1,1,1,3,1
application-layer,application-layer,,0,1,4,1,3,5,9,1
pg-stat-statements,pg-stat-statements,,1,1,2,2,1,4,4,1
vgo,vgo,,1,1,6,2,8,8,6,1
docker-ce,docker-ce,,0,2,10,2,7,12,6,100
xed,xed,,0,0,0,0,1,0,9,1
amazon-simple-email-service,amazon-simple-email-service,,2,4,5,6,5,11,6,100
jmxtrans,jmxtrans,,1,2,1,3,3,4,3,100
iot-devkit,iot-devkit,,2,1,7,3,1,10,8,1
em-websocket,em-websocket,,0,0,0,0,1,0,12,1
osmandmapcreator,osmandmapcreator,,0,0,0,0,1,0,3,1
materialized-path-pattern,materialized-path-pattern,,1,0,0,1,1,1,8,1
deadbolt,deadbolt,,0,0,0,0,1,0,2,1
ducc,ducc,,0,0,0,0,1,0,3,1
easyimage,easyimage,,0,0,4,0,1,4,3,1
elasticsearch-1.7.5,elasticsearch-1.7.5,,1,0,0,1,2,1,6,1
out-of-source,out-of-source,,0,0,0,0,1,0,9,1
document-directory,document-directory,,4,0,1,4,5,5,13,1
livecoding,livecoding,,0,0,2,0,1,2,2,1
react-native-charts-wrapper,react-native-charts-wrapper,,2,0,1,2,1,3,1,1
gulp-ruby-sass,gulp-ruby-sass,,1,0,1,1,1,2,1,1
deviceeventemitter,deviceeventemitter,,1,0,2,1,1,3,1,1
reactotron,reactotron,,6,3,3,9,2,12,1,1
haskell-beam,haskell-beam,,0,0,0,0,2,0,2,1
solr-highlight,solr-highlight,,1,0,2,1,1,3,2,1
file-icons,file-icons,,0,0,1,0,1,1,8,1
grads,grads,,0,0,1,0,1,1,6,1
crf++,crf++,,0,3,1,3,1,4,0,200
goa,goa,,0,0,2,0,3,2,6,1
angular-hybrid,angular-hybrid,,8,8,17,16,25,33,1,1
jseparator,jseparator,,0,1,1,1,1,2,3,1
codeigniter-flashdata,codeigniter-flashdata,,2,0,4,2,2,6,4,1
nop,nop,,1,0,4,1,1,5,9,1
structure-of-arrays,structure-of-arrays,,0,0,1,0,3,1,9,1
webradio,webradio,,0,0,0,0,1,0,1,1
threads.h,threads.h,,0,0,0,0,1,0,9,1
pion-net,pion-net,,0,0,0,0,1,0,9,1
makecode,makecode,,0,0,4,0,3,4,0,1
vimpulse,vimpulse,,0,0,0,0,1,0,0,1
counterclockwise,counterclockwise,,0,0,1,0,1,1,9,1
ckshare,ckshare,,0,3,2,3,1,5,13,200
cloudkit-sharing,cloudkit-sharing,,3,0,1,3,4,4,13,1
flutter-channel,flutter-channel,,0,1,2,1,1,3,13,1
fiware-pegasus,fiware-pegasus,,0,0,0,0,1,0,3,1
android-extracted-text,android-extracted-text,,0,0,0,0,4,0,3,1
touchimageview,touchimageview,,2,2,5,4,2,9,3,1
julius-speech,julius-speech,,0,2,0,2,1,2,6,100
bodybuilder.js,bodybuilder.js,,2,0,2,2,2,4,6,1
poudriere,poudriere,,0,0,0,0,1,0,9,1
glr,glr,,1,0,0,1,2,1,0,1
twilio-amd,twilio-amd,,0,0,0,0,1,0,13,1
gulp-changed,gulp-changed,,0,0,0,0,2,0,1,1
transferwise,transferwise,,0,1,1,1,1,2,1,1
hash-location-strategy,hash-location-strategy,,1,1,3,2,1,5,1,1
material-ui-pickers,material-ui-pickers,,13,14,7,27,2,34,1,7.692308
spatial-pooling,spatial-pooling,,2,3,1,5,1,6,0,50
balsamiq,balsamiq,,0,0,2,0,1,2,7,1
appstoreconnect,appstoreconnect,,36,45,52,81,15,133,13,25
gosublime,gosublime,,0,0,0,0,1,0,0,1
windowsversion,windowsversion,,0,1,0,1,1,1,9,1
haskell-frames,haskell-frames,,0,1,0,1,1,1,2,1
allusersprofile,allusersprofile,,1,0,0,1,2,1,4,1
haste,haste,,0,0,1,0,2,1,1,1
assistive,assistive,,0,0,0,0,1,0,3,1
smtpexception,smtpexception,,0,0,1,0,1,1,0,1
servertag,servertag,,0,0,0,0,1,0,8,1
django-hosts,django-hosts,,2,1,1,3,2,4,0,1
std-span,std-span,,1,6,3,7,1,10,9,500
ngx-http-rewrite-module,ngx-http-rewrite-module,,0,0,0,0,1,0,6,1
qlibrary,qlibrary,,0,0,0,0,2,0,1,1
sproutcore,sproutcore,,1,0,0,1,1,1,19,1
sproutcore-2,sproutcore-2,,0,0,0,0,1,0,19,1
mark-of-the-web,mark-of-the-web,,0,0,0,0,2,0,8,1
prcomp,prcomp,,4,2,9,6,3,15,0,1
maven-eclipse-plugin,maven-eclipse-plugin,,3,1,0,4,2,4,3,1
rhq,rhq,,0,0,0,0,1,0,3,1
qrect,qrect,,0,0,2,0,1,2,9,1
vaadin-session,vaadin-session,,0,0,0,0,1,0,3,1
osmium,osmium,,2,1,2,3,2,5,0,1
android-httptransport,android-httptransport,,0,0,2,0,1,2,3,1
drupal-console,drupal-console,,0,1,1,1,1,2,4,1
filepattern,filepattern,,1,0,3,1,1,4,9,1
canonical-name,canonical-name,,1,0,0,1,1,1,3,1
grapesjs,grapesjs,,3,5,13,8,3,21,1,66.666667
eclipse-installer,eclipse-installer,,2,0,0,2,1,2,3,1
nsviewanimation,nsviewanimation,,0,0,0,0,1,0,13,1
gradle-experimental,gradle-experimental,,0,0,3,0,1,3,3,1
blockcypher,blockcypher,,6,1,4,7,2,11,6,1
jetbrains-hub,jetbrains-hub,,1,1,1,2,3,3,6,1
snazzymaps,snazzymaps,,0,1,3,1,2,4,1,1
selenium-jupiter,selenium-jupiter,,1,0,4,1,1,5,3,1
r2rml,r2rml,,0,0,0,0,2,0,2,1
delphi-run-time-library,delphi-run-time-library,,0,0,0,0,2,0,9,1
ploneformgen,ploneformgen,,1,0,1,1,1,2,0,1
gradle-custom-plugin,gradle-custom-plugin,,1,3,1,4,2,5,3,200
endlessadapter,endlessadapter,,0,0,0,0,1,0,3,1
ng-zorro-antd,ng-zorro-antd,,11,11,14,22,3,36,1,1
visibilitychange,visibilitychange,,0,2,1,2,2,3,1,100
qtooltip,qtooltip,,0,1,1,1,3,2,9,1
rusoto,rusoto,,2,4,1,6,2,7,9,100
psreadline,psreadline,,0,1,3,1,1,4,8,1
go-imagick,go-imagick,,0,0,1,0,3,1,12,1
tadodataset,tadodataset,,0,0,0,0,1,0,9,1
messageboard,messageboard,,0,0,0,0,1,0,1,1
websockify,websockify,,2,0,2,2,1,4,9,1
ungetc,ungetc,,0,0,0,0,1,0,9,1
etcpasswd,etcpasswd,,0,0,2,0,1,2,9,1
nameservice,nameservice,,0,0,0,0,1,0,9,1
android-studio-3.1.3,android-studio-3.1.3,,0,0,2,0,32,2,3,1
service-bus-explorer,service-bus-explorer,,1,1,1,2,1,3,8,1
ref-struct,ref-struct,,1,1,1,2,3,3,8,1
javascript-api-for-office,javascript-api-for-office,,2,4,1,6,2,7,5,100
pylibmc,pylibmc,,2,0,2,2,1,4,0,1
symmetric-difference,symmetric-difference,,1,0,2,1,2,3,0,1
cedar,cedar,,2,1,0,3,2,3,13,1
packages.config,packages.config,,0,1,2,1,3,3,8,1
plexe-veins,plexe-veins,,0,0,1,0,5,1,9,1
plexe,plexe,,0,0,0,0,4,0,9,1
request-timed-out,request-timed-out,,2,2,3,4,3,7,4,1
db.js,db.js,,0,0,0,0,1,0,1,1
grails-test,grails-test,,0,0,1,0,2,1,3,1
system-generator,system-generator,,0,0,1,0,1,1,9,1
implicit-instantiation,implicit-instantiation,,0,0,1,0,1,1,9,1
virtual-channel,virtual-channel,,0,0,0,0,1,0,8,1
client-side-data,client-side-data,,0,0,1,0,1,1,1,1
scala-script,scala-script,,0,3,1,3,2,4,2,200
lcid,lcid,,1,0,0,1,1,1,8,1
fast-app-switching,fast-app-switching,,0,0,0,0,1,0,13,1
email-bounces,email-bounces,,2,1,5,3,2,8,4,1
angular-socket-io,angular-socket-io,,0,0,2,0,1,2,1,1
gpshell,gpshell,,0,0,0,0,1,0,3,1
dsld,dsld,,0,1,0,1,1,1,6,1
stagefright,stagefright,,0,0,1,0,1,1,3,1
cloudhopper,cloudhopper,,0,0,0,0,1,0,6,1
total-commander,total-commander,,0,0,3,0,1,3,9,1
figlet,figlet,,1,0,0,1,1,1,9,1
long-lines,long-lines,,0,1,1,1,1,2,0,1
waitforexit,waitforexit,,0,0,2,0,2,2,9,1
angular-jit,angular-jit,,1,2,2,3,1,5,1,100
aws-elemental,aws-elemental,,5,3,2,8,4,10,6,1
intellij-12,intellij-12,,0,0,0,0,1,0,3,1
python-dragonfly,python-dragonfly,,0,0,0,0,1,0,0,1
augmentor,augmentor,,1,0,1,1,1,2,0,1
hdbscan,hdbscan,,5,8,4,13,2,17,0,60
getpwuid,getpwuid,,0,0,0,0,1,0,9,1
dynamic-attributes,dynamic-attributes,,2,0,1,2,1,3,4,1
view-components,view-components,,3,1,3,4,2,7,8,1
coliru,coliru,,0,1,0,1,1,1,9,1
jimfs,jimfs,,0,0,0,0,1,0,3,1
postgresql-11,postgresql-11,,57,68,73,125,3,198,4,19.298246
sc,sc,,2,0,1,2,2,3,9,1
communityengine,communityengine,,0,1,1,1,1,2,8,1
oculusgo,oculusgo,,13,6,32,19,7,51,8,1
turbopower,turbopower,,0,0,0,0,1,0,6,1
trng,trng,,0,0,2,0,2,2,0,1
write-through,write-through,,0,1,1,1,1,2,3,1
flutter-plugin,flutter-plugin,,30,27,25,57,5,82,13,1
pwabuilder,pwabuilder,,2,3,6,5,1,11,1,50
uses,uses,,0,0,0,0,1,0,9,1
android-wear-notification,android-wear-notification,,3,0,3,3,2,6,3,1
tungus,tungus,,0,0,0,0,1,0,2,1
citrus-engine,citrus-engine,,0,0,0,0,1,0,4,1
generic-callback,generic-callback,,1,0,0,1,1,1,3,1
ova,ova,,0,0,3,0,4,3,6,1
sirius,sirius,,1,0,1,1,1,2,3,1
language-theory,language-theory,,0,1,2,1,3,3,9,1
resolv,resolv,,1,1,1,2,2,3,6,1
bs-json,bs-json,,0,0,2,0,1,2,9,1
facebook-payments,facebook-payments,,1,0,4,1,3,5,13,1
kappa,kappa,,2,2,2,4,3,6,0,1
msbuild-batching,msbuild-batching,,0,0,0,0,1,0,8,1
laravel-resource,laravel-resource,,4,3,14,7,6,21,4,1
esdoc,esdoc,,1,2,0,3,2,3,1,100
vue-native,vue-native,,12,12,23,24,5,47,1,1
kube-applier,kube-applier,,0,0,0,0,1,0,6,1
pandas-ml,pandas-ml,,1,0,1,1,1,2,0,1
git-ls-files,git-ls-files,,4,6,3,10,2,13,6,50
qelapsedtimer,qelapsedtimer,,0,0,0,0,1,0,9,1
scratchcard,scratchcard,,1,0,2,1,1,3,1,1
windows-xp-sp3,windows-xp-sp3,,1,1,1,2,2,3,4,1
pypubsub,pypubsub,,2,0,1,2,1,3,0,1
as86,as86,,1,2,1,3,1,4,9,100
openimageio,openimageio,,1,0,3,1,1,4,0,1
angularjs-gridster,angularjs-gridster,,1,0,0,1,3,1,1,1
angularjs-jqlite,angularjs-jqlite,,0,0,1,0,1,1,1,1
winsql,winsql,,0,2,1,2,2,3,4,100
magpie,magpie,,0,0,0,0,1,0,4,1
vsm,vsm,,1,0,0,1,1,1,6,1
uwp-navigation,uwp-navigation,,0,2,5,2,3,7,8,100
prerequesthandler,prerequesthandler,,0,0,0,0,1,0,4,1
python-2.3,python-2.3,,0,0,0,0,1,0,3,1
bism,bism,,0,0,0,0,1,0,4,1
resharper-sdk,resharper-sdk,,1,1,2,2,1,4,8,1
psr-0,psr-0,,2,1,1,3,2,4,4,1
subcommand,subcommand,,2,1,3,3,3,6,0,1
redhat-datagrid,redhat-datagrid,,0,0,0,0,1,0,3,1
docker-run,docker-run,,18,18,29,36,9,65,6,1
parallella,parallella,,0,0,0,0,2,0,9,1
libchan,libchan,,0,0,0,0,3,0,6,1
pagekit,pagekit,,0,0,1,0,1,1,4,1
custom-compare,custom-compare,,4,3,2,7,3,9,9,1
promoted-builds,promoted-builds,,2,0,4,2,2,6,6,1
openpai,openpai,,0,0,2,0,1,2,6,1
pymox,pymox,,0,0,0,0,1,0,0,1
ssis-powerpack,ssis-powerpack,,0,0,0,0,1,0,4,1
perlnetssh,perlnetssh,,0,1,0,1,2,1,9,1
hyperledger-caliper,hyperledger-caliper,,3,9,4,12,1,16,6,200
tensorflowjs-converter,tensorflowjs-converter,,38,8,26,46,8,72,0,1
neopixel,neopixel,,5,6,6,11,3,17,9,20
corona-director,corona-director,,0,0,0,0,1,0,9,1
alibaba-cloud-function-compute,alibaba-cloud-function-compute,,0,0,2,0,2,2,6,1
osquery,osquery,,2,5,5,7,2,12,9,150
cradle,cradle,,0,0,1,0,2,1,3,1
post-checkout-hook,post-checkout-hook,,0,0,0,0,1,0,6,1
scrapely,scrapely,,0,0,2,0,2,2,0,1
oracle-application-server,oracle-application-server,,1,0,1,1,1,2,4,1
amazon-workspaces,amazon-workspaces,,4,9,5,13,4,18,6,125
osql,osql,,1,0,1,1,1,2,4,1
wsdl4j,wsdl4j,,0,0,1,0,2,1,3,1
cement,cement,,0,0,0,0,1,0,0,1
angularjs-nvd3-directives,angularjs-nvd3-directives,,2,0,3,2,1,5,1,1
xmos,xmos,,0,0,0,0,1,0,9,1
esri-oss,esri-oss,,0,2,1,2,2,3,1,100
acc,acc,,0,1,2,1,1,3,13,1
g-wan,g-wan,,1,1,1,2,3,3,4,1
glassfish-embedded,glassfish-embedded,,0,0,1,0,2,1,3,1
reagent-forms,reagent-forms,,1,1,0,2,1,2,2,1
angularjs-1.7,angularjs-1.7,,1,1,6,2,4,8,1,1
r-mapedit,r-mapedit,,1,2,0,3,2,3,0,100
handbrake-js,handbrake-js,,0,0,0,0,1,0,1,1
cabal-sandbox,cabal-sandbox,,2,0,0,2,1,2,2,1
egovernment,egovernment,,0,1,1,1,1,2,3,1
jtracert,jtracert,,0,0,0,0,1,0,6,1
nsobjectcontroller,nsobjectcontroller,,0,0,0,0,1,0,13,1
directmemory,directmemory,,0,0,2,0,1,2,3,1
ora-01034,ora-01034,,0,0,0,0,1,0,4,1
ora-27101,ora-27101,,0,0,0,0,1,0,4,1
qsizegrip,qsizegrip,,0,0,0,0,2,0,9,1
dentrix,dentrix,,0,0,0,0,1,0,1,1
appwarp,appwarp,,1,0,0,1,1,1,9,1
testflight-public-link,testflight-public-link,,1,1,4,2,1,6,13,1
android-vts,android-vts,,1,1,2,2,3,4,3,1
akka-persistent-fsm,akka-persistent-fsm,,0,0,1,0,1,1,2,1
vmalloc,vmalloc,,2,0,0,2,1,2,9,1
springloops,springloops,,0,0,1,0,2,1,6,1
safari-push-notifications,safari-push-notifications,,0,1,1,1,2,2,13,1
constructor-exception,constructor-exception,,0,0,0,0,1,0,9,1
django-mixer,django-mixer,,0,0,2,0,3,2,0,1
boost-chrono,boost-chrono,,0,0,1,0,1,1,9,1
xfn,xfn,,0,0,1,0,1,1,4,1
cordova-chrome-app,cordova-chrome-app,,0,0,1,0,1,1,1,1
memoryanalyzer,memoryanalyzer,,0,0,1,0,1,1,9,1
portable-python,portable-python,,0,0,1,0,1,1,0,1
jsperf,jsperf,,0,0,2,0,1,2,1,1
amazon-eks,amazon-eks,,67,62,115,129,38,244,6,1
catch-exception,catch-exception,,0,0,0,0,1,0,1,1
ezpdf,ezpdf,,0,0,1,0,1,1,8,1
lucene-boosting,lucene-boosting,,0,0,0,0,1,0,2,1
bigfloat,bigfloat,,2,0,1,2,1,3,0,1
drupal-content-types,drupal-content-types,,0,2,2,2,1,4,4,100
stp,stp,,0,0,0,0,1,0,9,1
grunt-requirejs,grunt-requirejs,,0,0,0,0,1,0,1,1
tkx,tkx,,0,0,0,0,1,0,9,1
venmo,venmo,,1,1,4,2,1,6,4,1
angular-transfer-state,angular-transfer-state,,1,1,3,2,2,5,1,1
http-range,http-range,,1,1,1,2,1,3,1,1
oracle-mds,oracle-mds,,0,0,0,0,1,0,4,1
execute-as,execute-as,,0,0,0,0,1,0,4,1
certify,certify,,0,0,1,0,2,1,6,1
xsocket,xsocket,,0,0,0,0,1,0,8,1
pixbuf,pixbuf,,1,2,1,3,1,4,9,100
speakerphone,speakerphone,,0,1,0,1,1,1,3,1
azuresphere,azuresphere,,5,5,3,10,1,13,8,1
openvino,openvino,,17,25,19,42,4,61,0,47.058824
ffmpy,ffmpy,,0,0,6,0,4,6,0,1
paragraph-marker,paragraph-marker,,0,0,0,0,2,0,5,1
mailup,mailup,,0,0,0,0,1,0,8,1
property-initializer,property-initializer,,0,0,0,0,1,0,8,1
ccr,ccr,,1,0,0,1,1,1,0,1
node-kafka,node-kafka,,4,3,1,7,1,8,2,1
git-cvs,git-cvs,,0,0,0,0,1,0,6,1
alt-ergo,alt-ergo,,0,0,0,0,1,0,9,1
pp-perl-par-packager,pp-perl-par-packager,,0,0,0,0,2,0,9,1
phpunit-testing,phpunit-testing,,22,20,56,42,19,98,4,1
dbaccess,dbaccess,,1,0,2,1,2,3,13,1
skorch,skorch,,1,2,1,3,3,4,0,100
errortemplate,errortemplate,,0,1,0,1,1,1,6,1
pdffocus,pdffocus,,0,0,0,0,1,0,8,1
vfs-stream,vfs-stream,,0,1,0,1,1,1,3,1
dynamics-crm-4,dynamics-crm-4,,0,0,0,0,1,0,8,1
cfftp,cfftp,,0,0,0,0,1,0,4,1
ios-statusbar,ios-statusbar,,0,1,4,1,2,5,13,1
graphene-sqlalchemy,graphene-sqlalchemy,,2,7,4,9,1,13,1,250
browser-plugin,browser-plugin,,2,0,0,2,2,2,1,1
textpad,textpad,,2,0,7,2,1,9,0,1
tus,tus,,4,2,6,6,3,12,1,1
scipy-spatial,scipy-spatial,,9,7,19,16,7,35,0,1
sirishortcuts,sirishortcuts,,20,23,76,43,10,119,13,15
skein,skein,,0,1,0,1,1,1,0,1
jquery-mobile-ajax,jquery-mobile-ajax,,0,0,0,0,1,0,1,1
carve,carve,,0,0,0,0,1,0,0,1
semplot,semplot,,0,3,1,3,2,4,0,200
authorized-keys,authorized-keys,,0,0,1,0,2,1,9,1
remotipart,remotipart,,0,1,0,1,1,1,12,1
tizen-tv-emulator,tizen-tv-emulator,,0,1,0,1,1,1,13,1
generate-scripts,generate-scripts,,1,0,0,1,1,1,4,1
swipecardview,swipecardview,,1,0,2,1,1,3,3,1
ios11.4,ios11.4,,0,2,13,2,12,15,13,100
jbrowse,jbrowse,,0,0,1,0,1,1,9,1
foxycart,foxycart,,0,0,0,0,1,0,1,1
extjs-mvc,extjs-mvc,,0,0,1,0,1,1,1,1
aws-iot-analytics,aws-iot-analytics,,2,2,8,4,2,12,6,1
groovy-eclipse,groovy-eclipse,,0,0,4,0,1,4,3,1
bi-temporal,bi-temporal,,2,0,3,2,2,5,4,1
rapidclipse,rapidclipse,,5,5,1,10,2,11,3,1
nsurlrequestcachepolicy,nsurlrequestcachepolicy,,0,1,1,1,1,2,13,1
jquery-source-map,jquery-source-map,,0,0,0,0,1,0,1,1
p8,p8,,0,1,4,1,1,5,13,1
dartium,dartium,,0,0,0,0,2,0,13,1
vimgrep,vimgrep,,0,0,0,0,2,0,9,1
hyperkube,hyperkube,,0,1,0,1,1,1,6,1
vim-quickfix,vim-quickfix,,0,0,3,0,1,3,9,1
dahdi,dahdi,,0,2,2,2,1,4,13,100
watson-assistant-solutions,watson-assistant-solutions,,0,1,9,1,3,10,6,1
retrytemplate,retrytemplate,,2,1,2,3,2,5,3,1
vsct,vsct,,0,1,0,1,1,1,8,1
gwt-dev-mode,gwt-dev-mode,,0,1,0,1,2,1,3,1
docker-app,docker-app,,0,0,1,0,1,1,6,1
adobe-xd,adobe-xd,,8,3,21,11,2,32,1,1
rational-performance-test,rational-performance-test,,0,0,0,0,1,0,3,1
scntranscaction,scntranscaction,,0,0,0,0,1,0,13,1
pod6,pod6,,0,0,1,0,1,1,9,1
createwritestream,createwritestream,,7,1,2,8,1,10,1,1
android-userdictionary,android-userdictionary,,0,0,0,0,1,0,3,1
timing-diagram,timing-diagram,,0,0,2,0,1,2,9,1
linkedin-j,linkedin-j,,0,0,3,0,1,3,4,1
rhino-etl,rhino-etl,,0,0,0,0,2,0,8,1
redex,redex,,0,1,1,1,1,2,0,1
spree-paypal-express,spree-paypal-express,,0,0,1,0,1,1,12,1
supersized,supersized,,0,0,0,0,1,0,4,1
ionic2-select,ionic2-select,,0,0,2,0,1,2,1,1
pyrcca,pyrcca,,0,0,0,0,2,0,0,1
rust-2018,rust-2018,,0,0,4,0,4,4,9,1
lua-sol,lua-sol,,0,0,0,0,1,0,9,1
mapmyfitness,mapmyfitness,,0,0,0,0,2,0,13,1
elmo,elmo,,15,14,2,29,1,31,0,1
nwebsec,nwebsec,,0,1,5,1,1,6,8,1
astyanax,astyanax,,1,0,2,1,2,3,2,1
catalyst-optimizer,catalyst-optimizer,,2,4,2,6,3,8,2,100
ruby-kafka,ruby-kafka,,1,0,4,1,1,5,2,1
react-native-ble-plx,react-native-ble-plx,,5,3,7,8,3,15,3,1
storemagic,storemagic,,0,0,0,0,1,0,0,1
dismissible,dismissible,,2,2,5,4,2,9,13,1
epoxy,epoxy,,3,4,11,7,5,18,3,33.333333
balanced-data-distributor,balanced-data-distributor,,0,0,1,0,1,1,4,1
mosek,mosek,,1,0,7,1,2,8,0,1
movewindow,movewindow,,1,0,0,1,2,1,9,1
commando,commando,,8,17,14,25,2,39,1,112.5
mysql-error-1130,mysql-error-1130,,0,0,0,0,1,0,0,1
d3dx,d3dx,,2,2,3,4,1,7,9,1
velox,velox,,0,0,1,0,2,1,0,1
shipping-method,shipping-method,,33,12,49,45,17,94,4,1
x10-language,x10-language,,0,0,1,0,1,1,9,1
r-base,r-base,,5,6,5,11,5,16,0,20
rfc2822,rfc2822,,1,3,1,4,1,5,4,200
circusd,circusd,,1,1,1,2,4,3,6,1
alibaba-cloud-direct-mail,alibaba-cloud-direct-mail,,0,0,1,0,3,1,6,1
hft,hft,,1,0,0,1,1,1,0,1
bootstrap-file-input,bootstrap-file-input,,4,7,13,11,1,24,1,75
angular-material-6,angular-material-6,,51,24,180,75,72,255,1,1
grasp,grasp,,0,1,0,1,1,1,3,1
core-file,core-file,,0,2,2,2,2,4,9,100
dll-reference,dll-reference,,2,1,2,3,2,5,8,1
orphaned-objects,orphaned-objects,,0,0,1,0,1,1,3,1
angular2-materialize,angular2-materialize,,0,0,3,0,1,3,1,1
webstore,webstore,,0,0,2,0,2,2,4,1
flash-component,flash-component,,0,0,0,0,1,0,4,1
object-inspector,object-inspector,,0,0,0,0,2,0,9,1
pnrp,pnrp,,1,0,1,1,1,2,8,1
maru,maru,,0,0,0,0,1,0,2,1
dcraw,dcraw,,0,0,1,0,4,1,0,1
libraw,libraw,,1,3,1,4,3,5,0,200
voxeo,voxeo,,0,2,0,2,1,2,13,100
openal-soft,openal-soft,,0,2,1,2,1,3,9,100
win-bash,win-bash,,0,0,0,0,1,0,9,1
cubism.js,cubism.js,,0,0,0,0,1,0,1,1
firefox-sidebar,firefox-sidebar,,1,1,1,2,1,3,1,1
monochrome,monochrome,,0,1,2,1,2,3,0,1
libsmbclient,libsmbclient,,3,0,2,3,1,5,9,1
thorntail,thorntail,,14,20,28,34,7,62,3,42.857143
dex2oat,dex2oat,,0,0,1,0,1,1,3,1
dbsetup,dbsetup,,0,0,0,0,3,0,3,1
angular4-aot,angular4-aot,,0,0,0,0,1,0,1,1
sony-audio-control-api,sony-audio-control-api,,0,0,2,0,1,2,4,1
activity-streams,activity-streams,,1,1,3,2,2,5,3,1
circletype,circletype,,0,0,0,0,2,0,1,1
akismet,akismet,,0,0,1,0,2,1,12,1
input-type-range,input-type-range,,1,1,2,2,1,4,1,1
bean-managed-transactions,bean-managed-transactions,,0,0,1,0,1,1,3,1
confirmation-email,confirmation-email,,1,0,0,1,1,1,4,1
servicecontract,servicecontract,,1,0,2,1,1,3,8,1
sharepoint-timer-job,sharepoint-timer-job,,0,0,0,0,1,0,8,1
linuxkit,linuxkit,,0,1,1,1,1,2,6,1
hibernate-types,hibernate-types,,2,0,1,2,1,3,3,1
octomap,octomap,,0,4,3,4,1,7,9,300
isomorphic-git,isomorphic-git,,0,2,1,2,1,3,1,100
ui-scroll,ui-scroll,,0,1,2,1,2,3,1,1
jquery-wrap,jquery-wrap,,0,0,0,0,1,0,1,1
gatling-jsonpath,gatling-jsonpath,,6,2,5,8,1,13,2,1
asp.net-core-mvc-2.1,asp.net-core-mvc-2.1,,1,5,17,6,12,23,8,400
lookup-field,lookup-field,,0,0,1,0,1,1,0,1
content-grabber,content-grabber,,0,0,1,0,1,1,1,1
jsweet,jsweet,,0,0,3,0,1,3,2,1
ionice,ionice,,1,0,0,1,1,1,9,1
lsuielement,lsuielement,,0,0,0,0,1,0,13,1
maven-jibx,maven-jibx,,0,0,1,0,1,1,3,1
youtrack-api,youtrack-api,,3,2,2,5,4,7,6,1
opencms,opencms,,0,0,1,0,1,1,4,1
onyx-platform,onyx-platform,,0,0,1,0,1,1,2,1
propfind,propfind,,0,1,1,1,1,2,4,1
mysql-error-1046,mysql-error-1046,,0,0,0,0,1,0,4,1
django-silk,django-silk,,1,0,2,1,1,3,0,1
record-rules,record-rules,,0,0,0,0,2,0,0,1
bitwise-not,bitwise-not,,3,2,1,5,1,6,9,1
bottom-type,bottom-type,,0,0,0,0,1,0,9,1
adjust-android,adjust-android,,0,2,2,2,1,4,3,100
returnn,returnn,,0,0,2,0,3,2,0,1
foreign-collection,foreign-collection,,0,0,0,0,1,0,4,1
unigrid,unigrid,,0,0,0,0,1,0,8,1
pagersnaphelper,pagersnaphelper,,3,2,3,5,5,8,3,1
sentinel1,sentinel1,,1,0,2,1,4,3,0,1
snap-python,snap-python,,0,0,1,0,3,1,0,1
sentinel2,sentinel2,,9,4,4,13,3,17,0,1
android-studio-import,android-studio-import,,0,0,0,0,1,0,3,1
dotnet-publish,dotnet-publish,,2,2,5,4,1,9,8,1
amplifyjs,amplifyjs,,14,11,14,25,1,39,6,1
imageset,imageset,,0,0,0,0,2,0,13,1
interaction-media-features,interaction-media-features,,0,0,0,0,1,0,1,1
hcsticky,hcsticky,,0,0,1,0,1,1,1,1
column-oriented,column-oriented,,0,0,3,0,2,3,4,1
clientbin,clientbin,,0,0,0,0,1,0,8,1
codeigniter-query-builder,codeigniter-query-builder,,2,1,7,3,56,10,4,1
multi-camera-api,multi-camera-api,,2,0,1,2,1,3,3,1
angular2-upgrade,angular2-upgrade,,0,0,0,0,1,0,1,1
microsoft-graph-mail,microsoft-graph-mail,,41,40,8,81,1,89,8,1
rancheros,rancheros,,7,1,2,8,2,10,6,1
ios6,ios6,,1,0,1,1,1,2,13,1
aws-sns,aws-sns,,0,0,0,0,1,0,6,1
morte,morte,,0,0,0,0,1,0,2,1
predicatewithformat,predicatewithformat,,0,0,0,0,1,0,13,1
bootstrap-lightbox,bootstrap-lightbox,,1,2,4,3,1,7,1,100
jsonnode,jsonnode,,5,8,6,13,3,19,3,60
argon,argon,,0,1,1,1,1,2,6,1
related-posts,related-posts,,1,1,5,2,2,7,4,1
visual-studio-liveshare,visual-studio-liveshare,,4,3,0,7,1,7,8,1
rjb,rjb,,0,0,1,0,1,1,12,1
mlflow,mlflow,,12,25,4,37,4,41,0,108.333333
ada95,ada95,,2,0,1,2,2,3,9,1
web-analytics-tools,web-analytics-tools,,1,0,2,1,1,3,5,1
sqlalchemy-continuum,sqlalchemy-continuum,,1,0,2,1,1,3,0,1
streaming-analytics,streaming-analytics,,0,0,4,0,1,4,8,1
hl7-cda,hl7-cda,,0,0,0,0,1,0,3,1
ngx-graphs,ngx-graphs,,5,5,5,10,3,15,1,1
external-contenttype,external-contenttype,,1,0,2,1,1,3,8,1
manticore,manticore,,0,0,0,0,1,0,6,1
slack-commands,slack-commands,,9,9,17,18,10,35,6,1
slack-dialog,slack-dialog,,2,5,7,7,1,14,6,150
angular-builder,angular-builder,,7,11,8,18,3,26,1,57.142857
angular-devkit,angular-devkit,,4,8,2,12,1,14,1,100
respond-with,respond-with,,1,0,2,1,1,3,12,1
class-dbi,class-dbi,,0,0,0,0,1,0,9,1
installshield-2018,installshield-2018,,2,0,1,2,2,3,8,1
charisma,charisma,,0,0,0,0,1,0,1,1
normalizing,normalizing,,0,0,1,0,1,1,0,1
tlyshynavbar,tlyshynavbar,,0,0,0,0,1,0,13,1
stringreader,stringreader,,1,0,3,1,2,4,3,1
securitycenter,securitycenter,,0,1,2,1,5,3,8,1
starlark,starlark,,3,2,2,5,2,7,9,1
square-wire,square-wire,,0,1,0,1,1,1,3,1
application-monitoring,application-monitoring,,1,2,1,3,2,4,1,100
query-engine,query-engine,,0,0,1,0,1,1,4,1
testtrack,testtrack,,0,0,1,0,1,1,3,1
pgx,pgx,,1,2,2,3,1,5,4,100
jsonconverter,jsonconverter,,3,4,5,7,6,12,8,33.333333
tortoisegitmerge,tortoisegitmerge,,0,0,0,0,1,0,6,1
javahg,javahg,,0,0,0,0,2,0,6,1
jigoshop,jigoshop,,0,0,0,0,2,0,4,1
gumbo,gumbo,,0,0,0,0,2,0,12,1
mongoose-os,mongoose-os,,1,2,3,3,1,6,8,100
dismax,dismax,,2,2,2,4,1,6,2,1
kloxo,kloxo,,0,0,0,0,1,0,4,1
p4vs,p4vs,,0,0,0,0,1,0,6,1
openinfowindowhtml,openinfowindowhtml,,0,0,0,0,1,0,1,1
betamax,betamax,,0,0,1,0,1,1,0,1
kubernetes-cluster,kubernetes-cluster,,3,6,14,9,4,23,6,100
meck,meck,,0,0,0,0,1,0,2,1
kefir.js,kefir.js,,0,0,0,0,1,0,0,1
calmm,calmm,,0,0,0,0,1,0,0,1
treenodecollection,treenodecollection,,0,0,0,0,2,0,8,1
platform-sdk,platform-sdk,,0,1,0,1,2,1,3,1
prefuse,prefuse,,0,0,0,0,2,0,3,1
hydra,hydra,,2,1,7,3,2,10,4,1
ibm-ilog-opl,ibm-ilog-opl,,2,5,3,7,1,10,0,150
policy-gradient-descent,policy-gradient-descent,,5,6,3,11,3,14,0,20
url-modification,url-modification,,0,1,0,1,2,1,1,1
peer-discovery,peer-discovery,,0,0,0,0,1,0,9,1
global-functions,global-functions,,2,0,2,2,1,4,1,1
yguard,yguard,,0,1,1,1,1,2,3,1
mysql-notifier,mysql-notifier,,0,0,0,0,1,0,4,1
db2-9.7,db2-9.7,,0,1,0,1,1,1,4,1
doublebuffered,doublebuffered,,1,0,1,1,2,2,8,1
pdal,pdal,,7,2,3,9,4,12,0,1
inet-socket,inet-socket,,0,0,0,0,1,0,9,1
cordova-native-file,cordova-native-file,,0,0,2,0,1,2,1,1
cordova-3.8.0,cordova-3.8.0,,0,0,0,0,1,0,1,1
context-injection,context-injection,,0,0,0,0,2,0,8,1
controlled-folder-access,controlled-folder-access,,0,0,2,0,1,2,8,1
targit,targit,,0,1,0,1,1,1,4,1
phonegap-developer-app,phonegap-developer-app,,0,0,0,0,1,0,1,1
racf,racf,,0,0,0,0,1,0,4,1
grails-3.3.x,grails-3.3.x,,2,7,11,9,3,20,3,250
hive-table,hive-table,,2,1,4,3,3,7,2,1
jacorb,jacorb,,5,0,2,5,1,7,3,1
code-testing,code-testing,,1,0,1,1,1,2,0,1
aws-visual-studio-toolkit,aws-visual-studio-toolkit,,0,1,2,1,1,3,6,1
serverless-application-model,serverless-application-model,,6,5,10,11,1,21,6,1
pragma-pack,pragma-pack,,0,1,3,1,2,4,9,1
phonegap-plugin-push,phonegap-plugin-push,,3,3,22,6,4,28,1,1
dynamic-keyword,dynamic-keyword,,2,1,0,3,1,3,8,1
try-with,try-with,,0,0,1,0,1,1,3,1
basm,basm,,0,0,0,0,1,0,9,1
io-socket-ssl,io-socket-ssl,,0,0,1,0,1,1,6,1
boost-context,boost-context,,1,0,1,1,2,2,9,1
epoxy-modelview,epoxy-modelview,,2,0,3,2,2,5,3,1
installshield-2011,installshield-2011,,0,0,1,0,2,1,8,1
non-scrolling,non-scrolling,,1,2,0,3,1,3,1,100
ivyde,ivyde,,1,0,2,1,1,3,3,1
dbtable,dbtable,,0,0,2,0,1,2,0,1
google-cloud-build,google-cloud-build,,50,75,80,125,26,205,6,50
hibernate-restrictions,hibernate-restrictions,,0,0,1,0,2,1,3,1
container-managed,container-managed,,1,0,0,1,1,1,3,1
apache-aries,apache-aries,,0,0,0,0,2,0,3,1
okular,okular,,1,0,0,1,1,1,9,1
finnish,finnish,,1,0,0,1,1,1,4,1
stellaris,stellaris,,1,0,0,1,1,1,9,1
scopeguard,scopeguard,,0,0,1,0,1,1,9,1
pymtp,pymtp,,0,0,0,0,1,0,0,1
yappi,yappi,,0,1,0,1,1,1,0,1
animsition,animsition,,0,0,0,0,2,0,1,1
apsw,apsw,,3,0,0,3,1,3,3,1
parsefacebookutils,parsefacebookutils,,0,0,1,0,1,1,13,1
stripe-elixir,stripe-elixir,,0,0,0,0,2,0,2,1
strange-attractor,strange-attractor,,0,0,0,0,1,0,0,1
pyo3,pyo3,,0,5,7,5,1,12,9,400
tox-globinterpreter,tox-globinterpreter,,0,0,0,0,1,0,0,1
linksys,linksys,,1,0,0,1,1,1,9,1
jquery-delegate,jquery-delegate,,0,0,0,0,1,0,1,1
rawurl,rawurl,,0,0,0,0,2,0,4,1
inform7,inform7,,0,0,0,0,1,0,1,1
pex,pex,,2,1,4,3,2,7,0,1
ionic.io,ionic.io,,0,0,0,0,1,0,1,1
f#+,f#+,,2,1,0,3,1,3,8,1
uvw,uvw,,0,0,0,0,1,0,9,1
distcc,distcc,,2,1,7,3,1,10,9,1
audit4j,audit4j,,0,0,1,0,1,1,3,1
react-notifications,react-notifications,,2,1,0,3,2,3,1,1
rtts,rtts,,1,0,0,1,1,1,5,1
pivotviewer,pivotviewer,,0,0,0,0,2,0,4,1
photon-os,photon-os,,0,0,1,0,1,1,3,1
octicons,octicons,,1,1,0,2,1,2,1,1
vaadin6,vaadin6,,0,0,1,0,1,1,3,1
jsondoc,jsondoc,,0,0,0,0,1,0,9,1
dockable,dockable,,1,0,0,1,1,1,3,1
floating-point-comparison,floating-point-comparison,,2,3,0,5,2,5,0,50
logan-square,logan-square,,1,0,0,1,1,1,3,1
smart-app-banner,smart-app-banner,,0,0,1,0,2,1,1,1
sysdig,sysdig,,1,1,2,2,1,4,6,1
suphp,suphp,,1,0,1,1,2,2,4,1
cameracapturetask,cameracapturetask,,0,1,1,1,1,2,0,1
flamerobin,flamerobin,,1,1,2,2,1,4,4,1
ibm-forms,ibm-forms,,0,0,2,0,1,2,1,1
asp.net-core-hosted-services,asp.net-core-hosted-services,,7,11,11,18,9,29,8,57.142857
tavern,tavern,,5,4,0,9,2,9,0,1
ios10.2,ios10.2,,0,0,1,0,1,1,13,1
moto-360,moto-360,,0,0,2,0,1,2,3,1
facebook-batch-request,facebook-batch-request,,0,1,0,1,1,1,13,1
ilias,ilias,,1,0,0,1,1,1,4,1
sap-smp,sap-smp,,0,0,1,0,1,1,5,1
p3x-angular-compile,p3x-angular-compile,,1,2,0,3,1,3,1,100
kubespray,kubespray,,10,3,12,13,4,25,6,1
apache-nifi-registry,apache-nifi-registry,,4,3,3,7,1,10,2,1
cloudsponge,cloudsponge,,0,0,0,0,1,0,1,1
ora-01555,ora-01555,,0,0,0,0,1,0,4,1
revoscalepy,revoscalepy,,3,1,3,4,1,7,0,1
jmdns,jmdns,,3,0,2,3,3,5,3,1
javax.comm,javax.comm,,1,0,0,1,1,1,3,1
ncr,ncr,,1,0,3,1,1,4,0,1
pymses,pymses,,0,0,0,0,1,0,0,1
solarwinds-orion,solarwinds-orion,,2,1,5,3,3,8,4,1
google-tez,google-tez,,1,0,3,1,3,4,3,1
google-indexing-api,google-indexing-api,,4,3,11,7,4,18,5,1
traefik-ingress,traefik-ingress,,17,17,37,34,6,71,6,1
sequence-analysis,sequence-analysis,,0,0,3,0,1,3,0,1
gwt-2.4,gwt-2.4,,0,0,0,0,1,0,1,1
dpinst,dpinst,,0,0,1,0,1,1,8,1
long-parameter-list,long-parameter-list,,0,0,0,0,1,0,8,1
bipro,bipro,,0,0,0,0,1,0,3,1
google-license-manager,google-license-manager,,0,1,1,1,2,2,3,1
toscawidgets,toscawidgets,,0,0,0,0,1,0,0,1
peach,peach,,0,0,1,0,1,1,0,1
sharepoint-survey-list,sharepoint-survey-list,,0,0,2,0,1,2,8,1
nustache,nustache,,0,1,1,1,1,2,8,1
git-branch-sculpting,git-branch-sculpting,,2,0,1,2,1,3,6,1
google-cloud-visualstudio,google-cloud-visualstudio,,1,0,0,1,1,1,8,1
g77,g77,,0,0,0,0,1,0,9,1
windowsdomainaccount,windowsdomainaccount,,1,1,0,2,2,2,8,1
securid,securid,,0,0,0,0,1,0,9,1
federated-table,federated-table,,1,0,2,1,1,3,4,1
gruff,gruff,,0,0,0,0,1,0,12,1
golang-migrate,golang-migrate,,7,7,6,14,3,20,6,1
mongodb4.0,mongodb4.0,,3,3,10,6,4,16,1,1
qsharedmemory,qsharedmemory,,1,0,0,1,1,1,0,1
nativescript-vue,nativescript-vue,,90,111,112,201,17,313,1,23.333333
joomla-jform,joomla-jform,,0,0,0,0,1,0,4,1
uniface,uniface,,0,0,0,0,2,0,3,1
pykka,pykka,,0,1,1,1,1,2,0,1
bit-src,bit-src,,0,0,6,0,1,6,1,1
pybuffer,pybuffer,,0,0,0,0,1,0,0,1
prism.xamarin,prism.xamarin,,0,0,1,0,1,1,8,1
execute-sql-task,execute-sql-task,,8,6,13,14,2,27,4,1
hinstance,hinstance,,0,1,1,1,1,2,9,1
cmfctoolbar,cmfctoolbar,,2,0,8,2,1,10,9,1
wsdlc,wsdlc,,0,0,0,0,1,0,3,1
rdiff-backup,rdiff-backup,,0,0,1,0,1,1,6,1
camediatiming,camediatiming,,0,0,0,0,1,0,13,1
xcharts,xcharts,,0,0,0,0,1,0,3,1
lidar-data,lidar-data,,2,1,1,3,2,4,0,1
android-blur-effect,android-blur-effect,,2,0,1,2,2,3,3,1
covariance-matrix,covariance-matrix,,9,5,17,14,4,31,0,1
buster.js,buster.js,,0,0,0,0,1,0,6,1
nsnetservicebrowser,nsnetservicebrowser,,0,0,1,0,2,1,13,1
angular-validator,angular-validator,,2,6,7,8,8,15,1,200
midi-interface,midi-interface,,0,0,1,0,1,1,0,1
client-dependency,client-dependency,,0,0,1,0,1,1,8,1
lessql,lessql,,0,0,0,0,1,0,4,1
zinc,zinc,,1,1,1,2,1,3,2,1
lit-html,lit-html,,34,23,23,57,3,80,1,1
jdepend,jdepend,,0,0,0,0,1,0,3,1
openlayers-5,openlayers-5,,66,54,100,120,26,220,1,1
xrmservicetoolkit,xrmservicetoolkit,,0,0,1,0,3,1,8,1
blend-mode,blend-mode,,1,0,2,1,2,3,3,1
simplejdbccall,simplejdbccall,,3,1,5,4,3,9,3,1
nsinteger,nsinteger,,1,2,0,3,2,3,13,100
kommunicate,kommunicate,,0,0,2,0,1,2,13,1
fingerprintjs,fingerprintjs,,0,0,0,0,1,0,3,1
openmap,openmap,,1,1,1,2,3,3,0,1
idbconnection,idbconnection,,0,0,0,0,1,0,8,1
javalin,javalin,,6,1,2,7,2,9,3,1
lansa,lansa,,0,0,0,0,1,0,3,1
parallel-io,parallel-io,,1,0,4,1,1,5,0,1
slickedit,slickedit,,0,0,1,0,1,1,3,1
componentlistener,componentlistener,,0,0,0,0,1,0,3,1
angular-require,angular-require,,0,1,0,1,1,1,1,1
ruby-test,ruby-test,,0,0,0,0,1,0,12,1
bluejeans,bluejeans,,0,0,0,0,5,0,0,1
pup,pup,,2,0,2,2,2,4,1,1
.net-internals,.net-internals,,0,0,1,0,2,1,8,1
nodejs-server,nodejs-server,,39,25,4,64,3,68,1,1
shelving,shelving,,0,1,1,1,1,2,6,1
dart-build,dart-build,,1,0,4,1,1,5,13,1
jgss,jgss,,0,0,1,0,1,1,3,1
bootstrap-validate,bootstrap-validate,,0,4,0,4,1,4,1,300
ujmp,ujmp,,0,0,0,0,8,0,3,1
mems,mems,,1,1,3,2,1,5,3,1
kanji,kanji,,1,0,2,1,3,3,0,1
transmitfile,transmitfile,,1,0,1,1,2,2,9,1
cctalk,cctalk,,0,0,0,0,1,0,9,1
phalcon-webtools,phalcon-webtools,,0,0,0,0,1,0,4,1
phalcon-devtools,phalcon-devtools,,0,0,0,0,1,0,4,1
nsshadow,nsshadow,,2,0,0,2,1,2,13,1
math-mode,math-mode,,1,0,0,1,1,1,0,1
dpm,dpm,,0,1,1,1,1,2,3,1
arcsight,arcsight,,0,1,0,1,2,1,6,1
xmlattributecollection,xmlattributecollection,,0,0,0,0,1,0,8,1
growlnotify,growlnotify,,0,0,0,0,1,0,1,1
sonarscanner,sonarscanner,,20,11,22,31,7,53,3,1
cuckoo,cuckoo,,4,3,5,7,2,12,0,1
sencha-test,sencha-test,,1,0,2,1,1,3,3,1
mysql-error-1442,mysql-error-1442,,1,1,2,2,1,4,4,1
ddl-trigger,ddl-trigger,,1,0,2,1,1,3,4,1
ibm-data-db2,ibm-data-db2,,1,0,0,1,2,1,4,1
websocket-rails,websocket-rails,,0,0,0,0,2,0,12,1
steemit,steemit,,3,0,7,3,2,10,6,1
bootp,bootp,,0,0,1,0,1,1,9,1
amazon-advertising-api,amazon-advertising-api,,2,4,7,6,2,13,6,100
tlabel,tlabel,,1,0,1,1,1,2,9,1
glumpy,glumpy,,1,4,2,5,1,7,0,300
visualhg,visualhg,,0,0,0,0,1,0,8,1
qgraphicssimpletextitem,qgraphicssimpletextitem,,1,0,0,1,1,1,9,1
mysqli-fetch-array,mysqli-fetch-array,,6,2,9,8,2,17,4,1
mod-dir,mod-dir,,0,0,1,0,1,1,4,1
jikes,jikes,,0,0,0,0,2,0,3,1
patternsyntaxexception,patternsyntaxexception,,0,0,1,0,1,1,3,1
chrome-developer-protocol,chrome-developer-protocol,,3,2,0,5,2,5,1,1
popupmenubutton,popupmenubutton,,2,0,0,2,2,2,13,1
embedio,embedio,,0,1,3,1,1,4,8,1
graphql-go,graphql-go,,1,0,5,1,2,6,1,1
mkpolygon,mkpolygon,,2,1,8,3,1,11,13,1
sbt-idea,sbt-idea,,0,1,1,1,1,2,3,1
sketchapp-plugin,sketchapp-plugin,,0,0,2,0,2,2,1,1
freb,freb,,0,0,0,0,1,0,8,1
alembic-format,alembic-format,,0,1,2,1,2,3,0,1
redux-saga-test-plan,redux-saga-test-plan,,4,3,9,7,3,16,1,1
logoff,logoff,,2,0,4,2,1,6,8,1
kie-wb,kie-wb,,0,1,3,1,2,4,3,1
datestamp,datestamp,,2,3,3,5,2,8,0,50
gps-time,gps-time,,3,0,6,3,1,9,3,1
android-cab,android-cab,,0,0,0,0,1,0,3,1
forwarderrorcorrection,forwarderrorcorrection,,1,1,5,2,1,7,9,1
act-as-taggable-on,act-as-taggable-on,,0,0,2,0,1,2,12,1
tracking-reference,tracking-reference,,0,0,0,0,1,0,8,1
functx,functx,,1,0,0,1,1,1,3,1
app-preview,app-preview,,2,2,2,4,3,6,13,1
autoplay-media-studio,autoplay-media-studio,,0,0,1,0,1,1,4,1
scrollable-table,scrollable-table,,0,0,2,0,1,2,1,1
rlmarray,rlmarray,,1,0,0,1,2,1,13,1
pyclips,pyclips,,0,0,1,0,1,1,0,1
clara.io,clara.io,,2,0,0,2,2,2,1,1
wxglcanvas,wxglcanvas,,0,0,0,0,1,0,0,1
nvelocity,nvelocity,,0,0,0,0,1,0,5,1
exclusion-constraint,exclusion-constraint,,5,0,2,5,1,7,4,1
webcodecamjs,webcodecamjs,,1,0,0,1,1,1,1,1
appletviewer,appletviewer,,2,0,1,2,1,3,3,1
tradier,tradier,,0,0,2,0,1,2,0,1
selectonelistbox,selectonelistbox,,0,0,1,0,1,1,3,1
globalevent,globalevent,,0,0,0,0,1,0,1,1
scrapy-settings,scrapy-settings,,2,1,1,3,1,4,0,1
user-acceptance-testing,user-acceptance-testing,,0,1,1,1,1,2,3,1
first-class-modules,first-class-modules,,0,1,1,1,2,2,0,1
saturn-framework,saturn-framework,,3,0,2,3,3,5,8,1
jinq,jinq,,0,0,1,0,1,1,3,1
magic-function,magic-function,,0,1,2,1,1,3,9,1
qt5.4,qt5.4,,0,0,0,0,1,0,1,1
winobjc,winobjc,,0,0,2,0,2,2,8,1
hoverintent,hoverintent,,1,0,3,1,2,4,1,1
ispell,ispell,,2,0,0,2,1,2,0,1
connectycube,connectycube,,0,8,4,8,5,12,1,700
protofield,protofield,,0,0,0,0,2,0,9,1
gmlib,gmlib,,2,0,1,2,1,3,9,1
flowpanel,flowpanel,,0,1,0,1,1,1,8,1
liferay-7.1,liferay-7.1,,8,14,12,22,7,34,3,75
mega-api,mega-api,,0,0,0,0,1,0,8,1
epg,epg,,0,1,2,1,4,3,3,1
nested-groups,nested-groups,,1,0,1,1,2,2,8,1
factor-lang,factor-lang,,0,0,0,0,1,0,0,1
dead-key,dead-key,,0,0,0,0,1,0,1,1
restore-points,restore-points,,0,0,1,0,1,1,8,1
microsoft-planner,microsoft-planner,,5,4,8,9,1,17,8,1
switch-parameter,switch-parameter,,0,0,0,0,1,0,8,1
vue2-highcharts,vue2-highcharts,,0,0,1,0,2,1,1,1
vueify,vueify,,3,1,4,4,1,8,1,1
conda-build,conda-build,,4,7,9,11,1,20,0,75
desktop-wallpaper,desktop-wallpaper,,1,0,0,1,1,1,9,1
riak-js,riak-js,,0,0,0,0,1,0,2,1
basho-client,basho-client,,0,0,0,0,1,0,2,1
post-update,post-update,,0,0,2,0,1,2,4,1
safecontrols,safecontrols,,0,0,0,0,1,0,8,1
computation-graph,computation-graph,,2,0,1,2,4,3,0,1
smartfoxserver,smartfoxserver,,2,0,1,2,1,3,8,1
codeigniter-download,codeigniter-download,,0,0,0,0,3,0,4,1
activity-state,activity-state,,0,1,2,1,1,3,3,1
macos-mail-app,macos-mail-app,,0,0,1,0,1,1,13,1
jquery-attributes,jquery-attributes,,0,0,0,0,1,0,1,1
budo,budo,,0,0,3,0,2,3,1,1
logfactory,logfactory,,0,0,0,0,1,0,3,1
kafka-topic,kafka-topic,,4,16,15,20,12,35,2,300
xamarin-component,xamarin-component,,0,0,1,0,1,1,8,1
vue.draggable,vue.draggable,,8,5,2,13,5,15,1,1
callcontext,callcontext,,0,1,5,1,3,6,8,1
twitter-client,twitter-client,,0,0,0,0,1,0,3,1
svn-update,svn-update,,0,0,0,0,2,0,6,1
raddatepicker,raddatepicker,,0,0,2,0,1,2,8,1
fluent.ribbon,fluent.ribbon,,1,0,0,1,1,1,8,1
rquery,rquery,,0,1,1,1,1,2,0,1
qsqlrelationaltablemodel,qsqlrelationaltablemodel,,1,2,2,3,2,5,0,100
pngcrush,pngcrush,,0,0,0,0,1,0,9,1
ora-01747,ora-01747,,0,0,0,0,1,0,4,1
opencv-text,opencv-text,,0,0,0,0,1,0,0,1
google-earth-plugin,google-earth-plugin,,1,0,0,1,1,1,1,1
fluent-bit,fluent-bit,,9,7,9,16,2,25,6,1
dbms-xmlgen,dbms-xmlgen,,2,0,1,2,2,3,4,1
wcf-sap,wcf-sap,,0,0,0,0,2,0,8,1
sap-nco,sap-nco,,0,0,0,0,2,0,8,1
wsc,wsc,,0,0,2,0,1,2,5,1
commandlineutils,commandlineutils,,1,0,0,1,2,1,8,1
openwebbeans,openwebbeans,,0,0,3,0,2,3,3,1
req,req,,2,2,2,4,2,6,1,1
callfire,callfire,,0,1,0,1,1,1,4,1
loose,loose,,0,0,0,0,1,0,6,1
cpd,cpd,,0,2,1,2,1,3,3,100
call-flow,call-flow,,0,0,0,0,1,0,9,1
proc-filesystem,proc-filesystem,,0,2,1,2,1,3,9,100
view-model-pattern,view-model-pattern,,0,0,0,0,1,0,1,1
imutils,imutils,,5,2,10,7,3,17,0,1
scheme48,scheme48,,0,0,1,0,1,1,0,1
curb,curb,,1,2,2,3,1,5,12,100
boost-uuid,boost-uuid,,0,1,1,1,1,2,9,1
win32serviceutil,win32serviceutil,,1,0,1,1,2,2,0,1
eventvalidation,eventvalidation,,2,2,0,4,1,4,8,1
pfrelation,pfrelation,,0,0,0,0,1,0,13,1
visual-assist-x,visual-assist-x,,0,0,1,0,1,1,8,1
vanilla-forums,vanilla-forums,,1,1,2,2,1,4,1,1
npm-ci,npm-ci,,4,2,4,6,1,10,1,1
os-dependent,os-dependent,,0,0,0,0,1,0,0,1
luabind,luabind,,0,0,1,0,1,1,9,1
dotnet-linux,dotnet-linux,,0,0,0,0,1,0,8,1
simpleflatmapper,simpleflatmapper,,1,0,0,1,1,1,3,1
python-blessings,python-blessings,,0,1,0,1,1,1,9,1
facebook-game-groups,facebook-game-groups,,0,0,1,0,1,1,13,1
jd-gui,jd-gui,,0,0,2,0,1,2,3,1
opengl-es-lighting,opengl-es-lighting,,0,0,0,0,1,0,9,1
shtool,shtool,,0,0,0,0,1,0,3,1
database-driven,database-driven,,0,0,1,0,3,1,3,1
embeddedlist,embeddedlist,,0,0,0,0,2,0,2,1
jpa-annotations,jpa-annotations,,2,0,6,2,1,8,3,1
reportparameter,reportparameter,,0,1,2,1,2,3,8,1
cryptol,cryptol,,0,0,0,0,1,0,6,1
env-file,env-file,,1,0,1,1,2,2,4,1
refresher,refresher,,2,0,0,2,1,2,1,1
npm-login,npm-login,,0,0,3,0,1,3,1,1
lemp,lemp,,0,1,1,1,4,2,4,1
ec#,ec#,,0,0,0,0,2,0,8,1
wildfly-13,wildfly-13,,4,1,9,5,5,14,3,1
django-dynamic-scraper,django-dynamic-scraper,,1,1,1,2,1,3,0,1
pecs,pecs,,1,1,2,2,1,4,3,1
extract-error-message,extract-error-message,,0,1,2,1,1,3,3,1
typescript-class,typescript-class,,4,0,3,4,2,7,1,1
custom-paging,custom-paging,,0,0,0,0,1,0,3,1
checkboxtree,checkboxtree,,0,0,2,0,1,2,1,1
qcursor,qcursor,,2,0,1,2,1,3,0,1
odatalib,odatalib,,0,0,0,0,1,0,8,1
javascript-security,javascript-security,,0,0,2,0,1,2,1,1
hyperdrive,hyperdrive,,0,0,0,0,2,0,1,1
dat-project,dat-project,,0,0,1,0,1,1,1,1
rad-studio,rad-studio,,12,14,34,26,4,60,9,16.666667
ubiquitycontainer,ubiquitycontainer,,0,0,0,0,1,0,13,1
smtps,smtps,,2,1,1,3,2,4,4,1
spring-lemon,spring-lemon,,0,0,3,0,1,3,3,1
torchvision,torchvision,,17,21,24,38,3,62,0,23.529412
mosix,mosix,,0,0,0,0,1,0,0,1
domain-masking,domain-masking,,0,2,3,2,2,5,4,100
webpack-hot-client,webpack-hot-client,,0,1,0,1,2,1,1,1
cp-optimizer,cp-optimizer,,9,1,4,10,2,14,0,1
gulp-compile-handlebars,gulp-compile-handlebars,,0,1,0,1,2,1,1,1
qualified-name,qualified-name,,0,1,2,1,2,3,9,1
uiimageorientation,uiimageorientation,,0,0,1,0,1,1,13,1
amazon-sumerian,amazon-sumerian,,3,5,6,8,1,14,6,66.666667
solidcolorbrush,solidcolorbrush,,0,0,0,0,1,0,8,1
azure-notebooks,azure-notebooks,,4,6,5,10,1,15,8,50
trusted-sites,trusted-sites,,1,2,2,3,1,5,1,100
cdma,cdma,,0,0,2,0,1,2,0,1
interior-mutability,interior-mutability,,3,4,5,7,2,12,9,33.333333
bobril,bobril,,0,0,0,0,1,0,1,1
multiscroll.js,multiscroll.js,,0,0,0,0,2,0,1,1
collaborative-editing,collaborative-editing,,0,0,3,0,1,3,1,1
freshbooks-api,freshbooks-api,,0,0,0,0,1,0,4,1
impacket,impacket,,0,1,1,1,1,2,4,1
uwebsockets,uwebsockets,,3,2,4,5,1,9,1,1
mixed-case,mixed-case,,0,0,0,0,1,0,6,1
bsb,bsb,,1,0,1,1,1,2,9,1
sitedesign,sitedesign,,0,0,0,0,1,0,1,1
seedstack,seedstack,,0,3,5,3,2,8,3,200
resharper-10.0,resharper-10.0,,0,0,0,0,1,0,8,1
spyware,spyware,,0,0,0,0,1,0,4,1
sunstudio,sunstudio,,0,0,1,0,2,1,9,1
solaris-studio,solaris-studio,,1,0,2,1,2,3,9,1
suncc,suncc,,0,0,2,0,2,2,9,1
column-aggregation,column-aggregation,,0,1,0,1,1,1,0,1
getcolor,getcolor,,0,0,1,0,1,1,8,1
module-export,module-export,,3,1,3,4,2,7,1,1
wostringstream,wostringstream,,0,0,0,0,1,0,9,1
asmjit,asmjit,,0,0,1,0,1,1,9,1
unsemantic-css,unsemantic-css,,0,0,0,0,1,0,1,1
maven-scala-plugin,maven-scala-plugin,,0,0,0,0,1,0,2,1
pljava,pljava,,0,2,0,2,1,2,4,100
spring-flex,spring-flex,,0,0,0,0,1,0,1,1
avaudioconverter,avaudioconverter,,0,1,1,1,1,2,13,1
digital-downloads,digital-downloads,,1,0,2,1,2,3,4,1
watchos-simulator,watchos-simulator,,1,1,6,2,2,8,13,1
gnu-complexity,gnu-complexity,,0,0,0,0,1,0,9,1
chilkat-email,chilkat-email,,3,1,2,4,1,6,4,1
xbehave.net,xbehave.net,,1,0,0,1,1,1,8,1
sap-ase,sap-ase,,0,0,0,0,1,0,1,1
dataflow-diagram,dataflow-diagram,,1,0,1,1,2,2,0,1
vms,vms,,1,0,0,1,1,1,9,1
setdlldirectory,setdlldirectory,,0,0,0,0,2,0,8,1
amd-rocm,amd-rocm,,4,0,6,4,2,10,0,1
babel-6,babel-6,,0,0,1,0,1,1,1,1
hyperopt,hyperopt,,8,14,16,22,1,38,0,75
awesome-nested-set,awesome-nested-set,,0,0,0,0,1,0,12,1
roots-toolkit,roots-toolkit,,0,0,0,0,3,0,4,1
laravel-helper,laravel-helper,,1,2,6,3,1,9,4,100
swagger-akka-http,swagger-akka-http,,0,2,1,2,2,3,2,100
react-native-pages,react-native-pages,,1,0,0,1,1,1,1,1
jib,jib,,8,4,9,12,1,21,6,1
mod-env,mod-env,,0,0,1,0,1,1,4,1
typo3-tca,typo3-tca,,3,4,5,7,3,12,4,33.333333
inshortcut,inshortcut,,0,0,1,0,1,1,13,1
mobilefirst-console,mobilefirst-console,,0,0,0,0,1,0,13,1
trackjs,trackjs,,0,1,0,1,1,1,1,1
jedox,jedox,,0,1,0,1,1,1,5,1
qglviewer,qglviewer,,0,2,2,2,1,4,9,100
bindinghandlers,bindinghandlers,,0,0,0,0,1,0,1,1
modx-snippets,modx-snippets,,0,0,0,0,1,0,4,1
react-native-sentry,react-native-sentry,,2,4,2,6,5,8,1,100
project-lib,project-lib,,0,1,1,1,4,2,6,1
carla,carla,,0,6,2,6,1,8,0,500
joda-convert,joda-convert,,0,1,4,1,1,5,3,1
siren,siren,,1,0,2,1,1,3,13,1
phpstorm-2016.3,phpstorm-2016.3,,0,0,1,0,1,1,9,1
pyp,pyp,,0,0,0,0,1,0,0,1
pdblp,pdblp,,2,1,3,3,1,6,0,1
sfc,sfc,,2,0,0,2,3,2,1,1
movilizer,movilizer,,0,0,0,0,1,0,3,1
static-text,static-text,,0,0,1,0,1,1,0,1
lv2,lv2,,0,0,0,0,1,0,13,1
beans-binding,beans-binding,,0,0,1,0,1,1,3,1
tingodb,tingodb,,0,0,0,0,3,0,1,1
nscountedset,nscountedset,,0,1,0,1,1,1,13,1
classifyjs,classifyjs,,0,0,0,0,1,0,0,1
tealeaf,tealeaf,,1,0,0,1,1,1,3,1
vb-power-pack,vb-power-pack,,0,0,0,0,1,0,8,1
ora-01741,ora-01741,,0,0,0,0,1,0,4,1
kiln,kiln,,0,1,0,1,2,1,6,1
scoop-installer,scoop-installer,,0,1,2,1,2,3,6,1
polyline-decorator,polyline-decorator,,0,1,0,1,2,1,1,1
mlmodel,mlmodel,,5,3,12,8,4,20,13,1
xcode10beta3,xcode10beta3,,0,0,0,0,4,0,13,1
typescript-namespace,typescript-namespace,,0,0,2,0,1,2,1,1
multi-term,multi-term,,0,1,0,1,1,1,9,1
datajs,datajs,,0,0,0,0,1,0,4,1
docker-ee,docker-ee,,3,2,5,5,7,10,6,1
android-reflection,android-reflection,,0,0,1,0,2,1,3,1
ibm-datacap,ibm-datacap,,0,0,2,0,1,2,9,1
assembly.load,assembly.load,,0,0,0,0,1,0,8,1
external-assemblies,external-assemblies,,0,0,0,0,1,0,8,1
redpitaya,redpitaya,,1,2,4,3,1,7,9,100
libtorch,libtorch,,7,17,8,24,1,32,9,142.857143
tie,tie,,0,2,5,2,2,7,9,100
umple,umple,,0,0,1,0,1,1,9,1
serviceinstall,serviceinstall,,0,0,1,0,1,1,8,1
ip2location,ip2location,,0,0,2,0,1,2,3,1
leakcheck,leakcheck,,0,0,0,0,1,0,9,1
titled-border,titled-border,,0,1,0,1,3,1,3,1
tangible-t4-editor,tangible-t4-editor,,0,0,1,0,1,1,8,1
wap,wap,,0,0,5,0,1,5,3,1
grpc-python,grpc-python,,26,23,24,49,5,73,6,1
autoexec,autoexec,,0,1,0,1,1,1,5,1
dart-isolates,dart-isolates,,5,7,9,12,1,21,13,40
thinktecture-ident-server,thinktecture-ident-server,,1,0,1,1,1,2,8,1
redux-batched-actions,redux-batched-actions,,0,0,0,0,1,0,1,1
rfc2396,rfc2396,,0,0,0,0,1,0,13,1
mixim,mixim,,0,0,0,0,1,0,9,1
kafka-join,kafka-join,,0,0,0,0,2,0,2,1
wetransfer,wetransfer,,0,1,1,1,1,2,4,1
react-native-stylesheet,react-native-stylesheet,,2,1,14,3,5,17,1,1
nsmanagedobjectid,nsmanagedobjectid,,0,1,1,1,1,2,13,1
arcasolutions-edirectory,arcasolutions-edirectory,,0,0,0,0,4,0,4,1
jwasm,jwasm,,0,1,2,1,1,3,1,1
kql,kql,,8,13,4,21,1,25,8,62.5
livevalidation,livevalidation,,0,0,0,0,1,0,1,1
codeigniter-restapi,codeigniter-restapi,,3,0,0,3,4,3,4,1
seal,seal,,2,7,8,9,8,17,9,250
blog-engine,blog-engine,,1,0,0,1,1,1,8,1
libnodave,libnodave,,1,0,0,1,1,1,3,1
android-automotive,android-automotive,,3,4,1,7,1,8,3,33.333333
role-manager,role-manager,,1,1,4,2,1,6,8,1
ansi-nulls,ansi-nulls,,1,0,2,1,1,3,4,1
txmldocument,txmldocument,,1,0,0,1,1,1,9,1
amp-date-picker,amp-date-picker,,1,0,1,1,2,2,1,1
flexcel,flexcel,,0,0,1,0,2,1,8,1
apollo-angular,apollo-angular,,4,10,10,14,2,24,1,150
fable,fable,,0,2,1,2,1,3,8,100
filesystemexception,filesystemexception,,0,1,2,1,1,3,3,1
nexus-player,nexus-player,,0,0,0,0,1,0,1,1
default-scope,default-scope,,0,0,1,0,1,1,12,1
codeigniter-library,codeigniter-library,,0,0,1,0,1,1,4,1
blocklayered,blocklayered,,0,0,1,0,1,1,4,1
setter-injection,setter-injection,,1,0,1,1,1,2,8,1
directory-server,directory-server,,0,0,0,0,1,0,8,1
jdiframework,jdiframework,,1,0,2,1,1,3,3,1
crazyflie,crazyflie,,0,0,0,0,3,0,0,1
mainloop,mainloop,,2,4,7,6,2,13,0,100
product-catalog,product-catalog,,1,2,1,3,1,4,4,100
toolstripcontrolhost,toolstripcontrolhost,,0,0,0,0,1,0,8,1
mlvision,mlvision,,1,1,1,2,1,3,13,1
jest-image-snapshot,jest-image-snapshot,,5,1,0,6,1,6,1,1
conjunctive-normal-form,conjunctive-normal-form,,0,0,2,0,1,2,0,1
redux-first-router,redux-first-router,,0,0,1,0,1,1,1,1
ng-img-crop,ng-img-crop,,0,0,0,0,1,0,1,1
for-range,for-range,,0,0,1,0,1,1,9,1
power-state,power-state,,0,0,2,0,1,2,8,1
relative-time-span,relative-time-span,,1,0,0,1,1,1,1,1
richedit-control,richedit-control,,0,0,0,0,3,0,9,1
concurrency-runtime,concurrency-runtime,,3,1,1,4,1,5,9,1
objectpool,objectpool,,0,1,1,1,1,2,8,1
typescript3.0,typescript3.0,,23,18,82,41,17,123,1,1
georss,georss,,0,0,0,0,1,0,3,1
mainscreen,mainscreen,,0,0,0,0,1,0,8,1
extjs-form,extjs-form,,0,0,0,0,1,0,1,1
context-info,context-info,,1,0,0,1,1,1,4,1
hcluster,hcluster,,0,0,0,0,1,0,0,1
dkan,dkan,,0,0,0,0,3,0,2,1
qgraphicslineitem,qgraphicslineitem,,2,0,0,2,1,2,9,1
cats-effect,cats-effect,,7,9,22,16,5,38,2,28.571429
system.web.ui.webcontrols,system.web.ui.webcontrols,,0,3,0,3,1,3,8,200
antergos,antergos,,0,0,4,0,2,4,9,1
dcat,dcat,,2,0,0,2,3,2,2,1
module-packaging,module-packaging,,1,0,1,1,1,2,0,1
nat-traversal,nat-traversal,,2,0,2,2,1,4,9,1
scraperwiki,scraperwiki,,0,0,1,0,1,1,9,1
es-module,es-module,,5,9,10,14,5,24,1,80
mjs,mjs,,2,3,2,5,1,7,1,50
view-injection,view-injection,,0,0,1,0,1,1,8,1
codeigniter-email,codeigniter-email,,0,0,0,0,3,0,4,1
git-ls-tree,git-ls-tree,,0,1,1,1,1,2,6,1
react-graph-vis,react-graph-vis,,1,0,1,1,2,2,1,1
airpods,airpods,,7,1,5,8,1,13,13,1
graphdracula,graphdracula,,0,1,0,1,1,1,1,1
sitelock,sitelock,,0,0,1,0,1,1,4,1
user-customization,user-customization,,0,0,0,0,1,0,1,1
static-language,static-language,,0,0,0,0,1,0,9,1
pypng,pypng,,1,0,1,1,2,2,0,1
iis-arr,iis-arr,,0,0,0,0,1,0,3,1
bwwalkthrough,bwwalkthrough,,1,0,0,1,1,1,13,1
rope,rope,,0,0,2,0,1,2,8,1
character-reference,character-reference,,0,0,0,0,1,0,0,1
layout-editor,layout-editor,,0,0,0,0,1,0,3,1
chronon,chronon,,0,0,0,0,1,0,3,1
idangero,idangero,,3,2,5,5,2,10,1,1
mashup,mashup,,1,1,3,2,1,5,1,1
groovyc,groovyc,,0,0,1,0,1,1,3,1
haskell-thyme,haskell-thyme,,0,0,0,0,3,0,2,1
writer-monad,writer-monad,,2,1,0,3,1,3,2,1
sonicwall,sonicwall,,3,1,1,4,1,5,6,1
dexoptions,dexoptions,,0,0,0,0,1,0,3,1
method-combination,method-combination,,0,0,0,0,1,0,0,1
jffs2,jffs2,,1,0,0,1,1,1,9,1
tdlib,tdlib,,6,7,4,13,3,17,0,16.666667
devicehive,devicehive,,0,0,0,0,2,0,0,1
coco,coco,,3,4,3,7,2,10,0,33.333333
akka-zeromq,akka-zeromq,,0,0,1,0,1,1,2,1
validator.js,validator.js,,0,0,3,0,1,3,1,1
custom-linq-providers,custom-linq-providers,,1,0,0,1,1,1,8,1
recent-file-list,recent-file-list,,3,0,0,3,1,3,8,1
value-analysis,value-analysis,,0,0,0,0,1,0,9,1
angular-template-variable,angular-template-variable,,3,1,4,4,1,8,1,1
multicol,multicol,,0,0,1,0,1,1,0,1
textout,textout,,0,1,1,1,1,2,9,1
box-view-api,box-view-api,,0,0,0,0,1,0,8,1
datasetextensions,datasetextensions,,0,0,0,0,1,0,8,1
android-kripton,android-kripton,,0,0,1,0,1,1,3,1
pageheap,pageheap,,0,0,0,0,1,0,9,1
wix-iisextension,wix-iisextension,,0,0,0,0,1,0,8,1
boost-mp11,boost-mp11,,0,1,1,1,1,2,9,1
apple-pdfkit,apple-pdfkit,,7,10,6,17,3,23,13,42.857143
polymer-modulizer,polymer-modulizer,,0,0,0,0,2,0,1,1
fiware-cep,fiware-cep,,5,0,0,5,1,5,6,1
kana,kana,,0,0,2,0,1,2,0,1
databound-controls,databound-controls,,0,0,0,0,1,0,8,1
phobos,phobos,,2,0,2,2,1,4,9,1
relativedelta,relativedelta,,3,0,6,3,1,9,0,1
jsonconvert,jsonconvert,,13,12,20,25,5,45,8,1
revenuecat,revenuecat,,1,5,2,6,1,8,13,400
ofx,ofx,,1,1,1,2,1,3,3,1
android-apache-legacy,android-apache-legacy,,0,1,0,1,1,1,3,1
superobject,superobject,,0,0,3,0,1,3,9,1
codeigniter-form-validation,codeigniter-form-validation,,1,0,3,1,4,4,4,1
synchronizedcollection,synchronizedcollection,,0,0,1,0,1,1,3,1
anychart-8.2,anychart-8.2,,3,2,1,5,2,6,1,1
spout,spout,,2,5,5,7,2,12,4,150
chromebug,chromebug,,0,0,0,0,2,0,1,1
remote-process,remote-process,,0,2,2,2,2,4,9,100
measureoverride,measureoverride,,0,0,1,0,1,1,8,1
jshowoff,jshowoff,,0,0,1,0,1,1,1,1
cocoapods-1.2,cocoapods-1.2,,4,1,0,5,1,5,13,1
httpapplication,httpapplication,,0,0,1,0,2,1,8,1
qwebpage,qwebpage,,0,1,1,1,1,2,0,1
binomial-theorem,binomial-theorem,,2,0,1,2,1,3,0,1
betareg,betareg,,5,1,3,6,1,9,0,1
jquery-location-picker,jquery-location-picker,,1,0,0,1,1,1,1,1
freezable,freezable,,0,0,0,0,2,0,8,1
ape,ape,,0,0,3,0,2,3,0,1
powershell-provider,powershell-provider,,0,0,0,0,1,0,8,1
morningstar,morningstar,,2,1,3,3,3,6,0,1
google-cloud-automl-nl,google-cloud-automl-nl,,7,5,11,12,3,23,6,1
eslint-loader,eslint-loader,,1,1,2,2,1,4,1,1
database-fragmentation,database-fragmentation,,0,2,0,2,1,2,4,100
elisp-macro,elisp-macro,,0,0,2,0,1,2,9,1
nvlink,nvlink,,1,1,5,2,1,7,0,1
combres,combres,,0,0,0,0,1,0,8,1
zuul-testing,zuul-testing,,2,3,2,5,2,7,3,50
my-model-jami,my-model-jami,,0,0,1,0,1,1,4,1
nsincrementalstore,nsincrementalstore,,0,0,0,0,1,0,13,1
tlbexp,tlbexp,,0,0,0,0,1,0,8,1
configsection,configsection,,0,1,2,1,1,3,8,1
vaex,vaex,,1,1,0,2,1,2,0,1
pandastream,pandastream,,0,0,0,0,1,0,4,1
nshield,nshield,,1,0,0,1,1,1,6,1
go-cdk,go-cdk,,2,0,2,2,1,4,6,1
customtypedescriptor,customtypedescriptor,,0,0,1,0,1,1,8,1
typedescriptionprovider,typedescriptionprovider,,0,0,0,0,1,0,8,1
diff3,diff3,,1,1,0,2,1,2,6,1
call-queue,call-queue,,2,0,0,2,1,2,3,1
swish,swish,,1,0,1,1,2,2,13,1
svelte-component,svelte-component,,8,10,7,18,2,25,1,25
svelte-2,svelte-2,,0,0,1,0,1,1,1,1
icontact,icontact,,0,0,0,0,1,0,5,1
.ico,.ico,,0,0,2,0,1,2,0,1
doh,doh,,0,0,0,0,1,0,4,1
transitive-const,transitive-const,,0,0,1,0,1,1,9,1
finereader,finereader,,2,3,2,5,1,7,0,50
runit,runit,,1,2,1,3,1,4,9,100
nvblas,nvblas,,0,0,3,0,1,3,9,1
nsdecimal,nsdecimal,,0,0,0,0,1,0,13,1
dynamic-feature,dynamic-feature,,8,12,7,20,1,27,3,50
mdac,mdac,,0,0,2,0,1,2,8,1
createitem,createitem,,0,0,1,0,1,1,5,1
nsclipview,nsclipview,,0,0,0,0,1,0,13,1
iso-image,iso-image,,1,0,1,1,1,2,6,1
shap,shap,,0,8,0,8,1,8,0,700
qstringlist,qstringlist,,1,3,5,4,1,9,9,200
omisego,omisego,,0,0,0,0,1,0,6,1
gulp-install,gulp-install,,0,1,0,1,1,1,1,1
flipper,flipper,,0,1,0,1,1,1,3,1
wildfly-cluster,wildfly-cluster,,1,2,0,3,1,3,3,100
cfilefind,cfilefind,,0,0,0,0,1,0,9,1
symengine,symengine,,2,1,3,3,2,6,0,1
svgutils,svgutils,,0,0,0,0,1,0,0,1
flutter-redux,flutter-redux,,17,6,10,23,4,33,13,1
user-forums,user-forums,,0,0,0,0,1,0,5,1
scribunto,scribunto,,0,0,0,0,1,0,9,1
babel-decorator,babel-decorator,,1,0,0,1,1,1,1,1
xfermode,xfermode,,0,1,1,1,1,2,3,1
false-language,false-language,,0,0,0,0,1,0,0,1
salesforce-marketing-cloud,salesforce-marketing-cloud,,11,11,29,22,2,51,14,1
matlab-load,matlab-load,,0,0,0,0,1,0,0,1
schemabinding,schemabinding,,0,1,1,1,2,2,4,1
floppy,floppy,,0,1,4,1,2,5,9,1
recursive-triggers,recursive-triggers,,0,0,0,0,1,0,4,1
gradle-node-plugin,gradle-node-plugin,,0,0,0,0,2,0,3,1
webfocus,webfocus,,0,0,2,0,2,2,1,1
matio,matio,,1,0,0,1,1,1,0,1
http4k,http4k,,2,1,3,3,1,6,3,1
gvfs,gvfs,,1,2,3,3,1,6,9,100
python-winshell,python-winshell,,0,0,2,0,1,2,0,1
omake,omake,,0,0,1,0,1,1,6,1
cgminer,cgminer,,0,1,0,1,1,1,9,1
arctext.js,arctext.js,,0,0,1,0,1,1,1,1
jenv,jenv,,1,1,2,2,1,4,3,1
knockout-postbox,knockout-postbox,,0,0,0,0,1,0,1,1
directory-upload,directory-upload,,2,0,1,2,1,3,1,1
stackexchange.exceptional,stackexchange.exceptional,,1,0,1,1,1,2,8,1
pyrfc,pyrfc,,4,0,10,4,3,14,5,1
wopi,wopi,,5,3,3,8,2,11,8,1
libredwg,libredwg,,1,0,0,1,1,1,0,1
geom-vline,geom-vline,,2,1,7,3,2,10,0,1
yada,yada,,1,0,0,1,1,1,2,1
daycount,daycount,,0,0,0,0,1,0,8,1
winrun4j,winrun4j,,0,0,0,0,1,0,3,1
httpapi,httpapi,,0,4,5,4,2,9,4,300
circuit-sdk,circuit-sdk,,1,7,3,8,4,11,8,600
vcproj,vcproj,,0,0,1,0,1,1,6,1
android-singleline,android-singleline,,0,0,0,0,1,0,3,1
ymail,ymail,,0,0,0,0,1,0,4,1
fssql,fssql,,0,0,0,0,2,0,8,1
rsolr,rsolr,,0,0,0,0,1,0,12,1
dragonfly-bsd,dragonfly-bsd,,0,0,0,0,1,0,9,1
opendiff,opendiff,,1,0,0,1,1,1,6,1
jpacontainer,jpacontainer,,0,0,0,0,1,0,3,1
windows-machine-learning,windows-machine-learning,,2,1,9,3,2,12,8,1
ncml,ncml,,0,0,0,0,1,0,0,1
jlex,jlex,,0,0,0,0,1,0,9,1
reparenting,reparenting,,0,0,1,0,1,1,1,1
redux-logger,redux-logger,,1,0,2,1,1,3,1,1
spring-integration-ip,spring-integration-ip,,6,1,2,7,1,9,3,1
asch-development,asch-development,,0,0,1,0,7,1,6,1
vue-nativescript,vue-nativescript,,1,2,5,3,1,8,1,100
nuxmv,nuxmv,,1,1,5,2,1,7,0,1
dbext,dbext,,0,0,1,0,1,1,9,1
google-cloud-automl,google-cloud-automl,,25,30,34,55,4,89,6,20
mongoalchemy,mongoalchemy,,3,3,0,6,1,6,0,1
railsinstaller-windows,railsinstaller-windows,,1,0,1,1,1,2,12,1
code-complete,code-complete,,0,0,0,0,1,0,9,1
dhall,dhall,,2,1,1,3,2,4,2,1
alljoyn,alljoyn,,0,1,0,1,1,1,3,1
angular6-json-schema-form,angular6-json-schema-form,,9,3,15,12,1,27,1,1
winwrap,winwrap,,0,3,1,3,1,4,8,200
streaming-flv-video,streaming-flv-video,,1,1,0,2,1,2,13,1
so-linger,so-linger,,1,0,0,1,1,1,9,1
metricsgraphicsjs,metricsgraphicsjs,,0,1,1,1,1,2,1,1
bmesh,bmesh,,0,0,0,0,1,0,0,1
wxlua,wxlua,,0,0,1,0,1,1,9,1
whitespace-language,whitespace-language,,0,0,0,0,1,0,0,1
hot-code-replace,hot-code-replace,,2,0,1,2,2,3,3,1
activitygroup,activitygroup,,0,0,0,0,1,0,3,1
nested-object,nested-object,,10,4,9,14,2,23,1,1
open-packaging-convention,open-packaging-convention,,0,0,0,0,1,0,5,1
jsonx,jsonx,,0,1,1,1,1,2,3,1
disconnected-session,disconnected-session,,0,0,0,0,1,0,8,1
pwa-starter-kit,pwa-starter-kit,,1,2,4,3,1,7,1,100
sequelize-auto,sequelize-auto,,0,3,4,3,1,7,1,200
oci-go-sdk,oci-go-sdk,,0,0,0,0,2,0,4,1
markitup,markitup,,0,0,0,0,1,0,4,1
alertdialogpro,alertdialogpro,,0,0,0,0,1,0,3,1
build2,build2,,0,1,0,1,1,1,9,1
ember.js-component,ember.js-component,,1,0,0,1,1,1,1,1
fhs-twitter-engine,fhs-twitter-engine,,0,0,0,0,1,0,13,1
yq,yq,,2,3,0,5,1,5,3,50
elasticsearch-marvel,elasticsearch-marvel,,0,1,0,1,1,1,6,1
ngx-easy-table,ngx-easy-table,,0,0,2,0,1,2,1,1
dbx,dbx,,0,2,2,2,3,4,9,100
botlibre,botlibre,,0,0,0,0,1,0,0,1
wce,wce,,0,0,0,0,2,0,8,1
ptc-windchill,ptc-windchill,,0,1,4,1,1,5,3,1
node-stitch,node-stitch,,0,0,0,0,1,0,1,1
image-composite-editor,image-composite-editor,,0,0,1,0,1,1,8,1
ndk-gdb,ndk-gdb,,0,1,0,1,1,1,3,1
magic-quotes-gpc,magic-quotes-gpc,,0,0,0,0,1,0,4,1
fts4,fts4,,4,3,2,7,2,9,3,1
chuck,chuck,,0,0,0,0,1,0,3,1
fixedpage,fixedpage,,0,0,0,0,1,0,8,1
marathontesting,marathontesting,,0,0,1,0,3,1,12,1
sidechain-technology,sidechain-technology,,0,0,1,0,1,1,6,1
asch,asch,,0,0,1,0,6,1,6,1
decentralized-applications,decentralized-applications,,8,6,17,14,6,31,6,1
nxt-python,nxt-python,,0,0,0,0,1,0,0,1
asch-cli,asch-cli,,0,0,0,0,1,0,6,1
varint,varint,,0,1,0,1,1,1,0,1
vk-sdk,vk-sdk,,1,0,4,1,2,5,4,1
nsmatrix,nsmatrix,,0,0,0,0,1,0,13,1
windows-controls,windows-controls,,0,0,3,0,1,3,8,1
codeigniter-session,codeigniter-session,,0,0,6,0,4,6,4,1
afabstractrestclient,afabstractrestclient,,0,0,0,0,1,0,4,1
spring-cloud-zookeeper,spring-cloud-zookeeper,,3,2,8,5,2,13,3,1
dapper-rainbow,dapper-rainbow,,0,0,1,0,1,1,8,1
stagevideo,stagevideo,,0,0,0,0,1,0,13,1
ibm-rad-7.5,ibm-rad-7.5,,0,0,0,0,2,0,3,1
intercal,intercal,,0,0,0,0,1,0,9,1
google-cloud-filestore,google-cloud-filestore,,1,6,4,7,4,11,6,500
coldspring,coldspring,,0,0,0,0,2,0,4,1
google-organization-chart,google-organization-chart,,1,3,3,4,1,7,1,200
codeigniter-htaccess,codeigniter-htaccess,,12,4,16,16,6,32,4,1
appcompatdialogfragment,appcompatdialogfragment,,1,1,0,2,1,2,3,1
aws-cdk,aws-cdk,,16,55,12,71,1,83,6,243.75
apama,apama,,3,2,7,5,1,12,6,1
codeigniter-database,codeigniter-database,,0,0,1,0,6,1,4,1
psfrag,psfrag,,0,0,0,0,1,0,0,1
meiomask,meiomask,,0,0,0,0,1,0,1,1
css-doodle,css-doodle,,0,2,1,2,1,3,1,100
sharepoint-rest-api,sharepoint-rest-api,,10,16,35,26,4,61,8,60
netcobol,netcobol,,0,0,2,0,1,2,4,1
dpd,dpd,,1,0,0,1,1,1,4,1
grunt-connect,grunt-connect,,0,0,0,0,1,0,1,1
go-http,go-http,,7,1,6,8,4,14,6,1
simplecursortreeadapter,simplecursortreeadapter,,0,0,0,0,2,0,3,1
breakpoint-sass,breakpoint-sass,,1,0,1,1,1,2,1,1
low-level-code,low-level-code,,0,0,2,0,1,2,9,1
resolutionstrategy,resolutionstrategy,,0,1,1,1,1,2,3,1
cruisecontrol.rb,cruisecontrol.rb,,0,0,0,0,1,0,8,1
gwt-polymer,gwt-polymer,,0,0,0,0,1,0,3,1
structlog,structlog,,1,2,2,3,1,5,0,100
mobivm,mobivm,,1,0,2,1,2,3,3,1
sitecore-rocks,sitecore-rocks,,0,1,0,1,1,1,8,1
power-series,power-series,,0,1,1,1,1,2,0,1
mvcgrid.net,mvcgrid.net,,2,1,2,3,1,5,8,1
coala-bears,coala-bears,,0,0,0,0,1,0,0,1
laravel-5.7,laravel-5.7,,237,108,949,345,2,1294,4,1
openfin,openfin,,1,3,4,4,5,8,3,200
server-mode,server-mode,,0,0,0,0,1,0,4,1
safefilehandle,safefilehandle,,0,1,1,1,1,2,8,1
splist,splist,,1,0,1,1,2,2,8,1
ngnotify,ngnotify,,0,0,1,0,1,1,1,1
magellan,magellan,,1,1,2,2,2,4,1,1
clash,clash,,3,2,4,5,1,9,2,1
apexcharts,apexcharts,,19,32,20,51,3,71,1,68.421053
armflang,armflang,,0,0,0,0,1,0,9,1
xmatters,xmatters,,0,0,0,0,1,0,13,1
nssplitviewcontroller,nssplitviewcontroller,,0,0,7,0,2,7,13,1
paysafe,paysafe,,0,1,2,1,1,3,4,1
datagridviewlinkcolumn,datagridviewlinkcolumn,,0,0,0,0,1,0,8,1
associated-sorting,associated-sorting,,0,0,0,0,1,0,0,1
prolog-tabling,prolog-tabling,,0,0,0,0,1,0,0,1
tawk.to,tawk.to,,3,2,6,5,2,11,1,1
angular-auth-oidc-client,angular-auth-oidc-client,,1,8,1,9,2,10,1,700
scrapoxy,scrapoxy,,1,0,1,1,1,2,0,1
koala-app,koala-app,,0,0,0,0,1,0,1,1
isilon,isilon,,0,2,2,2,3,4,6,100
onefs,onefs,,0,0,0,0,2,0,6,1
lxss,lxss,,0,0,0,0,2,0,9,1
nsspeechrecognizer,nsspeechrecognizer,,1,0,0,1,1,1,13,1
objectivezip,objectivezip,,0,0,0,0,2,0,13,1
grunt-ngdocs,grunt-ngdocs,,0,0,2,0,1,2,1,1
rcaller,rcaller,,0,1,1,1,1,2,0,1
leshan,leshan,,2,0,4,2,1,6,9,1
team-project-collection,team-project-collection,,0,1,1,1,1,2,8,1
swashbuckle.examples,swashbuckle.examples,,1,0,5,1,2,6,8,1
windows-mobile-6,windows-mobile-6,,0,0,1,0,2,1,8,1
bllip-parser,bllip-parser,,0,0,0,0,1,0,13,1
validatelongrange,validatelongrange,,0,0,0,0,1,0,3,1
soaphttpclientprotocol,soaphttpclientprotocol,,1,1,1,2,1,3,3,1
paserver,paserver,,1,1,2,2,1,4,9,1
tbar,tbar,,0,0,0,0,1,0,1,1
appgyver,appgyver,,0,0,0,0,1,0,3,1
webactivator,webactivator,,0,0,0,0,1,0,3,1
turbolinks-ios,turbolinks-ios,,3,0,1,3,1,4,13,1
iis-modules,iis-modules,,1,1,0,2,1,2,8,1
wxstyledtextctrl,wxstyledtextctrl,,2,0,2,2,1,4,0,1
simpleusers,simpleusers,,0,0,0,0,1,0,1,1
selection-color,selection-color,,0,0,0,0,1,0,8,1
tivoli-identity-manager,tivoli-identity-manager,,3,0,3,3,1,6,3,1
nopcommerce-4.1,nopcommerce-4.1,,5,1,10,6,3,16,8,1
column-defaults,column-defaults,,0,0,2,0,1,2,4,1
image-charts,image-charts,,3,1,0,4,1,4,1,1
pushpin,pushpin,,1,0,4,1,2,5,8,1
pnpm,pnpm,,1,2,6,3,1,9,1,100
xml-rpc.net,xml-rpc.net,,0,0,0,0,1,0,8,1
itemcollection,itemcollection,,2,0,0,2,1,2,8,1
acymailing,acymailing,,0,0,0,0,1,0,4,1
least-astonishment,least-astonishment,,0,0,0,0,1,0,0,1
touchescancelled,touchescancelled,,0,0,0,0,1,0,3,1
draw2d,draw2d,,2,3,2,5,1,7,1,50
fedora16,fedora16,,0,0,0,0,1,0,9,1
koa-bodyparser,koa-bodyparser,,0,0,3,0,1,3,1,1
auto-keras,auto-keras,,3,1,18,4,1,22,0,1
webviewdidfinishload,webviewdidfinishload,,0,0,0,0,1,0,13,1
django-smart-selects,django-smart-selects,,0,0,4,0,1,4,0,1
skaffold,skaffold,,8,3,4,11,1,15,6,1
zend-paginator,zend-paginator,,0,1,1,1,1,2,4,1
abstract-function,abstract-function,,0,0,0,0,1,0,3,1
beamng,beamng,,0,0,1,0,1,1,9,1
fsxaml,fsxaml,,2,1,1,3,1,4,8,1
fsharp.viewmodule,fsharp.viewmodule,,0,0,0,0,1,0,8,1
azure-webapps,azure-webapps,,26,28,42,54,2,96,8,7.692308
crm-outlook-client,crm-outlook-client,,0,0,0,0,2,0,5,1
poodle-attack,poodle-attack,,0,0,1,0,1,1,6,1
styleddocument,styleddocument,,1,0,2,1,1,3,3,1
jcaptcha,jcaptcha,,1,0,1,1,1,2,3,1
moarvm,moarvm,,0,0,2,0,1,2,9,1
spark-shell,spark-shell,,14,13,19,27,3,46,2,1
php-vcr,php-vcr,,1,0,1,1,1,2,4,1
service-management,service-management,,0,0,1,0,1,1,13,1
unqualified-name,unqualified-name,,1,1,1,2,1,3,9,1
scalaz-zio,scalaz-zio,,5,13,2,18,1,20,2,160
workflow-engine,workflow-engine,,1,2,2,3,1,5,8,100
netflix-conductor,netflix-conductor,,2,0,4,2,1,6,3,1
wallpapermanager,wallpapermanager,,4,2,8,6,2,14,3,1
oitnb,oitnb,,0,0,0,0,2,0,0,1
pharo-6,pharo-6,,0,0,3,0,2,3,13,1
angularjs-1.2,angularjs-1.2,,1,1,0,2,4,2,1,1
unhookwindowshookex,unhookwindowshookex,,0,0,2,0,1,2,9,1
sads,sads,,0,0,0,0,1,0,0,1
multiple-input,multiple-input,,4,7,7,11,2,18,0,75
docotic.pdf,docotic.pdf,,0,0,0,0,1,0,8,1
gcc-statement-expression,gcc-statement-expression,,0,1,0,1,1,1,9,1
nspoint,nspoint,,0,0,0,0,1,0,13,1
import-hooks,import-hooks,,0,0,0,0,1,0,0,1
sha1sum,sha1sum,,1,0,1,1,2,2,9,1
kermit,kermit,,0,1,1,1,1,2,9,1
xcodekit,xcodekit,,0,0,2,0,1,2,13,1
controller-factory,controller-factory,,1,0,0,1,1,1,8,1
joda-money,joda-money,,0,0,0,0,1,0,3,1
protected-resource,protected-resource,,0,1,0,1,1,1,9,1
xrp,xrp,,1,2,5,3,1,8,3,100
rippled,rippled,,2,0,2,2,1,4,3,1
smbj,smbj,,1,0,10,1,3,11,3,1
stringwriter,stringwriter,,0,0,2,0,1,2,3,1
yelp-fusion-api,yelp-fusion-api,,10,1,3,11,3,14,4,1
mediaplayback,mediaplayback,,0,2,2,2,1,4,3,100
liferay-velocity,liferay-velocity,,1,0,0,1,1,1,3,1
react-dropdown-tree-select,react-dropdown-tree-select,,0,2,0,2,2,2,1,100
rvg,rvg,,0,1,0,1,3,1,0,1
grapecity,grapecity,,3,0,1,3,1,4,4,1
uml-decision-node,uml-decision-node,,0,0,0,0,2,0,3,1
uml-merge-node,uml-merge-node,,0,0,0,0,2,0,3,1
historical-debugging,historical-debugging,,0,0,0,0,1,0,0,1
magento-fpc,magento-fpc,,1,0,1,1,1,2,4,1
couch-cms,couch-cms,,2,3,3,5,1,8,1,50
acceptance,acceptance,,1,2,4,3,2,7,3,100
azure-mysql-database,azure-mysql-database,,6,5,14,11,3,25,8,1
phpstorm-2018.2,phpstorm-2018.2,,0,0,4,0,3,4,4,1
azure-managed-database,azure-managed-database,,2,3,2,5,2,7,8,50
kaios,kaios,,2,3,4,5,2,9,1,50
react-spring,react-spring,,32,24,25,56,5,81,1,1
play-bootstrap,play-bootstrap,,0,0,0,0,1,0,2,1
okd,okd,,17,18,46,35,1,81,6,5.882353
heapq,heapq,,8,3,12,11,3,23,0,1
node-csv-parse,node-csv-parse,,7,2,3,9,2,12,1,1
npm-lazy,npm-lazy,,0,0,0,0,1,0,1,1
cakephp-3.6,cakephp-3.6,,4,3,38,7,3,45,4,1
acucobol-gt,acucobol-gt,,0,0,0,0,1,0,4,1
s-lang,s-lang,,0,0,0,0,1,0,9,1
shellforge,shellforge,,0,0,0,0,1,0,9,1
managed-ews,managed-ews,,0,0,0,0,1,0,8,1
c++builder-tokyo,c++builder-tokyo,,0,1,7,1,1,8,9,1
siena,siena,,0,1,0,1,1,1,6,1
oneupuploaderbundle,oneupuploaderbundle,,0,0,7,0,1,7,4,1
iplanet,iplanet,,1,0,3,1,2,4,4,1
talloc,talloc,,0,0,0,0,1,0,9,1
bioservices,bioservices,,0,0,1,0,1,1,0,1
tinyalsa,tinyalsa,,1,0,2,1,1,3,3,1
nsinvocation,nsinvocation,,0,1,0,1,1,1,13,1
kissfft,kissfft,,0,1,4,1,1,5,0,1
rfc2231,rfc2231,,0,0,0,0,1,0,4,1
serverless-offline,serverless-offline,,6,5,4,11,1,15,6,1
stackless,stackless,,0,0,0,0,1,0,9,1
.netrc,.netrc,,0,1,1,1,1,2,6,1
built-in-web-server,built-in-web-server,,1,0,0,1,1,1,4,1
deployment-project,deployment-project,,2,0,0,2,1,2,8,1
p4-lang,p4-lang,,0,0,0,0,1,0,9,1
azureblockchainservice,azureblockchainservice,,1,9,0,10,1,10,8,800
timed-events,timed-events,,0,0,0,0,1,0,8,1
regfreecom,regfreecom,,1,0,1,1,1,2,8,1
browser-api,browser-api,,1,0,0,1,1,1,1,1
symja,symja,,0,0,0,0,1,0,3,1
svnx,svnx,,0,0,1,0,1,1,13,1
siemens-nx,siemens-nx,,0,1,1,1,1,2,5,1
ncftp,ncftp,,0,1,2,1,1,3,4,1
brooklyn,brooklyn,,0,1,1,1,1,2,4,1
ompr,ompr,,0,0,0,0,1,0,0,1
mathcontext,mathcontext,,0,0,0,0,1,0,3,1
external-application,external-application,,0,2,2,2,2,4,3,100
tinn-r,tinn-r,,0,0,1,0,1,1,0,1
package-structuring,package-structuring,,1,2,1,3,1,4,3,100
tfs-alerts,tfs-alerts,,0,0,1,0,1,1,8,1
xhtml-1.0-strict,xhtml-1.0-strict,,2,0,0,2,1,2,3,1
mysqlsh,mysqlsh,,0,0,2,0,2,2,4,1
qtmacextras,qtmacextras,,0,0,0,0,1,0,13,1
cloud.typography,cloud.typography,,0,1,0,1,1,1,1,1
ucum,ucum,,0,0,1,0,1,1,0,1
android-studio-3.1.4,android-studio-3.1.4,,0,0,14,0,14,14,3,1
strongly-typed-enum,strongly-typed-enum,,0,0,1,0,1,1,9,1
lightyear,lightyear,,0,0,0,0,1,0,2,1
sal,sal,,2,2,4,4,2,8,9,1
connection-close,connection-close,,0,0,1,0,1,1,8,1
uisnapbehavior,uisnapbehavior,,0,0,0,0,1,0,8,1
integer64,integer64,,0,2,0,2,1,2,0,100
ontouchstart,ontouchstart,,2,2,1,4,1,5,1,1
angular-l10n,angular-l10n,,0,1,0,1,1,1,1,1
manipulationdelta,manipulationdelta,,0,0,0,0,1,0,8,1
spinwait,spinwait,,1,0,0,1,1,1,9,1
fetchmail,fetchmail,,0,2,1,2,1,3,4,100
self-documenting-code,self-documenting-code,,1,0,0,1,1,1,9,1
grpc-go,grpc-go,,38,12,0,50,1,50,6,1
struts2-jsr303-plugin,struts2-jsr303-plugin,,0,0,0,0,1,0,3,1
scala-logging,scala-logging,,0,0,1,0,1,1,2,1
s3-rewrite-rules,s3-rewrite-rules,,2,2,1,4,1,5,4,1
known-types,known-types,,1,0,1,1,1,2,8,1
biff,biff,,0,0,0,0,1,0,3,1
theia,theia,,2,0,7,2,1,9,3,1
tiger,tiger,,1,0,0,1,1,1,0,1
nodeunit,nodeunit,,0,1,0,1,1,1,1,1
nginx-ingress,nginx-ingress,,102,91,153,193,16,346,6,1
sql-azure-federations,sql-azure-federations,,1,1,2,2,1,4,8,1
userstyles,userstyles,,0,0,2,0,1,2,1,1
ocrspace-ocr-api,ocrspace-ocr-api,,1,0,2,1,1,3,4,1
sentinel-application-platform,sentinel-application-platform,,1,0,0,1,1,1,0,1
haskell-time,haskell-time,,0,0,2,0,1,2,2,1
sre,sre,,2,3,2,5,3,7,6,50
dgraph-dgo,dgraph-dgo,,0,0,1,0,2,1,2,1
cmsmadesimple,cmsmadesimple,,0,3,0,3,1,3,4,200
yii2-web-service,yii2-web-service,,0,0,1,0,1,1,4,1
mod-authz-host,mod-authz-host,,0,0,0,0,1,0,4,1
match-recognize,match-recognize,,0,1,1,1,1,2,4,1
spring-micrometer,spring-micrometer,,20,26,28,46,4,74,3,30
coreerlang,coreerlang,,0,0,0,0,1,0,2,1
eviews,eviews,,1,5,4,6,1,10,0,400
ember-3,ember-3,,1,4,1,5,9,6,1,300
azure-relay,azure-relay,,0,1,3,1,2,4,8,1
clbeacon,clbeacon,,0,1,2,1,1,3,13,1
ora-00934,ora-00934,,0,0,0,0,1,0,4,1
juliadb,juliadb,,2,1,0,3,2,3,0,1
panfs,panfs,,0,0,0,0,1,0,3,1
continuity,continuity,,0,0,1,0,1,1,13,1
complex-data-types,complex-data-types,,2,5,3,7,1,10,0,150
combinedchart,combinedchart,,2,1,6,3,1,9,3,1
java.util.random,java.util.random,,2,0,2,2,2,4,3,1
generic-repository,generic-repository,,2,4,5,6,1,11,8,100
samsung-health,samsung-health,,2,2,1,4,1,5,3,1
web-container,web-container,,0,0,2,0,1,2,3,1
perl-packager,perl-packager,,1,1,0,2,1,2,9,1
azure-sdk-for-ruby,azure-sdk-for-ruby,,0,0,0,0,3,0,8,1
node-modules-esm,node-modules-esm,,0,0,0,0,1,0,1,1
nifty-gui,nifty-gui,,0,0,0,0,1,0,3,1
fstar-mode,fstar-mode,,0,0,2,0,1,2,9,1
ms-android-emulator,ms-android-emulator,,0,3,1,3,1,4,3,200
selection-object,selection-object,,0,0,2,0,1,2,3,1
leaflet.deflate,leaflet.deflate,,0,0,0,0,1,0,1,1
activetcl,activetcl,,1,0,2,1,1,3,3,1
createuserwizard,createuserwizard,,0,0,0,0,1,0,8,1
control-p5,control-p5,,0,0,1,0,1,1,3,1
pyqtchart,pyqtchart,,0,1,1,1,1,2,0,1
angular2-material,angular2-material,,0,0,3,0,1,3,1,1
spring-cloud-skipper,spring-cloud-skipper,,0,4,5,4,1,9,3,300
2d-context-api,2d-context-api,,0,3,0,3,1,3,1,200
variablesizedwrapgrid,variablesizedwrapgrid,,0,0,0,0,1,0,8,1
anytime,anytime,,0,2,0,2,1,2,0,100
formatmessage,formatmessage,,1,0,0,1,1,1,1,1
webforms-routing,webforms-routing,,0,1,0,1,1,1,8,1
parameter-sniffing,parameter-sniffing,,1,0,1,1,1,2,4,1
c64,c64,,3,1,1,4,3,5,9,1
xsitype,xsitype,,0,0,1,0,1,1,3,1
xdvi,xdvi,,0,0,0,0,1,0,0,1
android-jetifier,android-jetifier,,5,10,20,15,1,35,3,100
apple-ii,apple-ii,,0,0,0,0,1,0,5,1
stasm,stasm,,0,0,0,0,1,0,0,1
clicking,clicking,,3,0,1,3,2,4,3,1
ucs,ucs,,0,0,1,0,1,1,0,1
activedirectorymembership,activedirectorymembership,,1,1,4,2,1,6,8,1
responsive-slides,responsive-slides,,3,1,0,4,1,4,1,1
portal-system,portal-system,,0,0,0,0,1,0,1,1
svg-font,svg-font,,0,1,0,1,1,1,1,1
subcontroller,subcontroller,,0,0,1,0,1,1,4,1
auv3,auv3,,1,2,1,3,1,4,13,100
nstrackingarea,nstrackingarea,,0,0,2,0,1,2,13,1
mat-stepper,mat-stepper,,3,6,7,9,2,16,1,100
spring-cloud-gcp,spring-cloud-gcp,,9,6,10,15,1,25,3,1
javali,javali,,0,0,0,0,1,0,9,1
adobe-media-server,adobe-media-server,,0,0,0,0,1,0,6,1
git-dangling,git-dangling,,0,0,0,0,1,0,6,1
tabbed-interface,tabbed-interface,,1,0,0,1,1,1,8,1
gradle-daemon,gradle-daemon,,2,1,1,3,1,4,3,1
irule,irule,,0,2,2,2,1,4,6,100
django-1.4,django-1.4,,0,1,2,1,2,3,0,1
starcluster,starcluster,,0,0,1,0,1,1,6,1
grimport,grimport,,0,0,3,0,1,3,0,1
geonear,geonear,,1,3,6,4,3,10,1,200
phony-target,phony-target,,0,0,0,0,1,0,9,1
disable-app,disable-app,,0,0,0,0,1,0,3,1
json-schema-defaults,json-schema-defaults,,0,0,1,0,1,1,1,1
pylama,pylama,,1,0,0,1,1,1,0,1
kconfig,kconfig,,1,1,4,2,1,6,9,1
smjobbless,smjobbless,,0,1,0,1,1,1,13,1
project-open,project-open,,0,0,0,0,1,0,0,1
f#-fake-5,f#-fake-5,,0,0,1,0,1,1,8,1
libselinux,libselinux,,0,0,2,0,1,2,9,1
launch-daemon,launch-daemon,,2,1,3,3,1,6,13,1
wechat-auth,wechat-auth,,2,2,1,4,1,5,1,1
compact-database,compact-database,,0,1,0,1,1,1,3,1
snmptrapd,snmptrapd,,0,1,2,1,2,3,9,1
python-logging,python-logging,,40,27,19,67,1,86,0,1
tablednd,tablednd,,0,0,2,0,1,2,1,1
mql,mql,,10,2,10,12,1,22,7,1
drupal-feeds,drupal-feeds,,0,0,0,0,1,0,4,1
outlining,outlining,,0,0,2,0,1,2,4,1
flash-cs5.5,flash-cs5.5,,0,0,0,0,1,0,13,1
google-apps-script-menu,google-apps-script-menu,,0,1,1,1,1,2,5,1
opalvoip,opalvoip,,0,0,1,0,1,1,13,1
igrid,igrid,,0,0,0,0,1,0,8,1
help-viewer,help-viewer,,0,0,0,0,1,0,9,1
qdoublespinbox,qdoublespinbox,,4,3,3,7,1,10,0,1
django-authopenid,django-authopenid,,0,0,0,0,1,0,0,1
crfsuite,crfsuite,,1,2,3,3,1,6,0,100
python-crfsuite,python-crfsuite,,1,2,3,3,1,6,0,100
p7b,p7b,,1,2,2,3,1,5,6,100
greta,greta,,1,1,1,2,1,3,0,1
windows-server-2003-r2,windows-server-2003-r2,,1,0,1,1,1,2,6,1
provider-hosted,provider-hosted,,1,5,3,6,2,9,8,400
justonedb,justonedb,,0,0,0,0,1,0,1,1
yarv,yarv,,0,0,0,0,1,0,12,1
typemoq,typemoq,,2,1,1,3,1,4,1,1
cloud-connect,cloud-connect,,0,0,2,0,3,2,2,1
nservicebus7,nservicebus7,,0,0,2,0,1,2,8,1
documentfragment,documentfragment,,4,1,3,5,1,8,1,1
funcy,funcy,,1,0,0,1,1,1,0,1
nodejs-8.11,nodejs-8.11,,0,2,1,2,2,3,12,100
gcp-ai-platform-notebook,gcp-ai-platform-notebook,,2,15,2,17,1,19,0,650
resharper-2018,resharper-2018,,1,0,6,1,1,7,8,1
pvcs,pvcs,,2,0,1,2,2,3,6,1
flowgear,flowgear,,0,0,0,0,1,0,4,1
rmic,rmic,,0,0,0,0,1,0,3,1
nscondition,nscondition,,0,0,0,0,1,0,13,1
epipe,epipe,,2,2,1,4,1,5,1,1
crystal-reports-formulas,crystal-reports-formulas,,1,0,1,1,3,2,8,1
pick,pick,,0,1,2,1,1,3,4,1
authenticity,authenticity,,1,0,1,1,1,2,4,1
yaf,yaf,,1,0,0,1,1,1,1,1
kendo-ui-splitter,kendo-ui-splitter,,0,0,0,0,1,0,1,1
gobot.io,gobot.io,,1,1,3,2,2,5,6,1
google-postmaster,google-postmaster,,0,0,1,0,1,1,4,1
upx,upx,,0,1,3,1,1,4,0,1
javafx-11,javafx-11,,33,16,92,49,5,141,3,1
poly,poly,,3,1,5,4,2,9,0,1
google-cloud-language,google-cloud-language,,1,1,5,2,1,7,6,1
kongregate,kongregate,,0,1,1,1,1,2,1,1
statistical-mode,statistical-mode,,1,0,1,1,1,2,0,1
pdftextstream,pdftextstream,,1,1,0,2,1,2,0,1
rhea,rhea,,2,0,0,2,1,2,3,1
urlvariables,urlvariables,,0,0,0,0,1,0,4,1
oraclecommand,oraclecommand,,1,0,1,1,1,2,8,1
smartos,smartos,,0,0,0,0,1,0,9,1
activitytransitionapi,activitytransitionapi,,0,0,2,0,1,2,3,1
android-c2dm,android-c2dm,,0,0,0,0,1,0,13,1
kattis,kattis,,3,2,3,5,2,8,0,1
b2g,b2g,,0,0,0,0,1,0,1,1
gegl,gegl,,0,1,0,1,1,1,0,1
zend-db-select,zend-db-select,,0,0,1,0,1,1,4,1
whpx,whpx,,2,0,3,2,1,5,3,1
android-device-manager,android-device-manager,,2,1,2,3,1,5,3,1
apollo-link-rest,apollo-link-rest,,3,2,4,5,1,9,1,1
microsoft-documentation,microsoft-documentation,,1,1,1,2,1,3,8,1
altium-designer,altium-designer,,0,1,2,1,1,3,9,1
hardware-id,hardware-id,,1,0,2,1,1,3,9,1
cloudkit-js,cloudkit-js,,2,0,1,2,2,3,13,1
jbase,jbase,,0,2,3,2,1,5,4,100
immutability-helper,immutability-helper,,2,1,7,3,2,10,1,1
nhibernate-search,nhibernate-search,,0,1,0,1,1,1,6,1
httpcfg.exe,httpcfg.exe,,0,0,0,0,1,0,3,1
nuke-build,nuke-build,,0,0,0,0,1,0,8,1
ipmiutil,ipmiutil,,1,0,0,1,1,1,9,1
hard-delete,hard-delete,,1,0,0,1,1,1,12,1
settimeinterval,settimeinterval,,2,2,2,4,1,6,1,1
aws-sdk-android,aws-sdk-android,,1,1,2,2,2,4,6,1
microsoft.extensions.hosting,microsoft.extensions.hosting,,0,0,3,0,1,3,8,1
ncron,ncron,,0,0,0,0,1,0,8,1
memory-reallocation,memory-reallocation,,4,1,4,5,1,9,9,1
gwt-2.5,gwt-2.5,,0,0,0,0,1,0,3,1
fanotify,fanotify,,0,0,0,0,1,0,9,1
lazy-io,lazy-io,,0,0,0,0,1,0,2,1
aws-aurora-serverless,aws-aurora-serverless,,2,7,6,9,1,15,6,250
postgresql-triggers,postgresql-triggers,,1,1,4,2,1,6,4,1
snaplogic-script-snap,snaplogic-script-snap,,1,0,2,1,2,3,3,1
truesdk,truesdk,,0,0,0,0,2,0,3,1
firebase-in-app-messaging,firebase-in-app-messaging,,12,18,29,30,7,59,13,50
dblatex,dblatex,,0,0,0,0,1,0,3,1
css-validator,css-validator,,0,1,1,1,1,2,1,1
izimodal,izimodal,,3,2,1,5,1,6,1,1
ember-intl,ember-intl,,1,1,1,2,1,3,1,1
extrafont,extrafont,,2,2,2,4,1,6,0,1
catch2,catch2,,10,7,12,17,1,29,9,1
lindo,lindo,,1,0,2,1,1,3,0,1
nectarjs,nectarjs,,1,0,0,1,1,1,9,1
datasourceview,datasourceview,,0,0,1,0,1,1,4,1
windowsondevices,windowsondevices,,0,0,0,0,1,0,8,1
meizu,meizu,,2,1,1,3,1,4,3,1
topography,topography,,1,0,5,1,1,6,0,1
mvccontrib,mvccontrib,,0,0,0,0,1,0,8,1
postgres-bdr,postgres-bdr,,2,0,2,2,1,4,4,1
pyo,pyo,,1,0,1,1,3,2,0,1
operation-contract,operation-contract,,0,0,0,0,1,0,8,1
fxyz3d,fxyz3d,,0,0,1,0,2,1,3,1
wicket-8,wicket-8,,1,0,2,1,2,3,3,1
iced-coffeescript,iced-coffeescript,,0,1,0,1,1,1,1,1
genericdao,genericdao,,1,0,0,1,1,1,3,1
setclasslong,setclasslong,,0,0,0,0,1,0,13,1
angularjs-lifecycle,angularjs-lifecycle,,0,0,0,0,1,0,1,1
filesysteminfo,filesysteminfo,,0,0,0,0,1,0,8,1
rowset,rowset,,2,1,2,3,2,5,3,1
usb-descriptor,usb-descriptor,,0,0,4,0,1,4,3,1
xgbclassifier,xgbclassifier,,0,5,6,5,1,11,0,400
ember-concurrency,ember-concurrency,,1,1,2,2,1,4,1,1
smartsheet-api-1.1,smartsheet-api-1.1,,0,1,1,1,1,2,8,1
ngsticky,ngsticky,,0,0,0,0,1,0,1,1
strlcpy,strlcpy,,0,0,2,0,1,2,9,1
apollo-link,apollo-link,,2,3,9,5,1,14,1,50
connected-react-router,connected-react-router,,14,11,21,25,3,46,1,1
activitypub,activitypub,,2,0,2,2,1,4,3,1
rendertron,rendertron,,1,2,4,3,1,7,1,100
double-splat,double-splat,,0,0,0,0,1,0,12,1
mui-datatable,mui-datatable,,11,9,1,20,1,21,1,1
dlm,dlm,,1,0,1,1,2,2,0,1
missing-symbols,missing-symbols,,1,1,0,2,1,2,13,1
jackson-module-scala,jackson-module-scala,,0,0,1,0,1,1,2,1
website-metrics,website-metrics,,0,0,0,0,1,0,5,1
circular-content-carousel,circular-content-carousel,,0,0,0,0,1,0,1,1
typebuilder,typebuilder,,2,2,2,4,1,6,8,1
leanplum,leanplum,,0,0,2,0,1,2,13,1
xhr-mock,xhr-mock,,0,0,1,0,1,1,3,1
fulcro,fulcro,,0,0,0,0,1,0,2,1
reakit,reakit,,1,1,0,2,1,2,1,1
k,k,,2,0,0,2,1,2,0,1
euler-math-toolbox,euler-math-toolbox,,0,0,1,0,1,1,0,1
68hc08,68hc08,,0,0,0,0,1,0,9,1
68hc,68hc,,0,0,0,0,1,0,9,1
sygic-mobile-sdk,sygic-mobile-sdk,,0,0,10,0,1,10,13,1
supertab,supertab,,0,2,1,2,1,3,1,100
stryker,stryker,,0,0,2,0,1,2,1,1
policykit,policykit,,1,0,1,1,1,2,9,1
snapshot-view,snapshot-view,,0,0,0,0,1,0,13,1
django-recaptcha,django-recaptcha,,0,0,2,0,1,2,0,1
react-native-button,react-native-button,,1,1,2,2,1,4,1,1
drobo,drobo,,0,0,0,0,1,0,4,1
nested-set-model,nested-set-model,,2,4,0,6,1,6,4,100
uomo,uomo,,0,0,0,0,1,0,9,1
xlw,xlw,,0,0,0,0,1,0,0,1
durability,durability,,0,0,3,0,1,3,3,1
php-mode,php-mode,,0,0,0,0,1,0,9,1
emacs26,emacs26,,0,0,2,0,3,2,9,1
rxjs-marbles,rxjs-marbles,,1,5,7,6,1,13,1,400
platform-specific,platform-specific,,1,0,3,1,1,4,1,1
delta-lake,delta-lake,,9,19,7,28,1,35,2,111.111111
chilkat-xml,chilkat-xml,,0,0,1,0,1,1,4,1
xml-document-transform,xml-document-transform,,0,0,2,0,1,2,8,1
nexus2,nexus2,,0,0,4,0,2,4,3,1
opengl-shader-builder,opengl-shader-builder,,0,0,1,0,1,1,3,1
frequency-domain,frequency-domain,,1,1,1,2,1,3,0,1
photo-management,photo-management,,0,0,0,0,1,0,4,1
proxygen,proxygen,,0,0,0,0,1,0,9,1
jdmk,jdmk,,0,0,0,0,1,0,3,1
opendmk,opendmk,,0,0,0,0,1,0,3,1
hdrimages,hdrimages,,1,1,0,2,1,2,0,1
proxy-object,proxy-object,,2,0,0,2,1,2,0,1
block-programming,block-programming,,0,0,1,0,1,1,13,1
deno,deno,,3,4,4,7,1,11,1,33.333333
azure-pipelines-task-lib,azure-pipelines-task-lib,,0,0,0,0,1,0,8,1
bullet-chart,bullet-chart,,2,0,1,2,3,3,1,1
reactor-rabbitmq,reactor-rabbitmq,,0,0,4,0,1,4,3,1
soaplite,soaplite,,0,1,4,1,1,5,3,1
aws-appsync-ios,aws-appsync-ios,,5,1,8,6,1,14,6,1
jtextcomponent,jtextcomponent,,1,1,1,2,1,3,3,1
kyotocabinet,kyotocabinet,,0,0,5,0,1,5,0,1
qvideofilterrunnable,qvideofilterrunnable,,0,0,1,0,1,1,9,1
typed-lambda-calculus,typed-lambda-calculus,,0,1,2,1,1,3,2,1
mkclusterannotation,mkclusterannotation,,1,1,1,2,1,3,13,1
azure-blockchain-workbench,azure-blockchain-workbench,,3,4,15,7,1,22,8,33.333333
araxis-merge,araxis-merge,,1,0,0,1,1,1,13,1
chrome-sync,chrome-sync,,0,2,0,2,1,2,1,100
phpcrawl,phpcrawl,,0,1,0,1,1,1,0,1
generic-relationship,generic-relationship,,0,0,0,0,1,0,0,1
mageia,mageia,,1,1,0,2,1,2,4,1
mutablelist,mutablelist,,3,3,9,6,2,15,3,1
transmogrifai,transmogrifai,,1,1,0,2,3,2,3,1
return-path,return-path,,0,2,2,2,1,4,4,100
modgrammar,modgrammar,,0,0,0,0,1,0,0,1
azure-service-fabric-mesh,azure-service-fabric-mesh,,3,3,6,6,1,12,8,1
kubeless,kubeless,,0,3,1,3,3,4,6,200
asdl,asdl,,0,0,0,0,1,0,0,1
createwindowex,createwindowex,,0,1,0,1,1,1,9,1
liquid.net,liquid.net,,1,0,1,1,1,2,1,1
alternation,alternation,,2,0,1,2,1,3,0,1
mr.gestures,mr.gestures,,0,0,1,0,1,1,8,1
urlauthenticationchallenges,urlauthenticationchallenges,,0,0,2,0,1,2,13,1
hostheaders,hostheaders,,2,2,6,4,2,10,6,1
jepp,jepp,,1,0,1,1,1,2,0,1
plottable,plottable,,0,0,0,0,2,0,1,1
ecstatic,ecstatic,,0,0,0,0,1,0,4,1
shared-cache,shared-cache,,0,0,1,0,1,1,3,1
nls-sort,nls-sort,,0,0,1,0,1,1,4,1
nls-comp,nls-comp,,0,0,0,0,1,0,4,1
zend-cache,zend-cache,,1,1,0,2,1,2,4,1
installshield-express,installshield-express,,1,0,0,1,1,1,8,1
laravel-nova,laravel-nova,,82,65,189,147,14,336,4,1
sardine,sardine,,0,1,1,1,1,2,4,1
matlab-hg2,matlab-hg2,,0,0,0,0,1,0,0,1
findfirst,findfirst,,3,0,5,3,1,8,5,1
android-motionlayout,android-motionlayout,,36,35,32,71,1,103,3,1
imposition,imposition,,0,1,0,1,1,1,8,1
akita,akita,,2,4,2,6,3,8,1,100
perspectives,perspectives,,0,0,0,0,1,0,4,1
uninstallstring,uninstallstring,,0,0,2,0,1,2,9,1
tcheckbox,tcheckbox,,0,0,0,0,1,0,9,1
ansicon,ansicon,,0,0,0,0,1,0,9,1
objective-git,objective-git,,0,0,0,0,1,0,6,1
jquery-select2-3,jquery-select2-3,,1,0,0,1,1,1,1,1
webpack-bundle,webpack-bundle,,0,0,3,0,1,3,1,1
r2d3,r2d3,,6,3,2,9,1,11,0,1
wysiwym,wysiwym,,0,0,1,0,1,1,1,1
interlacing,interlacing,,0,0,0,0,1,0,13,1
docker-quickstart-terminal,docker-quickstart-terminal,,0,1,1,1,1,2,6,1
perl-pod,perl-pod,,0,0,0,0,1,0,9,1
nuxt-edge,nuxt-edge,,0,0,7,0,1,7,1,1
rpsystembroadcastpickerview,rpsystembroadcastpickerview,,1,0,3,1,1,4,13,1
apache-camel-aws-kinesis,apache-camel-aws-kinesis,,3,0,1,3,1,4,6,1
pylearn,pylearn,,0,0,0,0,1,0,0,1
google-cloud-powershell,google-cloud-powershell,,0,0,0,0,1,0,6,1
graphwalker,graphwalker,,1,0,0,1,1,1,3,1
doctrine-dbal,doctrine-dbal,,1,0,1,1,2,2,4,1
getmodulefilename,getmodulefilename,,0,0,0,0,1,0,9,1
collection-json,collection-json,,1,0,0,1,1,1,3,1
proxy.pac,proxy.pac,,1,0,1,1,1,2,6,1
faunadb,faunadb,,3,4,0,7,1,7,4,33.333333
tinyweb,tinyweb,,0,0,1,0,1,1,4,1
fibplus,fibplus,,1,0,1,1,2,2,9,1
exide,exide,,0,0,0,0,1,0,3,1
angular-dependency-injection,angular-dependency-injection,,2,9,14,11,1,25,1,350
bio7,bio7,,0,0,0,0,1,0,6,1
oracle-commerce-cloud,oracle-commerce-cloud,,1,0,6,1,1,7,1,1
vizard,vizard,,0,0,1,0,1,1,0,1
easyxdm,easyxdm,,0,0,1,0,1,1,1,1
compressed-files,compressed-files,,2,0,1,2,2,3,0,1
colt,colt,,0,0,1,0,1,1,3,1
cudamat,cudamat,,1,0,1,1,1,2,0,1
ext-direct,ext-direct,,0,0,1,0,1,1,1,1
docker-flow-proxy,docker-flow-proxy,,0,0,1,0,1,1,6,1
skype4py,skype4py,,1,0,2,1,1,3,8,1
comscore,comscore,,0,0,1,0,1,1,5,1
rngcryptoserviceprovider,rngcryptoserviceprovider,,0,0,1,0,2,1,8,1
tttattritubedlabel,tttattritubedlabel,,0,0,0,0,1,0,13,1
nanoscroller,nanoscroller,,0,0,0,0,1,0,1,1
mapsvg,mapsvg,,1,1,0,2,1,2,1,1
dolby,dolby,,0,0,0,0,1,0,13,1
unbound,unbound,,0,3,11,3,2,14,4,200
pca3d,pca3d,,0,0,1,0,1,1,0,1
nshomedirectory,nshomedirectory,,0,0,0,0,1,0,13,1
mobfox,mobfox,,0,0,0,0,1,0,13,1
c5.0,c5.0,,5,1,4,6,1,10,0,1
maintenance-mode,maintenance-mode,,0,3,2,3,1,5,4,200
coq-plugin,coq-plugin,,2,0,4,2,1,6,2,1
cakephp-2.4,cakephp-2.4,,0,2,1,2,1,3,4,100
ui-spy,ui-spy,,1,0,4,1,1,5,3,1
html5-animation,html5-animation,,0,0,1,0,1,1,1,1
ccnet-config,ccnet-config,,0,0,0,0,1,0,6,1
active-pattern,active-pattern,,0,0,0,0,1,0,8,1
correspondence,correspondence,,0,1,5,1,1,6,0,1
netrexx,netrexx,,0,0,0,0,1,0,9,1
underscores,underscores,,2,2,0,4,1,4,0,1
conversational-ui,conversational-ui,,4,0,1,4,1,5,1,1
close-button,close-button,,0,0,2,0,1,2,8,1
flex-builder-3,flex-builder-3,,0,0,0,0,1,0,13,1
instagram-graph-api,instagram-graph-api,,48,30,64,78,1,142,13,1
cvsnt,cvsnt,,0,0,1,0,1,1,6,1
form-designer,form-designer,,0,0,2,0,2,2,8,1
reflection-vba,reflection-vba,,0,0,0,0,1,0,5,1
textboxio,textboxio,,0,0,0,0,1,0,1,1
final-class,final-class,,0,0,1,0,1,1,3,1
fail-fast-fail-early,fail-fast-fail-early,,0,1,0,1,1,1,9,1
android-spannable,android-spannable,,2,0,0,2,1,2,3,1
unobtrusive,unobtrusive,,0,0,0,0,2,0,8,1
jayway,jayway,,4,2,4,6,1,10,1,1
preference-v7,preference-v7,,0,0,0,0,2,0,3,1
richtextctrl,richtextctrl,,0,0,2,0,1,2,0,1
virus-definitions,virus-definitions,,0,0,1,0,1,1,8,1
semicolon-inference,semicolon-inference,,1,1,0,2,1,2,0,1
radwindow,radwindow,,3,1,2,4,1,6,8,1
dragdealer-js,dragdealer-js,,1,0,0,1,1,1,1,1
kawa,kawa,,0,0,1,0,1,1,0,1
amethyst,amethyst,,1,2,0,3,1,3,9,100
cocos2d-x-3.17,cocos2d-x-3.17,,0,1,2,1,1,3,9,1
tmxtiledmap,tmxtiledmap,,2,0,6,2,1,8,3,1
android-app-licensing,android-app-licensing,,1,0,1,1,1,2,3,1
msitransform,msitransform,,1,0,0,1,1,1,8,1
satchmo,satchmo,,0,0,0,0,1,0,0,1
wurfl,wurfl,,0,0,0,0,1,0,8,1
brackets-shell,brackets-shell,,0,0,0,0,1,0,1,1
mesibo,mesibo,,4,3,2,7,1,9,3,1
riak-kv,riak-kv,,0,0,1,0,1,1,2,1
sbt-scalaxb,sbt-scalaxb,,1,1,1,2,1,3,2,1
teavm,teavm,,2,0,1,2,1,3,3,1
universal-crt,universal-crt,,0,1,1,1,1,2,9,1
go-modules,go-modules,,37,44,38,81,4,119,6,18.918919
constraint-validation,constraint-validation,,2,2,2,4,1,6,3,1
fusetools,fusetools,,1,0,1,1,1,2,3,1
r8,r8,,23,17,11,40,2,51,3,1
rtcpeerconnection,rtcpeerconnection,,8,14,11,22,3,33,1,75
qgyroscopereading,qgyroscopereading,,0,1,1,1,1,2,9,1
animated-webp,animated-webp,,0,1,1,1,1,2,3,1
google-glass-camera,google-glass-camera,,0,0,2,0,2,2,3,1
laravel-environment,laravel-environment,,1,1,0,2,1,2,4,1
laravel-encryption,laravel-encryption,,2,1,1,3,1,4,4,1
opencensus,opencensus,,10,7,6,17,1,23,6,1
firefox-reader-view,firefox-reader-view,,0,0,0,0,1,0,1,1
qnames,qnames,,1,2,0,3,1,3,3,100
file-header,file-header,,1,1,1,2,1,3,9,1
knative-serving,knative-serving,,11,5,2,16,2,18,6,1
neshan,neshan,,0,0,1,0,1,1,3,1
neshan-android-sdk,neshan-android-sdk,,0,0,1,0,1,1,3,1
git-rev-parse,git-rev-parse,,0,0,2,0,1,2,6,1
app42,app42,,1,0,0,1,2,1,1,1
jsr380,jsr380,,0,1,4,1,1,5,3,1
daap,daap,,0,0,1,0,1,1,6,1
correlated,correlated,,1,2,2,3,1,5,0,100
socketfactory,socketfactory,,1,0,0,1,1,1,3,1
entity-linking,entity-linking,,1,0,0,1,1,1,0,1
elasticsearch-geo-shape,elasticsearch-geo-shape,,3,3,7,6,1,13,6,1
bytestowrite,bytestowrite,,0,0,0,0,1,0,8,1
numbered,numbered,,0,1,0,1,1,1,5,1
plugin.media.crossmedia,plugin.media.crossmedia,,1,2,4,3,1,7,8,100
form-generator,form-generator,,0,0,0,0,1,0,1,1
vex,vex,,0,1,0,1,1,1,0,1
googledns,googledns,,3,0,1,3,1,4,6,1
adminfaces,adminfaces,,0,1,1,1,1,2,3,1
jquery-ui-layout,jquery-ui-layout,,0,1,0,1,1,1,1,1
amio,amio,,0,0,2,0,1,2,13,1
asp.net-optimization,asp.net-optimization,,0,0,0,0,1,0,8,1
spring-swift,spring-swift,,0,0,0,0,1,0,13,1
javax.script,javax.script,,0,0,1,0,1,1,3,1
spring-mobile,spring-mobile,,2,1,0,3,1,3,3,1
real-datatype,real-datatype,,0,0,0,0,1,0,4,1
sysoperationframework,sysoperationframework,,0,0,0,0,1,0,8,1
phpxlsxwriter,phpxlsxwriter,,2,0,1,2,1,3,4,1
angular-akita,angular-akita,,3,9,4,12,2,16,1,200
blitz++,blitz++,,0,0,0,0,1,0,9,1
moqcontrib,moqcontrib,,0,0,0,0,1,0,1,1
updateexception,updateexception,,0,0,1,0,1,1,8,1
recent-documents,recent-documents,,0,0,1,0,1,1,5,1
mailcatcher,mailcatcher,,2,0,2,2,1,4,12,1
drmaa,drmaa,,0,0,0,0,1,0,9,1
viewresult,viewresult,,0,0,0,0,1,0,8,1
sundials,sundials,,0,2,5,2,1,7,0,100
yellow,yellow,,2,0,1,2,1,3,1,1
sidekiq-superworker,sidekiq-superworker,,0,0,0,0,1,0,12,1
ts-check,ts-check,,0,0,0,0,2,0,1,1
nlog.config,nlog.config,,0,1,2,1,1,3,8,1
smart-playlist,smart-playlist,,0,0,0,0,1,0,13,1
facebook-graph-api-v2.7,facebook-graph-api-v2.7,,0,0,0,0,1,0,13,1
ora-01036,ora-01036,,0,0,0,0,1,0,8,1
cmd2,cmd2,,0,2,3,2,1,5,0,100
spry,spry,,0,1,0,1,1,1,1,1
dropdownbutton,dropdownbutton,,7,4,17,11,1,28,13,1
jsonapi-rails,jsonapi-rails,,0,1,2,1,1,3,12,1
facebook-sdk-3.1,facebook-sdk-3.1,,1,0,5,1,1,6,13,1
memory-pressure,memory-pressure,,0,0,0,0,1,0,9,1
hardware-infrastructure,hardware-infrastructure,,0,0,0,0,1,0,6,1
lli,lli,,1,0,4,1,1,5,9,1
angular-moviemasher,angular-moviemasher,,0,0,3,0,1,3,1,1
moviemasher,moviemasher,,0,0,3,0,1,3,1,1
zend-log,zend-log,,1,0,2,1,1,3,4,1
tsr,tsr,,0,1,0,1,1,1,9,1
impromptu-interface,impromptu-interface,,1,0,0,1,1,1,8,1
igor,igor,,0,1,0,1,1,1,0,1
meta-query,meta-query,,14,9,21,23,3,44,4,1
luaxml,luaxml,,0,0,1,0,1,1,9,1
python-zappa,python-zappa,,3,0,12,3,1,15,6,1
monkey-testing,monkey-testing,,1,0,2,1,1,3,13,1
pyper,pyper,,2,0,2,2,1,4,0,1
google-surveys,google-surveys,,1,2,4,3,1,7,1,100
raddocking,raddocking,,0,1,1,1,1,2,8,1
cakephp-bootstrap-ui,cakephp-bootstrap-ui,,0,0,0,0,1,0,4,1
ripping,ripping,,0,0,0,0,1,0,9,1
php-amqp,php-amqp,,0,0,2,0,1,2,4,1
delegated-properties,delegated-properties,,0,0,3,0,1,3,3,1
nspreferencepane,nspreferencepane,,0,0,3,0,1,3,13,1
tmsh,tmsh,,0,0,2,0,2,2,6,1
link-header,link-header,,0,0,0,0,1,0,5,1
dirset,dirset,,0,0,1,0,1,1,3,1
zkemkeeper,zkemkeeper,,5,4,6,9,1,15,8,1
usb-camera,usb-camera,,3,5,7,8,1,15,3,66.666667
timestep,timestep,,3,4,5,7,1,12,0,33.333333
parliament,parliament,,0,0,0,0,1,0,2,1
development-mode,development-mode,,0,0,0,0,1,0,4,1
bigstatsr,bigstatsr,,0,2,4,2,1,6,0,100
scratchbox,scratchbox,,0,1,0,1,2,1,9,1
kepserverex,kepserverex,,0,2,4,2,1,6,8,100
oracle-webdb,oracle-webdb,,0,0,0,0,1,0,4,1
switch-path,switch-path,,0,0,0,0,1,0,4,1
iterator-protocol,iterator-protocol,,0,0,0,0,1,0,13,1
xcode10beta6,xcode10beta6,,0,0,5,0,3,5,13,1
geocaching,geocaching,,0,0,1,0,1,1,3,1
zkteco,zkteco,,8,14,16,22,1,38,8,75
scala-2.13,scala-2.13,,1,12,0,13,1,13,2,1100
google-perftools,google-perftools,,0,0,1,0,1,1,9,1
mappers,mappers,,0,0,0,0,1,0,2,1
arworldmap,arworldmap,,2,0,5,2,1,7,13,1
amazon-clouddrive,amazon-clouddrive,,0,0,0,0,1,0,13,1
go-present,go-present,,1,0,0,1,1,1,6,1
oracle8,oracle8,,0,1,1,1,1,2,4,1
ionic-appflow,ionic-appflow,,8,1,0,9,1,9,1,1
mimer-sql,mimer-sql,,0,0,4,0,1,4,4,1
ora-00054,ora-00054,,0,0,0,0,1,0,8,1
imake,imake,,0,0,0,0,1,0,9,1
spreedly,spreedly,,0,0,2,0,1,2,4,1
mahotas,mahotas,,1,0,2,1,1,3,0,1
napajs,napajs,,0,0,2,0,1,2,1,1
stx,stx,,0,0,0,0,1,0,3,1
git-diff-tree,git-diff-tree,,0,0,3,0,1,3,6,1
dcu,dcu,,1,1,1,2,1,3,9,1
enjoyhint,enjoyhint,,1,0,0,1,1,1,1,1
multiple-browsers,multiple-browsers,,0,0,0,0,1,0,3,1
spiffy,spiffy,,0,0,0,0,1,0,0,1
lackey,lackey,,0,0,0,0,1,0,0,1
noinitialcontextexception,noinitialcontextexception,,0,0,0,0,1,0,3,1
dumping,dumping,,0,1,1,1,1,2,9,1
amazonica,amazonica,,0,1,1,1,1,2,6,1
wse3.0,wse3.0,,0,0,2,0,1,2,8,1
arraystoreexception,arraystoreexception,,1,1,0,2,1,2,3,1
db2-express-c,db2-express-c,,2,0,3,2,1,5,4,1
olive,olive,,0,0,0,0,1,0,8,1
listgrid,listgrid,,0,0,3,0,1,3,3,1
pgtap,pgtap,,0,1,1,1,1,2,4,1
gaul,gaul,,0,0,0,0,1,0,1,1
caketime,caketime,,0,0,0,0,1,0,4,1
parsekit,parsekit,,0,0,0,0,1,0,13,1
language-history,language-history,,1,1,1,2,1,3,9,1
bounding-volume,bounding-volume,,0,0,1,0,1,1,3,1
google-dl-platform,google-dl-platform,,2,3,8,5,1,13,0,50
dogpile.cache,dogpile.cache,,0,1,2,1,1,3,0,1
appian,appian,,0,0,1,0,1,1,8,1
word-diff,word-diff,,0,0,1,0,1,1,6,1
ctcallcenter,ctcallcenter,,1,1,0,2,1,2,13,1
cxcallobserver,cxcallobserver,,0,1,1,1,1,2,13,1
iris-dataset,iris-dataset,,4,1,3,5,1,8,0,1
toolrunner,toolrunner,,0,0,0,0,1,0,2,1
lwrp,lwrp,,1,3,2,4,1,6,8,200
plpy,plpy,,0,0,0,0,1,0,4,1
scalaj-http,scalaj-http,,2,5,1,7,1,8,2,150
meteorite,meteorite,,0,0,1,0,1,1,1,1
scala-pickling,scala-pickling,,0,0,0,0,1,0,2,1
multiarch,multiarch,,1,4,2,5,1,7,6,300
atlassprites,atlassprites,,0,0,0,0,1,0,8,1
rfc5322,rfc5322,,1,1,2,2,1,4,0,1
react-hooks,react-hooks,,685,919,303,1604,1,1907,1,34.160584
phonegap-admob,phonegap-admob,,1,1,2,2,2,4,3,1
cgm,cgm,,0,2,0,2,1,2,3,100
lightning-network,lightning-network,,4,0,1,4,1,5,6,1
luafilesystem,luafilesystem,,1,0,0,1,1,1,9,1
about-box,about-box,,1,0,0,1,1,1,3,1
mifos,mifos,,0,0,2,0,1,2,4,1
query-variables,query-variables,,1,1,1,2,1,3,4,1
std-variant,std-variant,,6,7,17,13,1,30,9,16.666667
apply-visitor,apply-visitor,,0,0,0,0,1,0,9,1
static-visitor,static-visitor,,0,0,0,0,1,0,9,1
serializableattribute,serializableattribute,,0,0,0,0,1,0,3,1
pinned-header-list-view,pinned-header-list-view,,0,0,0,0,1,0,1,1
dvajs,dvajs,,0,1,2,1,1,3,1,1
react-material,react-material,,15,19,16,34,1,50,1,26.666667
altiris,altiris,,1,0,0,1,1,1,8,1
threecsg,threecsg,,2,0,1,2,1,3,1,1
custom-url-protocol,custom-url-protocol,,1,1,1,2,1,3,13,1
influxql,influxql,,24,20,21,44,1,65,6,1
off-the-record-messaging,off-the-record-messaging,,0,0,0,0,1,0,6,1
google-persistent-disk,google-persistent-disk,,1,3,3,4,1,7,6,200
cache-failover,cache-failover,,0,0,0,0,1,0,4,1
locomotivecms,locomotivecms,,1,0,1,1,1,2,12,1
location-button,location-button,,1,0,1,1,1,2,1,1
nuproj,nuproj,,0,0,0,0,1,0,8,1
panelbar,panelbar,,1,0,0,1,1,1,1,1
ftplugin,ftplugin,,0,1,2,1,1,3,9,1
traceability,traceability,,0,0,4,0,1,4,4,1
google-compile-testing,google-compile-testing,,0,0,1,0,0,1,3,1
grahams-scan,grahams-scan,,0,0,4,0,0,4,0,1
jtapi,jtapi,,0,0,2,0,0,2,5,1
httpunhandledexception,httpunhandledexception,,0,0,1,0,0,1,3,1
boofuzz,boofuzz,,1,1,2,2,0,4,9,1
pppd,pppd,,0,0,3,0,0,3,9,1
expressionengine3,expressionengine3,,0,0,1,0,0,1,0,1
lotionjs,lotionjs,,0,0,4,0,0,4,6,1
storio,storio,,0,0,2,0,0,2,3,1
quickwin,quickwin,,0,0,1,0,0,1,9,1
storyshots,storyshots,,0,4,3,4,0,7,1,300
queue-table,queue-table,,0,0,1,0,0,1,3,1
square-reader,square-reader,,0,1,4,1,0,5,13,1
azure-pipelines-release-task,azure-pipelines-release-task,,10,3,18,13,0,31,8,1
pyav,pyav,,1,3,4,4,0,8,13,200
plotmatrix,plotmatrix,,0,0,2,0,0,2,0,1
svg-salamander,svg-salamander,,2,0,1,2,0,3,3,1
node-celery,node-celery,,0,1,1,1,0,2,3,1
infomaker,infomaker,,0,3,3,3,0,6,4,200
sap-successfactors,sap-successfactors,,1,2,5,3,0,8,3,100
ocaml-lwt,ocaml-lwt,,3,1,3,4,0,7,0,1
tsocks,tsocks,,1,1,1,2,0,3,9,1
juddi,juddi,,2,0,2,2,0,4,3,1
clpplus,clpplus,,0,0,1,0,0,1,4,1
sql-server-administration,sql-server-administration,,1,0,3,1,0,4,4,1
innerxml,innerxml,,0,0,2,0,0,2,8,1
aha,aha,,0,1,2,1,0,3,6,1
qscrollbar,qscrollbar,,0,0,5,0,0,5,9,1
weffc++,weffc++,,1,0,2,1,0,3,9,1
dbartisan,dbartisan,,0,0,1,0,0,1,2,1
facelet-tag,facelet-tag,,0,0,2,0,0,2,3,1
ascii85,ascii85,,0,0,1,0,0,1,8,1
jboss-forge,jboss-forge,,0,0,1,0,0,1,3,1
asynchronous-method-call,asynchronous-method-call,,0,1,1,1,0,2,3,1
bpython,bpython,,1,0,2,1,0,3,0,1
streaminsight,streaminsight,,1,0,2,1,0,3,4,1
brew-doctor,brew-doctor,,0,0,1,0,0,1,13,1
rose-compiler-framework,rose-compiler-framework,,0,0,1,0,0,1,9,1
sli,sli,,0,1,2,1,0,3,9,1
log-forging,log-forging,,1,1,1,2,0,3,3,1
muxer,muxer,,1,5,3,6,0,9,13,400
libharu,libharu,,1,2,2,3,0,5,9,100
apache-johnzon,apache-johnzon,,0,0,2,0,0,2,3,1
reddot,reddot,,0,0,1,0,0,1,13,1
boost.build,boost.build,,0,0,2,0,0,2,9,1
libshorttext,libshorttext,,0,0,2,0,0,2,0,1
es6-symbol,es6-symbol,,1,2,2,3,0,5,1,100
emf-compare,emf-compare,,1,0,1,1,0,2,3,1
conqat,conqat,,0,0,1,0,0,1,3,1
business-connector,business-connector,,0,0,1,0,0,1,8,1
wiegand,wiegand,,0,1,2,1,0,3,3,1
application.xml,application.xml,,0,0,2,0,0,2,3,1
unreal-umg,unreal-umg,,1,0,3,1,0,4,9,1
cocos2d-x-2.x,cocos2d-x-2.x,,1,0,2,1,0,3,3,1
number-literal,number-literal,,0,0,2,0,0,2,1,1
orsserialport,orsserialport,,2,0,1,2,0,3,13,1
emblem.js,emblem.js,,0,0,1,0,0,1,1,1
ixguard,ixguard,,0,0,3,0,0,3,13,1
validationgroup,validationgroup,,0,0,2,0,0,2,8,1
lookupfield,lookupfield,,0,1,3,1,0,4,0,1
jsdatepick,jsdatepick,,1,0,1,1,0,2,1,1
display-cutouts,display-cutouts,,1,5,5,6,0,11,3,400
owned-types,owned-types,,1,1,5,2,0,7,8,1
axmediaplayer,axmediaplayer,,0,0,1,0,0,1,8,1
column-sizing,column-sizing,,0,0,1,0,0,1,4,1
unicurses,unicurses,,0,0,1,0,0,1,0,1
mime4j,mime4j,,0,1,1,1,0,2,4,1
rxdart,rxdart,,47,14,64,61,0,125,13,1
scenekit-modelio,scenekit-modelio,,0,0,4,0,0,4,13,1
react-sticky,react-sticky,,1,0,2,1,0,3,1,1
passive-view,passive-view,,0,0,1,0,0,1,3,1
concur,concur,,2,1,2,3,0,5,4,1
tss,tss,,1,1,2,2,0,4,13,1
starling-server,starling-server,,0,0,1,0,0,1,1,1
gpc,gpc,,0,0,2,0,0,2,3,1
join-hints,join-hints,,0,0,1,0,0,1,4,1
cmfcribbonpanel,cmfcribbonpanel,,0,0,1,0,0,1,9,1
aws-alb,aws-alb,,14,9,25,23,0,48,6,1
namecoin,namecoin,,0,0,1,0,0,1,6,1
azure-dev-spaces,azure-dev-spaces,,3,6,2,9,0,11,6,100
payone,payone,,0,0,1,0,0,1,4,1
cmfcpropertypage,cmfcpropertypage,,0,0,1,0,0,1,9,1
grunt-exec,grunt-exec,,0,1,1,1,0,2,1,1
dreamservice,dreamservice,,1,0,1,1,0,2,3,1
pocketpc,pocketpc,,1,0,2,1,0,3,8,1
admanager,admanager,,0,2,7,2,0,9,3,100
matpower,matpower,,2,0,2,2,0,4,0,1
swift5,swift5,,135,192,8,327,0,335,13,42.222222
feature-activation,feature-activation,,0,1,1,1,0,2,8,1
acts-as-taggable,acts-as-taggable,,0,0,3,0,0,3,12,1
chrome-plugins,chrome-plugins,,0,1,2,1,0,3,1,1
bai2,bai2,,0,0,2,0,0,2,4,1
mod-filter,mod-filter,,0,0,1,0,0,1,4,1
access-data-project,access-data-project,,1,0,1,1,0,2,5,1
farpoint,farpoint,,0,0,2,0,0,2,8,1
android-pagedlistview,android-pagedlistview,,4,3,4,7,0,11,3,1
openscep,openscep,,0,0,2,0,0,2,6,1
nsfastenumeration,nsfastenumeration,,0,0,1,0,0,1,13,1
jst,jst,,1,0,1,1,0,2,1,1
gexperts,gexperts,,1,0,1,1,0,2,4,1
jqbargraph,jqbargraph,,0,1,1,1,0,2,1,1
force-index,force-index,,0,0,3,0,0,3,4,1
scnaction,scnaction,,2,0,3,2,0,5,13,1
extender,extender,,0,0,2,0,0,2,4,1
isync,isync,,0,0,1,0,0,1,4,1
easy-rules,easy-rules,,1,1,3,2,0,5,3,1
pdftables,pdftables,,3,1,4,4,0,8,8,1
adjustviewbounds,adjustviewbounds,,0,0,1,0,0,1,3,1
partial-refresh,partial-refresh,,0,0,3,0,0,3,5,1
reddison,reddison,,3,1,5,4,0,9,3,1
wice-grid,wice-grid,,1,0,3,1,0,4,12,1
scriban,scriban,,1,0,3,1,0,4,8,1
flatten-maven-plugin,flatten-maven-plugin,,1,0,2,1,0,3,3,1
cryptico,cryptico,,1,0,2,1,0,3,6,1
etherscan,etherscan,,5,3,10,8,0,18,6,1
crystal-reports-9,crystal-reports-9,,0,1,2,1,0,3,8,1
less.js,less.js,,0,0,2,0,0,2,1,1
glue,glue,,20,19,18,39,0,57,6,1
biztalk-2006,biztalk-2006,,0,0,1,0,0,1,8,1
ima4,ima4,,0,0,1,0,0,1,13,1
intellilock,intellilock,,2,0,1,2,0,3,8,1
markdown-it,markdown-it,,4,0,5,4,0,9,1,1
jython-2.2,jython-2.2,,0,0,1,0,0,1,0,1
java-12,java-12,,41,39,6,80,0,86,3,1
preview-feature,preview-feature,,1,0,3,1,0,4,3,1
vim-mode-plus,vim-mode-plus,,0,0,2,0,0,2,0,1
objectbrowser,objectbrowser,,1,0,2,1,0,3,8,1
proguard-maven-plugin,proguard-maven-plugin,,1,1,1,2,0,3,3,1
c51,c51,,0,0,6,0,0,6,9,1
mod-wsgi-express,mod-wsgi-express,,0,0,2,0,0,2,0,1
owlim,owlim,,0,0,1,0,0,1,2,1
expectit,expectit,,0,0,1,0,0,1,3,1
unfoldingmap,unfoldingmap,,0,1,4,1,0,5,3,1
lcom,lcom,,0,0,1,0,0,1,3,1
sgi,sgi,,0,0,1,0,0,1,9,1
irix,irix,,0,0,2,0,0,2,9,1
vaadin-navigator,vaadin-navigator,,0,0,1,0,0,1,3,1
kdialog,kdialog,,0,0,1,0,0,1,9,1
taptargetview,taptargetview,,0,1,1,1,0,2,3,1
tweener,tweener,,0,0,1,0,0,1,9,1
background-audio,background-audio,,1,0,5,1,0,6,13,1
mojo-useragent,mojo-useragent,,1,3,5,4,0,9,9,200
data-member-pointers,data-member-pointers,,0,0,2,0,0,2,9,1
ejabberd-server,ejabberd-server,,0,0,2,0,0,2,3,1
xmlanyelement,xmlanyelement,,0,0,2,0,0,2,3,1
loadleveler,loadleveler,,0,0,2,0,0,2,0,1
force-based-algorithm,force-based-algorithm,,0,0,1,0,0,1,0,1
cldc,cldc,,0,0,1,0,0,1,4,1
erwin,erwin,,1,0,2,1,0,3,4,1
facebooktoolkit,facebooktoolkit,,0,0,1,0,0,1,14,1
observablehq,observablehq,,5,3,5,8,0,13,1,1
hwui,hwui,,0,0,1,0,0,1,9,1
qgroundcontrol,qgroundcontrol,,2,0,2,2,0,4,6,1
ora-12541,ora-12541,,0,0,1,0,0,1,4,1
codetyphon,codetyphon,,0,1,1,1,0,2,9,1
angular-material-table,angular-material-table,,27,26,42,53,0,95,1,1
kafka-net,kafka-net,,1,1,3,2,0,5,2,1
neolane,neolane,,0,0,1,0,0,1,1,1
phpstan,phpstan,,2,0,5,2,0,7,4,1
localsystem,localsystem,,0,0,2,0,0,2,8,1
bronto,bronto,,1,0,3,1,0,4,4,1
svndumpfilter,svndumpfilter,,0,0,1,0,0,1,6,1
user-identification,user-identification,,1,0,5,1,0,6,8,1
perl-package,perl-package,,0,0,1,0,0,1,9,1
zend-debugger,zend-debugger,,0,0,2,0,0,2,4,1
usocket,usocket,,0,1,3,1,0,4,0,1
asp.net-core-webapi-2.1,asp.net-core-webapi-2.1,,7,7,27,14,0,41,8,1
fselect,fselect,,0,0,4,0,0,4,1,1
boost-functional,boost-functional,,0,0,1,0,0,1,9,1
kubebuilder,kubebuilder,,2,4,3,6,0,9,6,100
maven-help-plugin,maven-help-plugin,,0,0,1,0,0,1,3,1
seleniumwire,seleniumwire,,1,2,2,3,0,5,3,100
multiviews,multiviews,,0,0,1,0,0,1,8,1
formlets,formlets,,0,0,1,0,0,1,0,1
ziggeo-api,ziggeo-api,,2,1,2,3,0,5,1,1
go-agent,go-agent,,0,0,3,0,0,3,6,1
watch-os-5,watch-os-5,,13,5,46,18,0,64,13,1
macaulay2,macaulay2,,0,0,2,0,0,2,0,1
jsjac,jsjac,,0,0,1,0,0,1,8,1
paintbox,paintbox,,1,0,3,1,0,4,9,1
get-display-media,get-display-media,,3,0,7,3,0,10,1,1
sitemappath,sitemappath,,0,0,2,0,0,2,8,1
hdp,hdp,,21,40,45,61,0,106,2,90.47619
require-handlebars,require-handlebars,,0,0,1,0,0,1,1,1
maven-pdf-plugin,maven-pdf-plugin,,0,0,2,0,0,2,3,1
silk,silk,,0,0,4,0,0,4,3,1
proper,proper,,2,0,1,2,0,3,5,1
xname,xname,,0,0,2,0,0,2,8,1
pointycastle,pointycastle,,1,0,4,1,0,5,13,1
ora-01438,ora-01438,,0,0,1,0,0,1,4,1
freemind,freemind,,0,0,1,0,0,1,9,1
snap7,snap7,,2,0,5,2,0,7,9,1
table-driven,table-driven,,0,0,1,0,0,1,6,1
libqmi,libqmi,,0,2,2,2,0,4,9,100
akka-grpc,akka-grpc,,5,1,2,6,0,8,2,1
arangodb-foxx,arangodb-foxx,,1,3,6,4,0,10,2,200
openebs,openebs,,2,0,53,2,0,55,6,1
chartfx,chartfx,,0,0,1,0,0,1,8,1
login-name,login-name,,0,1,1,1,0,2,8,1
telerik-raddatepicker,telerik-raddatepicker,,0,0,1,0,0,1,1,1
uptime-monitoring,uptime-monitoring,,0,0,3,0,0,3,1,1
shopify-javascript-buy-sdk,shopify-javascript-buy-sdk,,8,2,12,10,0,22,1,1
apache-poi-4,apache-poi-4,,11,8,14,19,0,33,3,1
smooth-streaming-player,smooth-streaming-player,,0,0,1,0,0,1,13,1
kindlegen,kindlegen,,1,0,1,1,0,2,0,1
noir,noir,,0,0,3,0,0,3,2,1
lib-noir,lib-noir,,0,0,3,0,0,3,2,1
itemgroup,itemgroup,,0,1,2,1,0,3,0,1
motzkin-numbers,motzkin-numbers,,0,0,1,0,0,1,0,1
deepsecurity,deepsecurity,,1,4,1,5,0,6,3,300
android-time-square,android-time-square,,0,0,3,0,0,3,3,1
tensorflow2.0,tensorflow2.0,,183,182,4,365,0,369,0,1
pg-notify,pg-notify,,0,0,1,0,0,1,4,1
angular8,angular8,,24,669,3,693,0,696,1,2687.5
presentationml,presentationml,,0,1,1,1,0,2,8,1
quickbuild,quickbuild,,1,0,1,1,0,2,3,1
struts2-tiles-plugin,struts2-tiles-plugin,,0,0,2,0,0,2,3,1
annotation-introspector,annotation-introspector,,0,0,1,0,0,1,3,1
openxml-powertools,openxml-powertools,,2,2,3,4,0,7,8,1
vmime,vmime,,0,0,1,0,0,1,4,1
cmfcmenubutton,cmfcmenubutton,,0,0,2,0,0,2,9,1
stapler,stapler,,3,0,1,3,0,4,13,1
suit-css,suit-css,,0,1,1,1,0,2,1,1
zend-session-namespace,zend-session-namespace,,0,0,1,0,0,1,4,1
react-popper,react-popper,,4,8,4,12,0,16,1,100
arbor.js,arbor.js,,0,1,1,1,0,2,1,1
baml,baml,,0,1,3,1,0,4,8,1
text-xslate,text-xslate,,0,0,1,0,0,1,9,1
orbit.js,orbit.js,,0,0,1,0,0,1,1,1
umdf,umdf,,1,4,9,5,0,14,9,300
xspace,xspace,,0,0,1,0,0,1,0,1
kafka-interactive-queries,kafka-interactive-queries,,0,2,2,2,0,4,2,100
irs,irs,,2,0,5,2,0,7,3,1
decision-model-notation,decision-model-notation,,1,2,1,3,0,4,3,100
qtopcua,qtopcua,,0,1,2,1,0,3,8,1
magic-leap,magic-leap,,1,1,2,2,0,4,13,1
shapesheet,shapesheet,,0,1,3,1,0,4,5,1
misuse,misuse,,0,0,1,0,0,1,8,1
hyperic,hyperic,,0,0,1,0,0,1,9,1
oraclelinux,oraclelinux,,2,1,4,3,0,7,9,1
targetprocess,targetprocess,,0,0,3,0,0,3,6,1
haskell-sdl,haskell-sdl,,0,0,1,0,0,1,2,1
uca,uca,,0,0,1,0,0,1,9,1
white-box,white-box,,0,0,2,0,0,2,3,1
ripcord,ripcord,,2,0,2,2,0,4,0,1
system.printing,system.printing,,0,1,4,1,0,5,1,1
mouse-picking,mouse-picking,,2,1,3,3,0,6,9,1
bee-smalltalk,bee-smalltalk,,0,0,1,0,0,1,13,1
entity-group-transactions,entity-group-transactions,,0,0,1,0,0,1,6,1
aunit,aunit,,0,0,2,0,0,2,6,1
cglayer,cglayer,,1,1,2,2,0,4,13,1
yandex-mapkit,yandex-mapkit,,1,1,1,2,0,3,3,1
dashlet,dashlet,,0,0,1,0,0,1,4,1
escript,escript,,0,1,1,1,0,2,2,1
xxtea,xxtea,,1,0,1,1,0,2,9,1
notarize,notarize,,8,18,5,26,0,31,13,125
mediacapture,mediacapture,,3,8,7,11,0,18,8,166.666667
maql,maql,,0,0,1,0,0,1,2,1
data-replicator,data-replicator,,0,0,2,0,0,2,4,1
heroku-nodejs,heroku-nodejs,,1,1,5,2,0,7,1,1
iphone-xs,iphone-xs,,3,3,14,6,0,20,13,1
quick-search,quick-search,,2,1,2,3,0,5,8,1
google-cloud-vpn,google-cloud-vpn,,5,4,6,9,0,15,6,1
diazo,diazo,,0,0,1,0,0,1,0,1
fabric8-maven-plugin,fabric8-maven-plugin,,3,2,8,5,0,13,3,1
python.el,python.el,,0,0,1,0,0,1,9,1
nuxt,nuxt,,153,160,204,313,0,517,1,4.575163
sort-object,sort-object,,0,0,5,0,0,5,8,1
brightpearl,brightpearl,,0,0,1,0,0,1,8,1
jblas,jblas,,0,0,2,0,0,2,3,1
gitorious,gitorious,,0,0,1,0,0,1,6,1
ctframe,ctframe,,0,0,1,0,0,1,13,1
conrod,conrod,,0,0,1,0,0,1,9,1
scrutor,scrutor,,0,1,1,1,0,2,8,1
react-native-keychain,react-native-keychain,,2,2,3,4,0,7,1,1
pot,pot,,0,2,3,2,0,5,4,100
bluepill,bluepill,,2,1,3,3,0,6,12,1
aws-eks,aws-eks,,39,47,44,86,0,130,6,20.512821
here-autocomplete,here-autocomplete,,1,1,3,2,0,5,3,1
here-maps-rest,here-maps-rest,,33,9,33,42,0,75,3,1
vod,vod,,2,1,1,3,0,4,13,1
vim-fzf,vim-fzf,,0,0,2,0,0,2,9,1
forward-delete,forward-delete,,0,0,1,0,0,1,9,1
datanitro,datanitro,,0,0,1,0,0,1,0,1
sitecollection,sitecollection,,0,0,4,0,0,4,8,1
madge,madge,,0,0,1,0,0,1,1,1
searchcontainer,searchcontainer,,0,0,1,0,0,1,3,1
swiftybeaver,swiftybeaver,,0,1,1,1,0,2,13,1
rabbitmq-federation,rabbitmq-federation,,1,0,3,1,0,4,3,1
wsdl-2.0,wsdl-2.0,,0,0,2,0,0,2,3,1
assemblybuilder,assemblybuilder,,0,0,1,0,0,1,8,1
ant-design-pro,ant-design-pro,,10,21,42,31,0,73,1,110
translation-editor,translation-editor,,2,0,1,2,0,3,3,1
modman,modman,,0,0,2,0,0,2,4,1
bmake,bmake,,0,0,2,0,0,2,9,1
kyma,kyma,,0,0,3,0,0,3,6,1
nodequeue,nodequeue,,1,0,1,1,0,2,3,1
uiattachmentbehavior,uiattachmentbehavior,,0,0,1,0,0,1,13,1
clientaccesspolicy.xml,clientaccesspolicy.xml,,0,0,2,0,0,2,4,1
dog,dog,,1,0,1,1,0,2,0,1
mellon,mellon,,2,0,2,2,0,4,8,1
root-access,root-access,,0,3,2,3,0,5,9,200
partial-sort,partial-sort,,0,0,2,0,0,2,0,1
ado-net-source,ado-net-source,,0,0,2,0,0,2,8,1
ado.net-connection,ado.net-connection,,0,0,2,0,0,2,8,1
bitmiracle,bitmiracle,,1,0,1,1,0,2,8,1
angular-ivy,angular-ivy,,5,13,3,18,0,21,1,160
pybossa,pybossa,,0,1,3,1,0,4,0,1
wind-river-workbench,wind-river-workbench,,1,1,2,2,0,4,9,1
concurrent-collections,concurrent-collections,,0,0,3,0,0,3,8,1
microsoft-identity-platform,microsoft-identity-platform,,3,6,2,9,0,11,8,100
adk,adk,,0,2,4,2,0,6,3,100
sijax,sijax,,0,1,2,1,0,3,0,1
mathematical-typesetting,mathematical-typesetting,,0,0,1,0,0,1,0,1
gina,gina,,0,1,1,1,0,2,9,1
mediawiki-visualeditor,mediawiki-visualeditor,,1,2,3,3,0,6,4,100
codemirror-grammar,codemirror-grammar,,0,0,1,0,0,1,1,1
divi-theme,divi-theme,,9,8,1,17,0,18,4,1
compress-archive,compress-archive,,2,0,4,2,0,6,8,1
icloud-photo-library,icloud-photo-library,,0,1,2,1,0,3,13,1
unity3d-terrain,unity3d-terrain,,3,1,4,4,0,8,8,1
osx-leopard,osx-leopard,,0,0,1,0,0,1,13,1
sfsafariviewcontrollerdelegate,sfsafariviewcontrollerdelegate,,1,1,4,2,0,6,13,1
safariservices,safariservices,,0,0,4,0,0,4,13,1
apollo-boost,apollo-boost,,5,1,9,6,0,15,1,1
django-webtest,django-webtest,,0,0,2,0,0,2,0,1
easypie,easypie,,2,2,1,4,0,5,1,1
todomvc,todomvc,,0,0,3,0,0,3,1,1
ora-00937,ora-00937,,1,0,2,1,0,3,4,1
lamar,lamar,,3,2,7,5,0,12,8,1
fillfactor,fillfactor,,0,0,2,0,0,2,0,1
splitchunksplugin,splitchunksplugin,,3,6,11,9,0,20,1,100
loadium,loadium,,0,0,1,0,0,1,3,1
cofoundry,cofoundry,,0,2,1,2,0,3,8,100
lxr,lxr,,0,0,1,0,0,1,20,1
grepcode,grepcode,,0,0,1,0,0,1,20,1
pylot,pylot,,0,0,1,0,0,1,0,1
dfd,dfd,,0,2,1,2,0,3,6,100
lumia-imaging-sdk,lumia-imaging-sdk,,0,0,1,0,0,1,8,1
repopulation,repopulation,,0,0,1,0,0,1,1,1
rainloop,rainloop,,1,1,1,2,0,3,4,1
asciidoctor-fopub,asciidoctor-fopub,,0,0,1,0,0,1,3,1
unresponsive-progressbar,unresponsive-progressbar,,0,0,1,0,0,1,8,1
fitvids,fitvids,,0,0,3,0,0,3,1,1
cubesat-protocol,cubesat-protocol,,0,0,1,0,0,1,9,1
selenium-remotedriver,selenium-remotedriver,,6,5,5,11,0,16,3,1
crash-recovery,crash-recovery,,0,0,1,0,0,1,6,1
global-assembly-cache,global-assembly-cache,,0,1,2,1,0,3,8,1
facebook-python-business-sdk,facebook-python-business-sdk,,5,4,14,9,0,23,13,1
downshift,downshift,,5,1,8,6,0,14,1,1
epytext,epytext,,0,0,1,0,0,1,0,1
gulp-minify,gulp-minify,,2,1,1,3,0,4,1,1
intellij-13,intellij-13,,1,4,6,5,0,11,3,300
isa-swizzling,isa-swizzling,,0,0,1,0,0,1,13,1
mono.addins,mono.addins,,0,0,1,0,0,1,8,1
sequelize-typescript,sequelize-typescript,,15,15,22,30,0,52,1,1
filter-bank,filter-bank,,0,0,1,0,0,1,8,1
darkroom.js,darkroom.js,,0,0,1,0,0,1,1,1
v-slider,v-slider,,0,0,2,0,0,2,1,1
gaze-buttons,gaze-buttons,,0,0,3,0,0,3,8,1
stream-framework,stream-framework,,0,1,2,1,0,3,6,1
multihomed,multihomed,,0,0,2,0,0,2,2,1
authorize.net-arb,authorize.net-arb,,0,1,3,1,0,4,4,1
graph-reduction,graph-reduction,,0,0,2,0,0,2,0,1
pyspotlight,pyspotlight,,0,0,1,0,0,1,2,1
jfairy,jfairy,,1,0,1,1,0,2,3,1
reflect,reflect,,12,10,23,22,0,45,6,1
android-wheel,android-wheel,,1,0,1,1,0,2,3,1
office-web-app,office-web-app,,3,1,4,4,0,8,5,1
prometheus-java,prometheus-java,,4,4,8,8,0,16,6,1
form-library,form-library,,0,0,1,0,0,1,4,1
localconnection,localconnection,,0,0,1,0,0,1,13,1
sitespeed,sitespeed,,2,2,4,4,0,8,1,1
character-codes,character-codes,,0,0,3,0,0,3,0,1
llrp,llrp,,2,1,3,3,0,6,3,1
hllapi,hllapi,,1,0,2,1,0,3,5,1
yetanotherforum,yetanotherforum,,1,0,1,1,0,2,1,1
openhtmltopdf,openhtmltopdf,,3,3,3,6,0,9,3,1
duke,duke,,0,0,1,0,0,1,3,1
uib-tabset,uib-tabset,,0,0,2,0,0,2,1,1
vulas,vulas,,0,0,1,0,0,1,3,1
ora-12560,ora-12560,,1,0,2,1,0,3,1,1
cote,cote,,1,0,2,1,0,3,1,1
slacktextviewcontroller,slacktextviewcontroller,,0,0,2,0,0,2,13,1
ms-error-1004,ms-error-1004,,4,5,14,9,0,23,5,25
jsonidentityinfo,jsonidentityinfo,,0,0,2,0,0,2,3,1
spring-data-jpa-datatables,spring-data-jpa-datatables,,0,0,5,0,0,5,3,1
microsoft-adal-angular6,microsoft-adal-angular6,,3,3,8,6,0,14,8,1
showtext,showtext,,2,1,2,3,0,5,0,1
uiinputviewcontroller,uiinputviewcontroller,,0,1,2,1,0,3,13,1
modalpopups,modalpopups,,0,0,1,0,0,1,3,1
xenomai,xenomai,,4,1,4,5,0,9,9,1
gulp-connect,gulp-connect,,0,0,2,0,0,2,1,1
humanize,humanize,,0,0,4,0,0,4,0,1
radtextbox,radtextbox,,2,1,1,3,0,4,8,1
angularjs-animation,angularjs-animation,,1,1,1,2,0,3,1,1
restrict-qualifier,restrict-qualifier,,2,0,7,2,0,9,9,1
likebtn,likebtn,,0,0,2,0,0,2,3,1
stargate,stargate,,1,0,2,1,0,3,2,1
graph-api-explorer,graph-api-explorer,,0,0,1,0,0,1,13,1
jmx-exporter,jmx-exporter,,6,11,7,17,0,24,3,83.333333
wakatime,wakatime,,0,0,2,0,0,2,9,1
facebook-ui,facebook-ui,,1,0,1,1,0,2,13,1
go-get,go-get,,6,3,3,9,0,12,6,1
drupal-field-api,drupal-field-api,,1,0,1,1,0,2,4,1
httpcookiecollection,httpcookiecollection,,0,0,2,0,0,2,4,1
stylecop-plus,stylecop-plus,,0,0,1,0,0,1,8,1
enumeratum,enumeratum,,1,0,2,1,0,3,2,1
angular-carousel,angular-carousel,,1,0,2,1,0,3,1,1
afhttprequestoperation,afhttprequestoperation,,0,2,2,2,0,4,13,100
dltk,dltk,,0,0,2,0,0,2,3,1
jest-puppeteer,jest-puppeteer,,6,9,6,15,0,21,1,50
lessphp,lessphp,,0,0,1,0,0,1,4,1
wsgiref,wsgiref,,2,0,2,2,0,4,0,1
background-substraction,background-substraction,,0,0,1,0,0,1,4,1
mongodb-java-3.8,mongodb-java-3.8,,1,0,3,1,0,4,1,1
service-application,service-application,,2,1,1,3,0,4,3,1
lemoon,lemoon,,0,0,1,0,0,1,8,1
masm64,masm64,,2,0,7,2,0,9,9,1
twisted.conch,twisted.conch,,0,2,2,2,0,4,0,100
gulp-jasmine,gulp-jasmine,,1,0,2,1,0,3,1,1
tocttou,tocttou,,0,1,1,1,0,2,9,1
domain-record,domain-record,,1,0,1,1,0,2,4,1
technet,technet,,0,0,1,0,0,1,8,1
powershell-v5.1,powershell-v5.1,,10,7,36,17,0,53,8,1
fourier-descriptors,fourier-descriptors,,1,2,2,3,0,5,0,100
pysimplesoap,pysimplesoap,,0,1,1,1,0,2,0,1
scala-placeholder-syntax,scala-placeholder-syntax,,1,0,1,1,0,2,2,1
python-regex,python-regex,,42,28,10,70,0,80,0,1
executable-format,executable-format,,1,1,1,2,0,3,9,1
power-architecture,power-architecture,,0,0,1,0,0,1,0,1
f2c,f2c,,0,0,1,0,0,1,3,1
lesshat,lesshat,,0,0,1,0,0,1,1,1
umount,umount,,2,0,5,2,0,7,9,1
windows-virtual-pc,windows-virtual-pc,,0,0,1,0,0,1,6,1
mac-spoofing,mac-spoofing,,0,1,3,1,0,4,9,1
iosurface,iosurface,,1,1,7,2,0,9,13,1
musicg,musicg,,3,1,2,4,0,6,3,1
excss,excss,,0,0,1,0,0,1,8,1
cljsrn,cljsrn,,0,0,5,0,0,5,2,1
vue-multiselect,vue-multiselect,,8,6,15,14,0,29,1,1
pignosecalendar,pignosecalendar,,2,0,1,2,0,3,1,1
conkin,conkin,,0,0,1,0,0,1,2,1
permissionset,permissionset,,0,0,3,0,0,3,8,1
elasticsearch-bulk,elasticsearch-bulk,,0,1,3,1,0,4,6,1
xcode10.1,xcode10.1,,62,30,115,92,0,207,13,1
workmanagertaskexecutor,workmanagertaskexecutor,,0,0,1,0,0,1,3,1
elasticsearch-sql,elasticsearch-sql,,3,1,2,4,0,6,6,1
indexwriter,indexwriter,,1,0,1,1,0,2,2,1
qcodo,qcodo,,0,0,1,0,0,1,4,1
qcubed,qcubed,,0,0,1,0,0,1,4,1
ms-gsl,ms-gsl,,0,0,1,0,0,1,9,1
amp-youtube,amp-youtube,,1,0,2,1,0,3,1,1
amp-story,amp-story,,2,3,31,5,0,36,1,50
expression-bodied-members,expression-bodied-members,,0,1,2,1,0,3,8,1
ibm-directory-server,ibm-directory-server,,0,0,1,0,0,1,3,1
dsbulk,dsbulk,,1,0,3,1,0,4,2,1
htmlcleaner,htmlcleaner,,0,1,1,1,0,2,3,1
mod-proxy-ajp,mod-proxy-ajp,,2,1,1,3,0,4,4,1
morena,morena,,0,1,1,1,0,2,3,1
pysys,pysys,,1,0,2,1,0,3,6,1
pods-framework,pods-framework,,0,0,2,0,0,2,4,1
enclose,enclose,,0,0,1,0,0,1,9,1
wmain,wmain,,0,0,2,0,0,2,9,1
windows-themes,windows-themes,,1,1,2,2,0,4,8,1
powerapps-selected-items,powerapps-selected-items,,0,3,8,3,0,11,8,200
olsrd,olsrd,,0,0,1,0,0,1,6,1
standardanalyzer,standardanalyzer,,0,0,2,0,0,2,6,1
spring-security4,spring-security4,,0,0,1,0,0,1,4,1
loadoptions,loadoptions,,0,0,1,0,0,1,8,1
sharedarraybuffer,sharedarraybuffer,,0,0,4,0,0,4,1,1
privatefontcollection,privatefontcollection,,1,2,1,3,0,4,8,100
marching-ants,marching-ants,,0,0,1,0,0,1,5,1
geofirestore,geofirestore,,18,14,21,32,0,53,13,1
cogl,cogl,,0,0,1,0,0,1,9,1
watson-openscale,watson-openscale,,9,0,2,9,0,11,6,1
2-satisfiability,2-satisfiability,,1,0,3,1,0,4,0,1
.x,.x,,0,0,1,0,0,1,0,1
hbm2java,hbm2java,,0,0,1,0,0,1,3,1
garlicjs,garlicjs,,0,0,2,0,0,2,1,1
drizzle,drizzle,,2,1,5,3,0,8,6,1
amazon-fba,amazon-fba,,6,2,1,8,0,9,6,1
crostini,crostini,,1,0,5,1,0,6,3,1
sublimemerge,sublimemerge,,0,1,4,1,0,5,6,1
scaleform,scaleform,,0,0,1,0,0,1,9,1
custom-panel,custom-panel,,0,0,1,0,0,1,3,1
pwsh,pwsh,,0,1,3,1,0,4,8,1
android-paging-library,android-paging-library,,15,9,15,24,0,39,3,1
naturalid,naturalid,,0,0,1,0,0,1,3,1
react-native-svg,react-native-svg,,12,16,26,28,0,54,1,33.333333
approximate-nn-searching,approximate-nn-searching,,1,1,2,2,0,4,0,1
react-navigation-drawer,react-navigation-drawer,,28,22,46,50,0,96,1,1
react-navigation-stack,react-navigation-stack,,34,32,69,66,0,135,1,1
libopencm3,libopencm3,,0,0,1,0,0,1,9,1
jsmn,jsmn,,0,0,2,0,0,2,9,1
windows-package-manager,windows-package-manager,,0,1,3,1,0,4,8,1
numeral-system,numeral-system,,0,0,1,0,0,1,0,1
strimzi,strimzi,,2,1,1,3,0,4,6,1
alcatel-ot,alcatel-ot,,0,0,1,0,0,1,3,1
shell-verbs,shell-verbs,,1,1,1,2,0,3,9,1
lost-grid,lost-grid,,1,0,2,1,0,3,1,1
mapdeck,mapdeck,,3,2,3,5,0,8,0,1
mat-input,mat-input,,1,2,7,3,0,10,1,100
plan-9,plan-9,,1,1,3,2,0,5,9,1
asp.net-core-2.2,asp.net-core-2.2,,254,203,213,457,0,670,8,1
metacpan,metacpan,,0,0,3,0,0,3,9,1
ml.net-model-builder,ml.net-model-builder,,0,3,1,3,0,4,8,200
pcl-crypto,pcl-crypto,,2,0,1,2,0,3,8,1
meteor-mobile,meteor-mobile,,0,0,1,0,0,1,1,1
netapi32,netapi32,,0,0,2,0,0,2,8,1
ncb,ncb,,0,0,1,0,0,1,9,1
acm-icpc,acm-icpc,,1,0,3,1,0,4,0,1
wagtail-search,wagtail-search,,0,1,4,1,0,5,0,1
gmsa,gmsa,,2,1,2,3,0,5,8,1
enterprise-portal,enterprise-portal,,0,0,1,0,0,1,5,1
jsonrpc4j,jsonrpc4j,,0,1,3,1,0,4,3,1
mcapi,mcapi,,0,0,1,0,0,1,9,1
servicedcomponent,servicedcomponent,,0,0,1,0,0,1,8,1
direct2,direct2,,0,0,1,0,0,1,0,1
veeva,veeva,,0,0,2,0,0,2,1,1
ucma2.0,ucma2.0,,0,0,1,0,0,1,8,1
jhat,jhat,,1,0,1,1,0,2,3,1
skitter-slider,skitter-slider,,0,0,1,0,0,1,1,1
openxava,openxava,,0,0,1,0,0,1,3,1
filevault,filevault,,0,0,4,0,0,4,13,1
protected-views,protected-views,,0,0,1,0,0,1,3,1
sharepoint-feature,sharepoint-feature,,0,0,1,0,0,1,8,1
alternate-access-mappings,alternate-access-mappings,,0,0,2,0,0,2,8,1
sqlite4java,sqlite4java,,0,0,1,0,0,1,3,1
ngx-bootstrap-typeahead,ngx-bootstrap-typeahead,,0,1,1,1,0,2,1,1
component-services,component-services,,1,0,1,1,0,2,8,1
tbd,tbd,,0,0,2,0,0,2,6,1
android-multiple-apk,android-multiple-apk,,0,0,1,0,0,1,3,1
automapper-7,automapper-7,,1,0,6,1,0,7,8,1
ratchet-2,ratchet-2,,0,0,1,0,0,1,4,1
awesome-typescript-loader,awesome-typescript-loader,,2,1,8,3,0,11,1,1
jquery-1.5,jquery-1.5,,0,0,1,0,0,1,1,1
ambientcontext,ambientcontext,,0,0,2,0,0,2,8,1
video-game-consoles,video-game-consoles,,1,0,4,1,0,5,9,1
http2-lawyers,http2-lawyers,,0,0,1,0,0,1,3,1
tera,tera,,2,3,2,5,0,7,9,50
zola,zola,,3,0,2,3,0,5,9,1
teamcity-7.0,teamcity-7.0,,0,0,2,0,0,2,8,1
noweb,noweb,,0,1,2,1,0,3,0,1
aws-elastictranscoder,aws-elastictranscoder,,3,2,5,5,0,10,6,1
iphone-xs-max,iphone-xs-max,,2,4,19,6,0,25,13,100
scrooge,scrooge,,0,0,1,0,0,1,2,1
application-end,application-end,,0,0,1,0,0,1,8,1
macos-darkmode,macos-darkmode,,11,9,21,20,0,41,13,1
pocl,pocl,,2,0,1,2,0,3,9,1
asp.net5,asp.net5,,0,0,3,0,0,3,8,1
azure-cosmosdb-tables,azure-cosmosdb-tables,,4,2,10,6,0,16,8,1
servicepacks,servicepacks,,0,0,1,0,0,1,4,1
wso2es,wso2es,,0,1,1,1,0,2,14,1
immer.js,immer.js,,12,11,6,23,0,29,1,1
jooq-sbt-plugin,jooq-sbt-plugin,,0,0,1,0,0,1,3,1
pusherswift,pusherswift,,1,1,2,2,0,4,13,1
cvlib,cvlib,,0,0,2,0,0,2,0,1
gin-gonic,gin-gonic,,8,16,17,24,0,41,6,100
generator-react-webpack,generator-react-webpack,,1,0,1,1,0,2,1,1
skfuzzy,skfuzzy,,3,1,3,4,0,7,0,1
jcstress,jcstress,,1,0,3,1,0,4,3,1
option-set,option-set,,2,1,1,3,0,4,8,1
visual-build-professional,visual-build-professional,,0,0,1,0,0,1,9,1
stdapply,stdapply,,0,0,2,0,0,2,9,1
aws-toolkit,aws-toolkit,,12,2,13,14,0,27,6,1
wnck,wnck,,0,0,1,0,0,1,9,1
msbuildextensionpack,msbuildextensionpack,,1,0,1,1,0,2,8,1
memory-visibility,memory-visibility,,1,0,5,1,0,6,3,1
openvg,openvg,,0,0,3,0,0,3,9,1
beanstalk-maven-plugin,beanstalk-maven-plugin,,0,0,1,0,0,1,6,1
jscalendar,jscalendar,,0,1,2,1,0,3,1,1
fast-protocol,fast-protocol,,0,0,3,0,0,3,9,1
eaglview,eaglview,,0,0,1,0,0,1,13,1
jmeter-5.0,jmeter-5.0,,46,50,63,96,0,159,3,8.695652
deviare,deviare,,0,0,2,0,0,2,9,1
nsappleeventmanager,nsappleeventmanager,,0,0,1,0,0,1,13,1
keycloak-gatekeeper,keycloak-gatekeeper,,9,7,9,16,0,25,3,1
nvgraph,nvgraph,,0,0,1,0,0,1,0,1
boost-build,boost-build,,0,1,3,1,0,4,9,1
curry-currency-converter,curry-currency-converter,,0,1,1,1,0,2,4,1
ttimer,ttimer,,0,1,2,1,0,3,9,1
xsengine,xsengine,,0,0,1,0,0,1,5,1
mongodb-geospatial,mongodb-geospatial,,6,4,10,10,0,20,1,1
dnn9,dnn9,,10,15,13,25,0,38,8,50
shfb,shfb,,0,1,1,1,0,2,8,1
ibm-jre,ibm-jre,,2,0,1,2,0,3,3,1
eclipse-2018-09,eclipse-2018-09,,3,0,11,3,0,14,3,1
pysmb,pysmb,,3,2,5,5,0,10,0,1
pydio,pydio,,0,0,3,0,0,3,4,1
aion,aion,,2,2,6,4,0,10,6,1
panelgrid,panelgrid,,0,0,1,0,0,1,3,1
adipoli,adipoli,,0,0,1,0,0,1,1,1
aumbry,aumbry,,0,0,1,0,0,1,0,1
pulumi,pulumi,,11,5,8,16,0,24,6,1
video-component,video-component,,0,0,1,0,0,1,1,1
ssms-18,ssms-18,,1,3,1,4,0,5,4,200
code-search-engine,code-search-engine,,0,0,3,0,0,3,4,1
quectel,quectel,,5,3,8,8,0,16,9,1
ms-error-9,ms-error-9,,3,0,2,3,0,5,5,1
httppostedfile,httppostedfile,,1,1,1,2,0,3,8,1
jstorm,jstorm,,0,0,1,0,0,1,2,1
extension-objects,extension-objects,,0,0,1,0,0,1,8,1
kakasi,kakasi,,1,0,1,1,0,2,0,1
spoon-gradle-plugin,spoon-gradle-plugin,,0,0,2,0,0,2,3,1
nuxt-i18n,nuxt-i18n,,4,2,9,6,0,15,1,1
uwsgi-stats-server,uwsgi-stats-server,,1,0,1,1,0,2,0,1
cmake-language,cmake-language,,6,7,6,13,0,19,9,16.666667
azure-sql-managed-instance,azure-sql-managed-instance,,11,6,30,17,0,47,8,1
unity3d-shaders,unity3d-shaders,,3,1,9,4,0,13,8,1
haskell-backpack,haskell-backpack,,2,0,1,2,0,3,2,1
void-safety,void-safety,,0,0,5,0,0,5,9,1
ios13,ios13,,2,364,1,366,0,367,13,18100
cfadmin,cfadmin,,3,1,1,4,0,5,4,1
pkcs#15,pkcs#15,,0,0,1,0,0,1,6,1
imagedata,imagedata,,5,3,8,8,0,16,1,1
ecmascript-intl,ecmascript-intl,,0,1,1,1,0,2,1,1
srec-cat,srec-cat,,0,0,2,0,0,2,0,1
apache-airflow-xcom,apache-airflow-xcom,,16,14,18,30,0,48,0,1
xamarin-previewer,xamarin-previewer,,2,0,1,2,0,3,8,1
location-history,location-history,,0,0,1,0,0,1,1,1
mkoverlaypathrenderer,mkoverlaypathrenderer,,0,0,2,0,0,2,13,1
gitfs,gitfs,,0,1,2,1,0,3,0,1
general-sql-parser,general-sql-parser,,0,1,1,1,0,2,4,1
ios9.1,ios9.1,,0,0,2,0,0,2,13,1
dev-appserver-2,dev-appserver-2,,0,0,1,0,0,1,6,1
anglican,anglican,,0,0,2,0,0,2,2,1
adwords-budgetservice,adwords-budgetservice,,0,0,2,0,0,2,5,1
cirrious.fluentlayout,cirrious.fluentlayout,,0,0,1,0,0,1,8,1
http-daemon,http-daemon,,0,0,1,0,0,1,9,1
machine-config,machine-config,,0,0,1,0,0,1,8,1
cdap,cdap,,8,6,7,14,0,21,6,1
open-components,open-components,,0,0,2,0,0,2,1,1
bukkit-vault,bukkit-vault,,0,0,1,0,0,1,3,1
makekeyandordertofront,makekeyandordertofront,,0,0,1,0,0,1,13,1
patch-package,patch-package,,0,1,1,1,0,2,1,1
android-subscriptionmanager,android-subscriptionmanager,,2,0,3,2,0,5,3,1
azure-digital-twins,azure-digital-twins,,5,5,3,10,0,13,8,1
node-xbee,node-xbee,,0,1,2,1,0,3,0,1
mpls,mpls,,1,1,4,2,0,6,9,1
v-stepper,v-stepper,,0,0,4,0,0,4,1,1
echonest,echonest,,0,0,1,0,0,1,4,1
coldfusion-2018,coldfusion-2018,,11,14,25,25,0,50,4,27.272727
frame-size,frame-size,,0,1,3,1,0,4,0,1
jerkson,jerkson,,0,0,1,0,0,1,2,1
procps,procps,,1,1,1,2,0,3,9,1
rust-obsolete,rust-obsolete,,0,0,1,0,0,1,9,1
webdna,webdna,,0,0,1,0,0,1,5,1
ora-00955,ora-00955,,0,0,2,0,0,2,0,1
rc-form,rc-form,,1,2,2,3,0,5,1,100
cocoapods-1.6,cocoapods-1.6,,0,0,1,0,0,1,13,1
mms-gateway,mms-gateway,,0,0,3,0,0,3,3,1
proxybroker,proxybroker,,0,2,2,2,0,4,0,100
google-chrome-frame,google-chrome-frame,,0,0,1,0,0,1,1,1
gdx-ai,gdx-ai,,1,1,1,2,0,3,3,1
gradle-native,gradle-native,,2,1,1,3,0,4,9,1
cbt,cbt,,0,1,2,1,0,3,6,1
entity-framework-6.2,entity-framework-6.2,,4,2,4,6,0,10,8,1
advising-functions,advising-functions,,0,0,1,0,0,1,9,1
ninjakit,ninjakit,,0,0,2,0,0,2,1,1
zsync,zsync,,0,0,2,0,0,2,1,1
batch-drawing,batch-drawing,,0,0,1,0,0,1,8,1
drupal-fapi,drupal-fapi,,1,0,2,1,0,3,4,1
jdk-internal-api,jdk-internal-api,,0,0,1,0,0,1,5,1
librecad,librecad,,0,0,1,0,0,1,0,1
balde,balde,,0,0,1,0,0,1,4,1
product-key,product-key,,0,2,3,2,0,5,8,100
stylus-loader,stylus-loader,,1,4,4,5,0,9,1,300
swiftgen,swiftgen,,1,0,3,1,0,4,13,1
neutralinojs,neutralinojs,,0,0,1,0,0,1,1,1
high-level-architecture,high-level-architecture,,0,0,2,0,0,2,9,1
mcs,mcs,,0,2,2,2,0,4,4,100
com.sun.net.httpserver,com.sun.net.httpserver,,1,1,4,2,0,6,3,1
druntime,druntime,,0,0,1,0,0,1,9,1
hamachi,hamachi,,0,0,4,0,0,4,3,1
dask-ml,dask-ml,,4,9,11,13,0,24,0,125
php-generators,php-generators,,0,2,2,2,0,4,4,100
jython-music,jython-music,,1,0,1,1,0,2,0,1
knockout-templating,knockout-templating,,0,0,2,0,0,2,1,1
rust-proc-macros,rust-proc-macros,,5,3,9,8,0,17,9,1
internet-explorer-5,internet-explorer-5,,0,0,3,0,0,3,1,1
ocmockito,ocmockito,,0,0,2,0,0,2,13,1
build-templates,build-templates,,0,0,1,0,0,1,8,1
gravitee,gravitee,,2,4,3,6,0,9,3,100
sitecore-branch-templates,sitecore-branch-templates,,0,0,1,0,0,1,8,1
jquery-flipster,jquery-flipster,,0,0,2,0,0,2,1,1
sitetemplate,sitetemplate,,0,0,1,0,0,1,8,1
qlinkedlist,qlinkedlist,,0,0,1,0,0,1,9,1
teltonika,teltonika,,0,0,2,0,0,2,3,1
ultrawebgrid,ultrawebgrid,,1,0,1,1,0,2,8,1
plunit,plunit,,0,0,3,0,0,3,0,1
svggraph,svggraph,,0,0,1,0,0,1,4,1
uberspace,uberspace,,0,0,2,0,0,2,12,1
alpr,alpr,,6,1,5,7,0,12,0,1
double-submit-problem,double-submit-problem,,0,0,1,0,0,1,4,1
hypersql,hypersql,,0,2,3,2,0,5,3,100
gedmo-loggable,gedmo-loggable,,0,1,5,1,0,6,4,1
angularjs-include,angularjs-include,,0,0,2,0,0,2,1,1
cryptlib,cryptlib,,2,1,1,3,0,4,13,1
amazon-gateway,amazon-gateway,,1,5,4,6,0,10,6,400
bartmachine,bartmachine,,1,0,4,1,0,5,0,1
clim,clim,,0,0,1,0,0,1,0,1
weld-junit5,weld-junit5,,0,3,3,3,0,6,3,200
nteract,nteract,,1,0,1,1,0,2,0,1
dart-editor,dart-editor,,0,0,1,0,0,1,13,1
grandstack,grandstack,,2,7,5,9,0,14,1,250
deploymentitem,deploymentitem,,0,0,1,0,0,1,8,1
tcpportsharing,tcpportsharing,,0,0,1,0,0,1,8,1
peekmessage,peekmessage,,0,1,2,1,0,3,9,1
datacolumncollection,datacolumncollection,,0,0,1,0,0,1,8,1
ubuntu-10.04,ubuntu-10.04,,1,1,2,2,0,4,6,1
truevault,truevault,,0,1,2,1,0,3,1,1
bitmex,bitmex,,1,3,8,4,0,12,0,200
elm-0.18,elm-0.18,,3,0,1,3,0,4,1,1
mako-sdk,mako-sdk,,1,0,6,1,0,7,8,1
azure-front-door,azure-front-door,,9,9,4,18,0,22,8,1
threestate,threestate,,0,0,1,0,0,1,8,1
xproc,xproc,,1,0,1,1,0,2,9,1
meshroom,meshroom,,0,0,1,0,0,1,0,1
self-signed-certificate,self-signed-certificate,,18,14,21,32,0,53,6,1
better-errors-gem,better-errors-gem,,0,0,1,0,0,1,12,1
ios-pdfkit-outlines,ios-pdfkit-outlines,,0,0,1,0,0,1,13,1
netjson,netjson,,0,0,1,0,0,1,1,1
invoke-webrequest,invoke-webrequest,,14,18,16,32,0,48,8,28.571429
miso.dataset,miso.dataset,,0,0,1,0,0,1,5,1
rejoiner,rejoiner,,0,0,1,0,0,1,6,1
pylearn2,pylearn2,,0,0,1,0,0,1,0,1
serviceconnection,serviceconnection,,3,1,1,4,0,5,8,1
app-data,app-data,,2,1,2,3,0,5,9,1
common-service-locator,common-service-locator,,2,1,2,3,0,5,8,1
xslt-tools,xslt-tools,,0,0,1,0,0,1,3,1
3d-mapping,3d-mapping,,4,3,2,7,0,9,0,1
toolkitscriptmanager,toolkitscriptmanager,,0,0,1,0,0,1,8,1
meteor-plugin,meteor-plugin,,0,0,1,0,0,1,1,1
zip-conduit,zip-conduit,,0,0,1,0,0,1,2,1
list-unsubscribe,list-unsubscribe,,0,1,5,1,0,6,4,1
rollup-plugin-license,rollup-plugin-license,,0,0,1,0,0,1,1,1
hexchat,hexchat,,0,0,2,0,0,2,9,1
akka.fsharp,akka.fsharp,,0,0,1,0,0,1,8,1
entity-data-model,entity-data-model,,0,1,2,1,0,3,8,1
horizontal-accuracy,horizontal-accuracy,,1,0,4,1,0,5,3,1
pkcs#5,pkcs#5,,0,0,3,0,0,3,6,1
bixby,bixby,,47,38,39,85,0,124,21,1
windows-live-id,windows-live-id,,0,0,2,0,0,2,8,1
matplotlib-table,matplotlib-table,,1,1,3,2,0,5,0,1
qtest,qtest,,4,8,3,12,0,15,9,100
reverting,reverting,,0,1,1,1,0,2,6,1
nhibernate-inheritance,nhibernate-inheritance,,0,1,1,1,0,2,8,1
system.threading.channels,system.threading.channels,,1,2,4,3,0,7,8,100
google-auth-library,google-auth-library,,11,8,16,19,0,35,5,1
tclientsocket,tclientsocket,,0,2,3,2,0,5,9,100
android-jsinterface,android-jsinterface,,2,0,2,2,0,4,3,1
libasound,libasound,,1,0,3,1,0,4,13,1
plsql-gateway,plsql-gateway,,0,0,1,0,0,1,4,1
learnpress,learnpress,,3,3,2,6,0,8,4,1
drupal-multi-domain,drupal-multi-domain,,1,0,2,1,0,3,6,1
knockout-components,knockout-components,,0,0,3,0,0,3,1,1
alexa-notification,alexa-notification,,0,0,3,0,0,3,6,1
wkinterfacemap,wkinterfacemap,,1,0,1,1,0,2,13,1
qaudioinput,qaudioinput,,0,1,2,1,0,3,9,1
zero-extension,zero-extension,,2,0,1,2,0,3,9,1
oledbparameter,oledbparameter,,1,0,1,1,0,2,8,1
jupyter-dyalog-kernel,jupyter-dyalog-kernel,,0,0,1,0,0,1,0,1
systypes.h,systypes.h,,0,0,1,0,0,1,9,1
instruction-reordering,instruction-reordering,,5,1,2,6,0,8,9,1
nunit-addins,nunit-addins,,0,0,1,0,0,1,8,1
libmongoc,libmongoc,,1,1,6,2,0,8,1,1
jsdoc2md,jsdoc2md,,0,0,1,0,0,1,1,1
autoexpect,autoexpect,,1,0,1,1,0,2,9,1
ruby-box,ruby-box,,0,0,1,0,0,1,4,1
ikimageview,ikimageview,,0,1,2,1,0,3,13,1
php-namespaces,php-namespaces,,0,0,3,0,0,3,4,1
informatica-cloud,informatica-cloud,,5,11,8,16,0,24,4,120
visual-studio-publish,visual-studio-publish,,2,0,3,2,0,5,8,1
tensorflow-data-validation,tensorflow-data-validation,,2,0,5,2,0,7,0,1
dse-graph-frames,dse-graph-frames,,1,2,5,3,0,8,2,100
postgres-xc,postgres-xc,,0,0,1,0,0,1,4,1
maven-nbm,maven-nbm,,0,0,1,0,0,1,3,1
http-status-code-505,http-status-code-505,,1,1,1,2,0,3,3,1
git-ls-remote,git-ls-remote,,3,0,1,3,0,4,6,1
vmargs,vmargs,,1,1,1,2,0,3,3,1
phonenumberkit,phonenumberkit,,2,1,3,3,0,6,13,1
component-query,component-query,,0,0,1,0,0,1,1,1
infrastructure-as-a-code,infrastructure-as-a-code,,18,20,18,38,0,56,6,11.111111
apache-tuscany,apache-tuscany,,0,0,1,0,0,1,3,1
kotlin-function-type,kotlin-function-type,,1,0,4,1,0,5,3,1
meta-search,meta-search,,0,0,2,0,0,2,12,1
brazos,brazos,,0,0,1,0,0,1,3,1
swipe.js,swipe.js,,0,0,1,0,0,1,1,1
microsoft-custom-vision,microsoft-custom-vision,,26,15,11,41,0,52,8,1
solr-cell,solr-cell,,0,0,1,0,0,1,2,1
osgi-ds,osgi-ds,,0,1,1,1,0,2,3,1
openid-dex,openid-dex,,1,1,1,2,0,3,6,1
scivis,scivis,,0,0,1,0,0,1,0,1
python-scoop,python-scoop,,0,1,4,1,0,5,0,1
firebase-util,firebase-util,,0,0,1,0,0,1,13,1
angle-to-euclidean-space,angle-to-euclidean-space,,0,0,1,0,0,1,0,1
cri-o,cri-o,,1,1,1,2,0,3,6,1
rawcontactid,rawcontactid,,0,0,1,0,0,1,3,1
pygrametl,pygrametl,,0,0,2,0,0,2,0,1
unreal-gameplay-ability-system,unreal-gameplay-ability-system,,0,1,10,1,0,11,9,1
xnat,xnat,,3,1,1,4,0,5,3,1
low-level-api,low-level-api,,0,2,3,2,0,5,0,100
sidekick,sidekick,,7,10,16,17,0,33,1,42.857143
react-leaflet-draw,react-leaflet-draw,,0,2,2,2,0,4,1,100
leaflet-draw,leaflet-draw,,3,9,4,12,0,16,1,200
steamvr,steamvr,,21,13,31,34,0,65,8,1
wombat-1,wombat-1,,0,0,2,0,0,2,9,1
time-bomb,time-bomb,,0,1,1,1,0,2,3,1
direct-composition,direct-composition,,0,0,2,0,0,2,9,1
react-static,react-static,,11,1,9,12,0,21,1,1
jakarta-ee,jakarta-ee,,8,4,6,12,0,18,3,1
vue-dropzone,vue-dropzone,,2,2,7,4,0,11,1,1
clktextprovider,clktextprovider,,0,0,2,0,0,2,13,1
bwplot,bwplot,,1,0,1,1,0,2,0,1
manim,manim,,4,7,2,11,0,13,0,75
network.framework,network.framework,,1,1,5,2,0,7,13,1
etcd2,etcd2,,1,0,1,1,0,2,6,1
cordova-plugin-advanced-http,cordova-plugin-advanced-http,,2,2,3,4,0,7,1,1
insight.database,insight.database,,1,0,2,1,0,3,8,1
firefly-mv,firefly-mv,,0,0,1,0,0,1,8,1
apache-commons-scxml,apache-commons-scxml,,0,0,3,0,0,3,9,1
ras,ras,,4,1,2,5,0,7,9,1
contentful-api,contentful-api,,3,4,2,7,0,9,1,33.333333
ballerina-kafka,ballerina-kafka,,1,0,1,1,0,2,14,1
mod-rails,mod-rails,,0,0,2,0,0,2,12,1
tpu,tpu,,37,35,23,72,0,95,0,1
cthreads,cthreads,,0,0,1,0,0,1,8,1
overhead-minimization,overhead-minimization,,1,0,1,1,0,2,9,1
vulcanjs,vulcanjs,,0,2,1,2,0,3,1,100
cfclient,cfclient,,0,0,1,0,0,1,4,1
inherited-constructors,inherited-constructors,,3,1,1,4,0,5,9,1
wsastartup,wsastartup,,1,0,2,1,0,3,9,1
nosql-injection,nosql-injection,,4,0,4,4,0,8,1,1
clouddb,clouddb,,0,1,1,1,0,2,3,1
pickmeup,pickmeup,,0,0,1,0,0,1,1,1
dreamweaver-templates,dreamweaver-templates,,0,0,1,0,0,1,1,1
smarty-plugins,smarty-plugins,,0,1,2,1,0,3,4,1
msrpc,msrpc,,1,0,1,1,0,2,3,1
collaborative,collaborative,,0,1,2,1,0,3,0,1
paya,paya,,0,0,1,0,0,1,12,1
dynamic-frameworks,dynamic-frameworks,,0,2,3,2,0,5,13,100
ag-grid-valuesetter,ag-grid-valuesetter,,2,0,4,2,0,6,1,1
ag-grid-validation,ag-grid-validation,,1,0,6,1,0,7,1,1
ora-06502,ora-06502,,0,0,1,0,0,1,4,1
google-cloud-armor,google-cloud-armor,,1,3,4,4,0,8,6,200
tradacoms,tradacoms,,0,0,1,0,0,1,3,1
document-imaging,document-imaging,,0,0,1,0,0,1,1,1
stripe-payout,stripe-payout,,2,1,2,3,0,5,4,1
omnicontacts-gem,omnicontacts-gem,,0,2,2,2,0,4,12,100
hdevelop,hdevelop,,0,0,2,0,0,2,0,1
windowsphotogallery,windowsphotogallery,,0,0,1,0,0,1,0,1
google-vault-api,google-vault-api,,1,1,5,2,0,7,5,1
ccombo,ccombo,,0,0,1,0,0,1,3,1
nspr,nspr,,0,1,2,1,0,3,9,1
fastzip,fastzip,,0,0,1,0,0,1,8,1
facebook-tag,facebook-tag,,0,0,1,0,0,1,3,1
proclarity,proclarity,,0,0,2,0,0,2,1,1
offline-web-app,offline-web-app,,0,0,3,0,0,3,1,1
steeltoe,steeltoe,,2,6,7,8,0,15,8,200
fedext,fedext,,0,0,1,0,0,1,4,1
rdbms-agnostic,rdbms-agnostic,,0,0,1,0,0,1,4,1
agm-direction,agm-direction,,1,2,3,3,0,6,1,100
listproperty,listproperty,,0,0,2,0,0,2,0,1
document-repository,document-repository,,0,0,1,0,0,1,4,1
ie-plugins,ie-plugins,,0,0,1,0,0,1,0,1
jeddict,jeddict,,1,0,1,1,0,2,4,1
qwtpolar,qwtpolar,,0,0,1,0,0,1,9,1
lucid,lucid,,0,4,1,4,0,5,0,300
irssi,irssi,,1,0,1,1,0,2,9,1
propositional-calculus,propositional-calculus,,1,1,2,2,0,4,0,1
zumero,zumero,,0,1,1,1,0,2,1,1
qtremoteobjects,qtremoteobjects,,0,3,6,3,0,9,9,200
apache-spot,apache-spot,,0,0,2,0,0,2,2,1
information-server,information-server,,2,0,4,2,0,6,4,1
webpack-provide-plugin,webpack-provide-plugin,,1,1,2,2,0,4,1,1
boost-mpi,boost-mpi,,2,2,1,4,0,5,9,1
facebooksdk-4.37,facebooksdk-4.37,,0,0,2,0,0,2,1,1
cubrid,cubrid,,0,1,1,1,0,2,3,1
itemcommand,itemcommand,,1,0,1,1,0,2,8,1
javaimports,javaimports,,0,0,1,0,0,1,3,1
enumerated-types,enumerated-types,,0,1,1,1,0,2,4,1
mstdc,mstdc,,0,0,1,0,0,1,8,1
google-alerts,google-alerts,,0,2,3,2,0,5,4,100
virtualmode,virtualmode,,0,0,4,0,0,4,8,1
iphone-xr,iphone-xr,,5,4,7,9,0,16,13,1
flow-expression,flow-expression,,0,0,2,0,0,2,8,1
actionform,actionform,,0,0,2,0,0,2,3,1
mapkeyjoincolumn,mapkeyjoincolumn,,0,0,1,0,0,1,3,1
node-vsphere,node-vsphere,,0,0,1,0,0,1,6,1
piexif,piexif,,1,1,3,2,0,5,0,1
vapoursynth,vapoursynth,,0,0,2,0,0,2,0,1
dukpt,dukpt,,0,0,2,0,0,2,6,1
bulk-import,bulk-import,,1,0,3,1,0,4,4,1
shinyanimate,shinyanimate,,0,0,2,0,0,2,0,1
reach-router,reach-router,,8,12,16,20,0,36,1,50
pyzmail,pyzmail,,0,1,2,1,0,3,0,1
skdownload,skdownload,,0,0,2,0,0,2,13,1
gacutil,gacutil,,2,1,2,3,0,5,8,1
turnip,turnip,,0,0,1,0,0,1,12,1
karel,karel,,1,0,4,1,0,5,3,1
ott,ott,,1,1,1,2,0,3,3,1
rna-seq,rna-seq,,9,5,15,14,0,29,0,1
govmomi,govmomi,,2,1,1,3,0,4,6,1
hi-tech-c,hi-tech-c,,0,1,1,1,0,2,9,1
cordite,cordite,,1,6,5,7,0,12,3,500
abandonedmutexexception,abandonedmutexexception,,0,0,1,0,0,1,9,1
integromat,integromat,,2,1,1,3,0,4,8,1
spring-tools-4,spring-tools-4,,7,7,5,14,0,19,3,1
ads-data-hub,ads-data-hub,,1,0,1,1,0,2,4,1
google-ads-data-hub,google-ads-data-hub,,1,1,2,2,0,4,4,1
androidx-test,androidx-test,,3,3,6,6,0,12,3,1
sqldmo,sqldmo,,0,0,1,0,0,1,8,1
chainability,chainability,,0,0,1,0,0,1,9,1
jolie,jolie,,2,2,5,4,0,9,3,1
ndnsim,ndnsim,,0,1,1,1,0,2,6,1
google-allo,google-allo,,0,0,1,0,0,1,3,1
alsb,alsb,,0,0,1,0,0,1,3,1
viadeo,viadeo,,0,0,1,0,0,1,3,1
spintax,spintax,,1,0,1,1,0,2,4,1
mapbox-unity,mapbox-unity,,1,0,1,1,0,2,8,1
wscript.shell,wscript.shell,,4,6,7,10,0,17,5,50
svn-server,svn-server,,0,1,1,1,0,2,6,1
osvr,osvr,,0,0,1,0,0,1,9,1
numeraljs,numeraljs,,1,2,1,3,0,4,1,100
time-to-first-byte,time-to-first-byte,,2,2,5,4,0,9,4,1
usercake,usercake,,0,1,1,1,0,2,4,1
draper,draper,,0,0,2,0,0,2,12,1
wasm-bindgen,wasm-bindgen,,9,5,14,14,0,28,9,1
column-sum,column-sum,,0,2,4,2,0,6,0,100
single-user,single-user,,0,1,1,1,0,2,4,1
gforge,gforge,,0,0,1,0,0,1,6,1
propertyeditor,propertyeditor,,0,1,2,1,0,3,3,1
swagger-3.0,swagger-3.0,,3,10,13,13,0,26,3,233.333333
react-ref,react-ref,,8,10,19,18,0,37,1,25
symfony-messenger,symfony-messenger,,3,8,7,11,0,18,4,166.666667
enqueue,enqueue,,14,16,15,30,0,45,4,14.285714
win32con,win32con,,2,1,1,3,0,4,0,1
iconbutton,iconbutton,,0,3,1,3,0,4,13,200
madlib,madlib,,0,0,2,0,0,2,4,1
telerik-radribbonbar,telerik-radribbonbar,,0,0,1,0,0,1,1,1
dfdl,dfdl,,0,4,3,4,0,7,3,300
medium-trust,medium-trust,,0,1,1,1,0,2,8,1
symfony-panther,symfony-panther,,1,2,4,3,0,7,4,100
exfat-fuse,exfat-fuse,,0,0,1,0,0,1,3,1
htmldocumentclass,htmldocumentclass,,0,0,1,0,0,1,8,1
sage-crm,sage-crm,,0,0,1,0,0,1,4,1
kendo-mobile,kendo-mobile,,3,1,5,4,0,9,1,1
moonscript,moonscript,,0,0,1,0,0,1,9,1
vlc.dotnet,vlc.dotnet,,2,3,4,5,0,9,8,50
imgix-js,imgix-js,,0,1,1,1,0,2,1,1
win-prolog,win-prolog,,1,0,2,1,0,3,0,1
lpa-flex,lpa-flex,,0,0,1,0,0,1,0,1
ctr-mode,ctr-mode,,0,0,3,0,0,3,6,1
wxerlang,wxerlang,,1,0,1,1,0,2,2,1
fetch2,fetch2,,1,0,1,1,0,2,3,1
minicart,minicart,,1,5,6,6,0,12,4,400
clkfullcolorimageprovider,clkfullcolorimageprovider,,0,0,2,0,0,2,13,1
defaultstyleddocument,defaultstyleddocument,,0,0,2,0,0,2,3,1
eucalyptus,eucalyptus,,1,0,3,1,0,4,6,1
loadingbar.js,loadingbar.js,,0,1,1,1,0,2,1,1
stream-wrapper,stream-wrapper,,0,0,1,0,0,1,6,1
strictfp,strictfp,,1,2,1,3,0,4,3,100
hbasestorage,hbasestorage,,0,0,2,0,0,2,2,1
nuget-credential-provider,nuget-credential-provider,,0,0,1,0,0,1,8,1
tls1.3,tls1.3,,14,8,9,22,0,31,6,1
apache-stanbol,apache-stanbol,,0,0,2,0,0,2,3,1
rubymotion-promotion,rubymotion-promotion,,0,0,1,0,0,1,13,1
pybonjour,pybonjour,,0,0,1,0,0,1,0,1
angular-material-datetimepicker,angular-material-datetimepicker,,3,10,8,13,0,21,1,233.333333
nes,nes,,1,1,3,2,0,5,9,1
asn1crypto,asn1crypto,,0,0,3,0,0,3,6,1
mock-location,mock-location,,4,1,6,5,0,11,3,1
scientific-software,scientific-software,,1,1,1,2,0,3,0,1
ias,ias,,0,0,1,0,0,1,9,1
vue-storefront,vue-storefront,,4,3,6,7,0,13,1,1
carrierwave-direct,carrierwave-direct,,0,0,3,0,0,3,12,1
nintendo-ds,nintendo-ds,,0,0,1,0,0,1,9,1
delay-bind,delay-bind,,0,0,2,0,0,2,8,1
spring-data-r2dbc,spring-data-r2dbc,,5,12,6,17,0,23,3,140
r2dbc,r2dbc,,7,13,7,20,0,27,3,85.714286
jbossts,jbossts,,0,1,1,1,0,2,3,1
slk,slk,,0,0,1,0,0,1,0,1
modin,modin,,2,3,1,5,0,6,0,50
windows-3.1,windows-3.1,,1,1,1,2,0,3,1,1
project-gutenberg,project-gutenberg,,0,2,3,2,0,5,0,100
settingsprovider,settingsprovider,,0,0,1,0,0,1,3,1
gost3410,gost3410,,0,2,1,2,0,3,6,100
odoo-12,odoo-12,,90,140,86,230,0,316,0,55.555556
rocket-loader,rocket-loader,,2,0,1,2,0,3,4,1
viewmodelproviders,viewmodelproviders,,1,1,4,2,0,6,3,1
vssconverter,vssconverter,,1,0,1,1,0,2,8,1
thruk,thruk,,0,0,4,0,0,4,6,1
composer-plugin,composer-plugin,,0,0,1,0,0,1,4,1
data.cube,data.cube,,0,0,1,0,0,1,0,1
odbc-sql-server-driver,odbc-sql-server-driver,,0,1,1,1,0,2,13,1
susy-compass,susy-compass,,1,0,1,1,0,2,1,1
map-api,map-api,,0,0,8,0,0,8,1,1
apiconnect-test-monitor,apiconnect-test-monitor,,0,0,3,0,0,3,6,1
ubersvn,ubersvn,,0,0,1,0,0,1,6,1
intellisense-documentati,intellisense-documentati,,0,0,1,0,0,1,8,1
jpanelmenu,jpanelmenu,,0,0,1,0,0,1,3,1
iclientmessageinspector,iclientmessageinspector,,0,0,2,0,0,2,8,1
poet,poet,,0,0,1,0,0,1,0,1
applescript-numbers,applescript-numbers,,2,1,2,3,0,5,13,1
read-host,read-host,,3,0,1,3,0,4,8,1
kotlin-fuel,kotlin-fuel,,2,0,2,2,0,4,3,1
inline-attachments,inline-attachments,,0,0,2,0,0,2,12,1
objectsize,objectsize,,1,1,1,2,0,3,0,1
ruby-development-tools,ruby-development-tools,,0,0,1,0,0,1,12,1
glossaries,glossaries,,1,0,1,1,0,2,0,1
terminal-services-gateway,terminal-services-gateway,,0,0,1,0,0,1,8,1
islamic-calendar,islamic-calendar,,0,0,3,0,0,3,3,1
vegeta,vegeta,,2,2,4,4,0,8,3,1
rainerscript,rainerscript,,0,0,2,0,0,2,9,1
testdrivendesign,testdrivendesign,,0,0,1,0,0,1,8,1
revision-graph,revision-graph,,0,0,1,0,0,1,6,1
prometheus-node-exporter,prometheus-node-exporter,,12,11,27,23,0,50,6,1
dbgeng,dbgeng,,0,0,1,0,0,1,9,1
radchart,radchart,,3,0,4,3,0,7,1,1
open-location-code,open-location-code,,1,0,1,1,0,2,1,1
mac-roman,mac-roman,,0,0,3,0,0,3,4,1
dawg,dawg,,1,0,1,1,0,2,0,1
ndebug,ndebug,,1,1,1,2,0,3,9,1
scale-color-manual,scale-color-manual,,1,2,6,3,0,9,0,100
sharepoint-upgrade,sharepoint-upgrade,,0,0,1,0,0,1,8,1
nsfontmanager,nsfontmanager,,0,0,1,0,0,1,13,1
nsfontpanel,nsfontpanel,,0,0,1,0,0,1,13,1
batarang,batarang,,0,0,1,0,0,1,1,1
ios-mqtt-client-framework,ios-mqtt-client-framework,,0,0,2,0,0,2,13,1
kovenant,kovenant,,0,0,3,0,0,3,3,1
workflow-manager-1.x,workflow-manager-1.x,,1,0,2,1,0,3,4,1
ucs-4,ucs-4,,0,0,1,0,0,1,0,1
kooboo,kooboo,,0,0,1,0,0,1,6,1
chgrp,chgrp,,0,0,1,0,0,1,9,1
nape,nape,,0,0,1,0,0,1,13,1
yii-chtml,yii-chtml,,0,0,1,0,0,1,4,1
forever-frame,forever-frame,,0,0,1,0,0,1,8,1
uiprintinfo,uiprintinfo,,0,1,1,1,0,2,13,1
graphql-python,graphql-python,,2,1,2,3,0,5,1,1
gcp-notebook,gcp-notebook,,3,5,3,8,0,11,0,66.666667
react-color,react-color,,0,1,1,1,0,2,1,1
stress,stress,,0,0,1,0,0,1,1,1
infection,infection,,0,1,2,1,0,3,4,1
event-calendar,event-calendar,,2,2,4,4,0,8,4,1
cmark,cmark,,0,0,1,0,0,1,13,1
p2-director,p2-director,,1,0,1,1,0,2,3,1
spring-groovy-config,spring-groovy-config,,0,0,2,0,0,2,3,1
azure-task-groups,azure-task-groups,,1,0,1,1,0,2,8,1
nunit-2.5,nunit-2.5,,0,1,2,1,0,3,8,1
gvisgeomap,gvisgeomap,,0,0,1,0,0,1,8,1
datascroller,datascroller,,0,1,3,1,0,4,3,1
gambas,gambas,,0,0,1,0,0,1,9,1
userjs,userjs,,0,0,2,0,0,2,1,1
loading-animation,loading-animation,,0,0,1,0,0,1,1,1
mdb-select,mdb-select,,0,0,1,0,0,1,1,1
iqueryprovider,iqueryprovider,,0,0,2,0,0,2,8,1
assemblyscript,assemblyscript,,0,2,2,2,0,4,1,100
conll,conll,,0,3,3,3,0,6,0,200
itemwriter,itemwriter,,1,1,5,2,0,7,3,1
ts-jest,ts-jest,,23,30,11,53,0,64,1,30.434783
google-cloud-talent-solution,google-cloud-talent-solution,,1,8,4,9,0,13,5,700
flask-flatpages,flask-flatpages,,0,0,1,0,0,1,0,1
lolcode,lolcode,,0,0,1,0,0,1,9,1
crawlera,crawlera,,1,2,10,3,0,13,0,100
las,las,,7,0,5,7,0,12,0,1
jquery-bootpag,jquery-bootpag,,0,0,2,0,0,2,1,1
time-precision,time-precision,,0,0,1,0,0,1,9,1
aswebauthenticationsession,aswebauthenticationsession,,2,1,3,3,0,6,13,1
mongobee,mongobee,,2,0,4,2,0,6,3,1
gulp-preprocess,gulp-preprocess,,0,1,1,1,0,2,1,1
wcf-streaming,wcf-streaming,,0,0,1,0,0,1,8,1
dvc,dvc,,1,2,3,3,0,6,0,100
josso,josso,,0,1,1,1,0,2,8,1
path.js,path.js,,0,0,1,0,0,1,1,1
trianglify,trianglify,,0,0,1,0,0,1,1,1
html5-capture,html5-capture,,0,0,2,0,0,2,1,1
turbogears,turbogears,,0,1,2,1,0,3,0,1
ggcorrplot,ggcorrplot,,1,4,2,5,0,7,0,300
server-tags,server-tags,,1,0,1,1,0,2,8,1
http-status-code-421,http-status-code-421,,0,0,2,0,0,2,4,1
msas,msas,,0,0,2,0,0,2,4,1
nativescript-codesharing,nativescript-codesharing,,3,2,6,5,0,11,1,1
oidc-provider,oidc-provider,,1,0,2,1,0,3,4,1
vivagraphjs,vivagraphjs,,0,0,1,0,0,1,1,1
javolution,javolution,,0,1,2,1,0,3,3,1
drupal-preprocess,drupal-preprocess,,0,0,2,0,0,2,4,1
data-interchange,data-interchange,,0,0,1,0,0,1,4,1
spring-cli,spring-cli,,1,0,2,1,0,3,3,1
frameworkelementfactory,frameworkelementfactory,,0,0,2,0,0,2,8,1
mkusertrackingmode,mkusertrackingmode,,0,0,1,0,0,1,13,1
hibernate-mode,hibernate-mode,,0,0,2,0,0,2,13,1
azure-devops-hosted-agent,azure-devops-hosted-agent,,11,2,15,13,0,28,8,1
scnsphere,scnsphere,,0,0,4,0,0,4,13,1
angular-material-7,angular-material-7,,48,28,33,76,0,109,1,1
littler,littler,,0,0,1,0,0,1,0,1
richdatatable,richdatatable,,0,0,2,0,0,2,3,1
avplayerlooper,avplayerlooper,,0,1,8,1,0,9,13,1
azure-data-studio,azure-data-studio,,8,6,11,14,0,25,4,1
excel-2019,excel-2019,,9,7,6,16,0,22,5,1
realitykit,realitykit,,1,25,1,26,0,27,13,2400
customscrollview,customscrollview,,4,3,2,7,0,9,13,1
haskell-src-exts,haskell-src-exts,,0,1,3,1,0,4,2,1
nshttpurlresponse,nshttpurlresponse,,1,2,2,3,0,5,13,100
c#-native-library,c#-native-library,,0,0,1,0,0,1,8,1
pygui,pygui,,0,0,1,0,0,1,0,1
visual-studio-app-center-push,visual-studio-app-center-push,,1,1,5,2,0,7,8,1
jasync-sql,jasync-sql,,2,0,1,2,0,3,3,1
cfform,cfform,,0,0,1,0,0,1,4,1
cnpostaladdress,cnpostaladdress,,0,1,1,1,0,2,13,1
adjustable,adjustable,,1,0,1,1,0,2,1,1
android-editable,android-editable,,0,0,4,0,0,4,3,1
powerapps-modeldriven,powerapps-modeldriven,,0,1,2,1,0,3,8,1
oracle-outside-in,oracle-outside-in,,0,1,1,1,0,2,8,1
parameter-splatting,parameter-splatting,,1,0,1,1,0,2,8,1
compositionroot,compositionroot,,0,1,1,1,0,2,8,1
smallcheck,smallcheck,,0,2,1,2,0,3,2,100
libfuzzer,libfuzzer,,1,2,4,3,0,7,9,100
partial-matches,partial-matches,,2,2,4,4,0,8,0,1
libp2p,libp2p,,3,3,5,6,0,11,1,1
go-libp2p,go-libp2p,,0,1,2,1,0,3,1,1
deeplab,deeplab,,17,16,24,33,0,57,0,1
bsdmake,bsdmake,,0,0,1,0,0,1,9,1
corestore,corestore,,10,7,3,17,0,20,13,1
geneticsharp,geneticsharp,,0,0,1,0,0,1,8,1
tkinter-text,tkinter-text,,2,4,1,6,0,7,0,100
wxstring,wxstring,,1,0,1,1,0,2,9,1
handlerexceptionresolver,handlerexceptionresolver,,0,0,2,0,0,2,3,1
qqmlcontext,qqmlcontext,,1,0,2,1,0,3,9,1
run-sequence,run-sequence,,0,0,3,0,0,3,1,1
modesetting,modesetting,,0,0,1,0,0,1,9,1
pycocotools,pycocotools,,2,2,1,4,0,5,0,1
csrf-token,csrf-token,,22,24,42,46,0,88,4,9.090909
dart-intl,dart-intl,,1,1,1,2,0,3,13,1
djnativeswing,djnativeswing,,0,0,1,0,0,1,3,1
krypton,krypton,,1,1,4,2,0,6,3,1
geodms,geodms,,3,0,3,3,0,6,0,1
xeponline,xeponline,,0,0,1,0,0,1,1,1
ipycache,ipycache,,0,1,1,1,0,2,0,1
jupyter-contrib-nbextensions,jupyter-contrib-nbextensions,,13,7,6,20,0,26,0,1
webdev.webserver,webdev.webserver,,1,1,1,2,0,3,0,1
resolvejs,resolvejs,,0,0,2,0,0,2,8,1
purescript-halogen,purescript-halogen,,2,1,2,3,0,5,2,1
scope-id,scope-id,,0,0,1,0,0,1,13,1
git-secret,git-secret,,0,3,2,3,0,5,6,200
memory-table,memory-table,,0,0,3,0,0,3,4,1
sql-trace,sql-trace,,0,0,2,0,0,2,4,1
non-admin,non-admin,,1,1,2,2,0,4,8,1
webmerge,webmerge,,1,0,1,1,0,2,4,1
wsp,wsp,,1,1,2,2,0,4,8,1
antlr4cs,antlr4cs,,0,1,1,1,0,2,0,1
oracle-analytics,oracle-analytics,,0,0,2,0,0,2,4,1
razor-class-library,razor-class-library,,5,1,8,6,0,14,8,1
rpa-express,rpa-express,,0,0,1,0,0,1,5,1
neo4j-mazerunner,neo4j-mazerunner,,0,0,1,0,0,1,2,1
ts-md5,ts-md5,,0,0,1,0,0,1,1,1
nsopengl,nsopengl,,0,0,1,0,0,1,13,1
signal-protocol,signal-protocol,,1,2,1,3,0,4,13,100
e2e-encryption,e2e-encryption,,0,0,1,0,0,1,13,1
textswitcher,textswitcher,,0,0,1,0,0,1,3,1
weblogic9.x,weblogic9.x,,0,0,2,0,0,2,3,1
spec2,spec2,,0,0,1,0,0,1,3,1
django-auditlog,django-auditlog,,2,0,2,2,0,4,0,1
orbitdb,orbitdb,,2,0,3,2,0,5,1,1
zinnia-entry,zinnia-entry,,0,0,2,0,0,2,0,1
perl5.16,perl5.16,,0,0,1,0,0,1,9,1
nzplsql,nzplsql,,0,0,1,0,0,1,4,1
radfileexplorer,radfileexplorer,,1,0,3,1,0,4,8,1
referrer-spam,referrer-spam,,0,0,2,0,0,2,4,1
case-study,case-study,,1,0,2,1,0,3,3,1
oracle-access-manager,oracle-access-manager,,0,2,3,2,0,5,8,100
cross-window-scripting,cross-window-scripting,,0,0,2,0,0,2,9,1
d3dimage,d3dimage,,0,1,3,1,0,4,0,1
leader-election,leader-election,,3,1,6,4,0,10,2,1
cassini,cassini,,0,0,2,0,0,2,8,1
cassini-dev,cassini-dev,,0,0,1,0,0,1,8,1
zstd,zstd,,1,4,1,5,0,6,9,300
github-actions,github-actions,,6,26,7,32,0,39,6,333.333333
microsoft-appstudio,microsoft-appstudio,,4,1,1,5,0,6,8,1
msdatasetgenerator,msdatasetgenerator,,0,0,1,0,0,1,8,1
nhlambdaextensions,nhlambdaextensions,,1,0,1,1,0,2,8,1
sts-securitytokenservice,sts-securitytokenservice,,2,3,2,5,0,7,4,50
getforegroundwindow,getforegroundwindow,,0,1,2,1,0,3,9,1
parseexcel,parseexcel,,0,1,1,1,0,2,5,1
csharpscript,csharpscript,,3,0,3,3,0,6,8,1
stlport,stlport,,0,0,1,0,0,1,9,1
pipestatus,pipestatus,,0,1,1,1,0,2,9,1
console.setout,console.setout,,0,0,1,0,0,1,8,1
packagemaker,packagemaker,,2,1,2,3,0,5,13,1
go-xorm,go-xorm,,4,0,4,4,0,8,6,1
jsr363,jsr363,,0,0,2,0,0,2,3,1
gmongo,gmongo,,0,0,2,0,0,2,3,1
madexcept,madexcept,,0,0,1,0,0,1,9,1
gitlab-ee,gitlab-ee,,6,2,5,8,0,13,6,1
aspstate,aspstate,,0,0,2,0,0,2,8,1
leaflet-editable,leaflet-editable,,1,2,2,3,0,5,1,100
sslv2,sslv2,,0,2,1,2,0,3,6,100
pyrebase,pyrebase,,16,12,14,28,0,42,13,1
qshell,qshell,,2,0,1,2,0,3,9,1
bitmapencoder,bitmapencoder,,0,0,3,0,0,3,8,1
mutated,mutated,,0,0,1,0,0,1,1,1
google-cloud-interconnect,google-cloud-interconnect,,1,0,2,1,0,3,6,1
genymotion-gps,genymotion-gps,,0,0,1,0,0,1,3,1
hglib,hglib,,0,0,1,0,0,1,6,1
outlook.application,outlook.application,,0,2,1,2,0,3,5,100
max-path,max-path,,1,1,1,2,0,3,8,1
compact-framework2.0,compact-framework2.0,,0,0,2,0,0,2,8,1
ueye,ueye,,3,3,3,6,0,9,0,1
www-mechanize-chrome,www-mechanize-chrome,,1,0,1,1,0,2,9,1
wcf-hosting,wcf-hosting,,1,0,2,1,0,3,8,1
atompub,atompub,,0,0,2,0,0,2,3,1
babel-eslint,babel-eslint,,0,0,5,0,0,5,1,1
alchemy-cms,alchemy-cms,,0,0,10,0,0,10,12,1
instrumented-test,instrumented-test,,5,2,6,7,0,13,3,1
visual-artifacts,visual-artifacts,,1,1,3,2,0,5,13,1
std-source-location,std-source-location,,0,2,2,2,0,4,9,100
gccfilter,gccfilter,,0,0,1,0,0,1,0,1
fart,fart,,0,0,1,0,0,1,9,1
methodbase,methodbase,,0,0,1,0,0,1,8,1
cakephp-2.2,cakephp-2.2,,0,0,1,0,0,1,4,1
oracle-policy-automation,oracle-policy-automation,,0,0,1,0,0,1,4,1
laravel-lighthouse,laravel-lighthouse,,4,12,4,16,0,20,4,200
sharpvectors,sharpvectors,,2,0,1,2,0,3,8,1
clipstobounds,clipstobounds,,0,0,2,0,0,2,13,1
componentart,componentart,,0,0,1,0,0,1,8,1
xcode-tools,xcode-tools,,1,0,1,1,0,2,13,1
data-quality-services,data-quality-services,,2,2,2,4,0,6,4,1
selectinput,selectinput,,13,9,15,22,0,37,0,1
barracuda,barracuda,,1,1,1,2,0,3,8,1
atlcom,atlcom,,0,0,1,0,0,1,9,1
add-references-dialog,add-references-dialog,,1,0,2,1,0,3,8,1
koji,koji,,0,0,1,0,0,1,9,1
logstash-filter,logstash-filter,,6,1,6,7,0,13,6,1
multidrop-bus,multidrop-bus,,1,0,2,1,0,3,9,1
itemplate,itemplate,,0,0,1,0,0,1,8,1
filenet-panagon,filenet-panagon,,0,0,2,0,0,2,8,1
filenet-idm,filenet-idm,,0,0,2,0,0,2,8,1
reddit-access-token,reddit-access-token,,0,1,1,1,0,2,1,1
pogo,pogo,,0,0,1,0,0,1,3,1
opengis,opengis,,0,1,3,1,0,4,3,1
laravel-3,laravel-3,,0,1,1,1,0,2,4,1
ibm-domino,ibm-domino,,7,6,10,13,0,23,5,1
csplitterwnd,csplitterwnd,,0,0,2,0,0,2,9,1
node-kafka-streams,node-kafka-streams,,0,1,3,1,0,4,2,1
invalid-postback,invalid-postback,,0,0,1,0,0,1,8,1
xmlhttprequest-states,xmlhttprequest-states,,0,0,1,0,0,1,1,1
picturefill,picturefill,,1,1,3,2,0,5,1,1
buildbox,buildbox,,5,6,5,11,0,16,3,20
partial-methods,partial-methods,,0,0,1,0,0,1,8,1
nsfilepromiseprovider,nsfilepromiseprovider,,1,0,1,1,0,2,13,1
armbian,armbian,,0,4,4,4,0,8,9,300
maven-1,maven-1,,0,0,1,0,0,1,3,1
parse-recdescent,parse-recdescent,,2,0,2,2,0,4,9,1
linux-rt,linux-rt,,0,0,4,0,0,4,9,1
splitterpanel,splitterpanel,,0,0,1,0,0,1,8,1
barbajs,barbajs,,4,9,7,13,0,20,1,125
psychparser,psychparser,,1,0,1,1,0,2,12,1
osprey,osprey,,0,0,1,0,0,1,14,1
backbase-portal,backbase-portal,,0,0,1,0,0,1,4,1
sap-cloud-sdk,sap-cloud-sdk,,20,11,1,31,0,32,3,1
nativescript-schematics,nativescript-schematics,,2,0,3,2,0,5,1,1
slimbox,slimbox,,0,0,1,0,0,1,4,1
alation,alation,,1,0,1,1,0,2,2,1
datacash,datacash,,0,0,1,0,0,1,4,1
cpm,cpm,,1,0,2,1,0,3,9,1
ascmd,ascmd,,0,0,1,0,0,1,4,1
jbig2,jbig2,,1,0,1,1,0,2,8,1
odata.net,odata.net,,1,0,1,1,0,2,8,1
amp-animation,amp-animation,,0,0,3,0,0,3,1,1
version-control-migration,version-control-migration,,2,0,2,2,0,4,6,1
jsbarcode,jsbarcode,,4,1,2,5,0,7,1,1
google-playground,google-playground,,1,0,1,1,0,2,5,1
react-router-hash-link,react-router-hash-link,,0,0,2,0,0,2,1,1
vapix,vapix,,0,0,2,0,0,2,1,1
application-blocks,application-blocks,,0,0,1,0,0,1,6,1
nextval,nextval,,2,1,2,3,0,5,4,1
soft-input-panel,soft-input-panel,,1,1,1,2,0,3,3,1
uicollectionviewdropdelegate,uicollectionviewdropdelegate,,0,1,2,1,0,3,13,1
optical-drive,optical-drive,,1,0,1,1,0,2,8,1
msn-messenger,msn-messenger,,0,0,1,0,0,1,3,1
lumenworks,lumenworks,,1,0,2,1,0,3,8,1
a0poster,a0poster,,0,0,1,0,0,1,0,1
twilio-flex,twilio-flex,,1,27,11,28,0,39,13,2600
projfs,projfs,,3,0,2,3,0,5,9,1
taiga,taiga,,0,0,1,0,0,1,6,1
github-webhook,github-webhook,,6,6,7,12,0,19,6,1
rmqclient,rmqclient,,0,0,1,0,0,1,8,1
wvvm,wvvm,,0,0,1,0,0,1,8,1
bamboo-bsc,bamboo-bsc,,0,0,2,0,0,2,6,1
rbga,rbga,,0,0,1,0,0,1,3,1
flawfinder,flawfinder,,0,0,1,0,0,1,9,1
libnids,libnids,,0,0,2,0,0,2,9,1
live-sdk,live-sdk,,0,0,1,0,0,1,8,1
mariadb-connector-c,mariadb-connector-c,,4,1,6,5,0,11,4,1
gift,gift,,1,0,2,1,0,3,4,1
interval-arithmetic,interval-arithmetic,,1,0,2,1,0,3,9,1
net-tcp,net-tcp,,0,0,3,0,0,3,8,1
nexus6,nexus6,,1,0,1,1,0,2,3,1
media-keys,media-keys,,1,0,2,1,0,3,9,1
qrc,qrc,,1,1,5,2,0,7,9,1
ixjs,ixjs,,0,0,1,0,0,1,1,1
char-traits,char-traits,,1,0,1,1,0,2,9,1
character-entities,character-entities,,0,0,4,0,0,4,3,1
ereg,ereg,,0,0,2,0,0,2,4,1
elasticsearch-rest-client,elasticsearch-rest-client,,3,4,3,7,0,10,6,33.333333
gcloud-node,gcloud-node,,0,1,2,1,0,3,6,1
pandorabots,pandorabots,,0,1,1,1,0,2,8,1
sysenter,sysenter,,0,0,1,0,0,1,9,1
mtls,mtls,,1,1,2,2,0,4,6,1
quantify,quantify,,0,0,1,0,0,1,9,1
inotifytaskcompletion,inotifytaskcompletion,,0,0,1,0,0,1,8,1
delightvr,delightvr,,1,1,1,2,0,3,1,1
query-derivation,query-derivation,,0,0,1,0,0,1,3,1
visual-studio-2002,visual-studio-2002,,1,0,1,1,0,2,8,1
google-cloud-scheduler,google-cloud-scheduler,,18,11,10,29,0,39,6,1
fadeto,fadeto,,1,0,1,1,0,2,1,1
cgridctrl,cgridctrl,,0,0,1,0,0,1,9,1
sharp7,sharp7,,1,0,1,1,0,2,9,1
konvajs-reactjs,konvajs-reactjs,,5,9,12,14,0,26,1,80
waypoint,waypoint,,7,8,5,15,0,20,1,14.285714
clipboard-interaction,clipboard-interaction,,1,1,3,2,0,5,1,1
codepeer,codepeer,,0,0,1,0,0,1,9,1
sc.exe,sc.exe,,0,0,2,0,0,2,3,1
userappdatapath,userappdatapath,,0,0,2,0,0,2,8,1
dpl,dpl,,1,0,1,1,0,2,8,1
graniteds,graniteds,,0,0,3,0,0,3,13,1
qtav,qtav,,0,1,3,1,0,4,9,1
signed-applet,signed-applet,,0,0,1,0,0,1,3,1
elessar,elessar,,0,0,1,0,0,1,1,1
appdirect,appdirect,,0,0,1,0,0,1,3,1
watch-window,watch-window,,2,0,2,2,0,4,8,1
legacy-build-system,legacy-build-system,,1,0,1,1,0,2,13,1
wheel-factorization,wheel-factorization,,0,0,1,0,0,1,0,1
zend-test,zend-test,,0,1,5,1,0,6,4,1
beaver,beaver,,0,0,1,0,0,1,4,1
string-span,string-span,,0,1,1,1,0,2,9,1
moniker,moniker,,0,0,1,0,0,1,8,1
dragdropmodule,dragdropmodule,,1,1,2,2,0,4,1,1
gulp-filter,gulp-filter,,0,0,1,0,0,1,1,1
range-header,range-header,,0,0,2,0,0,2,6,1
preforking,preforking,,0,0,8,0,0,8,4,1
rfc4122,rfc4122,,0,0,1,0,0,1,2,1
nsstoryboard,nsstoryboard,,0,0,3,0,0,3,13,1
powermockrunner,powermockrunner,,1,1,4,2,0,6,3,1
showuserlocation,showuserlocation,,0,0,1,0,0,1,13,1
precompile-assets,precompile-assets,,0,0,1,0,0,1,12,1
faultcontract,faultcontract,,0,1,1,1,0,2,8,1
element-binding,element-binding,,1,0,1,1,0,2,8,1
chef-habitat,chef-habitat,,0,1,1,1,0,2,12,1
spfile,spfile,,2,0,1,2,0,3,4,1
hcard,hcard,,0,0,2,0,0,2,2,1
executionengineexception,executionengineexception,,1,0,1,1,0,2,8,1
vue-sweetalert2,vue-sweetalert2,,0,3,2,3,0,5,1,200
phimagemanager,phimagemanager,,3,4,4,7,0,11,13,33.333333
apache-spark-2.1,apache-spark-2.1,,0,0,4,0,0,4,2,1
freewalljs,freewalljs,,0,2,1,2,0,3,1,100
immediate-attribute,immediate-attribute,,0,0,1,0,0,1,3,1
linqtocsv,linqtocsv,,0,0,2,0,0,2,8,1
django-select2,django-select2,,6,4,3,10,0,13,0,1
unisys,unisys,,0,1,1,1,0,2,8,1
unisys-mcp,unisys-mcp,,0,0,1,0,0,1,8,1
nhibernate-validator,nhibernate-validator,,0,1,1,1,0,2,8,1
ecomdev-phpunit,ecomdev-phpunit,,0,0,1,0,0,1,4,1
fitted-box,fitted-box,,1,0,1,1,0,2,13,1
grecaptcha,grecaptcha,,4,4,7,8,0,15,1,1
hyperledger-burrow,hyperledger-burrow,,2,0,2,2,0,4,6,1
opencorporates,opencorporates,,1,0,2,1,1,3,0,1
mercurial-server,mercurial-server,,0,0,1,0,0,1,6,1
scalaquery,scalaquery,,1,0,1,1,0,2,2,1
amd-app,amd-app,,0,0,1,0,0,1,0,1
cdsw,cdsw,,0,0,2,0,0,2,2,1
frontera,frontera,,0,0,3,0,0,3,0,1
service-level-agreement,service-level-agreement,,0,2,1,2,0,3,6,100
android-3.2-honeycomb,android-3.2-honeycomb,,0,0,1,0,0,1,3,1
sapui5-smarttable,sapui5-smarttable,,5,11,3,16,0,19,1,120
pgzero,pgzero,,1,3,1,4,0,5,0,200
mindscape,mindscape,,0,0,1,0,0,1,8,1
flutter-appbar,flutter-appbar,,9,10,10,19,0,29,13,11.111111
image-load,image-load,,0,0,4,0,0,4,1,1
react-widgets,react-widgets,,2,3,5,5,0,10,1,50
opends,opends,,0,0,2,0,0,2,8,1
windsor-facilities,windsor-facilities,,0,0,1,0,0,1,8,1
xcode4.2,xcode4.2,,1,1,1,2,0,3,13,1
firefox-driver,firefox-driver,,0,2,3,2,0,5,3,100
great-expectations,great-expectations,,0,0,1,0,0,1,0,1
inserthtml,inserthtml,,0,1,1,1,0,2,1,1
svg-animationelements,svg-animationelements,,2,0,1,2,0,3,1,1
google-keep,google-keep,,1,2,4,3,0,7,3,100
permessagedeflate,permessagedeflate,,1,0,1,1,0,2,1,1
weechat,weechat,,0,0,1,0,0,1,9,1
websense,websense,,0,0,3,0,0,3,3,1
chmcmd,chmcmd,,0,0,1,0,0,1,8,1
scaleout-hserver,scaleout-hserver,,0,0,1,0,0,1,6,1
ftpes,ftpes,,0,1,1,1,0,2,4,1
homomorphism,homomorphism,,0,1,1,1,0,2,6,1
eaccelerator,eaccelerator,,0,0,1,0,0,1,3,1
finalcut,finalcut,,0,1,1,1,0,2,13,1
disp,disp,,0,0,1,0,0,1,0,1
scorm-cloud-api,scorm-cloud-api,,1,0,2,1,0,3,1,1
d8-dexer,d8-dexer,,1,1,5,2,0,7,3,1
saba,saba,,1,0,1,1,0,2,4,1
system.drawing.common,system.drawing.common,,0,1,2,1,0,3,8,1
iguana-ui,iguana-ui,,1,0,1,1,0,2,9,1
google-cloud-identity,google-cloud-identity,,2,5,6,7,0,13,6,150
asp.net-mvc-layout,asp.net-mvc-layout,,2,1,1,3,0,4,8,1
fakeloader.js,fakeloader.js,,0,0,2,0,0,2,1,1
file-type-associations,file-type-associations,,0,1,6,1,0,7,8,1
j1939,j1939,,1,2,3,3,0,6,9,100
qdox,qdox,,0,0,1,0,0,1,3,1
stm32cubemx,stm32cubemx,,8,8,11,16,0,27,9,1
pysimplegui,pysimplegui,,14,28,4,42,0,46,0,100
angular-cli-v7,angular-cli-v7,,35,13,49,48,0,97,1,1
pymatlab,pymatlab,,0,0,1,0,0,1,0,1
kanna,kanna,,1,0,2,1,0,3,13,1
glamor,glamor,,0,0,1,0,0,1,9,1
bs-css,bs-css,,0,0,1,0,0,1,9,1
azure-lab-services,azure-lab-services,,0,1,2,1,0,3,8,1
v-tooltip,v-tooltip,,0,3,3,3,0,6,1,200
pythreejs,pythreejs,,3,2,5,5,0,10,0,1
glom,glom,,0,4,3,4,0,7,0,300
angular-rc5,angular-rc5,,0,0,1,0,0,1,1,1
angular-token,angular-token,,0,0,2,0,0,2,12,1
xmake,xmake,,0,0,1,0,0,1,9,1
cxx,cxx,,1,0,1,1,0,2,9,1
dojo-1.7,dojo-1.7,,0,0,1,0,0,1,4,1
inline-table-function,inline-table-function,,0,0,1,0,0,1,4,1
styleci,styleci,,0,1,1,1,0,2,9,1
thinkscript,thinkscript,,0,0,1,0,0,1,0,1
spartacus-storefront,spartacus-storefront,,2,0,1,2,0,3,1,1
ef-postgresql,ef-postgresql,,0,0,1,0,0,1,8,1
jest-mock-axios,jest-mock-axios,,1,2,3,3,0,6,1,100
bluetooth-mesh,bluetooth-mesh,,1,2,2,3,0,5,3,100
asyncmongo,asyncmongo,,0,0,1,0,0,1,1,1
t4scaffolding,t4scaffolding,,0,0,2,0,0,2,8,1
react-native-vector-icons,react-native-vector-icons,,15,20,16,35,0,51,1,33.333333
array-indexing,array-indexing,,8,3,3,11,0,14,1,1
webpack-cli,webpack-cli,,2,5,4,7,0,11,1,150
mod-userdir,mod-userdir,,0,1,3,1,0,4,4,1
splicer,splicer,,0,1,1,1,0,2,13,1
django-fluent,django-fluent,,1,0,2,1,0,3,0,1
joomla3.1,joomla3.1,,0,0,1,0,0,1,4,1
multiscaleimage,multiscaleimage,,0,0,2,0,0,2,0,1
sag,sag,,1,1,2,2,0,4,1,1
nsruleeditor,nsruleeditor,,1,0,1,1,0,2,13,1
echo.js,echo.js,,0,0,1,0,0,1,1,1
powerpoint-automation,powerpoint-automation,,0,2,1,2,0,3,5,100
mission-control,mission-control,,1,0,2,1,0,3,13,1
anyref,anyref,,1,0,1,1,0,2,1,1
leaflet.pm,leaflet.pm,,0,1,1,1,0,2,1,1
post-robot,post-robot,,0,0,1,0,0,1,1,1
amp-form,amp-form,,5,3,8,8,0,16,1,1
nsaffinetransform,nsaffinetransform,,0,0,2,0,0,2,13,1
kakoune,kakoune,,0,0,1,0,0,1,9,1
webbot,webbot,,1,1,4,2,0,6,0,1
jsapi,jsapi,,3,3,2,6,0,8,1,1
ijavascript,ijavascript,,2,0,3,2,0,5,0,1
bbdb,bbdb,,0,0,1,0,0,1,3,1
openstack-zuul,openstack-zuul,,1,2,1,3,0,4,3,100
persistent-memory,persistent-memory,,1,0,1,1,0,2,9,1
jtidy,jtidy,,1,0,2,1,0,3,3,1
fountain-codes,fountain-codes,,0,0,2,0,0,2,3,1
application-framework,application-framework,,1,0,1,1,0,2,3,1
ingest,ingest,,2,3,3,5,0,8,6,50
microk8s,microk8s,,9,8,12,17,0,29,6,1
mm7,mm7,,0,0,1,0,0,1,0,1
solandra,solandra,,0,0,1,0,0,1,2,1
adobe-connect,adobe-connect,,0,0,4,0,0,4,1,1
mi,mi,,1,1,9,2,0,11,3,1
google-cloud-network-load-balancer,google-cloud-network-load-balancer,,0,0,2,0,0,2,6,1
graphql-compose-mongoose,graphql-compose-mongoose,,2,2,2,4,0,6,1,1
nod32,nod32,,0,0,1,0,0,1,6,1
value-provider,value-provider,,0,1,1,1,0,2,8,1
gendarme,gendarme,,0,0,1,0,0,1,9,1
zuora-soap,zuora-soap,,0,1,1,1,0,2,3,1
kde4,kde4,,0,0,1,0,0,1,9,1
libman,libman,,2,4,4,6,0,10,8,100
armchair,armchair,,0,0,1,0,0,1,1,1
drupal-routes,drupal-routes,,0,0,1,0,0,1,4,1
web-setup-project,web-setup-project,,0,2,1,2,0,3,8,100
unsafe-unretained,unsafe-unretained,,0,0,1,0,0,1,13,1
azure-policy,azure-policy,,12,15,1,27,0,28,8,25
xpressive,xpressive,,1,0,1,1,0,2,9,1
rexml,rexml,,1,1,2,2,0,4,12,1
nhibernate-cascade,nhibernate-cascade,,0,0,2,0,0,2,8,1
genshi,genshi,,0,0,3,0,0,3,0,1
parquet-mr,parquet-mr,,3,5,12,8,0,20,2,66.666667
class-reference,class-reference,,0,0,1,0,0,1,9,1
render-html,render-html,,0,0,2,0,0,2,1,1
defensive-copy,defensive-copy,,0,0,2,0,0,2,3,1
allowed-origin,allowed-origin,,1,0,1,1,0,2,4,1
kubeconfig,kubeconfig,,5,3,4,8,0,12,6,1
mcclim,mcclim,,0,0,2,0,0,2,0,1
stubby4j,stubby4j,,0,0,1,0,0,1,1,1
safe-exam-browser,safe-exam-browser,,0,0,1,0,0,1,3,1
pg-upgrade,pg-upgrade,,0,2,6,2,0,8,4,100
impress.js,impress.js,,0,0,1,0,0,1,0,1
nativescript-google-maps-sdk,nativescript-google-maps-sdk,,1,1,4,2,0,6,1,1
remote-mysql,remote-mysql,,1,1,3,2,0,5,4,1
invocation-api,invocation-api,,0,0,3,0,0,3,9,1
google-closure,google-closure,,5,2,1,7,0,8,1,1
xvim,xvim,,0,0,1,0,0,1,13,1
kotlin-contracts,kotlin-contracts,,1,0,4,1,0,5,3,1
twinx,twinx,,2,4,4,6,0,10,0,100
resolveassemblyreference,resolveassemblyreference,,0,0,1,0,0,1,9,1
kusto-query-language,kusto-query-language,,3,15,3,18,0,21,8,400
headerfooter,headerfooter,,0,0,4,0,0,4,8,1
active-passive,active-passive,,3,1,1,4,0,5,6,1
joomla-jtable,joomla-jtable,,0,0,1,0,0,1,4,1
sablecc,sablecc,,0,0,1,0,0,1,0,1
until-loop,until-loop,,2,5,3,7,0,10,9,150
chasepayment,chasepayment,,0,0,2,0,0,2,1,1
bitdb,bitdb,,0,0,1,0,0,1,6,1
idxbroker,idxbroker,,0,0,1,0,0,1,1,1
ugc,ugc,,1,0,1,1,0,2,4,1
django-shop,django-shop,,1,1,2,2,0,4,0,1
hardy-ramanujan,hardy-ramanujan,,0,1,1,1,0,2,9,1
ice4j,ice4j,,0,0,1,0,0,1,3,1
graphql-spring-boot,graphql-spring-boot,,1,1,4,2,0,6,1,1
fogbugz-on-demand,fogbugz-on-demand,,0,1,1,1,0,2,6,1
rocketeer,rocketeer,,1,0,2,1,0,3,4,1
beaninfo,beaninfo,,0,0,1,0,0,1,3,1
ihttpasynchandler,ihttpasynchandler,,2,0,2,2,0,4,8,1
weblogic8.x,weblogic8.x,,0,0,3,0,0,3,3,1
common-code,common-code,,0,1,1,1,0,2,3,1
intelinde,intelinde,,0,0,1,0,0,1,3,1
sfguard,sfguard,,0,0,1,0,0,1,4,1
javascript-build,javascript-build,,2,0,2,2,0,4,1,1
httpsys,httpsys,,1,2,2,3,0,5,8,100
atg-droplet,atg-droplet,,2,0,4,2,0,6,3,1
kmongo,kmongo,,3,0,4,3,0,7,1,1
engineyard,engineyard,,0,0,1,0,0,1,9,1
maven-source-plugin,maven-source-plugin,,0,0,1,0,0,1,3,1
d3fo,d3fo,,0,0,4,0,0,4,8,1
data-entities,data-entities,,0,0,2,0,0,2,8,1
base64url,base64url,,13,6,6,19,0,25,1,1
lpstr,lpstr,,0,0,1,0,0,1,8,1
elastic-container-registry,elastic-container-registry,,3,1,2,4,0,6,6,1
hilo,hilo,,0,1,2,1,0,3,3,1
sub-network-access-protocol,sub-network-access-protocol,,0,0,1,0,0,1,9,1
python-openclip,python-openclip,,0,0,1,0,0,1,3,1
kubernetes-ha,kubernetes-ha,,0,0,1,0,0,1,6,1
embed-tag,embed-tag,,0,0,5,0,0,5,1,1
drupal-comments,drupal-comments,,0,0,1,0,0,1,4,1
django-formtools,django-formtools,,4,4,9,8,0,17,0,1
codecampserver,codecampserver,,0,0,1,0,0,1,1,1
devicepixelratio,devicepixelratio,,3,1,8,4,0,12,1,1
python-camelot,python-camelot,,6,3,13,9,0,22,0,1
xml-spreadsheet,xml-spreadsheet,,0,0,4,0,0,4,5,1
reporting-tools,reporting-tools,,0,0,2,0,0,2,4,1
agouti,agouti,,0,0,2,0,0,2,6,1
swift4.2.1,swift4.2.1,,5,4,8,9,0,17,13,1
r-infer,r-infer,,0,0,2,0,0,2,0,1
es6-generator,es6-generator,,2,1,4,3,0,7,1,1
entity-framework-migrations,entity-framework-migrations,,0,1,4,1,0,5,8,1
rc-slider,rc-slider,,5,3,2,8,0,10,1,1
avsystemcontroller,avsystemcontroller,,0,1,1,1,0,2,13,1
mdw,mdw,,1,0,2,1,0,3,5,1
ibm-sbt,ibm-sbt,,0,0,1,0,0,1,6,1
linkfieldvalue,linkfieldvalue,,0,0,1,0,0,1,8,1
testrunconfig,testrunconfig,,0,0,1,0,0,1,1,1
vmware-sdk,vmware-sdk,,2,0,2,2,0,4,6,1
jarsplice,jarsplice,,0,0,2,0,0,2,3,1
canonical-quickly,canonical-quickly,,0,0,1,0,0,1,9,1
mpmediaitemcollection,mpmediaitemcollection,,0,0,1,0,0,1,13,1
wavefront-telegraf,wavefront-telegraf,,0,0,1,0,0,1,3,1
layoutmargins,layoutmargins,,2,2,1,4,0,5,3,1
ag-grid-e2e,ag-grid-e2e,,0,0,1,0,0,1,3,1
alternateview,alternateview,,0,0,1,0,0,1,4,1
yii2-formwizard,yii2-formwizard,,0,2,1,2,0,3,4,100
javascript-scope,javascript-scope,,3,3,2,6,0,8,1,1
cassandra-lucene-index,cassandra-lucene-index,,0,0,1,0,0,1,2,1
gradle-tomcat-plugin,gradle-tomcat-plugin,,0,1,1,1,0,2,3,1
defaultbutton,defaultbutton,,0,0,2,0,0,2,3,1
loopback4,loopback4,,0,26,1,26,0,27,1,2500
silverlight-oob,silverlight-oob,,0,0,1,0,0,1,8,1
electron-rebuild,electron-rebuild,,1,2,3,3,0,6,1,100
web.sitemap,web.sitemap,,1,0,1,1,0,2,8,1
net-ftp,net-ftp,,0,0,2,0,0,2,9,1
chartify,chartify,,0,0,6,0,0,6,0,1
cachegrind,cachegrind,,1,0,1,1,0,2,9,1
nativescript-oauth2,nativescript-oauth2,,2,2,2,4,0,6,1,1
nws,nws,,1,0,3,1,0,4,1,1
starteam,starteam,,0,0,1,0,0,1,8,1
x509certificatevalidator,x509certificatevalidator,,1,0,1,1,0,2,6,1
constraintset,constraintset,,4,4,5,8,0,13,3,1
tetgen,tetgen,,0,0,1,0,0,1,0,1
ddmlib,ddmlib,,0,1,1,1,0,2,0,1
edsim51,edsim51,,0,0,1,0,0,1,9,1
jamstack,jamstack,,1,7,6,8,0,14,1,600
uniform-cost-search,uniform-cost-search,,2,0,3,2,0,5,0,1
bixbystudio,bixbystudio,,41,33,33,74,0,107,21,1
reversion,reversion,,0,0,1,0,0,1,0,1
funcall,funcall,,0,1,1,1,0,2,0,1
getfileversion,getfileversion,,0,0,1,0,0,1,8,1
msmessagetemplatelayout,msmessagetemplatelayout,,0,1,2,1,0,3,13,1
gasp,gasp,,0,2,1,2,0,3,1,100
apache-spark-2.3,apache-spark-2.3,,6,9,15,15,0,30,2,50
netbeans-10,netbeans-10,,11,4,14,15,0,29,3,1
python-schematics,python-schematics,,0,1,2,1,0,3,0,1
sfgui,sfgui,,0,0,1,0,0,1,9,1
app-site-association,app-site-association,,0,0,2,0,0,2,13,1
valdr-bean-validation,valdr-bean-validation,,0,0,1,0,0,1,3,1
apache-falcon,apache-falcon,,1,2,1,3,0,4,2,100
jvm-default,jvm-default,,0,0,2,0,0,2,3,1
microsoft-cdn,microsoft-cdn,,0,2,2,2,0,4,8,100
dropbox-java,dropbox-java,,0,0,1,0,0,1,1,1
oracleapplications,oracleapplications,,1,0,1,1,0,2,4,1
fedora12,fedora12,,0,0,2,0,0,2,9,1
windows-live-writer,windows-live-writer,,0,0,1,0,0,1,8,1
bytechannel,bytechannel,,0,0,2,0,0,2,3,1
multibox,multibox,,0,0,1,0,0,1,0,1
feedburner,feedburner,,1,0,2,1,0,3,0,1
windowstaskschedule,windowstaskschedule,,10,10,15,20,0,35,9,1
vim-tabular,vim-tabular,,0,0,2,0,0,2,9,1
flexible-search,flexible-search,,3,3,5,6,0,11,3,1
aolserver,aolserver,,1,1,1,2,0,3,9,1
immutablearray,immutablearray,,0,0,1,0,0,1,8,1
new-psdrive,new-psdrive,,3,0,2,3,0,5,8,1
npm-package,npm-package,,6,15,1,21,0,22,1,150
user-administration,user-administration,,1,1,2,2,0,4,3,1
telerik-scheduler,telerik-scheduler,,0,0,1,0,0,1,1,1
fullscreenchange,fullscreenchange,,0,2,1,2,0,3,1,100
dry-types,dry-types,,0,0,1,0,0,1,12,1
dry-struct,dry-struct,,0,0,1,0,0,1,12,1
gophernotes,gophernotes,,0,0,3,0,0,3,6,1
cityiq,cityiq,,0,0,1,0,0,1,1,1
adaptive-ui,adaptive-ui,,0,0,2,0,0,2,8,1
qas,qas,,0,1,2,1,0,3,8,1
infoview,infoview,,0,0,2,0,0,2,5,1
psl,psl,,0,0,2,0,0,2,3,1
tomtom-android-sdk,tomtom-android-sdk,,0,2,3,2,0,5,3,100
corecon,corecon,,0,0,1,0,0,1,8,1
sliver-grid,sliver-grid,,2,1,2,3,0,5,13,1
mxchip,mxchip,,1,0,8,1,0,9,8,1
ggpairs,ggpairs,,5,2,4,7,0,11,0,1
snom,snom,,0,0,2,0,0,2,6,1
cirqus,cirqus,,0,0,1,0,0,1,8,1
stringbyevaluatingjavascr,stringbyevaluatingjavascr,,0,0,2,0,0,2,13,1
hibernate-generic-dao,hibernate-generic-dao,,0,0,1,0,0,1,3,1
mothur,mothur,,0,0,1,0,0,1,9,1
acid-state,acid-state,,0,0,2,0,0,2,2,1
react-static-router,react-static-router,,1,0,1,1,0,2,1,1
vudroid,vudroid,,0,0,1,0,0,1,13,1
casing,casing,,0,0,1,0,0,1,8,1
ssdl,ssdl,,1,0,1,1,0,2,8,1
wwwhisper,wwwhisper,,0,0,2,0,0,2,1,1
clipped,clipped,,1,1,1,2,0,3,1,1
xcode10.2.1,xcode10.2.1,,0,9,1,9,0,10,13,800
shearsort,shearsort,,0,0,3,0,0,3,0,1
optunity,optunity,,0,0,1,0,0,1,0,1
django-ldapdb,django-ldapdb,,2,1,1,3,0,4,8,1
accountpicker,accountpicker,,0,0,2,0,0,2,3,1
system-console,system-console,,0,0,1,0,0,1,3,1
unspecified,unspecified,,0,0,1,0,0,1,0,1
dnsjava,dnsjava,,2,2,3,4,0,7,4,1
prometheus-blackbox-exporter,prometheus-blackbox-exporter,,6,5,5,11,0,16,6,1
c++builder-10.3-rio,c++builder-10.3-rio,,6,3,3,9,0,12,9,1
wid,wid,,0,0,1,0,0,1,3,1
openfeint,openfeint,,0,1,1,1,0,2,3,1
emacs22,emacs22,,0,0,1,0,0,1,9,1
metacello,metacello,,0,0,1,0,0,1,13,1
fakexrmeasy,fakexrmeasy,,2,0,2,2,0,4,8,1
phploc,phploc,,0,0,1,0,0,1,4,1
html-tbody,html-tbody,,4,2,2,6,0,8,1,1
domino-appdev-pack,domino-appdev-pack,,2,1,4,3,0,7,5,1
mongodb-hadoop,mongodb-hadoop,,1,0,2,1,0,3,2,1
readme.io,readme.io,,0,0,2,0,0,2,3,1
openssl-cms,openssl-cms,,0,0,1,0,0,1,6,1
http-status-code-412,http-status-code-412,,1,2,2,3,0,5,4,100
corretto,corretto,,7,2,12,9,0,21,3,1
s-plus,s-plus,,1,1,1,2,0,3,9,1
hobby-os,hobby-os,,0,0,1,0,0,1,9,1
cirrus-hpc,cirrus-hpc,,1,0,1,1,0,2,9,1
elastic-rest-client,elastic-rest-client,,1,1,1,2,0,3,6,1
pulsar,pulsar,,4,4,1,8,0,9,2,1
best-first-search,best-first-search,,1,0,2,1,0,3,0,1
finetunning,finetunning,,10,9,9,19,0,28,0,1
jswidget,jswidget,,1,0,1,1,0,2,1,1
android-clipboardmanager,android-clipboardmanager,,0,0,2,0,0,2,3,1
niagara-4,niagara-4,,0,0,5,0,0,5,3,1
tridium,tridium,,0,0,2,0,0,2,3,1
oraclize,oraclize,,1,2,3,3,0,6,6,100
pagespeed-insights,pagespeed-insights,,23,12,28,35,0,63,4,1
bpg,bpg,,0,0,1,0,0,1,9,1
ounit,ounit,,0,2,1,2,0,3,0,100
xmlinclude,xmlinclude,,0,0,1,0,0,1,8,1
mod-cache,mod-cache,,2,1,3,3,0,6,4,1
partial-lenses,partial-lenses,,0,0,3,0,0,3,1,1
dynamic-data-exchange,dynamic-data-exchange,,1,1,1,2,0,3,5,1
openrecord.js,openrecord.js,,0,0,1,0,0,1,1,1
hyperas,hyperas,,4,6,4,10,0,14,0,50
jemmyfx,jemmyfx,,1,0,1,1,0,2,3,1
aws-glue-data-catalog,aws-glue-data-catalog,,17,43,16,60,0,76,6,152.941176
npn,npn,,0,0,1,0,0,1,6,1
gradle-properties,gradle-properties,,0,0,1,0,0,1,3,1
cloudmailin,cloudmailin,,0,0,1,0,0,1,13,1
tabulate,tabulate,,6,9,8,15,0,23,0,50
magic-quotes,magic-quotes,,1,0,1,1,0,2,4,1
liveservertestcase,liveservertestcase,,2,0,3,2,0,5,3,1
tivoli-system-automation-zos,tivoli-system-automation-zos,,0,0,2,0,0,2,3,1
cameraapi2,cameraapi2,,2,0,1,2,0,3,3,1
ssh2,ssh2,,18,13,16,31,0,47,9,1
ccss,ccss,,0,0,1,0,0,1,1,1
hard-coding,hard-coding,,1,3,1,4,0,5,0,200
wpf-listview,wpf-listview,,1,2,2,3,0,5,8,100
rxfire,rxfire,,2,1,5,3,0,8,13,1
itanium-abi,itanium-abi,,0,0,1,0,0,1,9,1
jquery-checktree,jquery-checktree,,0,0,1,0,0,1,1,1
ag-grid-angular,ag-grid-angular,,101,89,78,190,0,268,1,1
runnable-jar,runnable-jar,,6,3,4,9,0,13,3,1
outputformatter,outputformatter,,0,0,2,0,0,2,8,1
amazon-dax,amazon-dax,,6,0,5,6,0,11,6,1
xsl-variable,xsl-variable,,0,0,2,0,0,2,3,1
perl5.8,perl5.8,,0,0,1,0,0,1,9,1
weblogic12g,weblogic12g,,0,0,1,0,0,1,3,1
beginread,beginread,,0,0,2,0,0,2,8,1
cross-page-posting,cross-page-posting,,0,0,2,0,0,2,4,1
requests-oauthlib,requests-oauthlib,,5,0,2,5,0,7,0,1
resourceproviderfactory,resourceproviderfactory,,0,0,1,0,0,1,8,1
pvm,pvm,,0,0,1,0,0,1,9,1
web-admin,web-admin,,0,0,1,0,0,1,4,1
pyi,pyi,,3,2,2,5,0,7,0,1
file-link,file-link,,0,0,1,0,0,1,0,1
free-theorem,free-theorem,,1,0,1,1,0,2,2,1
openindiana,openindiana,,2,0,1,2,0,3,9,1
airpush,airpush,,0,0,2,0,0,2,3,1
memgraphdb,memgraphdb,,0,1,2,1,0,3,2,1
lgi,lgi,,1,0,2,1,0,3,9,1
subscript-operator,subscript-operator,,1,2,2,3,0,5,9,100
semweb,semweb,,0,1,1,1,0,2,0,1
attachment-field,attachment-field,,1,0,1,1,0,2,5,1
transactional-database,transactional-database,,0,0,2,0,0,2,3,1
labelimg,labelimg,,2,2,1,4,0,5,0,1
swagger-codegen-maven-plugin,swagger-codegen-maven-plugin,,2,3,6,5,0,11,3,50
application.conf,application.conf,,0,0,2,0,0,2,3,1
intel-atom,intel-atom,,0,0,1,0,0,1,3,1
elastic-beats,elastic-beats,,7,4,16,11,0,27,6,1
obs,obs,,6,8,12,14,0,26,13,33.333333
spring-internationalization,spring-internationalization,,2,1,4,3,0,7,3,1
shape-rendering,shape-rendering,,0,0,1,0,0,1,1,1
floydhub,floydhub,,2,1,1,3,0,4,0,1
sendbeacon,sendbeacon,,4,2,3,6,0,9,1,1
fmzm,fmzm,,0,0,2,0,0,2,9,1
opensmppbox,opensmppbox,,0,0,2,0,0,2,3,1
grafana-variable,grafana-variable,,7,10,6,17,0,23,6,42.857143
meta-title,meta-title,,1,0,1,1,0,2,1,1
sylius-1.3,sylius-1.3,,0,1,4,1,0,5,4,1
knowledge-graph,knowledge-graph,,9,3,8,12,0,20,2,1
petastorm,petastorm,,2,0,2,2,0,4,0,1
apt-key,apt-key,,2,1,2,3,0,5,9,1
tstcon32,tstcon32,,0,0,1,0,0,1,9,1
autodesk-vault,autodesk-vault,,0,1,1,1,0,2,14,1
application-management,application-management,,0,0,1,0,0,1,6,1
gnu-sort,gnu-sort,,0,1,2,1,0,3,0,1
boost-accumulators,boost-accumulators,,2,1,2,3,0,5,9,1
b,b,,1,4,2,5,0,7,0,300
linea-pro,linea-pro,,1,1,1,2,0,3,13,1
rust-crypto,rust-crypto,,0,0,1,0,0,1,9,1
switch-expression,switch-expression,,4,0,1,4,0,5,3,1
rackunit,rackunit,,0,1,1,1,0,2,0,1
geopackage,geopackage,,2,6,5,8,0,13,0,200
samsung-gear-s2,samsung-gear-s2,,1,0,1,1,0,2,3,1
search-keywords,search-keywords,,0,0,1,0,0,1,3,1
elastic-apm,elastic-apm,,2,6,5,8,0,13,6,200
ravenhq,ravenhq,,1,0,1,1,0,2,6,1
flex4.7,flex4.7,,0,0,1,0,0,1,13,1
bpopup,bpopup,,0,0,1,0,0,1,1,1
redpark,redpark,,0,0,1,0,0,1,13,1
desktop-sharing,desktop-sharing,,0,0,2,0,0,2,1,1
astroquery,astroquery,,0,0,2,0,0,2,0,1
lynxos,lynxos,,0,0,1,0,0,1,9,1
aws-application-load-balancer,aws-application-load-balancer,,25,22,32,47,0,79,6,1
irony,irony,,1,1,2,2,0,4,8,1
pthread-exit,pthread-exit,,1,0,1,1,0,2,9,1
lsc,lsc,,0,0,1,0,0,1,8,1
qcommandlineparser,qcommandlineparser,,1,2,1,3,0,4,9,100
azure-signalr,azure-signalr,,14,17,19,31,0,50,8,21.428571
magic-unipaas,magic-unipaas,,0,0,1,0,0,1,3,1
rapids,rapids,,6,10,5,16,0,21,0,66.666667
adobe-scout,adobe-scout,,0,0,2,0,0,2,13,1
openonload,openonload,,0,0,2,0,0,2,9,1
muon,muon,,0,0,1,0,0,1,1,1
visual-studio-2010-sp1,visual-studio-2010-sp1,,0,0,1,0,0,1,9,1
visual-web-gui,visual-web-gui,,0,0,2,0,0,2,9,1
dlookup,dlookup,,2,4,5,6,0,11,5,100
laravel-5.8,laravel-5.8,,384,576,9,960,0,969,4,50
marblejs,marblejs,,0,0,2,0,0,2,1,1
loadui,loadui,,1,1,1,2,0,3,3,1
spritebuilder,spritebuilder,,0,0,2,0,0,2,13,1
ihtmlimgelement,ihtmlimgelement,,0,0,1,0,0,1,0,1
google-auth-library-nodejs,google-auth-library-nodejs,,2,3,2,5,0,7,5,50
cocoahttpserver,cocoahttpserver,,0,1,1,1,0,2,13,1
ics-openvpn,ics-openvpn,,1,1,1,2,0,3,3,1
mdptoolbox,mdptoolbox,,1,1,2,2,0,4,0,1
preprocessor-meta-program,preprocessor-meta-program,,0,0,1,0,0,1,9,1
microsoft-cpp-unit-test,microsoft-cpp-unit-test,,2,1,5,3,0,8,9,1
helix-server,helix-server,,0,0,1,0,0,1,6,1
wxmaxima,wxmaxima,,5,4,6,9,0,15,0,1
sql-rank,sql-rank,,1,1,2,2,0,4,4,1
azure-devops-server,azure-devops-server,,2,7,5,9,0,14,8,250
react-native-bridge,react-native-bridge,,7,0,6,7,0,13,1,1
react-native-mqtt,react-native-mqtt,,0,1,2,1,0,3,1,1
ng-app,ng-app,,1,1,2,2,0,4,1,1
text-driver,text-driver,,0,0,1,0,0,1,4,1
hyperledger-fabric-sdk-js,hyperledger-fabric-sdk-js,,15,13,24,28,0,52,6,1
launchdarkly,launchdarkly,,3,0,1,3,0,4,0,1
automapper-collections-ef-core,automapper-collections-ef-core,,1,0,1,1,0,2,8,1
xsom,xsom,,0,0,1,0,0,1,3,1
throbber,throbber,,0,0,1,0,0,1,1,1
vue-dynamic-components,vue-dynamic-components,,3,4,6,7,0,13,1,33.333333
sygic-maps,sygic-maps,,0,0,4,0,0,4,13,1
react-beautiful-dnd,react-beautiful-dnd,,11,8,13,19,0,32,1,1
ompl,ompl,,0,3,2,3,0,5,9,200
sql-server-2019,sql-server-2019,,7,9,9,16,0,25,4,28.571429
webloadui,webloadui,,0,0,1,0,0,1,3,1
boost-lambda,boost-lambda,,0,0,1,0,0,1,9,1
django-bootstrap4,django-bootstrap4,,2,4,6,6,0,12,0,100
azure-databricks,azure-databricks,,141,162,109,303,0,412,2,14.893617
lottie-ios,lottie-ios,,3,11,1,14,0,15,13,266.666667
lottie-xamarin,lottie-xamarin,,0,1,3,1,0,4,13,1
tensordot,tensordot,,1,4,4,5,0,9,0,300
directory-security,directory-security,,1,0,2,1,0,3,8,1
bjqs,bjqs,,0,0,2,0,0,2,1,1
sitefinity-dynamic-content-types,sitefinity-dynamic-content-types,,0,0,1,0,0,1,8,1
overtone,overtone,,0,1,1,1,0,2,2,1
amazon-gamelift,amazon-gamelift,,0,2,3,2,0,5,8,100
alexa-presentation-language,alexa-presentation-language,,3,1,4,4,0,8,6,1
codesynthesis,codesynthesis,,0,2,1,2,0,3,3,100
repeatbutton,repeatbutton,,0,1,1,1,0,2,8,1
django-1.3,django-1.3,,0,0,1,0,0,1,0,1
axis2c,axis2c,,0,2,1,2,0,3,3,100
django-kronos,django-kronos,,0,0,1,0,0,1,0,1
atari-2600,atari-2600,,0,3,2,3,0,5,0,200
windows-shortcut,windows-shortcut,,0,0,2,0,0,2,6,1
pspp,pspp,,0,1,3,1,0,4,0,1
mongoose-q,mongoose-q,,0,0,1,0,0,1,1,1
faust,faust,,5,2,6,7,0,13,0,1
holochain,holochain,,1,1,5,2,0,7,9,1
holochain-rust,holochain-rust,,1,2,5,3,0,8,9,100
module-alias,module-alias,,1,0,2,1,0,3,1,1
priam,priam,,0,0,2,0,0,2,6,1
source-compatibility,source-compatibility,,0,1,1,1,0,2,3,1
cometd.net,cometd.net,,0,0,1,0,0,1,8,1
qandroidjniobject,qandroidjniobject,,1,1,2,2,0,4,3,1
ion-segment,ion-segment,,1,1,2,2,0,4,1,1
trustkit,trustkit,,0,1,2,1,0,3,6,1
xamlwriter,xamlwriter,,0,0,1,0,0,1,3,1
function-call-operator,function-call-operator,,1,0,1,1,0,2,9,1
link-prefetch,link-prefetch,,0,4,2,4,0,6,1,300
quicktypebar,quicktypebar,,1,0,1,1,0,2,13,1
ca1062,ca1062,,0,0,1,0,0,1,8,1
ibm-compose,ibm-compose,,0,0,1,0,0,1,6,1
android-safe-args,android-safe-args,,4,2,5,6,0,11,3,1
oscp5,oscp5,,0,0,2,0,0,2,3,1
ubiquity,ubiquity,,1,0,2,1,0,3,6,1
react-wrapper,react-wrapper,,4,0,1,4,0,5,1,1
jsr311,jsr311,,0,0,1,0,0,1,4,1
sun-coding-conventions,sun-coding-conventions,,0,0,1,0,0,1,2,1
automapper-8,automapper-8,,6,3,9,9,0,18,8,1
remotecontrolevent,remotecontrolevent,,1,0,1,1,0,2,13,1
mod-speling,mod-speling,,0,1,1,1,0,2,4,1
zgc,zgc,,1,0,1,1,0,2,2,1
dukescript,dukescript,,0,0,1,0,0,1,1,1
yellow-pages,yellow-pages,,0,0,1,0,0,1,0,1
pureftpd,pureftpd,,3,1,1,4,0,5,6,1
console2,console2,,0,0,1,0,0,1,9,1
euterpea,euterpea,,0,0,5,0,0,5,2,1
list-processing,list-processing,,0,0,2,0,0,2,0,1
netcoreapp2.1,netcoreapp2.1,,3,1,5,4,0,9,8,1
early-return,early-return,,0,0,1,0,0,1,1,1
chartnew.js,chartnew.js,,0,0,1,0,0,1,1,1
com-callable-wrapper,com-callable-wrapper,,0,0,1,0,0,1,8,1
svglite,svglite,,0,0,2,0,0,2,0,1
context-sensitive-grammar,context-sensitive-grammar,,0,0,3,0,0,3,0,1
ngx-brotli,ngx-brotli,,1,0,1,1,0,2,0,1
python-novaclient,python-novaclient,,0,0,1,0,0,1,6,1
keyword-extraction,keyword-extraction,,2,1,1,3,0,4,0,1
phaser,phaser,,0,1,2,1,0,3,3,1
contactitem,contactitem,,0,0,1,0,0,1,5,1
framework-migration,framework-migration,,0,0,1,0,0,1,8,1
btstask,btstask,,0,0,1,0,0,1,8,1
forbiddenfruit,forbiddenfruit,,0,0,1,0,0,1,0,1
client-applications,client-applications,,0,0,2,0,0,2,3,1
google-cloud-load-balancer,google-cloud-load-balancer,,4,6,4,10,0,14,6,50
jchart2d,jchart2d,,0,0,1,0,0,1,3,1
pelco,pelco,,1,0,1,1,0,2,13,1
arfacegeometry,arfacegeometry,,0,2,3,2,0,5,13,100
delphi-10.3-rio,delphi-10.3-rio,,48,37,39,85,0,124,9,1
azure-devops-server-2019,azure-devops-server-2019,,14,19,2,33,0,35,8,35.714286
charm++,charm++,,0,0,1,0,0,1,9,1
r-telegram-bot,r-telegram-bot,,0,1,1,1,0,2,0,1
rails-3-upgrade,rails-3-upgrade,,0,0,1,0,0,1,12,1
cindyjs,cindyjs,,0,1,1,1,0,2,1,1
guitexture,guitexture,,0,0,1,0,0,1,8,1
shinymodules,shinymodules,,9,8,4,17,0,21,0,1
indexing-service,indexing-service,,0,0,1,0,0,1,8,1
ionic-http,ionic-http,,0,1,1,1,0,2,1,1
hootsuite,hootsuite,,0,1,3,1,0,4,4,1
arm9,arm9,,0,0,1,0,0,1,9,1
web-access,web-access,,0,0,1,0,0,1,8,1
unordered-containers,unordered-containers,,1,0,1,1,0,2,2,1
kotlin-dsl,kotlin-dsl,,6,6,6,12,0,18,3,1
ora-01858,ora-01858,,0,0,1,0,0,1,4,1
bloc,bloc,,99,78,56,177,0,233,13,1
iaccessible,iaccessible,,1,1,1,2,0,3,8,1
gitg,gitg,,0,1,1,1,0,2,9,1
crystal-reports-10,crystal-reports-10,,0,0,1,0,0,1,8,1
linq-to-xsd,linq-to-xsd,,0,1,1,1,0,2,8,1
fiware-kurento,fiware-kurento,,1,2,3,3,0,6,1,100
angular-nativescript,angular-nativescript,,9,7,17,16,0,33,1,1
planetary.js,planetary.js,,0,1,2,1,0,3,1,1
domain-service-class,domain-service-class,,0,0,1,0,0,1,8,1
domaincontext,domaincontext,,0,0,1,0,0,1,8,1
ng4-charts,ng4-charts,,0,0,1,0,0,1,1,1
lobibox,lobibox,,0,0,2,0,0,2,1,1
xcode-organizer,xcode-organizer,,0,1,4,1,0,5,13,1
astroturf,astroturf,,0,0,2,0,0,2,1,1
css-in-js,css-in-js,,21,10,13,31,0,44,1,1
gae-search,gae-search,,0,0,2,0,0,2,6,1
webdeploy-3.5,webdeploy-3.5,,1,0,2,1,0,3,8,1
react-snap,react-snap,,8,3,6,11,0,17,1,1
android-devicetoken,android-devicetoken,,1,0,1,1,0,2,13,1
knative,knative,,12,11,3,23,0,26,6,1
treesort,treesort,,0,0,1,0,0,1,9,1
textpattern,textpattern,,0,0,1,0,0,1,1,1
hpsa,hpsa,,0,0,1,0,0,1,3,1
pending-transition,pending-transition,,1,0,2,1,0,3,4,1
openiso8583.net,openiso8583.net,,0,0,1,0,0,1,3,1
iso8583-1993,iso8583-1993,,1,0,1,1,0,2,3,1
mizar,mizar,,0,1,1,1,0,2,2,1
documentum-d2,documentum-d2,,0,1,1,1,0,2,16,1
qrunnable,qrunnable,,0,3,1,3,0,4,0,200
domino-ui,domino-ui,,0,0,3,0,0,3,3,1
json-extract,json-extract,,4,13,6,17,0,23,3,225
yaxlib,yaxlib,,0,0,2,0,0,2,8,1
weak-head-normal-form,weak-head-normal-form,,0,0,2,0,0,2,2,1
bower-register,bower-register,,0,0,2,0,0,2,1,1
resource-router-middleware,resource-router-middleware,,1,0,1,1,0,2,4,1
ckoperation,ckoperation,,0,0,1,0,0,1,13,1
automatic-install,automatic-install,,1,1,1,2,0,3,8,1
sp-blitz,sp-blitz,,2,1,1,3,0,4,4,1
oauth-ruby,oauth-ruby,,0,0,1,0,0,1,4,1
vaadin11,vaadin11,,0,1,4,1,0,5,3,1
eslint-plugin-compat,eslint-plugin-compat,,1,0,1,1,0,2,1,1
puma-dev,puma-dev,,2,2,4,4,0,8,12,1
kube-state-metrics,kube-state-metrics,,3,4,3,7,0,10,6,33.333333
virtualalloc,virtualalloc,,1,0,3,1,0,4,9,1
android-pixel-copy,android-pixel-copy,,1,0,4,1,0,5,3,1
pchar,pchar,,0,0,1,0,0,1,9,1
palemoon,palemoon,,1,0,1,1,0,2,4,1
readblock,readblock,,0,0,1,0,0,1,9,1
fuzzer,fuzzer,,1,0,3,1,0,4,9,1
impredicativetypes,impredicativetypes,,0,1,2,1,0,3,2,1
go-bundle,go-bundle,,0,0,2,0,0,2,6,1
tiger-lines,tiger-lines,,0,0,1,0,0,1,1,1
nifi-api,nifi-api,,0,0,2,0,0,2,2,1
opennetcf,opennetcf,,0,0,1,0,0,1,8,1
itaskitem,itaskitem,,0,0,1,0,0,1,8,1
simple.odata,simple.odata,,0,0,2,0,0,2,8,1
retrying,retrying,,1,2,1,3,0,4,0,100
mobiledevice.framework,mobiledevice.framework,,0,1,1,1,0,2,13,1
ticket-tracking,ticket-tracking,,0,0,2,0,0,2,4,1
juniper-network-connect,juniper-network-connect,,0,2,1,2,0,3,9,100
angular-bootstrap-toggle,angular-bootstrap-toggle,,1,0,2,1,0,3,1,1
javasymbolsolver,javasymbolsolver,,1,2,3,3,0,6,3,100
yarn-lock.json,yarn-lock.json,,0,2,3,2,0,5,1,100
jquery-dynatree,jquery-dynatree,,0,0,2,0,0,2,1,1
dll-dependency,dll-dependency,,0,0,1,0,0,1,8,1
zend-translate,zend-translate,,0,0,2,0,0,2,4,1
ws,ws,,24,19,17,43,0,60,1,1
scoped-ptr,scoped-ptr,,1,0,1,1,0,2,9,1
chronicle-wire,chronicle-wire,,0,0,2,0,0,2,3,1
shared-addin,shared-addin,,0,0,1,0,0,1,5,1
css-paint-api,css-paint-api,,1,1,2,2,0,4,1,1
afl-fuzz,afl-fuzz,,2,0,2,2,0,4,6,1
metric-fu,metric-fu,,0,0,1,0,0,1,12,1
dotenv,dotenv,,48,31,19,79,0,98,1,1
wordsegment,wordsegment,,1,0,1,1,0,2,0,1
key-cache-size,key-cache-size,,0,0,1,0,0,1,9,1
xeus-cling,xeus-cling,,2,0,2,2,0,4,0,1
kafka-rebalance,kafka-rebalance,,1,1,2,2,0,4,2,1
kill-ring,kill-ring,,0,0,1,0,0,1,9,1
dyn,dyn,,0,0,2,0,0,2,0,1
webbbs,webbbs,,0,0,1,0,0,1,8,1
asgi,asgi,,4,9,4,13,0,17,0,125
starlette,starlette,,3,4,2,7,0,9,0,33.333333
redox-os,redox-os,,0,0,1,0,0,1,9,1
magic-mouse,magic-mouse,,0,0,1,0,0,1,13,1
sharepoint-discussion-board,sharepoint-discussion-board,,1,1,1,2,0,3,8,1
host-object,host-object,,0,0,1,0,0,1,1,1
fast-model,fast-model,,0,0,1,0,0,1,9,1
application-resource,application-resource,,1,1,2,2,0,4,8,1
naming-containers,naming-containers,,0,0,1,0,0,1,0,1
swiften,swiften,,0,0,1,0,0,1,9,1
hiphop,hiphop,,0,0,1,0,0,1,4,1
genexus-gam,genexus-gam,,0,1,1,1,0,2,3,1
repeatable-read,repeatable-read,,0,1,3,1,0,4,4,1
editfield,editfield,,0,0,1,0,0,1,3,1
requirejs-text,requirejs-text,,0,0,1,0,0,1,1,1
rqda,rqda,,2,3,4,5,0,9,0,50
tomee-8,tomee-8,,10,2,5,12,0,17,3,1
document-class,document-class,,0,0,1,0,0,1,0,1
firefox-addon-overlay,firefox-addon-overlay,,0,0,1,0,0,1,1,1
webkit.net,webkit.net,,0,0,2,0,0,2,8,1
eager-execution,eager-execution,,34,29,19,63,0,82,0,1
canjs-view,canjs-view,,0,1,1,1,0,2,1,1
cddvd,cddvd,,1,1,1,2,0,3,13,1
cd-drive,cd-drive,,0,0,1,0,0,1,13,1
dialogflow-fulfillment,dialogflow-fulfillment,,86,70,81,156,0,237,13,1
demand-paging,demand-paging,,1,0,1,1,0,2,9,1
graphlookup,graphlookup,,1,3,2,4,0,6,1,200
hubzilla,hubzilla,,0,0,1,0,0,1,4,1
font-lock-mode,font-lock-mode,,0,0,1,0,0,1,9,1
line-continuation,line-continuation,,1,1,3,2,0,5,0,1
eclipse-2018-12,eclipse-2018-12,,0,0,9,0,0,9,3,1
memoir,memoir,,0,0,1,0,0,1,0,1
go-structtag,go-structtag,,0,4,1,4,0,5,6,300
divolte,divolte,,0,0,1,0,0,1,2,1
kaniko,kaniko,,6,4,5,10,0,15,6,1
poshrsjob,poshrsjob,,1,0,1,1,0,2,8,1
ppc64le,ppc64le,,0,2,2,2,0,4,6,100
magento-2.3,magento-2.3,,48,48,31,96,0,127,4,1
tensorboardx,tensorboardx,,4,3,6,7,0,13,0,1
double-compare-and-swap,double-compare-and-swap,,1,0,1,1,0,2,9,1
openxpki,openxpki,,0,0,2,0,0,2,6,1
last-occurrence,last-occurrence,,0,1,2,1,0,3,0,1
mod-access,mod-access,,0,0,1,0,0,1,4,1
chef-workstation,chef-workstation,,0,2,2,2,0,4,12,100
taphold,taphold,,1,0,1,1,0,2,1,1
convertto-json,convertto-json,,2,1,2,3,0,5,8,1
westwind-globalization,westwind-globalization,,0,0,1,0,0,1,8,1
swiftprotobuf,swiftprotobuf,,0,1,1,1,0,2,13,1
responsive-navigation,responsive-navigation,,0,0,2,0,0,2,1,1
strtoul,strtoul,,1,0,2,1,0,3,9,1
massiv,massiv,,1,0,2,1,0,3,2,1
quorrajs,quorrajs,,0,0,2,0,0,2,6,1
netplan,netplan,,0,3,3,3,0,6,6,200
method-modifier,method-modifier,,0,0,2,0,0,2,3,1
hsc2hs,hsc2hs,,0,0,1,0,0,1,2,1
stream-builder,stream-builder,,14,18,17,32,0,49,13,28.571429
yagni,yagni,,0,0,1,0,0,1,3,1
modelmultiplechoicefield,modelmultiplechoicefield,,1,3,1,4,0,5,0,200
gasnet,gasnet,,1,0,4,1,0,5,0,1
batch-build,batch-build,,2,0,1,2,0,3,8,1
vc1,vc1,,0,0,1,0,0,1,13,1
oracle-map-viewer,oracle-map-viewer,,0,0,1,0,0,1,1,1
nano-sql,nano-sql,,0,0,1,0,0,1,4,1
luaplus,luaplus,,0,0,1,0,0,1,9,1
dotnet-tool,dotnet-tool,,2,1,2,3,0,5,8,1
pats,pats,,0,0,1,0,0,1,13,1
mpo,mpo,,0,0,1,0,0,1,0,1
eoserror,eoserror,,2,2,4,4,0,8,0,1
docker-checkpoint,docker-checkpoint,,0,2,1,2,0,3,6,100
link-to-function,link-to-function,,0,0,1,0,0,1,12,1
teamcity-7.1,teamcity-7.1,,0,0,1,0,0,1,8,1
cscfg,cscfg,,0,0,2,0,0,2,8,1
async-network-io,async-network-io,,0,0,2,0,0,2,4,1
pairwise-distance,pairwise-distance,,5,3,3,8,0,11,0,1
flash-video,flash-video,,0,0,1,0,0,1,13,1
copas,copas,,0,0,1,0,0,1,9,1
drag-to-select,drag-to-select,,0,0,1,0,0,1,1,1
react-native-pdf,react-native-pdf,,3,0,2,3,0,5,1,1
hostnetwork,hostnetwork,,1,0,2,1,0,3,6,1
asyncio,asyncio,,0,73,1,73,0,74,0,7200
python-contextvars,python-contextvars,,1,1,1,2,0,3,0,1
es-hyperneat,es-hyperneat,,2,1,2,3,0,5,0,1
proxytunnel,proxytunnel,,0,0,1,0,0,1,6,1
kotlin-when,kotlin-when,,1,1,1,2,0,3,3,1
xmlpoke,xmlpoke,,0,1,1,1,0,2,8,1
multitexturing,multitexturing,,0,0,2,0,0,2,4,1
xing,xing,,0,1,1,1,0,2,13,1
hierarchical-temporal-memory,hierarchical-temporal-memory,,0,0,1,0,0,1,0,1
svn-config,svn-config,,0,0,1,0,0,1,6,1
sarbanes-oxley,sarbanes-oxley,,1,0,1,1,0,2,5,1
oracle-wallet,oracle-wallet,,1,1,3,2,0,5,4,1
api-discovery,api-discovery,,0,0,1,0,0,1,5,1
qt-jambi,qt-jambi,,0,0,3,0,0,3,3,1
ef-core-2.2,ef-core-2.2,,127,139,90,266,0,356,8,9.448819
progressmonitor,progressmonitor,,0,0,2,0,0,2,3,1
hirefire,hirefire,,1,0,2,1,0,3,1,1
turing-lang,turing-lang,,1,0,1,1,0,2,0,1
trouble-tickets,trouble-tickets,,0,0,2,0,0,2,2,1
episerver-relate+,episerver-relate+,,0,1,1,1,0,2,8,1
facebook-recommendations,facebook-recommendations,,0,0,1,0,0,1,13,1
iccid,iccid,,0,1,1,1,0,2,9,1
pygraph,pygraph,,0,0,1,0,0,1,0,1
askbot,askbot,,0,0,2,0,0,2,0,1
smocks,smocks,,0,0,1,0,0,1,8,1
c4.5,c4.5,,2,2,3,4,0,7,0,1
8thwall-web,8thwall-web,,2,5,1,7,0,8,1,150
bareword,bareword,,0,0,2,0,0,2,9,1
dynalite,dynalite,,0,0,1,0,0,1,1,1
cncontactformatter,cncontactformatter,,0,0,1,0,0,1,13,1
litterallycanvas.js,litterallycanvas.js,,0,0,1,0,0,1,1,1
tinysort,tinysort,,0,0,1,0,0,1,1,1
ms-access-macros,ms-access-macros,,5,6,4,11,0,15,5,20
unicodescalar,unicodescalar,,0,0,3,0,0,3,0,1
msdev,msdev,,0,0,1,0,0,1,8,1
clicktoedit,clicktoedit,,0,0,1,0,0,1,5,1
s3ql,s3ql,,0,1,1,1,0,2,6,1
open-mobile-api,open-mobile-api,,1,0,3,1,0,4,3,1
coledatetime,coledatetime,,0,0,2,0,0,2,9,1
steelseries,steelseries,,0,1,1,1,0,2,3,1
magento-ee,magento-ee,,2,0,1,2,0,3,4,1
precompiling,precompiling,,0,0,2,0,0,2,9,1
sprig-template-functions,sprig-template-functions,,2,1,2,3,0,5,6,1
depottools,depottools,,1,0,2,1,0,3,9,1
jscience,jscience,,0,1,1,1,0,2,3,1
rif,rif,,0,0,1,0,0,1,2,1
ajaxpro,ajaxpro,,0,0,1,0,0,1,1,1
ionic-native-http,ionic-native-http,,4,1,2,5,0,7,1,1
visma-net,visma-net,,0,0,1,0,0,1,4,1
nscala-time,nscala-time,,0,0,1,0,0,1,2,1
dataset-designer,dataset-designer,,0,0,1,0,0,1,4,1
ngx-bootstrap-accordion,ngx-bootstrap-accordion,,0,1,2,1,0,3,1,1
typeguards,typeguards,,2,3,2,5,0,7,1,50
verp,verp,,0,1,1,1,0,2,4,1
.net-core-3.0,.net-core-3.0,,39,62,14,101,0,115,8,58.974359
squirrel,squirrel,,1,1,4,2,0,6,0,1
.net-core-2.2,.net-core-2.2,,54,71,24,125,0,149,8,31.481481
tomcat-juli,tomcat-juli,,0,1,2,1,0,3,3,1
pytagcloud,pytagcloud,,0,0,1,0,0,1,0,1
synplify,synplify,,1,1,3,2,0,5,9,1
documentpaginator,documentpaginator,,2,0,1,2,0,3,8,1
event-routing,event-routing,,0,0,1,0,0,1,8,1
powerapps-datatable,powerapps-datatable,,1,1,5,2,0,7,8,1
powerapps-collection,powerapps-collection,,9,2,4,11,0,15,8,1
iasyncenumerable,iasyncenumerable,,3,0,3,3,0,6,8,1
ls2j,ls2j,,0,0,1,0,0,1,3,1
akka-io,akka-io,,0,0,1,0,0,1,2,1
mouseleftbuttondown,mouseleftbuttondown,,0,0,2,0,0,2,1,1
webgrind,webgrind,,0,0,1,0,0,1,9,1
sqldroid,sqldroid,,0,0,1,0,0,1,3,1
storyblok,storyblok,,4,1,3,5,0,8,1,1
imageblocks,imageblocks,,0,0,2,0,0,2,9,1
kentico-cloud,kentico-cloud,,7,7,8,14,0,22,8,1
analytic-geometry,analytic-geometry,,1,0,1,1,0,2,0,1
mobile-app-tracker,mobile-app-tracker,,0,0,2,0,0,2,3,1
simple-spring-memcached,simple-spring-memcached,,0,0,1,0,0,1,3,1
xcodegen,xcodegen,,0,0,1,0,0,1,3,1
graphicex,graphicex,,0,0,1,0,0,1,8,1
ninject-mockingkernel,ninject-mockingkernel,,0,0,1,0,0,1,8,1
vaadin12,vaadin12,,8,0,23,8,0,31,3,1
rpbroadcastsamplehandler,rpbroadcastsamplehandler,,3,0,1,3,0,4,13,1
linderdaum,linderdaum,,0,0,1,0,0,1,3,1
google-cloud-router,google-cloud-router,,0,1,1,1,0,2,9,1
initramfs,initramfs,,2,2,5,4,0,9,9,1
receigen,receigen,,1,0,1,1,0,2,13,1
facebookatwork,facebookatwork,,0,0,1,0,0,1,1,1
restitution,restitution,,0,0,1,0,0,1,3,1
gouraud,gouraud,,1,1,1,2,0,3,9,1
flutter-container,flutter-container,,2,0,2,2,0,4,13,1
spring-batch-stream,spring-batch-stream,,0,1,2,1,0,3,3,1
alertview,alertview,,0,0,1,0,0,1,13,1
cadaver,cadaver,,0,0,3,0,0,3,4,1
stack-based,stack-based,,0,0,1,0,0,1,9,1
nftables,nftables,,1,1,1,2,0,3,9,1
cfgrib,cfgrib,,0,1,1,1,0,2,0,1
windows-phone-8-emulator,windows-phone-8-emulator,,0,0,1,0,0,1,9,1
infinite-sequence,infinite-sequence,,0,1,1,1,0,2,2,1
rgtk2,rgtk2,,3,6,3,9,0,12,0,100
emptydatatext,emptydatatext,,0,0,1,0,0,1,3,1
tile-engine,tile-engine,,0,0,1,0,0,1,1,1
appcelerator-cli,appcelerator-cli,,0,0,1,0,0,1,13,1
devel-cover,devel-cover,,0,1,1,1,0,2,9,1
eiffel-studio-18,eiffel-studio-18,,1,0,4,1,0,5,9,1
antora,antora,,0,0,1,0,0,1,3,1
gridding,gridding,,0,1,2,1,0,3,0,1
overlap2d,overlap2d,,2,0,1,2,0,3,3,1
gadbannerview,gadbannerview,,1,1,3,2,0,5,13,1
drupal-path-aliases,drupal-path-aliases,,0,0,1,0,0,1,1,1
travis-rb,travis-rb,,1,0,1,1,0,2,6,1
travis-ci-api,travis-ci-api,,1,2,4,3,0,7,6,100
model-view-adapter,model-view-adapter,,0,0,1,0,0,1,9,1
errorcollector,errorcollector,,0,0,1,0,0,1,3,1
farpoint-spread,farpoint-spread,,0,1,4,1,0,5,8,1
meta-toolkit,meta-toolkit,,0,0,1,0,0,1,9,1
dry-run,dry-run,,1,0,1,1,0,2,8,1
w3-css,w3-css,,3,3,2,6,0,8,1,1
schedulewidget,schedulewidget,,0,0,2,0,0,2,8,1
rosette,rosette,,0,0,2,0,0,2,0,1
richeditabletext,richeditabletext,,0,0,1,0,0,1,13,1
experitest,experitest,,1,0,1,1,0,2,3,1
jinja2-cli,jinja2-cli,,1,0,1,1,0,2,9,1
local-shared-object,local-shared-object,,0,0,1,0,0,1,3,1
apache-kafka-security,apache-kafka-security,,6,6,1,12,0,13,2,1
iot-workbench,iot-workbench,,0,0,4,0,0,4,8,1
autocorrelation,autocorrelation,,17,12,12,29,0,41,0,1
log4net-ext-json,log4net-ext-json,,0,0,1,0,0,1,8,1
fbrequest-form,fbrequest-form,,0,0,1,0,0,1,8,1
msinfo32,msinfo32,,0,0,1,0,0,1,9,1
electric-cloud,electric-cloud,,2,0,1,2,0,3,6,1
medium.js,medium.js,,0,0,1,0,0,1,1,1
basegameutils,basegameutils,,0,0,1,0,0,1,3,1
openears,openears,,0,0,2,0,0,2,13,1
jqxcombobox,jqxcombobox,,0,1,1,1,0,2,1,1
kitchen-dokken,kitchen-dokken,,0,1,1,1,0,2,12,1
smokejs,smokejs,,0,0,1,0,0,1,1,1
simmechanics,simmechanics,,0,0,1,0,0,1,0,1
cfprint,cfprint,,0,0,2,0,0,2,4,1
sparql-generate,sparql-generate,,0,1,1,1,0,2,2,1
cfndsl,cfndsl,,0,0,2,0,0,2,6,1
rootbeer,rootbeer,,0,1,1,1,0,2,1,1
compliant,compliant,,0,0,1,0,0,1,4,1
android-a11y,android-a11y,,1,2,3,3,0,6,3,100
artik,artik,,1,1,1,2,0,3,6,1
snapjs,snapjs,,0,0,1,0,0,1,1,1
text-compression,text-compression,,1,1,1,2,0,3,0,1
calendar-control,calendar-control,,2,0,1,2,0,3,8,1
liquibase-sql,liquibase-sql,,5,7,4,12,0,16,3,40
xodus-dnq,xodus-dnq,,2,0,1,2,0,3,3,1
graphiti,graphiti,,0,0,1,0,0,1,3,1
wmd-editor,wmd-editor,,0,0,1,0,0,1,4,1
typeinitializationexception,typeinitializationexception,,1,0,1,1,0,2,8,1
jini,jini,,0,0,1,0,0,1,3,1
rxmp,rxmp,,0,0,1,0,0,1,12,1
previous-installation,previous-installation,,0,0,1,0,0,1,8,1
cfdirectory,cfdirectory,,1,0,2,1,0,3,4,1
weceem,weceem,,0,0,1,0,0,1,3,1
image-store,image-store,,0,1,3,1,0,4,1,1
sendwithus,sendwithus,,0,0,1,0,0,1,1,1
telescope,telescope,,0,1,1,1,0,2,4,1
flipboard,flipboard,,0,0,1,0,0,1,4,1
simple-peer,simple-peer,,3,5,8,8,0,16,1,66.666667
reactjs-stripe,reactjs-stripe,,0,0,1,0,0,1,4,1
media-url,media-url,,0,0,1,0,0,1,0,1
class-based-tasks,class-based-tasks,,0,0,1,0,0,1,0,1
wsat,wsat,,1,0,1,1,0,2,3,1
merge-file,merge-file,,0,0,2,0,0,2,5,1
blackberry-simulator,blackberry-simulator,,0,1,1,1,0,2,3,1
hit,hit,,0,2,1,2,0,3,8,100
imageobserver,imageobserver,,0,0,1,0,0,1,3,1
react-native-twitter-signin,react-native-twitter-signin,,2,0,1,2,0,3,1,1
bundle-release-js-and-assets,bundle-release-js-and-assets,,0,1,2,1,0,3,1,1
vistadb,vistadb,,0,0,1,0,0,1,5,1
azure-git-deployment,azure-git-deployment,,1,1,3,2,0,5,6,1
goldbach-conjecture,goldbach-conjecture,,1,0,4,1,0,5,0,1
avdepthdata,avdepthdata,,4,1,1,5,0,6,13,1
robjects,robjects,,0,0,1,0,0,1,0,1
strongswan,strongswan,,5,4,3,9,0,12,6,1
grunt-nodemon,grunt-nodemon,,0,0,1,0,0,1,1,1
nsclickgesturerecognizer,nsclickgesturerecognizer,,0,0,1,0,0,1,13,1
app-actions,app-actions,,5,15,1,20,0,21,3,200
video-upload,video-upload,,2,4,3,6,0,9,4,100
react-native-instagram-login,react-native-instagram-login,,1,1,1,2,0,3,1,1
gslb,gslb,,0,0,1,0,0,1,6,1
intuit-wasabi,intuit-wasabi,,0,1,1,1,0,2,13,1
dry-validation,dry-validation,,1,3,1,4,0,5,12,200
spring-batch-tasklet,spring-batch-tasklet,,6,10,5,16,0,21,3,66.666667
ef-core-pooling,ef-core-pooling,,1,0,1,1,0,2,8,1
eclipse-project-file,eclipse-project-file,,0,0,1,0,0,1,9,1
dommel,dommel,,0,0,2,0,0,2,8,1
vertx-eventbus,vertx-eventbus,,6,6,3,12,0,15,3,1
nova-hypervisor-show,nova-hypervisor-show,,0,0,1,0,0,1,6,1
plt-redex,plt-redex,,0,0,1,0,0,1,0,1
openwisp,openwisp,,1,1,1,2,0,3,9,1
open-multilingual-wordnet,open-multilingual-wordnet,,0,0,2,0,0,2,0,1
ibm-swift-sandbox,ibm-swift-sandbox,,0,0,1,0,0,1,13,1
jnbridge,jnbridge,,1,0,1,1,0,2,8,1
quantitative,quantitative,,2,0,2,2,0,4,0,1
fabio,fabio,,1,0,1,1,0,2,6,1
ebay-net-sdk,ebay-net-sdk,,0,1,1,1,0,2,8,1
amazon-linux-2,amazon-linux-2,,6,10,3,16,0,19,6,66.666667
multivalue-database,multivalue-database,,0,1,2,1,0,3,0,1
geolitecity,geolitecity,,0,0,4,0,0,4,4,1
autodesk-arvr,autodesk-arvr,,1,5,1,6,0,7,14,400
removeeventlistener,removeeventlistener,,15,4,11,19,0,30,1,1
enquire.js,enquire.js,,0,0,1,0,0,1,3,1
embedded-server,embedded-server,,1,2,3,3,0,6,3,100
instantiationexception,instantiationexception,,0,0,2,0,0,2,13,1
mysql-error-1060,mysql-error-1060,,0,0,1,0,0,1,4,1
artwork,artwork,,0,0,1,0,0,1,13,1
.lrc,.lrc,,1,0,1,1,0,2,3,1
postgres-10,postgres-10,,5,4,5,9,0,14,4,1
apache-ftpserver,apache-ftpserver,,0,0,1,0,0,1,3,1
windows-10-sdk,windows-10-sdk,,0,1,4,1,0,5,8,1
anchor-modeling,anchor-modeling,,0,1,1,1,0,2,4,1
buybutton.js,buybutton.js,,1,0,1,1,0,2,1,1
fragmentnavigator,fragmentnavigator,,1,0,1,1,0,2,3,1
logmein,logmein,,0,0,1,0,0,1,3,1
postcss-nesting,postcss-nesting,,1,0,1,1,0,2,1,1
openelec,openelec,,0,0,1,0,0,1,0,1
hashtree,hashtree,,0,0,1,0,0,1,0,1
occurrence-typing,occurrence-typing,,0,1,1,1,0,2,4,1
syscache,syscache,,0,0,1,0,0,1,3,1
mkpolygonrenderer,mkpolygonrenderer,,1,0,1,1,0,2,13,1
mkpolygonview,mkpolygonview,,0,0,1,0,0,1,13,1
spring-kafka-test,spring-kafka-test,,11,10,9,21,0,30,3,1
256color,256color,,0,0,1,0,0,1,0,1
amazon-dynamodb-global-tables,amazon-dynamodb-global-tables,,0,2,2,2,0,4,6,100
google-java-format,google-java-format,,5,0,4,5,0,9,3,1
logtalk,logtalk,,1,0,4,1,0,5,0,1
android-softbuttons,android-softbuttons,,0,2,1,2,0,3,3,100
one-simulator,one-simulator,,2,4,5,6,0,11,3,100
couchnode,couchnode,,0,0,1,0,0,1,3,1
openstack-shade,openstack-shade,,0,0,1,0,0,1,0,1
field-description,field-description,,1,2,2,3,0,5,4,100
microsoft-ajax,microsoft-ajax,,0,0,1,0,0,1,1,1
pypugjs,pypugjs,,0,0,1,0,0,1,1,1
gorest,gorest,,0,0,1,0,0,1,6,1
djangae,djangae,,4,0,3,4,0,7,6,1
jquery-boilerplate,jquery-boilerplate,,0,0,1,0,0,1,1,1
embedded-postgres,embedded-postgres,,0,1,1,1,0,2,2,1
adduplex,adduplex,,0,0,1,0,0,1,8,1
appjs,appjs,,0,0,2,0,0,2,1,1
sas-wps,sas-wps,,0,0,2,0,0,2,0,1
omml,omml,,0,1,1,1,0,2,4,1
torchscript,torchscript,,1,2,1,3,0,4,0,100
django-advanced-filters,django-advanced-filters,,0,0,2,0,0,2,0,1
amazon-acl,amazon-acl,,2,0,1,2,0,3,6,1
ora-01403,ora-01403,,0,1,1,1,0,2,4,1
google-apps-script-web-application,google-apps-script-web-application,,1,23,2,24,0,26,5,2200
securepay,securepay,,0,0,1,0,0,1,4,1
session-replay,session-replay,,0,0,1,0,0,1,4,1
php-ncurses,php-ncurses,,0,0,1,0,0,1,9,1
domain-aliasing,domain-aliasing,,1,1,1,2,0,3,4,1
anormcypher,anormcypher,,0,0,1,0,0,1,2,1
acceptverbs,acceptverbs,,0,0,1,0,0,1,3,1
local-devices,local-devices,,0,0,2,0,0,2,1,1
pfcollectionviewcell,pfcollectionviewcell,,0,0,1,0,0,1,13,1
c++filt,c++filt,,0,0,1,0,0,1,9,1
python-poetry,python-poetry,,6,6,3,12,0,15,0,1
piracy-protection,piracy-protection,,0,2,1,2,0,3,3,100
wscf,wscf,,0,0,1,0,0,1,8,1
io-async,io-async,,0,0,1,0,0,1,9,1
coldfusion-7,coldfusion-7,,0,0,1,0,0,1,4,1
bluedragon,bluedragon,,0,0,1,0,0,1,4,1
gmail-promo-tab,gmail-promo-tab,,1,1,4,2,0,6,4,1
verizon,verizon,,0,1,2,1,0,3,8,1
apk-signing,apk-signing,,0,2,3,2,0,5,3,100
ui-guidelines,ui-guidelines,,3,0,1,3,0,4,13,1
expression-web,expression-web,,0,0,1,0,0,1,22,1
microsoft-expression-web,microsoft-expression-web,,0,0,1,0,0,1,22,1
mysql-error-1146,mysql-error-1146,,1,0,1,1,0,2,4,1
flutter-alertdialog,flutter-alertdialog,,0,2,1,2,0,3,13,100
os161,os161,,0,0,1,0,0,1,9,1
refund,refund,,2,1,6,3,0,9,4,1
vui,vui,,3,0,1,3,0,4,13,1
ora-00900,ora-00900,,1,0,1,1,0,2,4,1
jsr199,jsr199,,0,0,1,0,0,1,3,1
lingo,lingo,,2,0,1,2,0,3,0,1
directorystream,directorystream,,1,0,1,1,0,2,3,1
curl-commandline,curl-commandline,,0,0,1,0,0,1,6,1
chart-director,chart-director,,0,0,1,0,0,1,0,1
rowdetailstemplate,rowdetailstemplate,,0,0,1,0,0,1,8,1
newlisp,newlisp,,0,0,1,0,0,1,9,1
xnio,xnio,,0,0,2,0,0,2,3,1
mzn2fzn,mzn2fzn,,0,0,4,0,0,4,0,1
flymake,flymake,,0,0,1,0,0,1,9,1
defadvice,defadvice,,0,0,1,0,0,1,9,1
aws-java-sdk-2.x,aws-java-sdk-2.x,,2,7,10,9,0,19,6,250
core-flight-system,core-flight-system,,0,1,2,1,0,3,9,1
manyconsole,manyconsole,,0,0,1,0,0,1,9,1
ems-sql-manager,ems-sql-manager,,1,0,1,1,0,2,4,1
vql,vql,,0,0,1,0,0,1,1,1
flutter-navigation,flutter-navigation,,26,26,13,52,0,65,13,1
mediaprojection,mediaprojection,,1,0,3,1,0,4,3,1
spacewalk,spacewalk,,0,0,1,0,0,1,9,1
flutter-packages,flutter-packages,,10,7,7,17,0,24,13,1
dart-packages,dart-packages,,1,1,3,2,0,5,13,1
express-ntlm,express-ntlm,,1,1,4,2,0,6,1,1
fileprovider,fileprovider,,4,4,8,8,0,16,3,1
lcc,lcc,,0,1,1,1,0,2,9,1
create-guten-block,create-guten-block,,3,3,3,6,0,9,4,1
scalariform,scalariform,,1,0,1,1,0,2,2,1
react-native-scrollable-tab-view,react-native-scrollable-tab-view,,1,1,1,2,0,3,1,1
shortcut-file,shortcut-file,,0,0,1,0,0,1,8,1
vss-web-extension-sdk,vss-web-extension-sdk,,1,0,1,1,0,2,1,1
php-7.3,php-7.3,,43,38,28,81,0,109,4,1
react-native-elements,react-native-elements,,29,36,26,65,0,91,1,24.137931
cp1250,cp1250,,0,2,1,2,0,3,4,100
fennec,fennec,,0,0,1,0,0,1,1,1
farm-solution,farm-solution,,0,0,1,0,0,1,8,1
afx,afx,,1,0,1,1,0,2,9,1
dotnetnuke-5,dotnetnuke-5,,0,1,1,1,0,2,8,1
cfcache,cfcache,,0,0,1,0,0,1,4,1
root.plist,root.plist,,0,0,2,0,0,2,13,1
elasticjs,elasticjs,,0,1,1,1,0,2,6,1
ruby-on-rails-6,ruby-on-rails-6,,33,65,9,98,0,107,12,96.969697
big.js,big.js,,0,0,2,0,0,2,1,1
medial-axis,medial-axis,,1,0,1,1,0,2,4,1
heartbleed-bug,heartbleed-bug,,0,0,1,0,0,1,6,1
vue-good-table,vue-good-table,,5,4,4,9,0,13,1,1
bash-it,bash-it,,1,0,1,1,0,2,9,1
android-expandable-list-view,android-expandable-list-view,,3,3,2,6,0,8,3,1
google-cloud-print-privet,google-cloud-print-privet,,0,0,1,0,0,1,1,1
gkscore,gkscore,,0,0,1,0,0,1,13,1
postman-pre-request-script,postman-pre-request-script,,18,15,14,33,0,47,4,1
universal-ctags,universal-ctags,,1,2,1,3,0,4,9,100
qlocalserver,qlocalserver,,0,0,1,0,0,1,9,1
apache-karaf-feature,apache-karaf-feature,,0,2,3,2,0,5,3,100
django-wysiwyg,django-wysiwyg,,1,0,1,1,0,2,0,1
lightningchart,lightningchart,,0,4,1,4,0,5,8,300
flutter-cupertino,flutter-cupertino,,14,18,3,32,0,35,13,28.571429
scintillanet,scintillanet,,0,0,3,0,0,3,1,1
ruby-1.9,ruby-1.9,,1,0,1,1,0,2,12,1
unobserved-exception,unobserved-exception,,0,1,1,1,0,2,8,1
type-application-overlay,type-application-overlay,,0,0,2,0,0,2,3,1
source-depot,source-depot,,1,0,1,1,0,2,6,1
source-control-bindings,source-control-bindings,,1,0,1,1,0,2,8,1
cordova6.4.0,cordova6.4.0,,0,0,2,0,0,2,1,1
typedreference,typedreference,,0,0,1,0,0,1,3,1
pep3118,pep3118,,1,0,1,1,0,2,0,1
impactjs,impactjs,,0,1,1,1,0,2,3,1
wwan,wwan,,0,1,1,1,0,2,9,1
currencymanager,currencymanager,,0,0,1,0,0,1,8,1
picolisp,picolisp,,1,0,1,1,0,2,9,1
gridworld,gridworld,,1,0,3,1,0,4,0,1
phpass,phpass,,0,1,1,1,0,2,4,1
appium-snackbar,appium-snackbar,,1,0,1,1,0,2,3,1
smaato,smaato,,0,0,1,0,0,1,3,1
facebook-exception,facebook-exception,,0,0,1,0,0,1,13,1
coverity-prevent,coverity-prevent,,0,1,1,1,0,2,9,1
blazor-server-side,blazor-server-side,,33,83,16,116,0,132,8,151.515152
hypertable,hypertable,,0,0,2,0,0,2,4,1
epochx,epochx,,0,0,1,0,0,1,0,1
tagbar,tagbar,,1,0,1,1,0,2,9,1
qtimeedit,qtimeedit,,2,0,2,2,0,4,0,1
umts,umts,,0,1,2,1,0,3,3,1
typed-rest-client,typed-rest-client,,0,0,1,0,0,1,1,1
centos7.6,centos7.6,,4,1,4,5,0,9,4,1
webpackjsonp,webpackjsonp,,1,0,1,1,0,2,1,1
testng.xml,testng.xml,,19,16,16,35,0,51,3,1
bootstrap-4.1.x,bootstrap-4.1.x,,3,2,5,5,0,10,1,1
palm-os,palm-os,,0,0,1,0,0,1,23,1
garnet-os,garnet-os,,0,0,1,0,0,1,23,1
verysleepy,verysleepy,,0,0,1,0,0,1,9,1
elasticsearch-php,elasticsearch-php,,2,1,6,3,0,9,6,1
amazon-ami,amazon-ami,,2,3,1,5,0,6,6,50
wsdl2code,wsdl2code,,1,0,2,1,0,3,3,1
static-dispatch,static-dispatch,,1,1,1,2,0,3,13,1
codeguard,codeguard,,0,1,1,1,0,2,9,1
stdcopy,stdcopy,,2,2,1,4,0,5,9,1
ternary-search,ternary-search,,0,0,1,0,0,1,0,1
xamarin-forms-4,xamarin-forms-4,,3,3,2,6,0,8,8,1
boxsdk,boxsdk,,1,0,1,1,0,2,6,1
python-black,python-black,,0,2,4,2,0,6,6,100
s2,s2,,0,4,2,4,0,6,0,300
bardjs,bardjs,,0,0,1,0,0,1,1,1
deep-learning-ami,deep-learning-ami,,0,0,1,0,0,1,6,1
virtual-earth,virtual-earth,,0,0,1,0,0,1,8,1
mylocationoverlay,mylocationoverlay,,1,0,1,1,0,2,3,1
axi4,axi4,,0,0,3,0,0,3,9,1
xcode10.2,xcode10.2,,118,45,7,163,0,170,13,1
asift,asift,,0,0,1,0,0,1,9,1
microsoft-agent,microsoft-agent,,0,0,1,0,0,1,9,1
prawnto,prawnto,,1,1,1,2,0,3,12,1
firecracker,firecracker,,0,2,2,2,0,4,6,100
flow-based-programming,flow-based-programming,,0,1,2,1,0,3,3,1
cl-ppcre,cl-ppcre,,0,0,1,0,0,1,0,1
hpple,hpple,,0,0,1,0,0,1,13,1
open-esb,open-esb,,0,0,2,0,0,2,3,1
test-fixture,test-fixture,,0,0,1,0,0,1,12,1
vline,vline,,0,0,1,0,0,1,0,1
nastran,nastran,,2,0,3,2,0,5,0,1
w3.js,w3.js,,2,2,1,4,0,5,1,1
quantified-constraints,quantified-constraints,,0,2,1,2,0,3,2,100
real-time-multiplayer,real-time-multiplayer,,1,1,10,2,0,12,3,1
heapalloc,heapalloc,,0,0,1,0,0,1,9,1
create.js,create.js,,0,1,1,1,0,2,1,1
eclipse-ditto,eclipse-ditto,,3,9,2,12,0,14,6,200
ios-mvc,ios-mvc,,1,0,1,1,0,2,13,1
ruby-watir,ruby-watir,,0,1,1,1,0,2,12,1
tvalue,tvalue,,0,0,1,0,0,1,9,1
webget,webget,,0,0,1,0,0,1,8,1
unitils,unitils,,0,0,1,0,0,1,3,1
spring-cloud-kubernetes,spring-cloud-kubernetes,,6,6,4,12,0,16,3,1
closeablehttpresponse,closeablehttpresponse,,2,0,2,2,0,4,3,1
camel-jackson,camel-jackson,,0,0,2,0,0,2,3,1
asp.net-core-staticfile,asp.net-core-staticfile,,0,2,1,2,0,3,8,100
spurt,spurt,,2,0,1,2,0,3,4,1
x10,x10,,0,0,1,0,0,1,9,1
scotch-panels,scotch-panels,,0,0,2,0,0,2,4,1
asciinema,asciinema,,1,1,1,2,0,3,1,1
singlethreadmodel,singlethreadmodel,,0,2,1,2,0,3,3,100
mercury,mercury,,1,0,1,1,0,2,6,1
advanceddatagrid,advanceddatagrid,,1,1,2,2,0,4,8,1
swift-keypath,swift-keypath,,5,5,2,10,0,12,13,1
object-equality,object-equality,,0,1,1,1,0,2,1,1
square-tape,square-tape,,1,0,1,1,0,2,3,1
qopenglwidget,qopenglwidget,,6,6,5,12,0,17,9,1
.net-services,.net-services,,0,0,1,0,0,1,8,1
cakephp-3.7,cakephp-3.7,,22,22,9,44,0,53,4,1
geopositioning,geopositioning,,0,1,1,1,0,2,1,1
ngx-xml2json,ngx-xml2json,,1,0,2,1,0,3,3,1
ionic-popover,ionic-popover,,0,0,1,0,0,1,1,1
goertzel-algorithm,goertzel-algorithm,,0,1,1,1,0,2,0,1
maven-package,maven-package,,2,0,1,2,0,3,3,1
boost-statechart,boost-statechart,,0,1,1,1,0,2,9,1
jemos-podam,jemos-podam,,1,0,1,1,0,2,3,1
pachyderm,pachyderm,,1,1,3,2,0,5,0,1
osmo-pocket,osmo-pocket,,1,0,1,1,0,2,3,1
packr,packr,,0,1,1,1,0,2,3,1
countly-analytics,countly-analytics,,1,0,1,1,0,2,13,1
spoiwo,spoiwo,,1,0,1,1,0,2,2,1
brfs,brfs,,0,0,1,0,0,1,1,1
opml,opml,,0,1,1,1,0,2,9,1
mcpayment,mcpayment,,0,0,1,0,0,1,4,1
android-xml-attribute,android-xml-attribute,,2,1,2,3,0,5,3,1
webdis,webdis,,0,0,1,0,0,1,1,1
rmiio,rmiio,,0,0,1,0,0,1,3,1
rsnapshot,rsnapshot,,0,0,1,0,0,1,9,1
wbr,wbr,,0,0,1,0,0,1,1,1
django-bitfield,django-bitfield,,0,0,1,0,0,1,0,1
liteide,liteide,,1,0,1,1,0,2,6,1
accessdatasource,accessdatasource,,1,0,1,1,0,2,8,1
facebook-ios-sdk-4.38,facebook-ios-sdk-4.38,,0,0,1,0,0,1,13,1
mwe,mwe,,0,0,1,0,0,1,3,1
identitymodel,identitymodel,,4,4,4,8,0,12,8,1
csquery,csquery,,0,0,1,0,0,1,8,1
novelty-detection,novelty-detection,,0,0,1,0,0,1,0,1
unity3d-native-plugins,unity3d-native-plugins,,1,1,4,2,0,6,8,1
mailsettings,mailsettings,,0,0,1,0,0,1,8,1
sandbox-solution,sandbox-solution,,0,0,1,0,0,1,1,1
android-viewbinder,android-viewbinder,,0,0,1,0,0,1,3,1
s5,s5,,0,0,1,0,0,1,9,1
rtl-language,rtl-language,,0,2,2,2,0,4,13,100
android-studio-3.4,android-studio-3.4,,26,35,4,61,0,65,3,34.615385
jboss-messaging,jboss-messaging,,1,1,2,2,0,4,3,1
gulp-shell,gulp-shell,,0,0,1,0,0,1,9,1
facebook-graph-api-v2.2,facebook-graph-api-v2.2,,0,0,1,0,0,1,13,1
azure-sql-data-warehouse,azure-sql-data-warehouse,,25,23,10,48,0,58,8,1
pydantic,pydantic,,5,3,1,8,0,9,0,1
tbxml,tbxml,,0,0,1,0,0,1,13,1
fiware-keyrock,fiware-keyrock,,6,0,2,6,0,8,6,1
googlemobileads,googlemobileads,,11,5,4,16,0,20,3,1
lineargradientbrush,lineargradientbrush,,2,0,1,2,0,3,8,1
spawn-fcgi,spawn-fcgi,,0,1,1,1,0,2,9,1
zfc-rbac,zfc-rbac,,0,0,1,0,0,1,4,1
gijgo-treeview,gijgo-treeview,,0,2,1,2,0,3,1,100
kickstarter,kickstarter,,0,1,1,1,0,2,0,1
quilt,quilt,,0,0,1,0,0,1,9,1
associated-const,associated-const,,0,1,1,1,0,2,9,1
scala-shell,scala-shell,,4,0,1,4,0,5,2,1
protected-folders,protected-folders,,0,0,1,0,0,1,8,1
jmenupopup,jmenupopup,,0,0,2,0,0,2,3,1
dnspy,dnspy,,1,2,1,3,0,4,8,100
sequoiadb,sequoiadb,,0,0,8,0,0,8,4,1
dictmixin,dictmixin,,0,0,1,0,0,1,0,1
prebid,prebid,,5,1,4,6,0,10,3,1
py-redis,py-redis,,4,2,2,6,0,8,3,1
sqflite,sqflite,,44,35,25,79,0,104,13,1
bitsy,bitsy,,0,0,1,0,0,1,2,1
vue-infinite-loading,vue-infinite-loading,,1,0,3,1,0,4,1,1
itemscollection,itemscollection,,0,0,2,0,0,2,8,1
route-parameters,route-parameters,,2,2,3,4,0,7,1,1
flutter-focus,flutter-focus,,0,0,1,0,0,1,13,1
geophp,geophp,,0,1,1,1,0,2,4,1
fast-math,fast-math,,1,2,1,3,0,4,9,100
clout,clout,,0,0,1,0,0,1,2,1
jfs,jfs,,0,0,3,0,0,3,3,1
stack-dump,stack-dump,,0,0,2,0,0,2,3,1
spark-redshift,spark-redshift,,3,2,4,5,0,9,2,1
angular2-template-loader,angular2-template-loader,,0,0,1,0,0,1,1,1
adsl,adsl,,1,0,1,1,0,2,3,1
.hgtags,.hgtags,,0,0,1,0,0,1,6,1
hg-revert,hg-revert,,0,0,1,0,0,1,6,1
spresense,spresense,,0,0,5,0,0,5,9,1
mvp4g,mvp4g,,0,0,1,0,0,1,3,1
hg-merge,hg-merge,,0,0,1,0,0,1,6,1
neo4jrestclient,neo4jrestclient,,0,1,3,1,0,4,0,1
webformsmvp,webformsmvp,,0,0,2,0,0,2,8,1
jruby-java-interop,jruby-java-interop,,0,0,1,0,0,1,12,1
foundation-sticky,foundation-sticky,,0,0,1,0,0,1,1,1
crichedit,crichedit,,0,0,1,0,0,1,9,1
wintersmith,wintersmith,,0,0,1,0,0,1,1,1
rabbitmq-stomp,rabbitmq-stomp,,0,0,1,0,0,1,3,1
tobjectlist,tobjectlist,,0,0,2,0,0,2,9,1
tokumx,tokumx,,0,0,1,0,0,1,9,1
buildah,buildah,,1,4,2,5,0,7,6,300
nszombieenabled,nszombieenabled,,0,0,1,0,0,1,13,1
actionbarsherlock-map,actionbarsherlock-map,,0,0,1,0,0,1,3,1
rfc6455,rfc6455,,0,1,1,1,0,2,12,1
argo,argo,,1,3,1,4,0,5,6,200
model-view-update,model-view-update,,0,0,1,0,0,1,8,1
vulcanize,vulcanize,,0,0,1,0,0,1,1,1
selenium-shutterbug,selenium-shutterbug,,1,0,1,1,0,2,3,1
emacs-server,emacs-server,,0,0,2,0,0,2,9,1
voc,voc,,0,2,2,2,0,4,0,100
ttabsheet,ttabsheet,,0,0,2,0,0,2,9,1
help-authoring,help-authoring,,0,0,1,0,0,1,13,1
mediaplayerservices,mediaplayerservices,,0,0,1,0,0,1,3,1
liferay-developer-studio,liferay-developer-studio,,0,0,1,0,0,1,3,1
blender-2.61,blender-2.61,,0,0,1,0,0,1,0,1
geben,geben,,0,0,1,0,0,1,4,1
minibuffer,minibuffer,,0,0,1,0,0,1,9,1
nwjs-contexts,nwjs-contexts,,0,4,1,4,0,5,1,300
phalconphp,phalconphp,,2,8,1,10,0,11,4,300
odata-v3,odata-v3,,1,0,2,1,0,3,8,1
charm,charm,,3,0,2,3,0,5,0,1
upc,upc,,0,0,1,0,0,1,0,1
truss,truss,,0,0,1,0,0,1,0,1
binaris,binaris,,0,0,1,0,0,1,0,1
unwarp,unwarp,,0,0,1,0,0,1,0,1
react-chartist,react-chartist,,1,0,1,1,0,2,1,1
sql-data-services,sql-data-services,,0,0,2,0,0,2,5,1
size-reduction,size-reduction,,1,1,2,2,0,4,0,1
tiger-census,tiger-census,,1,1,2,2,0,4,0,1
scriptedbrowser,scriptedbrowser,,0,0,3,0,0,3,6,1
tron,tron,,17,2,4,19,0,23,6,1
llvm-mca,llvm-mca,,0,0,1,0,0,1,9,1
zucchini,zucchini,,1,0,1,1,0,2,3,1
project.json,project.json,,0,1,1,1,0,2,1,1
object-class,object-class,,0,0,2,0,0,2,3,1
ipersistfile,ipersistfile,,0,0,1,0,0,1,4,1
yasson,yasson,,3,6,3,9,0,12,3,100
dom3,dom3,,0,0,1,0,0,1,1,1
android-2.1-eclair,android-2.1-eclair,,0,0,1,0,0,1,3,1
nook,nook,,0,0,1,0,0,1,3,1
google-content-api,google-content-api,,2,2,2,4,0,6,5,1
sitecore-speak-ui,sitecore-speak-ui,,0,0,1,0,0,1,8,1
edit-tableview,edit-tableview,,0,0,1,0,0,1,1,1
scnaudioplayer,scnaudioplayer,,0,2,1,2,0,3,13,100
yugabyte-db,yugabyte-db,,11,6,7,17,0,24,4,1
vuejs-jsx,vuejs-jsx,,0,0,1,0,0,1,1,1
datarowcollection,datarowcollection,,1,0,1,1,0,2,8,1
executives,executives,,0,0,1,0,0,1,9,1
filepond,filepond,,32,26,14,58,0,72,1,1
github-archive,github-archive,,0,0,1,0,0,1,6,1
public-members,public-members,,0,1,1,1,0,2,3,1
swift-block,swift-block,,0,1,1,1,0,2,13,1
ihostingenvironment,ihostingenvironment,,1,0,1,1,0,2,8,1
claims-authentication,claims-authentication,,1,2,2,3,0,5,8,100
safe-browsing-api,safe-browsing-api,,3,5,2,8,0,10,5,66.666667
hawkbit,hawkbit,,1,0,1,1,0,2,4,1
ruby-2.6,ruby-2.6,,1,7,6,8,0,14,12,600
navigational-properties,navigational-properties,,1,0,2,1,0,3,8,1
libreoffice-macros,libreoffice-macros,,0,0,1,0,0,1,5,1
google-drive-picker,google-drive-picker,,10,2,2,12,0,14,5,1
document-preview,document-preview,,0,1,1,1,0,2,13,1
webpart-connection,webpart-connection,,0,0,1,0,0,1,8,1
os-agnostic,os-agnostic,,0,2,1,2,0,3,9,100
hamlit,hamlit,,0,0,1,0,0,1,12,1
eluna-lua-engine,eluna-lua-engine,,1,5,1,6,0,7,9,400
gtts,gtts,,9,7,7,16,0,23,0,1
bbc-micro,bbc-micro,,0,0,1,0,0,1,5,1
powerbasic,powerbasic,,0,0,1,0,0,1,5,1
sbt-jmh,sbt-jmh,,2,0,1,2,0,3,2,1
staleobjectstateexception,staleobjectstateexception,,0,0,1,0,0,1,3,1
msbuild-api,msbuild-api,,0,0,1,0,0,1,8,1
semantic-actions,semantic-actions,,2,0,1,2,0,3,9,1
babili,babili,,1,0,1,1,0,2,1,1
materialcardview,materialcardview,,5,3,2,8,0,10,3,1
econnect,econnect,,3,2,3,5,0,8,8,1
nested-includes,nested-includes,,1,0,2,1,0,3,12,1
cephfs,cephfs,,2,4,2,6,0,8,6,100
double-underscore,double-underscore,,1,0,1,1,0,2,0,1
less-plugins,less-plugins,,0,0,1,0,0,1,9,1
strongly-typed-view,strongly-typed-view,,0,0,1,0,0,1,8,1
reliablesession,reliablesession,,0,0,1,0,0,1,8,1
libvlcsharp,libvlcsharp,,8,8,1,16,0,17,13,1
senna,senna,,0,0,2,0,0,2,0,1
asna-visual-rpg,asna-visual-rpg,,0,0,1,0,0,1,13,1
gulp-dest,gulp-dest,,1,0,1,1,0,2,1,1
substrate,substrate,,20,19,2,39,0,41,9,1
shibboleth-sp,shibboleth-sp,,3,3,4,6,0,10,8,1
contextily,contextily,,1,1,1,2,0,3,0,1
paypal-soap,paypal-soap,,0,0,2,0,0,2,4,1
dynamics-business-central,dynamics-business-central,,8,11,2,19,0,21,8,37.5
microsoft-dynamics-business-central,microsoft-dynamics-business-central,,4,7,2,11,0,13,8,75
powerbi-js-api,powerbi-js-api,,2,0,2,2,0,4,5,1
wandisco,wandisco,,0,0,2,0,0,2,2,1
nrefactory,nrefactory,,0,0,1,0,0,1,8,1
toast-ui-image-editor,toast-ui-image-editor,,1,1,2,2,0,4,1,1
ora-04091,ora-04091,,0,0,1,0,0,1,4,1
viper-mode,viper-mode,,0,0,1,0,0,1,9,1
python-nolearn,python-nolearn,,0,0,1,0,0,1,0,1
logicblox,logicblox,,0,0,1,0,0,1,24,1
logiql,logiql,,0,0,1,0,0,1,24,1
array-combine,array-combine,,4,1,2,5,0,7,4,1
active-script,active-script,,0,0,1,0,0,1,5,1
shareware,shareware,,0,0,1,0,0,1,9,1
android-diffutils,android-diffutils,,11,20,1,31,0,32,3,81.818182
reorderable-list,reorderable-list,,0,2,1,2,0,3,13,100
cgpdf,cgpdf,,0,0,1,0,0,1,13,1
ruby-native-extensions,ruby-native-extensions,,1,0,1,1,0,2,12,1
terraform-provider-kubernetes,terraform-provider-kubernetes,,3,3,4,6,0,10,6,1
sqlite-odbc,sqlite-odbc,,0,0,1,0,0,1,4,1
.ctf,.ctf,,0,0,1,0,0,1,9,1
vue-directives,vue-directives,,6,8,3,14,0,17,1,33.333333
buildprovider,buildprovider,,0,0,2,0,0,2,8,1
nis,nis,,0,1,2,1,0,3,9,1
webpack-chain,webpack-chain,,3,2,1,5,0,6,1,1
design-time-data,design-time-data,,1,0,2,1,0,3,8,1
gvnix,gvnix,,0,0,1,0,0,1,25,1
gvnix-es,gvnix-es,,0,0,1,0,0,1,25,1
torus-knot,torus-knot,,0,0,2,0,0,2,0,1
perl-tidy,perl-tidy,,1,0,2,1,0,3,9,1
kvocontroller,kvocontroller,,0,0,1,0,0,1,13,1
http-negotiate,http-negotiate,,1,1,2,2,0,4,8,1
primeng-table,primeng-table,,2,4,5,6,0,11,1,100
mockhttpmessagehandler,mockhttpmessagehandler,,0,1,1,1,0,2,8,1
history-tables,history-tables,,0,0,1,0,0,1,5,1
trusted-application,trusted-application,,0,0,1,0,0,1,8,1
angular-console,angular-console,,1,2,1,3,0,4,1,100
spotify-mobius,spotify-mobius,,0,0,1,0,0,1,3,1
youtube.net-api,youtube.net-api,,0,0,1,0,0,1,5,1
deferrable-constraint,deferrable-constraint,,0,0,1,0,0,1,4,1
maturity,maturity,,0,0,1,0,0,1,0,1
xmlelement,xmlelement,,3,3,1,6,0,7,8,1
concurrently,concurrently,,0,4,2,4,0,6,1,300
azure-devops-deploymentgroups,azure-devops-deploymentgroups,,3,1,1,4,0,5,8,1
video-camera,video-camera,,0,0,2,0,0,2,13,1
raspberry-pi-zero,raspberry-pi-zero,,15,17,13,32,0,45,0,13.333333
headless-cms,headless-cms,,6,8,1,14,0,15,4,33.333333
cairoplot,cairoplot,,0,0,1,0,0,1,0,1
mulesoft,mulesoft,,59,72,21,131,0,152,14,22.033898
hdf5dotnet,hdf5dotnet,,0,1,4,1,0,5,8,1
mercurial-keyring,mercurial-keyring,,0,0,1,0,0,1,6,1
registering,registering,,0,1,2,1,0,3,13,1
infer.net,infer.net,,1,0,1,1,0,2,8,1
nativescript-camera,nativescript-camera,,1,0,1,1,0,2,1,1
wireguard,wireguard,,3,1,6,4,0,10,6,1
wherehas,wherehas,,2,1,2,3,0,5,4,1
intrinsic-ratio,intrinsic-ratio,,0,0,1,0,0,1,1,1
easytrieve,easytrieve,,1,0,1,1,0,2,4,1
dynamic-data-list,dynamic-data-list,,0,0,1,0,0,1,0,1
knopflerfish,knopflerfish,,1,0,1,1,0,2,3,1
android-host-api,android-host-api,,0,0,1,0,0,1,3,1
struts2-junit-plugin,struts2-junit-plugin,,0,0,1,0,0,1,3,1
grunt-contrib-jasmine,grunt-contrib-jasmine,,0,2,1,2,0,3,1,100
hybridauthprovider,hybridauthprovider,,0,2,1,2,0,3,4,100
nswagstudio,nswagstudio,,1,2,2,3,0,5,8,100
flatui,flatui,,0,0,1,0,0,1,8,1
libdbi,libdbi,,0,0,1,0,0,1,9,1
dynacache,dynacache,,0,0,1,0,0,1,3,1
docx4js,docx4js,,0,0,1,0,0,1,1,1
javapoly,javapoly,,0,0,1,0,0,1,1,1
xamarin.forms.maps,xamarin.forms.maps,,5,5,3,10,0,13,8,1
friendfeed,friendfeed,,0,0,1,0,0,1,4,1
pug-loader,pug-loader,,10,8,6,18,0,24,1,1
neshan-platform,neshan-platform,,0,1,1,1,0,2,3,1
fluent-orm,fluent-orm,,0,0,2,0,0,2,13,1
aws-mediatailor,aws-mediatailor,,0,0,1,0,0,1,6,1
compiler-generated,compiler-generated,,2,2,1,4,0,5,2,1
pager.js,pager.js,,0,0,1,0,0,1,1,1
groupdocs,groupdocs,,0,0,1,0,0,1,0,1
react-native-lightbox,react-native-lightbox,,0,0,2,0,0,2,1,1
remote-repository,remote-repository,,0,6,1,6,0,7,6,500
react-draft-wysiwyg,react-draft-wysiwyg,,4,10,2,14,0,16,1,150
bolero,bolero,,1,0,1,1,0,2,8,1
foreach-object,foreach-object,,1,1,2,2,0,4,8,1
code-freeze,code-freeze,,1,0,2,1,0,3,6,1
tfield,tfield,,0,0,1,0,0,1,9,1
camellia,camellia,,0,0,1,0,0,1,6,1
servicestack-openapi,servicestack-openapi,,0,1,1,1,0,2,3,1
child-objects,child-objects,,0,0,1,0,0,1,1,1
iptcinfo,iptcinfo,,0,0,1,0,0,1,4,1
aws-documentdb-mongoapi,aws-documentdb-mongoapi,,8,10,10,18,0,28,6,25
qitemselectionmodel,qitemselectionmodel,,0,1,1,1,0,2,9,1
wmdc,wmdc,,0,1,1,1,0,2,8,1
dynamics-nav-2015,dynamics-nav-2015,,0,0,1,0,0,1,1,1
airwatchsdk,airwatchsdk,,1,1,1,2,0,3,13,1
eclipse-iot,eclipse-iot,,2,9,1,11,4,12,6,350
clojure-repl,clojure-repl,,0,0,1,0,0,1,2,1
kotlin-inline-class,kotlin-inline-class,,2,0,1,2,0,3,3,1
kotlin-java-interop,kotlin-java-interop,,4,2,1,6,0,7,3,1
paf,paf,,1,0,1,1,0,2,0,1
azure-analytics,azure-analytics,,6,8,2,14,0,16,8,33.333333
react-native-sensors,react-native-sensors,,1,1,3,2,0,5,1,1
bodyscrolllock,bodyscrolllock,,1,0,1,1,0,2,1,1
coexistence,coexistence,,1,0,2,1,0,3,6,1
subspec,subspec,,1,0,2,1,0,3,13,1
visual-d,visual-d,,0,0,1,0,0,1,5,1
syncservices,syncservices,,0,0,1,0,0,1,3,1
react-router-navigation,react-router-navigation,,0,0,1,0,0,1,1,1
python-can,python-can,,7,3,3,10,0,13,0,1
vectorwise,vectorwise,,0,1,1,1,0,2,4,1
texture-wrapping,texture-wrapping,,0,0,1,0,0,1,9,1
nsurlcredential,nsurlcredential,,0,0,2,0,0,2,13,1
nsurlcredentialstorage,nsurlcredentialstorage,,0,0,1,0,0,1,13,1
phonejs,phonejs,,0,0,1,0,0,1,1,1
apple-pencil,apple-pencil,,5,5,1,10,0,11,13,1
class-cluster,class-cluster,,0,0,1,0,0,1,13,1
private-class,private-class,,0,0,2,0,0,2,13,1
grand-theft-auto,grand-theft-auto,,3,3,2,6,0,8,9,1
cezerin,cezerin,,1,0,1,1,0,2,1,1
clish,clish,,0,0,1,0,0,1,9,1
libcouchbase,libcouchbase,,0,0,1,0,0,1,3,1
flutter-image,flutter-image,,8,6,6,14,0,20,13,1
wcf-rest-starter-kit,wcf-rest-starter-kit,,0,0,1,0,0,1,1,1
dockerode,dockerode,,2,4,2,6,0,8,6,100
opensolaris,opensolaris,,2,0,1,2,0,3,9,1
jinterface,jinterface,,0,1,1,1,0,2,2,1
react-cache,react-cache,,1,0,2,1,0,3,1,1
cview,cview,,0,0,2,0,0,2,9,1
retained-in-memory,retained-in-memory,,0,0,1,0,0,1,9,1
telerik-editor,telerik-editor,,1,0,1,1,0,2,8,1
stdlaunder,stdlaunder,,1,1,1,2,0,3,9,1
facebook-graph-api-v2.3,facebook-graph-api-v2.3,,0,1,1,1,0,2,13,1
dnp3,dnp3,,1,0,2,1,0,3,9,1
jasmine-ts,jasmine-ts,,0,0,1,0,0,1,1,1
imposm,imposm,,0,1,1,1,0,2,4,1
length-modifiers,length-modifiers,,0,0,1,0,0,1,9,1
activebatch,activebatch,,1,0,1,1,0,2,3,1
flutter-provider,flutter-provider,,4,57,2,61,0,63,13,1325
movieplayer,movieplayer,,0,0,1,0,0,1,8,1
monkey-x,monkey-x,,0,0,1,0,0,1,9,1
openvbx,openvbx,,0,0,1,0,0,1,13,1
ev3,ev3,,5,6,6,11,0,17,0,20
n2o,n2o,,1,0,2,1,0,3,2,1
password-prompt,password-prompt,,0,0,1,0,0,1,8,1
twitter-feed,twitter-feed,,0,1,1,1,0,2,0,1
solrclient,solrclient,,2,4,1,6,0,7,2,100
flask-dance,flask-dance,,4,5,1,9,0,10,0,25
objecthandles,objecthandles,,0,0,1,0,0,1,0,1
bindgen,bindgen,,0,0,2,0,0,2,9,1
term-query,term-query,,1,0,2,1,0,3,2,1
cbutton,cbutton,,2,0,1,2,0,3,9,1
igx-grid,igx-grid,,1,0,2,1,0,3,1,1
koa-static,koa-static,,0,0,2,0,0,2,1,1
raw-file,raw-file,,4,2,2,6,0,8,0,1
directional-light,directional-light,,0,1,1,1,0,2,13,1
jsform,jsform,,0,0,1,0,0,1,1,1
vaadin-core-elements,vaadin-core-elements,,0,0,1,0,0,1,3,1
readiumjs,readiumjs,,0,1,1,1,0,2,3,1
rswag,rswag,,1,1,2,2,0,4,3,1
n-api,n-api,,9,5,5,14,0,19,1,1
oci-python-sdk,oci-python-sdk,,0,0,1,0,0,1,4,1
dbproj,dbproj,,0,0,2,0,0,2,4,1
vapor-fluent,vapor-fluent,,8,3,3,11,0,14,13,1
fullcalendar-4,fullcalendar-4,,72,104,8,176,0,184,1,44.444444
spuser,spuser,,0,0,1,0,0,1,8,1
spuserfield,spuserfield,,0,0,1,0,0,1,8,1
delphi-units,delphi-units,,0,0,1,0,0,1,9,1
friendrequest,friendrequest,,0,0,1,0,0,1,0,1
gamecanvas,gamecanvas,,0,0,1,0,0,1,1,1
dyon,dyon,,0,0,1,0,0,1,9,1
aws-nuke,aws-nuke,,0,0,1,0,0,1,6,1
magento-go,magento-go,,0,0,1,0,0,1,4,1
django-sslify,django-sslify,,0,0,1,0,0,1,0,1
magento-1.x,magento-1.x,,0,0,1,0,0,1,4,1
openaccess,openaccess,,0,0,1,0,0,1,8,1
fluent-mysql,fluent-mysql,,2,0,1,2,0,3,13,1
redoc,redoc,,5,4,4,9,0,13,3,1
domain-modelling,domain-modelling,,0,2,1,2,0,3,8,100
libfaac,libfaac,,0,0,1,0,0,1,13,1
precompiled-views,precompiled-views,,0,0,1,0,0,1,8,1
gimbal,gimbal,,0,1,1,1,0,2,3,1
step-through,step-through,,0,0,1,0,0,1,9,1
android-sdk-build-tools,android-sdk-build-tools,,0,0,2,0,0,2,3,1
codesense,codesense,,0,0,1,0,0,1,8,1
asynccontroller,asynccontroller,,0,0,1,0,0,1,8,1
xo.js,xo.js,,0,0,1,0,0,1,1,1
pac4j,pac4j,,3,0,2,3,0,5,3,1
cuteeditor,cuteeditor,,0,0,1,0,0,1,4,1
ip2long,ip2long,,0,0,3,0,0,3,4,1
spring-boot-jpa,spring-boot-jpa,,17,8,7,25,0,32,3,1
audio-panning,audio-panning,,0,0,1,0,0,1,0,1
inline-c,inline-c,,0,0,2,0,0,2,9,1
mindwave,mindwave,,2,0,1,2,0,3,13,1
uvcvideo,uvcvideo,,0,0,2,0,0,2,3,1
mt940,mt940,,0,0,1,0,0,1,3,1
android-gradle-plugin-3.3.0,android-gradle-plugin-3.3.0,,0,1,6,1,0,7,3,1
swagger-wcf,swagger-wcf,,1,0,2,1,0,3,8,1
zipapp,zipapp,,1,1,1,2,0,3,3,1
chatjs,chatjs,,0,0,1,0,0,1,1,1
37-signals,37-signals,,0,0,1,0,0,1,4,1
event-gateway,event-gateway,,0,1,2,1,0,3,6,1
microsoft-graph-calendar,microsoft-graph-calendar,,38,32,9,70,0,79,8,1
creole,creole,,0,0,2,0,0,2,3,1
zoomify,zoomify,,1,1,5,2,0,7,1,1
sap-connector-java,sap-connector-java,,0,0,1,0,0,1,3,1
google-ads-api,google-ads-api,,29,29,4,58,0,62,5,1
wdio-jasmine,wdio-jasmine,,1,1,2,2,0,4,3,1
sidewaffle,sidewaffle,,0,0,1,0,0,1,8,1
django-sorcery,django-sorcery,,1,0,1,1,0,2,0,1
google-chat,google-chat,,3,6,3,9,0,12,5,100
java-attach-api,java-attach-api,,0,0,1,0,0,1,3,1
parallel-execution,parallel-execution,,4,4,2,8,0,10,3,1
springy.js,springy.js,,0,0,1,0,0,1,1,1
eoutofresources,eoutofresources,,0,0,1,0,0,1,3,1
abp,abp,,11,32,5,43,0,48,8,190.909091
facebooksdk.net,facebooksdk.net,,0,0,1,0,0,1,13,1
okbuck,okbuck,,0,0,1,0,0,1,3,1
gpa,gpa,,0,3,2,3,0,5,0,200
media-manager,media-manager,,1,1,1,2,0,3,8,1
constructor-inheritance,constructor-inheritance,,0,0,1,0,0,1,9,1
mat-list,mat-list,,1,1,1,2,0,3,1,1
thingsboard-gateway,thingsboard-gateway,,1,5,3,6,0,9,6,400
wpf-4.0,wpf-4.0,,1,0,1,1,0,2,8,1
mass-package,mass-package,,0,0,1,0,0,1,0,1
voicexml,voicexml,,2,1,2,3,0,5,13,1
docker-dtr,docker-dtr,,0,0,1,0,0,1,6,1
pact-lang,pact-lang,,1,1,1,2,0,3,6,1
sequence-modeling,sequence-modeling,,2,1,1,3,0,4,0,1
spring-cloud-function,spring-cloud-function,,12,13,3,25,0,28,3,8.333333
odoo-server,odoo-server,,0,0,1,0,0,1,0,1
apr-util,apr-util,,0,0,2,0,0,2,9,1
html-mode,html-mode,,0,0,1,0,0,1,1,1
dashcast,dashcast,,0,0,1,0,0,1,13,1
cabwiz,cabwiz,,0,0,1,0,0,1,8,1
apache-torque,apache-torque,,0,0,1,0,0,1,2,1
dbghost,dbghost,,0,0,1,0,0,1,0,1
measurestring,measurestring,,0,0,1,0,0,1,8,1
serviceclient,serviceclient,,2,0,1,2,0,3,8,1
zigfu,zigfu,,0,0,2,0,0,2,8,1
functional-index,functional-index,,0,0,1,0,0,1,4,1
hyperledger-chaincode,hyperledger-chaincode,,30,30,9,60,0,69,6,1
url-template,url-template,,0,0,1,0,0,1,3,1
xmldog,xmldog,,0,0,1,0,0,1,3,1
scala-template,scala-template,,1,0,1,1,0,2,2,1
muxviz,muxviz,,0,1,1,1,0,2,0,1
nspointerarray,nspointerarray,,0,0,1,0,0,1,9,1
logonserver,logonserver,,0,0,1,0,0,1,4,1
flutter-animatedlist,flutter-animatedlist,,0,5,2,5,0,7,13,400
laravel-schema-builder,laravel-schema-builder,,1,0,1,1,0,2,4,1
nspopupbuttoncell,nspopupbuttoncell,,0,0,2,0,0,2,13,1
f#-argu,f#-argu,,2,1,1,3,0,4,8,1
speedus,speedus,,0,0,1,0,0,1,0,1
scribus,scribus,,1,0,2,1,0,3,8,1
camel-zipfile,camel-zipfile,,0,0,1,0,0,1,3,1
attributecertificate,attributecertificate,,0,0,1,0,0,1,6,1
dead-reckoning,dead-reckoning,,0,2,1,2,0,3,3,100
chipset,chipset,,0,0,1,0,0,1,9,1
bindings-library,bindings-library,,1,0,1,1,0,2,8,1
riemann-dashboard,riemann-dashboard,,0,0,1,0,0,1,2,1
photo-tagging,photo-tagging,,0,0,1,0,0,1,0,1
streamwriter.write,streamwriter.write,,1,0,1,1,0,2,8,1
fixed-length-file,fixed-length-file,,2,2,1,4,0,5,0,1
appdome,appdome,,0,0,1,0,0,1,3,1
hpx,hpx,,2,1,3,3,0,6,9,1
geant4,geant4,,2,6,1,8,0,9,9,200
dynamicgridview,dynamicgridview,,0,0,2,0,0,2,1,1
node-addon-api,node-addon-api,,7,8,5,15,0,20,1,14.285714
time-trial,time-trial,,0,0,1,0,0,1,1,1
postman-testcase,postman-testcase,,16,19,8,35,0,43,4,18.75
localsocket,localsocket,,0,2,1,2,0,3,3,100
membrane-soa,membrane-soa,,0,1,2,1,0,3,4,1
setapdf,setapdf,,0,1,1,1,0,2,8,1
gedit-plugin,gedit-plugin,,0,0,1,0,0,1,0,1
redux-react-hook,redux-react-hook,,3,3,1,6,0,7,1,1
ekreminder,ekreminder,,0,2,1,2,0,3,13,100
opencv4nodejs,opencv4nodejs,,1,4,2,5,0,7,1,300
sap.m,sap.m,,2,1,1,3,0,4,1,1
roll-forward,roll-forward,,0,0,1,0,0,1,4,1
azure-ad-domain-services,azure-ad-domain-services,,2,1,2,3,0,5,8,1
microcoding,microcoding,,0,0,1,0,0,1,9,1
genicam,genicam,,3,2,2,5,0,7,13,1
rust-decl-macros,rust-decl-macros,,2,2,5,4,0,9,9,1
eslint-plugin-vue,eslint-plugin-vue,,1,2,2,3,0,5,1,100
eclipse-2019-03,eclipse-2019-03,,3,3,2,6,0,8,3,1
clover-payment,clover-payment,,0,1,1,1,0,2,4,1
appengine-pipeline,appengine-pipeline,,0,0,1,0,0,1,6,1
azure-linux,azure-linux,,2,2,3,4,0,7,8,1
ctfe,ctfe,,0,0,1,0,0,1,9,1
esptool,esptool,,0,2,2,2,0,4,9,100
gravity-language,gravity-language,,0,0,1,0,0,1,9,1
cgcontextdrawpdfpage,cgcontextdrawpdfpage,,0,1,1,1,0,2,13,1
optional-typing,optional-typing,,1,1,1,2,0,3,1,1
gradual-typing,gradual-typing,,1,0,1,1,0,2,1,1
optuna,optuna,,0,1,1,1,0,2,0,1
android-restrictions,android-restrictions,,0,2,1,2,0,3,3,100
yii2-log,yii2-log,,1,0,1,1,0,2,4,1
holder.js,holder.js,,0,1,1,1,0,2,1,1
react-font-awesome,react-font-awesome,,1,2,1,3,0,4,1,100
xslkey,xslkey,,0,0,2,0,0,2,3,1
gridex,gridex,,0,2,3,2,0,5,8,100
leksah,leksah,,0,0,1,0,0,1,2,1
android-navigation-editor,android-navigation-editor,,7,3,1,10,0,11,3,1
xpathdocument,xpathdocument,,0,0,1,0,0,1,3,1
ixmldomdocument,ixmldomdocument,,0,0,1,0,0,1,9,1
ixmldomnode,ixmldomnode,,0,0,1,0,0,1,9,1
migrate-mongo,migrate-mongo,,1,0,1,1,0,2,1,1
qqwing,qqwing,,0,0,1,0,0,1,3,1
windows-server-2019,windows-server-2019,,18,20,8,38,0,46,6,11.111111
drupal-search,drupal-search,,1,0,1,1,0,2,4,1
dask-ssh,dask-ssh,,0,1,1,1,0,2,0,1
sente,sente,,0,3,1,3,0,4,2,200
assembly.reflectiononly,assembly.reflectiononly,,0,0,1,0,0,1,8,1
clx,clx,,0,0,1,0,0,1,9,1
sml-mode,sml-mode,,0,0,1,0,0,1,2,1
ribbon-form,ribbon-form,,0,0,1,0,0,1,8,1
dynamic-rebinding,dynamic-rebinding,,0,0,1,0,0,1,1,1
rust-gluon,rust-gluon,,0,0,1,0,0,1,9,1
gitahead,gitahead,,0,0,2,0,0,2,9,1
incremental-compiler,incremental-compiler,,0,2,3,2,0,5,3,100
statistical-semantics,statistical-semantics,,0,0,1,0,0,1,0,1
ora-01008,ora-01008,,0,0,1,0,0,1,4,1
jcasc,jcasc,,1,0,2,1,0,3,6,1
ora-01400,ora-01400,,0,0,1,0,0,1,4,1
tronweb,tronweb,,5,1,1,6,0,7,6,1
safeareaview,safeareaview,,1,6,2,7,0,9,1,500
bidirectional-search,bidirectional-search,,0,0,1,0,0,1,0,1
rethinkdb-go,rethinkdb-go,,0,0,1,0,0,1,1,1
staging-table,staging-table,,0,0,1,0,0,1,6,1
metacity,metacity,,0,1,1,1,0,2,9,1
tech-chat-ml,tech-chat-ml,,0,0,2,0,0,2,0,1
typesafe-actions,typesafe-actions,,4,3,1,7,0,8,1,1
libretro,libretro,,0,1,2,1,0,3,3,1
azure-cosmosdb-cassandra-api,azure-cosmosdb-cassandra-api,,4,2,4,6,0,10,8,1
weblogic-maven-plugin,weblogic-maven-plugin,,0,0,1,0,0,1,3,1
bayesglm,bayesglm,,0,0,1,0,0,1,0,1
gdata-python-client,gdata-python-client,,0,0,1,0,0,1,5,1
sevntu-checkstyle,sevntu-checkstyle,,0,0,1,0,0,1,3,1
refinery,refinery,,0,0,1,0,0,1,12,1
ydn-db,ydn-db,,0,0,1,0,0,1,4,1
wpbakery,wpbakery,,14,30,7,44,0,51,4,114.285714
cgitb,cgitb,,1,1,1,2,0,3,0,1
cfile,cfile,,1,1,2,2,0,4,9,1
language-enhancement,language-enhancement,,0,0,1,0,0,1,0,1
weak-symbol,weak-symbol,,0,0,1,0,0,1,9,1
shopt,shopt,,1,0,1,1,0,2,9,1
moovweb,moovweb,,0,0,2,0,0,2,1,1
react-storefront,react-storefront,,0,0,2,0,0,2,1,1
cloud66,cloud66,,2,0,1,2,0,3,12,1
couchbase-ottoman,couchbase-ottoman,,0,0,2,0,0,2,1,1
message-forwarding,message-forwarding,,0,2,1,2,0,3,3,100
windows-on-arm,windows-on-arm,,1,0,1,1,0,2,8,1
powerbi-datagateway,powerbi-datagateway,,0,1,1,1,0,2,5,1
release-flow,release-flow,,1,0,1,1,0,2,6,1
assimulo,assimulo,,2,0,1,2,0,3,0,1
proxool,proxool,,0,0,1,0,0,1,9,1
ngx-mydatepicker,ngx-mydatepicker,,0,1,1,1,0,2,1,1
phaselistener,phaselistener,,0,0,2,0,0,2,3,1
jsonq,jsonq,,0,1,1,1,0,2,4,1
viewcontext,viewcontext,,1,0,1,1,0,2,13,1
transcendental-equation,transcendental-equation,,1,0,1,1,0,2,0,1
input-iterator,input-iterator,,0,1,1,1,0,2,9,1
sbt-crossproject,sbt-crossproject,,4,0,2,4,0,6,2,1
android-largeheap,android-largeheap,,0,0,2,0,0,2,3,1
passport-facebook-token,passport-facebook-token,,3,1,1,4,0,5,1,1
const-method,const-method,,0,0,1,0,0,1,9,1
system-databases,system-databases,,0,0,1,0,0,1,4,1
js-fancyproductdesigner,js-fancyproductdesigner,,3,5,2,8,0,10,1,66.666667
xsltc,xsltc,,0,0,1,0,0,1,8,1
glad,glad,,4,2,4,6,0,10,9,1
laravel-guard,laravel-guard,,0,2,1,2,0,3,4,100
laravel-jwt,laravel-jwt,,0,1,1,1,0,2,4,1
wapiti,wapiti,,0,0,1,0,0,1,4,1
cudf,cudf,,3,9,2,12,0,14,0,200
nednsproxyprovider,nednsproxyprovider,,1,0,1,1,0,2,13,1
telr,telr,,1,0,2,1,0,3,13,1
grapheme-cluster,grapheme-cluster,,0,1,1,1,0,2,0,1
mkmf,mkmf,,0,0,1,0,0,1,12,1
secevents,secevents,,0,1,1,1,0,2,4,1
rfc2445,rfc2445,,0,0,1,0,0,1,4,1
bluebutton,bluebutton,,0,0,1,0,0,1,14,1
dcg-semicontext,dcg-semicontext,,3,0,1,3,0,4,0,1
bublejs,bublejs,,1,0,1,1,0,2,1,1
discrete-optimization,discrete-optimization,,2,1,1,3,0,4,0,1
java-assist,java-assist,,1,1,1,2,0,3,3,1
decorator-pattern,decorator-pattern,,1,0,2,1,0,3,3,1
revolute-joints,revolute-joints,,0,0,1,0,0,1,1,1
statusstrip,statusstrip,,1,0,1,1,0,2,8,1
raspbian-stretch,raspbian-stretch,,6,8,5,14,0,19,0,33.333333
nswindowrestoration,nswindowrestoration,,0,0,1,0,0,1,13,1
iruby,iruby,,0,3,3,3,0,6,12,200
shapedrawable,shapedrawable,,0,0,1,0,0,1,3,1
signalr-client,signalr-client,,4,1,1,5,0,6,8,1
play-framework-2.7,play-framework-2.7,,17,21,7,38,0,45,2,23.529412
gulp-cached,gulp-cached,,0,0,1,0,0,1,1,1
delayed-paperclip,delayed-paperclip,,0,0,1,0,0,1,13,1
multi-scene,multi-scene,,0,1,1,1,0,2,8,1
dijit.calendar,dijit.calendar,,0,0,2,0,0,2,1,1
real-time-java,real-time-java,,0,0,1,0,0,1,0,1
ora-01652,ora-01652,,0,0,1,0,0,1,4,1
snowboy,snowboy,,2,0,3,2,0,5,3,1
graaljs,graaljs,,4,1,1,5,0,6,3,1
opendns,opendns,,0,0,1,0,0,1,9,1
python-youtube-api,python-youtube-api,,0,1,1,1,0,2,0,1
libreoffice-draw,libreoffice-draw,,0,1,1,1,0,2,5,1
quicksand,quicksand,,0,0,1,0,0,1,1,1
vc10,vc10,,0,0,1,0,0,1,9,1
mediarouteproviderservice,mediarouteproviderservice,,0,0,1,0,0,1,3,1
sttp,sttp,,2,1,1,3,0,4,2,1
opencl-pipes,opencl-pipes,,0,0,1,0,0,1,9,1
sbt-onejar,sbt-onejar,,1,0,1,1,0,2,3,1
angular-cdk-virtual-scroll,angular-cdk-virtual-scroll,,12,10,7,22,0,29,1,1
i2b2,i2b2,,0,0,1,0,0,1,3,1
apollo-cache-inmemory,apollo-cache-inmemory,,1,3,2,4,0,6,1,200
drupal-ctools,drupal-ctools,,0,0,1,0,0,1,4,1
cocoalumberjack-swift,cocoalumberjack-swift,,1,0,2,1,0,3,13,1
pygi-aio,pygi-aio,,0,0,1,0,0,1,0,1
ruby-2.3.1,ruby-2.3.1,,1,1,1,2,0,3,12,1
hangfire-mongodb,hangfire-mongodb,,0,0,1,0,0,1,8,1
google-cloud-robotics,google-cloud-robotics,,0,0,1,0,0,1,6,1
cloudfiles,cloudfiles,,0,1,1,1,0,2,6,1
django-rules,django-rules,,1,0,1,1,0,2,0,1
delphi-multithreading,delphi-multithreading,,0,1,1,1,0,2,9,1
sqlworkflowpersistencese,sqlworkflowpersistencese,,0,0,1,0,0,1,8,1
rclone,rclone,,5,3,1,8,0,9,6,1
rsconnect,rsconnect,,2,1,3,3,0,6,0,1
adroll,adroll,,0,0,2,0,0,2,4,1
rsqlserver,rsqlserver,,0,1,1,1,0,2,0,1
symfony4-voter,symfony4-voter,,4,2,3,6,0,9,4,1
bootstrap-toast,bootstrap-toast,,2,0,1,2,0,3,1,1
kentico-api,kentico-api,,1,14,3,15,0,18,8,1300
crc64,crc64,,0,1,1,1,0,2,9,1
asymptote,asymptote,,2,0,1,2,0,3,0,1
shadowpath,shadowpath,,0,0,1,0,0,1,13,1
simpletype,simpletype,,1,2,1,3,0,4,3,100
powerapps-canvas,powerapps-canvas,,6,6,3,12,0,15,8,1
seamless-login,seamless-login,,0,1,2,1,0,3,8,1
uipath-studio,uipath-studio,,13,10,3,23,0,26,5,1
rxdb,rxdb,,2,1,1,3,0,4,1,1
roboguice,roboguice,,0,0,1,0,0,1,3,1
bottomappbar,bottomappbar,,4,0,2,4,0,6,3,1
maven-lifecycle,maven-lifecycle,,1,0,1,1,0,2,3,1
ctf,ctf,,8,3,4,11,0,15,9,1
cmake-format,cmake-format,,3,2,2,5,0,7,9,1
flatten-pdf,flatten-pdf,,3,0,1,3,0,4,8,1
librdkafka,librdkafka,,7,7,1,14,0,15,2,1
fody-validar,fody-validar,,0,0,1,0,0,1,8,1
send-on-behalf-of,send-on-behalf-of,,1,1,1,2,0,3,8,1
hotchocolate,hotchocolate,,0,5,2,5,0,7,8,400
util.cmd,util.cmd,,0,0,1,0,0,1,0,1
dojox.calendar,dojox.calendar,,0,0,1,0,0,1,1,1
padleft,padleft,,1,1,1,2,0,3,8,1
premultiplied-alpha,premultiplied-alpha,,1,0,1,1,0,2,13,1
batchsize,batchsize,,10,4,2,14,0,16,0,1
vensim,vensim,,1,2,2,3,0,5,3,100
multidimensional-cube,multidimensional-cube,,5,4,2,9,0,11,4,1
fbml,fbml,,0,0,1,0,0,1,13,1
webodf,webodf,,0,0,1,0,0,1,1,1
jwnl,jwnl,,0,3,1,3,0,4,0,200
flutter-platform-channel,flutter-platform-channel,,8,7,1,15,0,16,13,1
virtual-network-interface,virtual-network-interface,,3,0,1,3,0,4,9,1
android-jetpack-navigation,android-jetpack-navigation,,31,40,1,71,0,72,3,29.032258
taql,taql,,0,0,1,0,0,1,2,1
feistel-cipher,feistel-cipher,,0,0,1,0,0,1,6,1
djaty,djaty,,0,0,1,0,0,1,1,1
nspersistentcontainer,nspersistentcontainer,,2,4,2,6,0,8,13,100
glui,glui,,1,2,1,3,0,4,9,100
wp-mega-menu,wp-mega-menu,,0,0,1,0,0,1,1,1
oracle-apex-18.2,oracle-apex-18.2,,32,20,2,52,0,54,4,1
ozimov-email-tools,ozimov-email-tools,,0,0,1,0,0,1,3,1
doxia,doxia,,0,1,2,1,0,3,3,1
tracker-enabled-dbcontext,tracker-enabled-dbcontext,,0,0,1,0,0,1,8,1
sapera,sapera,,0,1,1,1,0,2,0,1
xembed,xembed,,0,1,1,1,0,2,9,1
gwt-jackson-apt,gwt-jackson-apt,,0,0,4,0,0,4,3,1
kitti,kitti,,5,3,1,8,0,9,0,1
chrome-automation-extension,chrome-automation-extension,,2,0,2,2,0,4,3,1
android-threading,android-threading,,12,13,2,25,0,27,3,8.333333
material-design-icons,material-design-icons,,1,1,2,2,0,4,1,1
toolbelt,toolbelt,,0,0,1,0,0,1,0,1
65816,65816,,0,0,1,0,0,1,9,1
symfony-4.2,symfony-4.2,,79,13,23,92,0,115,4,1
parse-react,parse-react,,0,0,1,0,0,1,1,1
web-animations-api,web-animations-api,,1,2,1,3,0,4,1,100
pecl-oauth,pecl-oauth,,0,0,1,0,0,1,4,1
react-native-contacts,react-native-contacts,,2,1,1,3,0,4,1,1
bitmapcache,bitmapcache,,0,0,1,0,0,1,8,1
cubefunctions,cubefunctions,,0,0,1,0,0,1,5,1
externalcontext,externalcontext,,0,0,1,0,0,1,3,1
xlsx-populate,xlsx-populate,,1,3,1,4,0,5,1,200
chartpanel,chartpanel,,2,0,1,2,0,3,3,1
opencv4,opencv4,,29,31,7,60,0,67,0,6.896552
jiprolog,jiprolog,,0,0,1,0,0,1,3,1
express.io,express.io,,0,0,1,0,0,1,1,1
benford.analysis,benford.analysis,,0,1,1,1,0,2,0,1
actix-web,actix-web,,11,18,2,29,0,31,9,63.636364
tomochain,tomochain,,1,0,1,1,0,2,6,1
coin-or,coin-or,,5,5,1,10,0,11,0,1
local-web-server,local-web-server,,0,0,1,0,0,1,13,1
text-database,text-database,,2,0,1,2,0,3,0,1
svsocket,svsocket,,0,0,1,0,0,1,9,1
formalize,formalize,,0,0,1,0,0,1,3,1
dremio,dremio,,2,7,3,9,0,12,4,250
docksal,docksal,,1,0,1,1,0,2,6,1
language-comparisons,language-comparisons,,5,1,1,6,0,7,12,1
navigation-architecture,navigation-architecture,,7,4,1,11,0,12,3,1
jenkins-kubernetes,jenkins-kubernetes,,4,1,1,5,0,6,6,1
node-github,node-github,,0,0,1,0,0,1,6,1
shedlock,shedlock,,3,3,2,6,0,8,3,1
circular-queue,circular-queue,,1,1,1,2,0,3,3,1
webpack-3.6,webpack-3.6,,0,0,1,0,0,1,1,1
cleartext,cleartext,,1,2,1,3,0,4,3,100
drakma,drakma,,0,0,1,0,0,1,0,1
msodbcsql17,msodbcsql17,,5,3,1,8,0,9,0,1
nodeservices,nodeservices,,1,0,1,1,0,2,8,1
dvi,dvi,,0,0,1,0,0,1,9,1
android-viewpager2,android-viewpager2,,10,25,2,35,0,37,3,150
page-index-changed,page-index-changed,,1,0,1,1,0,2,8,1
aws-landing-zone,aws-landing-zone,,1,0,2,1,0,3,6,1
audio-comparison,audio-comparison,,0,0,1,0,0,1,0,1
slt,slt,,0,0,1,0,0,1,5,1
positive-lookahead,positive-lookahead,,5,1,1,6,0,7,0,1
hlsl2glsl,hlsl2glsl,,0,0,1,0,0,1,1,1
laravel-eloquent-resource,laravel-eloquent-resource,,0,5,1,5,0,6,4,400
gui-test-framework,gui-test-framework,,0,0,1,0,0,1,3,1
streampipes,streampipes,,0,0,1,0,0,1,4,1
nvm-windows,nvm-windows,,1,2,1,3,0,4,1,100
derived-instances,derived-instances,,0,0,1,0,0,1,2,1
deepdrive,deepdrive,,0,0,1,0,0,1,0,1
mobileemulation,mobileemulation,,0,1,1,1,0,2,3,1
cwp,cwp,,1,0,1,1,0,2,4,1
pokt,pokt,,0,0,2,0,0,2,6,1
dtml,dtml,,0,0,1,0,0,1,0,1
terser,terser,,12,11,2,23,0,25,1,1
quip,quip,,0,0,1,0,0,1,4,1
misfit,misfit,,0,0,1,0,0,1,1,1
rhino-script,rhino-script,,0,1,1,1,0,2,3,1
ruckus-api,ruckus-api,,0,0,1,0,0,1,6,1
mongodb-motor,mongodb-motor,,0,0,1,0,0,1,0,1
meecrowave,meecrowave,,1,0,1,1,0,2,3,1
archos,archos,,0,0,1,0,0,1,3,1
sas-token,sas-token,,3,2,2,5,0,7,8,1
rose-db-object,rose-db-object,,0,0,1,0,0,1,9,1
rose-db,rose-db,,0,0,1,0,0,1,9,1
azure-application-insights-profiler,azure-application-insights-profiler,,1,7,2,8,0,10,8,600
rapi,rapi,,0,0,2,0,0,2,0,1
datefinder,datefinder,,2,4,1,6,0,7,0,100
ex-mode,ex-mode,,0,0,1,0,0,1,0,1
axion-release-plugin,axion-release-plugin,,1,0,1,1,0,2,6,1
ddf,ddf,,0,0,2,0,0,2,4,1
js-scrollby,js-scrollby,,0,0,1,0,0,1,1,1
js-scrollto,js-scrollto,,2,0,1,2,0,3,1,1
quicksight-embedding,quicksight-embedding,,2,3,1,5,0,6,6,50
sfauthorizationpluginview,sfauthorizationpluginview,,1,1,2,2,0,4,13,1
hotword,hotword,,0,2,1,2,0,3,3,100
python-hunter,python-hunter,,0,0,1,0,0,1,0,1
typo3-surf,typo3-surf,,0,1,1,1,0,2,1,1
xamarin.wpf,xamarin.wpf,,3,0,2,3,0,5,8,1
azure-cosmosdb-gremlinapi,azure-cosmosdb-gremlinapi,,21,20,3,41,0,44,2,1
daml,daml,,7,3,8,10,0,18,6,1
tf.keras,tf.keras,,152,172,12,324,0,336,0,13.157895
midori,midori,,0,1,1,1,0,2,0,1
public-suffix-list,public-suffix-list,,0,0,1,0,0,1,8,1
tagbuilder,tagbuilder,,0,5,1,5,0,6,8,400
compiler-compiler,compiler-compiler,,1,0,1,1,0,2,9,1
magicalrecord-2.2,magicalrecord-2.2,,0,0,1,0,0,1,13,1
retinanet,retinanet,,3,1,2,4,0,6,0,1
android-cling,android-cling,,0,0,1,0,0,1,9,1
paypal-connect,paypal-connect,,1,0,2,1,0,3,4,1
xmlseclibs,xmlseclibs,,2,0,1,2,0,3,4,1
kotlin-allopen,kotlin-allopen,,0,1,1,1,0,2,3,1
videojs-record,videojs-record,,1,1,1,2,0,3,1,1
azure-acr,azure-acr,,3,1,1,4,0,5,6,1
memberpress,memberpress,,4,1,2,5,0,7,4,1
typecase,typecase,,0,0,1,0,0,1,13,1
kiali,kiali,,3,4,2,7,0,9,6,33.333333
react-lifecycle-hooks,react-lifecycle-hooks,,4,7,1,11,0,12,1,75
hyperp-dbaas-mongodb,hyperp-dbaas-mongodb,,0,0,1,0,0,1,6,1
hyperp-dbass-postgresql,hyperp-dbass-postgresql,,0,0,1,0,0,1,6,1
alfresco-ldap,alfresco-ldap,,1,0,1,1,0,2,8,1
az,az,,11,13,1,24,0,25,8,18.181818
sas-af,sas-af,,0,0,1,0,0,1,0,1
featherlight,featherlight,,2,0,1,2,0,3,1,1
loadjs,loadjs,,0,0,1,0,0,1,1,1
numpy-indexed,numpy-indexed,,0,0,1,0,0,1,0,1
anchor-cms,anchor-cms,,0,0,1,0,0,1,1,1
webdriver-io-v4,webdriver-io-v4,,6,10,1,16,0,17,3,66.666667
atag,atag,,0,1,1,1,0,2,4,1
makepp,makepp,,0,0,1,0,0,1,9,1
allegro4,allegro4,,0,0,1,0,0,1,9,1
delphi-2005,delphi-2005,,0,0,1,0,0,1,9,1
rfc6749,rfc6749,,1,1,1,2,0,3,4,1
geneva-server,geneva-server,,0,0,1,0,0,1,6,1
globus-toolkit,globus-toolkit,,1,0,1,1,0,2,5,1
format-model,format-model,,0,0,1,0,0,1,4,1
vcscommand,vcscommand,,0,0,1,0,0,1,6,1
azure-ai,azure-ai,,2,0,1,2,0,3,8,1
js2xml,js2xml,,0,2,1,2,0,3,1,100
general-protection-fault,general-protection-fault,,0,0,1,0,0,1,9,1
mapjoin,mapjoin,,1,1,1,2,0,3,2,1
transition-coordinator,transition-coordinator,,0,0,2,0,0,2,13,1
furrr,furrr,,4,1,3,5,0,8,0,1
jedi-code-library,jedi-code-library,,0,0,1,0,0,1,9,1
git-deploy,git-deploy,,0,0,1,0,0,1,6,1
sql-plus-dot-net,sql-plus-dot-net,,0,0,1,0,0,1,4,1
mapbox-ios,mapbox-ios,,8,28,2,36,0,38,1,250
nlogit,nlogit,,0,0,1,0,0,1,0,1
mobx-dart,mobx-dart,,1,0,1,1,0,2,13,1
vagrant-ssh,vagrant-ssh,,0,0,2,0,0,2,4,1
sgc-websockets,sgc-websockets,,0,0,1,0,0,1,9,1
extjs-chart,extjs-chart,,1,0,1,1,0,2,1,1
cloudflarestream,cloudflarestream,,1,1,1,2,0,3,4,1
ewon,ewon,,0,0,4,0,0,4,3,1
reactify,reactify,,0,2,1,2,0,3,1,100
bulbs,bulbs,,0,0,1,0,0,1,14,1
extconf.rb,extconf.rb,,0,0,1,0,0,1,12,1
ng2-pdfjs-viewer,ng2-pdfjs-viewer,,1,6,1,7,0,8,1,500
referenceequals,referenceequals,,1,0,1,1,0,2,8,1
embedded-tomcat,embedded-tomcat,,3,2,1,5,0,6,3,1
primeicons,primeicons,,0,2,1,2,0,3,1,100
multi-database-connections,multi-database-connections,,2,1,1,3,0,4,3,1
cache-dependency,cache-dependency,,0,0,1,0,0,1,8,1
kong-plugin,kong-plugin,,12,7,2,19,0,21,6,1
amazon-cloudhsm,amazon-cloudhsm,,2,3,1,5,0,6,6,50
oeis,oeis,,1,0,1,1,0,2,0,1
service-node-port-range,service-node-port-range,,0,1,1,1,0,2,6,1
msagl,msagl,,0,1,1,1,0,2,0,1
react-pose,react-pose,,9,5,3,14,0,17,1,1
digital-compass,digital-compass,,0,0,1,0,0,1,0,1
frontend-maven-plugin,frontend-maven-plugin,,0,2,1,2,0,3,3,100
plotly-python,plotly-python,,41,62,7,103,0,110,0,51.219512
solr.net,solr.net,,0,0,1,0,0,1,2,1
script#,script#,,1,1,1,2,0,3,8,1
wbf,wbf,,1,0,1,1,0,2,9,1
wbdi,wbdi,,1,0,1,1,0,2,9,1
mongoid4,mongoid4,,0,0,1,0,0,1,12,1
kindle-kdk,kindle-kdk,,0,0,1,0,0,1,3,1
ghostlab,ghostlab,,0,0,1,0,0,1,3,1
sage-one,sage-one,,1,3,1,4,0,5,4,200
pyapns,pyapns,,0,0,1,0,0,1,0,1
zeroclipboard,zeroclipboard,,1,0,1,1,0,2,1,1
wcf-faults,wcf-faults,,0,0,1,0,0,1,8,1
op-tee,op-tee,,0,2,1,2,0,3,9,100
pydbg,pydbg,,1,0,1,1,0,2,0,1
capistrano-2,capistrano-2,,1,0,1,1,0,2,12,1
maven-replacer-plugin,maven-replacer-plugin,,0,1,1,1,0,2,3,1
micronaut-aws,micronaut-aws,,3,1,6,4,0,10,6,1
behance-api,behance-api,,1,0,1,1,0,2,1,1
minicpan,minicpan,,0,0,1,0,0,1,9,1
web-optimization,web-optimization,,1,2,1,3,0,4,1,100
pyviz,pyviz,,9,19,4,28,0,32,0,111.111111
peer-wire-protocol,peer-wire-protocol,,0,0,1,0,0,1,9,1
nne,nne,,1,0,1,1,0,2,3,1
goracle,goracle,,1,0,1,1,0,2,6,1
bizcharts,bizcharts,,0,0,1,0,0,1,1,1
g2,g2,,0,1,1,1,0,2,1,1
honeysql,honeysql,,0,0,1,0,0,1,2,1
com-automation,com-automation,,0,2,1,2,0,3,5,100
rmark,rmark,,1,0,1,1,0,2,0,1
dramatiq,dramatiq,,0,1,1,1,0,2,0,1
tensor-indexing,tensor-indexing,,3,1,1,4,0,5,0,1
appglidemodule,appglidemodule,,1,2,1,3,0,4,3,100
rpx,rpx,,0,0,1,0,0,1,8,1
mission-critical,mission-critical,,0,0,1,0,0,1,9,1
artos,artos,,0,1,1,1,0,2,3,1
account-linking,account-linking,,10,6,5,16,0,21,13,1
xframium,xframium,,1,0,1,1,0,2,3,1
sql-null,sql-null,,11,6,1,17,0,18,4,1
maas,maas,,0,0,1,0,0,1,6,1
cucumberish,cucumberish,,0,1,1,1,0,2,13,1
ludwig,ludwig,,2,4,1,6,0,7,0,100
bitrock,bitrock,,0,1,1,1,0,2,9,1
virtual-ethernet,virtual-ethernet,,1,2,1,3,0,4,6,100
episerver-commerce,episerver-commerce,,0,0,2,0,0,2,8,1
vpaid,vpaid,,5,0,1,5,0,6,3,1
centreon-api,centreon-api,,0,0,1,0,0,1,8,1
disk-imaging,disk-imaging,,0,1,1,1,0,2,9,1
android-appcompatspinner,android-appcompatspinner,,1,0,1,1,0,2,3,1
nservicebus4,nservicebus4,,0,0,1,0,0,1,8,1
aws-vm-import,aws-vm-import,,0,0,1,0,0,1,6,1
xapi,xapi,,6,5,1,11,0,12,1,1
mqtt-over-websockets,mqtt-over-websockets,,0,0,2,0,0,2,6,1
redbird,redbird,,1,2,1,3,0,4,1,100
get-filehash,get-filehash,,1,0,1,1,0,2,8,1
pleora-sdk,pleora-sdk,,0,1,1,1,0,2,9,1
redismqserver,redismqserver,,0,0,1,0,0,1,6,1
webtextedit,webtextedit,,0,0,1,0,0,1,1,1
keyserver,keyserver,,4,0,1,4,0,5,6,1
unitywebrequest,unitywebrequest,,5,9,3,14,0,17,8,80
visio-2010,visio-2010,,0,0,1,0,0,1,5,1
redis-3.2,redis-3.2,,0,0,1,0,0,1,3,1
tobase64string,tobase64string,,9,14,3,23,0,26,1,55.555556
pixlr,pixlr,,0,1,1,1,0,2,9,1
vshost.exe,vshost.exe,,0,0,1,0,0,1,8,1
sonarqube-5.4,sonarqube-5.4,,0,0,1,0,0,1,3,1
kuzzle,kuzzle,,5,0,1,5,0,6,1,1
fluentdata,fluentdata,,0,0,2,0,0,2,6,1
color-wheel,color-wheel,,0,2,1,2,0,3,0,100
prophet,prophet,,0,4,3,4,0,7,0,300
ibp-vscode-extension,ibp-vscode-extension,,2,4,2,6,0,8,6,100
dinktopdf,dinktopdf,,8,3,1,11,0,12,8,1
tony,tony,,0,0,1,0,0,1,6,1
embedded-control,embedded-control,,0,0,1,0,0,1,9,1
gridsome,gridsome,,7,12,1,19,0,20,1,71.428571
rbenv-gemset,rbenv-gemset,,0,0,1,0,0,1,12,1
pipe-forward-operator,pipe-forward-operator,,1,0,1,1,0,2,2,1
dapper-oracle,dapper-oracle,,1,0,1,1,0,2,8,1
buckaroo,buckaroo,,0,1,1,1,0,2,8,1
konyfabric,konyfabric,,0,0,1,0,0,1,13,1
xmldataset,xmldataset,,1,0,1,1,0,2,0,1
suggestbox,suggestbox,,1,1,1,2,0,3,5,1
kubernetes-vitess,kubernetes-vitess,,1,0,1,1,0,2,6,1
pymsql,pymsql,,2,1,3,3,0,6,4,1
amcharts4,amcharts4,,113,85,1,198,0,199,1,1
wavesplatform,wavesplatform,,28,11,15,39,0,54,6,1
ride,ride,,18,6,12,24,0,36,6,1
ejbql,ejbql,,0,0,1,0,0,1,3,1
angular-social-login,angular-social-login,,2,1,1,3,0,4,1,1
remotes,remotes,,1,0,1,1,0,2,0,1
standard-icons,standard-icons,,0,0,1,0,0,1,9,1
eks,eks,,38,53,4,91,0,95,6,39.473684
unified-diff,unified-diff,,0,0,1,0,0,1,1,1
cassandra-cluster,cassandra-cluster,,0,2,1,2,0,3,2,100
easy-batch,easy-batch,,0,0,1,0,0,1,3,1
zend-rest-route,zend-rest-route,,0,0,1,0,0,1,4,1
microsoft-graph-teams,microsoft-graph-teams,,11,10,1,21,0,22,8,1
query-timeout,query-timeout,,4,1,1,5,0,6,4,1
yoothemes,yoothemes,,2,4,1,6,0,7,4,100
orientdb3.0,orientdb3.0,,4,2,2,6,0,8,2,1
react-vis-network,react-vis-network,,0,0,2,0,0,2,0,1
fbsnapshottestcase,fbsnapshottestcase,,0,0,1,0,0,1,13,1
mvcrazortopdf,mvcrazortopdf,,0,0,1,0,0,1,8,1
semantic-logging,semantic-logging,,0,0,1,0,0,1,8,1
inview,inview,,0,1,1,1,0,2,1,1
ikimagebrowserview,ikimagebrowserview,,0,0,1,0,0,1,13,1
libudev,libudev,,4,0,1,4,0,5,9,1
totem,totem,,1,0,1,1,0,2,4,1
greenkeeper,greenkeeper,,0,0,1,0,0,1,6,1
bunch,bunch,,0,0,1,0,0,1,0,1
python-billiard,python-billiard,,0,2,2,2,0,4,0,100
davinci,davinci,,0,1,2,1,0,3,9,1
nsdragginginfo,nsdragginginfo,,1,0,1,1,0,2,13,1
dvb-t,dvb-t,,0,0,1,0,0,1,13,1
rfc1035,rfc1035,,1,1,1,2,0,3,4,1
erlang-escript,erlang-escript,,0,0,1,0,0,1,2,1
elasticsearch-highlight,elasticsearch-highlight,,1,0,1,1,0,2,6,1
rcpparmadillo,rcpparmadillo,,13,9,1,22,0,23,0,1
mobile-analytics,mobile-analytics,,0,1,1,1,0,2,5,1
getpropertyvalue,getpropertyvalue,,1,0,1,1,0,2,3,1
watermelondb,watermelondb,,1,2,1,3,0,4,1,100
ms-access-2002,ms-access-2002,,0,0,1,0,0,1,5,1
azure-spatial-anchors,azure-spatial-anchors,,13,8,1,21,0,22,8,1
android-activityrecord,android-activityrecord,,0,0,1,0,0,1,3,1
growable,growable,,0,0,1,0,0,1,0,1
spill-range,spill-range,,0,0,1,0,0,1,5,1
crystal-reports-2005,crystal-reports-2005,,0,0,1,0,0,1,8,1
xmlignore,xmlignore,,1,0,1,1,0,2,8,1
react-safeareaview,react-safeareaview,,1,0,1,1,0,2,1,1
algol,algol,,0,0,1,0,0,1,9,1
elasticsearch-snapshot,elasticsearch-snapshot,,1,3,1,4,0,5,6,200
apache-dubbo,apache-dubbo,,2,0,1,2,0,3,3,1
z-order-curve,z-order-curve,,1,0,1,1,0,2,0,1
firefox6,firefox6,,0,0,1,0,0,1,1,1
typescript-partial,typescript-partial,,0,0,1,0,0,1,1,1
inno-setup-v6,inno-setup-v6,,0,5,2,5,0,7,8,400
gosnmp,gosnmp,,0,1,1,1,0,2,9,1
redbrick,redbrick,,0,0,1,0,0,1,4,1
pop-up,pop-up,,3,4,1,7,0,8,1,33.333333
vapor-cloud,vapor-cloud,,0,1,1,1,0,2,13,1
page-loading-message,page-loading-message,,0,0,1,0,0,1,1,1
fastcgi++,fastcgi++,,2,1,1,3,0,4,4,1
acts-as-commentable,acts-as-commentable,,0,0,2,0,0,2,12,1
asbio,asbio,,1,0,2,1,0,3,0,1
django-cache-machine,django-cache-machine,,0,0,1,0,0,1,0,1
web-to-winforms,web-to-winforms,,1,1,1,2,0,3,8,1
fringe,fringe,,0,0,1,0,0,1,0,1
requiressl,requiressl,,0,1,1,1,0,2,8,1
onix,onix,,2,0,1,2,0,3,3,1
molehill,molehill,,0,0,1,0,0,1,13,1
scorep,scorep,,0,0,1,0,0,1,9,1
http-archive,http-archive,,1,0,1,1,0,2,9,1
wpl,wpl,,0,0,2,0,0,2,4,1
google-ad-exchange,google-ad-exchange,,0,0,1,0,0,1,3,1
jonas,jonas,,0,0,1,0,0,1,3,1
matrix-profile,matrix-profile,,1,0,1,1,0,2,0,1
midp-2.0,midp-2.0,,0,0,1,0,0,1,3,1
pygam,pygam,,0,1,1,1,0,2,0,1
tubes,tubes,,0,0,1,0,0,1,0,1
gcloud-compute,gcloud-compute,,1,0,1,1,0,2,6,1
apama-templates,apama-templates,,0,0,1,0,0,1,6,1
ionic-native-media,ionic-native-media,,1,0,1,1,0,2,1,1
rabbitmq-rpc,rabbitmq-rpc,,1,0,1,1,0,2,3,1
process-elevation,process-elevation,,0,0,1,0,0,1,8,1
capifony,capifony,,0,0,1,0,0,1,12,1
potion,potion,,0,0,1,0,0,1,9,1
clusterpoint,clusterpoint,,0,0,1,0,0,1,9,1
zend-file,zend-file,,0,0,1,0,0,1,4,1
nest2,nest2,,0,0,1,0,0,1,6,1
qgraphicsproxywidget,qgraphicsproxywidget,,0,2,1,2,0,3,9,100
ibm-maximo-worker-insights,ibm-maximo-worker-insights,,1,0,1,1,0,2,3,1
aspose.html,aspose.html,,0,0,1,0,0,1,8,1
onnxruntime,onnxruntime,,2,1,1,3,0,4,0,1
umbraco8,umbraco8,,24,16,2,40,0,42,8,1
linq.compiledquery,linq.compiledquery,,0,0,1,0,0,1,8,1
aws-comprehend,aws-comprehend,,6,6,1,12,0,13,6,1
isrequired,isrequired,,0,0,1,0,0,1,1,1
idlj,idlj,,0,0,1,0,0,1,3,1
sgmlreader,sgmlreader,,0,0,1,0,0,1,8,1
aws-msk,aws-msk,,4,9,1,13,0,14,6,125
clireg32,clireg32,,0,0,1,0,0,1,8,1
ajax-element-locator-factory,ajax-element-locator-factory,,0,1,1,1,0,2,3,1
jqxdocking,jqxdocking,,0,0,2,0,0,2,1,1
tabula-py,tabula-py,,5,6,2,11,0,13,0,20
convector,convector,,3,5,2,8,0,10,6,66.666667
ddfilelogger,ddfilelogger,,0,0,1,0,0,1,13,1
md-date-time-picker,md-date-time-picker,,0,1,1,1,0,2,1,1
ngx-ui-loader,ngx-ui-loader,,2,0,1,2,0,3,1,1
opencyc,opencyc,,0,0,1,0,0,1,0,1
conceptnet,conceptnet,,0,0,1,0,0,1,0,1
visualrules,visualrules,,0,0,1,0,0,1,3,1
dynamic-testing,dynamic-testing,,0,0,1,0,0,1,3,1
parametrized-testing,parametrized-testing,,1,4,2,5,0,7,3,300
issharedsizescope,issharedsizescope,,0,0,1,0,0,1,8,1
libtls,libtls,,0,0,1,0,0,1,6,1
groovyfx,groovyfx,,0,0,1,0,0,1,3,1
rfc1123,rfc1123,,1,0,1,1,0,2,3,1
page-state,page-state,,0,0,1,0,0,1,2,1
dyantree,dyantree,,0,0,1,0,0,1,8,1
quicken,quicken,,1,0,1,1,0,2,1,1
sieve-of-atkin,sieve-of-atkin,,0,0,1,0,0,1,2,1
inductive-logic-programming,inductive-logic-programming,,0,0,1,0,0,1,0,1
progol,progol,,1,0,1,1,0,2,0,1
baan,baan,,1,0,1,1,0,2,0,1
infor-ln,infor-ln,,1,0,1,1,0,2,0,1
beatsmusic,beatsmusic,,0,1,1,1,0,2,13,1
hurley,hurley,,1,0,1,1,0,2,6,1
checksum8,checksum8,,0,0,1,0,0,1,13,1
tinymce-5,tinymce-5,,12,6,1,18,0,19,1,1
flow-definitions,flow-definitions,,0,0,1,0,0,1,1,1
myro,myro,,0,0,1,0,0,1,1,1
mdxclient,mdxclient,,0,0,1,0,0,1,4,1
safari-content-script,safari-content-script,,0,1,1,1,0,2,13,1
dxflib,dxflib,,0,0,2,0,0,2,0,1
estraverse,estraverse,,0,0,1,0,0,1,1,1
plyvel,plyvel,,0,0,1,0,0,1,1,1
janalyser,janalyser,,0,0,1,0,0,1,3,1
ccuiviewwrapper,ccuiviewwrapper,,0,0,1,0,0,1,13,1
simscript,simscript,,1,0,1,1,0,2,9,1
programmable-completion,programmable-completion,,0,0,1,0,0,1,8,1
errbit,errbit,,1,1,1,2,0,3,1,1
atan,atan,,2,1,1,3,0,4,0,1
travelport-api,travelport-api,,3,0,1,3,0,4,4,1
travelport,travelport,,1,0,1,1,0,2,4,1
nsstepper,nsstepper,,0,0,1,0,0,1,13,1
valangvalidator,valangvalidator,,0,0,1,0,0,1,3,1
maniphest,maniphest,,1,0,1,1,0,2,6,1
pshost,pshost,,0,0,1,0,0,1,8,1
cosmosdbtrigger,cosmosdbtrigger,,3,1,1,4,0,5,8,1
pipe-operator,pipe-operator,,0,0,1,0,0,1,9,1
fullrowselect,fullrowselect,,1,0,1,1,0,2,8,1
iminuit,iminuit,,3,0,1,3,0,4,0,1
clj-time,clj-time,,0,0,1,0,0,1,2,1
pageshow,pageshow,,0,0,1,0,0,1,1,1
droidscript,droidscript,,0,0,1,0,0,1,1,1
bulk-synchronous-parallel,bulk-synchronous-parallel,,0,0,1,0,0,1,2,1
msinet,msinet,,0,0,1,0,0,1,4,1
rebasing,rebasing,,1,1,1,2,0,3,6,1
daru,daru,,0,0,1,0,0,1,12,1
webfinger,webfinger,,0,1,1,1,0,2,8,1
relationship-extraction,relationship-extraction,,0,1,1,1,0,2,0,1
flutter-gridview,flutter-gridview,,4,1,1,5,0,6,13,1
codecave,codecave,,0,0,1,0,0,1,9,1
expectiminimax,expectiminimax,,1,0,1,1,0,2,0,1
wpas,wpas,,0,0,1,0,0,1,0,1
compose.io,compose.io,,0,1,1,1,0,2,6,1
komodo-ide,komodo-ide,,1,2,1,3,0,4,0,100
shorewall,shorewall,,0,0,1,0,0,1,6,1
clog,clog,,0,0,1,0,0,1,9,1
substratevm,substratevm,,1,4,1,5,0,6,3,300
sailfish-os,sailfish-os,,1,1,1,2,0,3,9,1
state-machine-workflow,state-machine-workflow,,1,0,0,1,0,1,3,1
dsharp+,dsharp+,,1,1,0,2,0,2,8,1
hvplot,hvplot,,2,9,0,11,0,11,0,350
contenttypes,contenttypes,,3,0,0,3,0,3,0,1
savemany,savemany,,1,0,0,1,0,1,4,1
azure-dns,azure-dns,,2,4,0,6,0,6,8,100
buildresources,buildresources,,1,0,0,1,0,1,1,1
nethttpbinding,nethttpbinding,,1,0,0,1,0,1,8,1
wdio-v4,wdio-v4,,7,5,0,12,0,12,3,1
linda,linda,,1,0,0,1,0,1,8,1
mapbox-plugin,mapbox-plugin,,3,0,0,3,0,3,1,1
amazon-dynamodb-local,amazon-dynamodb-local,,11,7,0,18,0,18,6,1
import-table,import-table,,1,1,0,2,0,2,5,1
google-services-json,google-services-json,,1,0,0,1,0,1,3,1
mogenerator,mogenerator,,2,0,0,2,0,2,13,1
slimgrid,slimgrid,,1,0,0,1,0,1,1,1
openjms,openjms,,1,0,0,1,0,1,3,1
aws-cloudwatch-log-insights,aws-cloudwatch-log-insights,,5,11,0,16,0,16,6,120
google-talk,google-talk,,2,0,0,2,0,2,3,1
rust-warp,rust-warp,,1,1,0,2,0,2,9,1
elm-make,elm-make,,1,1,0,2,0,2,1,1
config-spec,config-spec,,1,1,0,2,0,2,6,1
grunt-html-build,grunt-html-build,,1,0,0,1,0,1,1,1
navigation-framework,navigation-framework,,1,0,0,1,0,1,3,1
phpflickr,phpflickr,,1,0,0,1,0,1,0,1
flickrj,flickrj,,1,0,0,1,0,1,0,1
rot-js,rot-js,,1,0,0,1,0,1,1,1
remote-forms,remote-forms,,1,1,0,2,0,2,12,1
electron-updater,electron-updater,,4,7,0,11,0,11,1,75
react-native-webview,react-native-webview,,12,31,0,43,0,43,1,158.333333
spreadsheet-excel-writer,spreadsheet-excel-writer,,2,1,0,3,0,3,0,1
ezswipecontroller,ezswipecontroller,,1,0,0,1,0,1,3,1
cqwp,cqwp,,1,0,0,1,0,1,8,1
number-with-delimiter,number-with-delimiter,,1,0,0,1,0,1,0,1
test-refactoring,test-refactoring,,1,0,0,1,0,1,1,1
distributed-tensorflow,distributed-tensorflow,,6,6,0,12,0,12,0,1
horovod,horovod,,8,4,0,12,0,12,0,1
structured-storage,structured-storage,,1,0,0,1,0,1,5,1
minmatch,minmatch,,1,0,0,1,0,1,5,1
songkick,songkick,,1,0,0,1,0,1,4,1
terraform-enterprise,terraform-enterprise,,3,1,0,4,0,4,6,1
hyper-protect-crypto,hyper-protect-crypto,,1,0,0,1,0,1,6,1
csdl,csdl,,1,0,0,1,0,1,3,1
swagger-play2,swagger-play2,,3,2,0,5,0,5,2,1
cpanel-uapi,cpanel-uapi,,3,1,0,4,0,4,4,1
essence,essence,,1,0,0,1,0,1,9,1
rr,rr,,1,1,0,2,0,2,4,1
compass-lucene,compass-lucene,,1,0,0,1,0,1,2,1
apache-utils,apache-utils,,1,3,0,4,0,4,3,200
backbone.validation.js,backbone.validation.js,,1,0,0,1,0,1,1,1
ocpsoft-rewrite,ocpsoft-rewrite,,2,0,0,2,0,2,3,1
azure-zulu,azure-zulu,,1,0,0,1,0,1,13,1
jnrpe,jnrpe,,1,0,0,1,0,1,6,1
unittest++,unittest++,,1,0,0,1,0,1,9,1
pattern-replace,pattern-replace,,1,0,0,1,0,1,4,1
gb2312,gb2312,,3,1,0,4,0,4,0,1
umn-mapserver,umn-mapserver,,2,0,0,2,0,2,1,1
edmgen,edmgen,,2,0,0,2,0,2,8,1
cut-and-paste,cut-and-paste,,1,0,0,1,0,1,0,1
hapi-fhir-android-library,hapi-fhir-android-library,,4,0,0,4,0,4,14,1
datastore-mode-emulator,datastore-mode-emulator,,2,0,0,2,0,2,6,1
documentpage,documentpage,,1,0,0,1,0,1,8,1
geoext3,geoext3,,1,1,0,2,0,2,1,1
bindingflags,bindingflags,,2,0,0,2,0,2,8,1
quarkus,quarkus,,42,35,0,77,0,77,3,1
async-loading,async-loading,,1,0,0,1,0,1,3,1
refinitiv-eikon,refinitiv-eikon,,2,0,0,2,0,2,0,1
refinitiv-eikon-api,refinitiv-eikon-api,,6,0,0,6,0,6,0,1
jet-django,jet-django,,1,0,0,1,0,1,0,1
iactivescript,iactivescript,,1,1,0,2,0,2,5,1
django-userena,django-userena,,1,0,0,1,0,1,0,1
airborne,airborne,,3,0,0,3,0,3,12,1
gitbox,gitbox,,1,0,0,1,0,1,6,1
ladder-logic,ladder-logic,,3,1,0,4,0,4,9,1
cequel,cequel,,2,0,0,2,0,2,12,1
controlflowguard,controlflowguard,,1,0,0,1,0,1,9,1
iconmenu,iconmenu,,1,0,0,1,0,1,1,1
dpath,dpath,,1,0,0,1,0,1,1,1
gulp-git,gulp-git,,1,0,0,1,0,1,8,1
bosh,bosh,,1,1,0,2,0,2,6,1
sapjvm,sapjvm,,1,1,0,2,0,2,3,1
uipath-orchestrator,uipath-orchestrator,,5,2,0,7,0,7,5,1
prefast,prefast,,1,0,0,1,0,1,9,1
google-poly,google-poly,,2,0,0,2,0,2,8,1
androidq,androidq,,42,80,0,122,0,122,3,90.47619
flutterwebviewplugin,flutterwebviewplugin,,12,8,0,20,0,20,13,1
edk2,edk2,,2,4,0,6,0,6,9,100
react-quill,react-quill,,6,5,0,11,0,11,1,1
adql,adql,,1,0,0,1,0,1,26,1
simbad,simbad,,1,0,0,1,0,1,26,1
ember.js-fastboot,ember.js-fastboot,,3,0,0,3,0,3,1,1
sharepoint-2019,sharepoint-2019,,2,12,0,14,0,14,8,500
riak-2i,riak-2i,,1,0,0,1,0,1,2,1
wagtail-apiv2,wagtail-apiv2,,6,2,0,8,0,8,0,1
type-slicing,type-slicing,,1,0,0,1,0,1,9,1
hubl,hubl,,4,1,0,5,0,5,1,1
hubspot-cms,hubspot-cms,,2,0,0,2,0,2,1,1
sublayout,sublayout,,1,0,0,1,0,1,13,1
shadow-cljs,shadow-cljs,,4,1,0,5,0,5,2,1
keyczar,keyczar,,1,1,0,2,0,2,6,1
synergy-dbl,synergy-dbl,,1,0,0,1,0,1,0,1
rocksdb-java,rocksdb-java,,8,4,0,12,0,12,2,1
fbi,fbi,,2,1,0,3,0,3,0,1
pyfilesystem,pyfilesystem,,4,1,0,5,0,5,0,1
azure-boards,azure-boards,,9,17,0,26,0,26,8,88.888889
tdatetimepicker,tdatetimepicker,,1,0,0,1,0,1,9,1
onigmo,onigmo,,1,0,0,1,0,1,12,1
mdd,mdd,,1,0,0,1,0,1,3,1
ora-17004,ora-17004,,1,0,0,1,0,1,4,1
commaide,commaide,,1,1,0,2,0,2,9,1
entityx,entityx,,1,0,0,1,0,1,9,1
6510,6510,,1,0,0,1,0,1,9,1
animatewindow,animatewindow,,1,0,0,1,0,1,9,1
levelhelper,levelhelper,,1,0,0,1,0,1,13,1
memory-movement,memory-movement,,1,0,0,1,0,1,9,1
wildcard-capture,wildcard-capture,,1,0,0,1,0,1,3,1
mailmap,mailmap,,2,0,0,2,0,2,9,1
resque-status,resque-status,,1,0,0,1,0,1,12,1
clean-language,clean-language,,2,0,0,2,0,2,2,1
expressiontosql,expressiontosql,,1,0,0,1,0,1,8,1
girth,girth,,1,0,0,1,0,1,0,1
uipath-api,uipath-api,,2,1,0,3,0,3,5,1
indexhibit,indexhibit,,1,0,0,1,0,1,4,1
ontology-network,ontology-network,,1,1,0,2,0,2,6,1
react-suspense,react-suspense,,9,9,0,18,0,18,1,1
bref,bref,,2,1,0,3,0,3,6,1
vrpn,vrpn,,1,0,0,1,0,1,3,1
cocoapods-1.1.1,cocoapods-1.1.1,,1,0,0,1,0,1,13,1
geofirex,geofirex,,2,1,0,3,0,3,13,1
chrome-for-ios,chrome-for-ios,,1,0,0,1,0,1,1,1
dolphindb,dolphindb,,35,75,0,110,0,110,4,114.285714
sbt-osgi,sbt-osgi,,1,0,0,1,0,1,2,1
google-people-api,google-people-api,,11,5,0,16,0,16,5,1
google-cloud-tasks,google-cloud-tasks,,9,11,0,20,0,20,6,22.222222
resume-upload,resume-upload,,2,1,0,3,0,3,1,1
scjp,scjp,,1,0,0,1,0,1,3,1
kentico-mvc,kentico-mvc,,5,18,0,23,0,23,8,260
kentico-12,kentico-12,,3,22,0,25,0,25,8,633.333333
k-9mail,k-9mail,,1,0,0,1,0,1,3,1
opensplice,opensplice,,4,1,0,5,0,5,9,1
pg-partman,pg-partman,,1,0,0,1,0,1,9,1
dns-update,dns-update,,1,0,0,1,0,1,9,1
mdfind,mdfind,,1,0,0,1,0,1,9,1
werl.exe,werl.exe,,1,0,0,1,0,1,2,1
nunitforms,nunitforms,,1,0,0,1,0,1,8,1
shinken,shinken,,1,0,0,1,0,1,6,1
javafx-1,javafx-1,,1,0,0,1,0,1,3,1
sencha-fashion,sencha-fashion,,1,0,0,1,0,1,1,1
firewall-access,firewall-access,,1,0,0,1,0,1,6,1
zipf,zipf,,2,1,0,3,0,3,0,1
aws-documentdb,aws-documentdb,,15,27,0,42,0,42,6,80
kotlin2js,kotlin2js,,1,1,0,2,0,2,3,1
rhino-licensing,rhino-licensing,,1,0,0,1,0,1,1,1
linspace,linspace,,2,0,0,2,0,2,0,1
bert-language-model,bert-language-model,,14,26,0,40,0,40,0,85.714286
oov,oov,,1,0,0,1,0,1,0,1
apache-kafka-mirrormaker,apache-kafka-mirrormaker,,3,1,0,4,0,4,2,1
wsit,wsit,,2,0,0,2,0,2,3,1
confidential-information,confidential-information,,1,0,0,1,0,1,1,1
mcps,mcps,,1,0,0,1,0,1,0,1
c#-code-model,c#-code-model,,1,0,0,1,0,1,8,1
amazon-qldb,amazon-qldb,,2,1,0,3,0,3,6,1
lightfm,lightfm,,1,5,0,6,0,6,0,400
android-car-api,android-car-api,,1,0,0,1,0,1,3,1
jquery-mobile-radio,jquery-mobile-radio,,1,0,0,1,0,1,1,1
imagecreatefromjpg,imagecreatefromjpg,,1,2,0,3,0,3,1,100
multi-table-delete,multi-table-delete,,1,0,0,1,0,1,0,1
flutter-engine,flutter-engine,,1,2,0,3,0,3,13,100
aim,aim,,1,0,0,1,0,1,6,1
built-value,built-value,,5,6,0,11,0,11,13,20
graylog3,graylog3,,8,7,0,15,0,15,6,1
dbicdump,dbicdump,,1,0,0,1,0,1,9,1
libphutil,libphutil,,1,0,0,1,0,1,4,1
composite-application,composite-application,,1,0,0,1,0,1,3,1
initializr,initializr,,1,0,0,1,0,1,3,1
data-reify,data-reify,,1,0,0,1,0,1,2,1
node-rules,node-rules,,1,0,0,1,0,1,3,1
facebook-payment-dialog,facebook-payment-dialog,,1,0,0,1,0,1,13,1
celery-log,celery-log,,1,0,0,1,0,1,0,1
vector-processing,vector-processing,,1,0,0,1,0,1,6,1
collapsiblepanelextender,collapsiblepanelextender,,1,0,0,1,0,1,8,1
elasticsearch-opendistro,elasticsearch-opendistro,,9,11,0,20,0,20,6,22.222222
express-mapper,express-mapper,,1,0,0,1,0,1,8,1
adoptopenjdk,adoptopenjdk,,7,13,0,20,0,20,3,85.714286
easygrid,easygrid,,1,0,0,1,0,1,3,1
oracleinternals,oracleinternals,,1,0,0,1,0,1,4,1
memmap,memmap,,3,0,0,3,0,3,0,1
autolayer,autolayer,,2,0,0,2,0,2,0,1
chromium-tabs,chromium-tabs,,1,0,0,1,0,1,0,1
graph-modelling-language,graph-modelling-language,,2,0,0,2,0,2,2,1
delta-pack,delta-pack,,1,0,0,1,0,1,3,1
cydia-substrate,cydia-substrate,,4,1,0,5,0,5,13,1
podman,podman,,5,9,0,14,0,14,6,80
o365security-compliance,o365security-compliance,,2,4,0,6,0,6,8,100
ediscovery,ediscovery,,1,0,0,1,0,1,8,1
template-auto,template-auto,,2,0,0,2,0,2,9,1
zend-queue,zend-queue,,1,0,0,1,0,1,4,1
driving-distance,driving-distance,,1,0,0,1,0,1,0,1
xmlbeans-maven-plugin,xmlbeans-maven-plugin,,1,1,0,2,0,2,3,1
xamarin.forms.webview,xamarin.forms.webview,,1,1,0,2,0,2,8,1
database-cloning,database-cloning,,1,1,0,2,0,2,4,1
idref,idref,,2,1,0,3,0,3,3,1
code-elimination,code-elimination,,1,0,0,1,0,1,9,1
nokogumbo,nokogumbo,,1,1,0,2,0,2,12,1
extensible,extensible,,2,1,0,3,0,3,9,1
queueuserworkitem,queueuserworkitem,,2,0,0,2,0,2,8,1
engopen,engopen,,1,0,0,1,0,1,0,1
simstring,simstring,,1,0,0,1,0,1,0,1
receive-side-scaling,receive-side-scaling,,1,0,0,1,0,1,8,1
nginx-module,nginx-module,,6,3,0,9,0,9,6,1
react-router-v5,react-router-v5,,6,3,0,9,0,9,1,1
linkettreemap,linkettreemap,,1,0,0,1,0,1,3,1
facebook-timeline,facebook-timeline,,1,0,0,1,0,1,13,1
dpan,dpan,,1,0,0,1,0,1,3,1
boolean-polynomials,boolean-polynomials,,1,1,0,2,0,2,0,1
routedeventargs,routedeventargs,,1,0,0,1,0,1,8,1
fbsdkmessengersharekit,fbsdkmessengersharekit,,1,0,0,1,0,1,13,1
ecrion,ecrion,,1,0,0,1,0,1,3,1
jumi,jumi,,1,0,0,1,0,1,1,1
embedded-script,embedded-script,,1,0,0,1,0,1,6,1
elm-ui,elm-ui,,1,3,0,4,0,4,1,200
laravel-permission,laravel-permission,,4,5,0,9,0,9,4,25
typeinitializer,typeinitializer,,1,0,0,1,0,1,8,1
codemagic,codemagic,,1,7,0,8,0,8,13,600
cld2,cld2,,2,0,0,2,0,2,0,1
cld3,cld3,,1,1,0,2,0,2,0,1
google-coral,google-coral,,10,21,0,31,0,31,0,110
mathematical-notation,mathematical-notation,,1,0,0,1,0,1,0,1
invokevirtual,invokevirtual,,1,0,0,1,0,1,3,1
mysql-escape-string,mysql-escape-string,,1,0,0,1,0,1,4,1
single-logout,single-logout,,9,3,0,12,0,12,8,1
asciidoctor-revealjs,asciidoctor-revealjs,,1,0,0,1,0,1,12,1
fela,fela,,1,1,0,2,0,2,1,1
eclipse-photran,eclipse-photran,,1,0,0,1,0,1,3,1
radio-transmission,radio-transmission,,1,2,0,3,0,3,9,100
elpa,elpa,,2,1,0,3,0,3,9,1
excellentexport,excellentexport,,1,0,0,1,0,1,5,1
jmeter-logging,jmeter-logging,,1,1,0,2,0,2,3,1
roassal,roassal,,1,0,0,1,0,1,13,1
module-search-path,module-search-path,,2,1,0,3,0,3,9,1
python-windows-bundle,python-windows-bundle,,1,1,0,2,0,2,0,1
system-monitoring,system-monitoring,,1,0,0,1,0,1,9,1
elmish-wpf,elmish-wpf,,2,0,0,2,0,2,8,1
daubechies-wavelet,daubechies-wavelet,,1,0,0,1,0,1,0,1
boost-fiber,boost-fiber,,2,3,0,5,0,5,9,50
measure-object,measure-object,,1,2,0,3,0,3,8,100
tjpegimage,tjpegimage,,1,0,0,1,0,1,0,1
ora-12519,ora-12519,,1,0,0,1,0,1,4,1
sleepy-mongoose,sleepy-mongoose,,1,0,0,1,0,1,1,1
beta-pert,beta-pert,,1,0,0,1,0,1,0,1
bigml,bigml,,3,0,0,3,0,3,4,1
mecanim,mecanim,,1,1,0,2,0,2,8,1
uialertviewdelegate,uialertviewdelegate,,1,0,0,1,0,1,13,1
kohttp,kohttp,,1,1,0,2,0,2,3,1
node-sqlserver,node-sqlserver,,1,0,0,1,0,1,4,1
constraintexception,constraintexception,,1,0,0,1,0,1,8,1
mochawesome,mochawesome,,3,1,0,4,0,4,3,1
objgraph,objgraph,,1,0,0,1,0,1,3,1
smsretriverapi,smsretriverapi,,11,8,0,19,0,19,3,1
hector,hector,,1,0,0,1,0,1,2,1
processexception,processexception,,1,0,0,1,0,1,9,1
python-architect,python-architect,,1,0,0,1,0,1,0,1
asyncdata,asyncdata,,1,2,0,3,0,3,1,100
prettier-standard,prettier-standard,,1,1,0,2,0,2,9,1
spidermon,spidermon,,2,1,0,3,0,3,0,1
isession,isession,,2,0,0,2,0,2,8,1
continuous-build,continuous-build,,2,0,0,2,0,2,9,1
finalbuilder7,finalbuilder7,,2,0,0,2,0,2,9,1
genero,genero,,1,0,0,1,0,1,1,1
4js,4js,,1,0,0,1,0,1,1,1
duo.js,duo.js,,1,0,0,1,0,1,0,1
duocode,duocode,,1,0,0,1,0,1,0,1
duostack,duostack,,1,0,0,1,0,1,0,1
pdoc,pdoc,,2,1,0,3,0,3,0,1
loket-nl,loket-nl,,1,0,0,1,0,1,4,1
spark-sftp,spark-sftp,,2,0,0,2,0,2,2,1
entity-groups,entity-groups,,1,0,0,1,0,1,14,1
github-repository-ownership,github-repository-ownership,,1,0,0,1,0,1,6,1
tzlocal,tzlocal,,1,0,0,1,0,1,0,1
subpartition,subpartition,,4,0,0,4,0,4,4,1
powerbi-filters,powerbi-filters,,3,0,0,3,0,3,5,1
android-layout-direction,android-layout-direction,,1,2,0,3,0,3,3,100
doit,doit,,4,2,0,6,0,6,0,1
netlify-cli,netlify-cli,,1,2,0,3,0,3,1,100
loki,loki,,1,2,0,3,0,3,3,100
spring-webclient,spring-webclient,,21,47,0,68,0,68,3,123.809524
ipad-playgrounds,ipad-playgrounds,,2,0,0,2,0,2,13,1
getbuffer,getbuffer,,1,0,0,1,0,1,3,1
background-media-player,background-media-player,,1,0,0,1,0,1,8,1
mod-auth-form,mod-auth-form,,1,0,0,1,0,1,8,1
prometheus-process-exporter,prometheus-process-exporter,,1,2,0,3,0,3,6,100
public-cloud,public-cloud,,1,0,0,1,0,1,8,1
samplegrabber,samplegrabber,,2,0,0,2,0,2,13,1
resource-governor,resource-governor,,1,1,0,2,0,2,4,1
sequence-sql,sequence-sql,,1,1,0,2,0,2,3,1
ambassador,ambassador,,2,8,0,10,0,10,6,300
tibco-businessconnect,tibco-businessconnect,,1,0,0,1,0,1,3,1
oracle-livesql,oracle-livesql,,3,1,0,4,0,4,4,1
statelist,statelist,,1,1,0,2,0,2,1,1
azure-app-configuration,azure-app-configuration,,2,4,0,6,0,6,8,100
spotfire-webplayer,spotfire-webplayer,,8,11,0,19,0,19,3,37.5
roadoi,roadoi,,1,0,0,1,0,1,4,1
unpaywall,unpaywall,,1,0,0,1,0,1,4,1
swarmplot,swarmplot,,4,2,0,6,0,6,0,1
c++builder-xe3,c++builder-xe3,,1,1,0,2,0,2,9,1
ignore-files,ignore-files,,1,0,0,1,0,1,1,1
strongbox,strongbox,,2,1,0,3,0,3,3,1
pysandbox,pysandbox,,1,0,0,1,0,1,0,1
fusionauth,fusionauth,,5,9,0,14,0,14,3,80
catboostregressor,catboostregressor,,2,2,0,4,0,4,0,1
jodit,jodit,,5,6,0,11,0,11,1,20
structural-equality,structural-equality,,1,0,0,1,0,1,9,1
semiotic,semiotic,,1,3,0,4,0,4,1,200
hivecli,hivecli,,2,1,0,3,0,3,2,1
google-cloud-cicp,google-cloud-cicp,,1,0,0,1,0,1,13,1
ndfd,ndfd,,1,0,0,1,0,1,4,1
invoke-result,invoke-result,,1,1,0,2,0,2,9,1
filemap,filemap,,1,0,0,1,0,1,9,1
is-same,is-same,,1,0,0,1,0,1,9,1
nsattributedescription,nsattributedescription,,1,0,0,1,0,1,13,1
declarative-authorization,declarative-authorization,,1,0,0,1,0,1,3,1
column-length,column-length,,1,0,0,1,0,1,4,1
martini,martini,,1,0,0,1,0,1,6,1
coursier,coursier,,3,0,0,3,0,3,2,1
tfx,tfx,,11,8,0,19,0,19,0,1
android-asynclistdiffer,android-asynclistdiffer,,2,0,0,2,0,2,3,1
entity-framework-core-2.2,entity-framework-core-2.2,,32,28,0,60,0,60,8,1
android-listadapter,android-listadapter,,6,9,0,15,0,15,3,50
writeablebitmapex,writeablebitmapex,,3,1,0,4,0,4,8,1
activerecord-calculations,activerecord-calculations,,1,0,0,1,0,1,8,1
coderush,coderush,,1,2,0,3,0,3,8,100
ipcmain,ipcmain,,4,2,0,6,0,6,1,1
ipcrenderer,ipcrenderer,,5,5,0,10,0,10,1,1
puppeteer-cluster,puppeteer-cluster,,3,10,0,13,0,13,1,233.333333
razor-components,razor-components,,16,2,0,18,0,18,8,1
midas-server,midas-server,,1,0,0,1,0,1,9,1
xmlserde,xmlserde,,1,1,0,2,0,2,2,1
nationbuilder,nationbuilder,,1,0,0,1,0,1,1,1
narray,narray,,2,0,0,2,0,2,12,1
twisted.application,twisted.application,,1,0,0,1,0,1,0,1
padre,padre,,1,0,0,1,0,1,9,1
ode-library,ode-library,,1,0,0,1,0,1,9,1
preconnect,preconnect,,4,2,0,6,0,6,1,1
routerjs,routerjs,,1,0,0,1,0,1,4,1
animatedimagedrawable,animatedimagedrawable,,1,0,0,1,0,1,3,1
string-prefix,string-prefix,,1,0,0,1,0,1,0,1
wkinterfacegroup,wkinterfacegroup,,2,0,0,2,0,2,13,1
wktapgesturerecognizer,wktapgesturerecognizer,,1,0,0,1,0,1,13,1
curand,curand,,2,1,0,3,0,3,0,1
mockito-kotlin,mockito-kotlin,,1,5,0,6,0,6,3,400
carrot,carrot,,1,1,0,2,0,2,2,1
gremlin-scala,gremlin-scala,,1,1,0,2,0,2,2,1
asammdf,asammdf,,2,1,0,3,0,3,8,1
material-design-components-react,material-design-components-react,,1,0,0,1,0,1,1,1
flutter-web,flutter-web,,30,77,0,107,0,107,13,156.666667
borrow,borrow,,4,2,0,6,0,6,9,1
finalescript,finalescript,,1,0,0,1,0,1,3,1
tensorflow-federated,tensorflow-federated,,9,5,0,14,0,14,0,1
watson-knowledge-catalog,watson-knowledge-catalog,,3,2,0,5,0,5,6,1
udisks,udisks,,2,0,0,2,0,2,9,1
react-native-chart-kit,react-native-chart-kit,,1,3,0,4,0,4,1,200
chaincode,chaincode,,20,19,0,39,0,39,6,1
vuejs-transition-group,vuejs-transition-group,,3,2,0,5,0,5,1,1
android-app-links,android-app-links,,6,13,0,19,0,19,3,116.666667
react-native-svg-charts,react-native-svg-charts,,2,8,0,10,0,10,1,300
guide4you,guide4you,,1,1,0,2,0,2,1,1
unblu,unblu,,1,0,0,1,0,1,3,1
omdbapi,omdbapi,,5,5,0,10,0,10,1,1
nb-iot,nb-iot,,3,0,0,3,0,3,9,1
message-level-security,message-level-security,,1,0,0,1,0,1,4,1
register-hook,register-hook,,1,0,0,1,0,1,0,1
skeleton-ui,skeleton-ui,,1,1,0,2,0,2,3,1
dot2tex,dot2tex,,1,0,0,1,0,1,0,1
hyland,hyland,,1,0,0,1,0,1,5,1
onbase,onbase,,2,0,0,2,0,2,5,1
memory-locking,memory-locking,,1,1,0,2,0,2,9,1
tfsintegrationplatform,tfsintegrationplatform,,1,0,0,1,0,1,8,1
hyperstack,hyperstack,,28,6,0,34,0,34,12,1
nuttx,nuttx,,1,1,0,2,0,2,9,1
pulsewidthmodulation,pulsewidthmodulation,,1,0,0,1,0,1,9,1
pyright,pyright,,1,2,0,3,0,3,0,100
python-stackless,python-stackless,,1,0,0,1,0,1,0,1
react-select-search,react-select-search,,2,1,0,3,0,3,1,1
data-studio-custom-visuals,data-studio-custom-visuals,,2,2,0,4,0,4,4,1
rhino-servicebus,rhino-servicebus,,1,0,0,1,0,1,8,1
has-ancestry,has-ancestry,,1,0,0,1,0,1,12,1
mercure,mercure,,2,7,0,9,0,9,4,250
jmscontext,jmscontext,,1,2,0,3,0,3,3,100
motioneyeos,motioneyeos,,2,0,0,2,0,2,0,1
uiviewanimation-curve,uiviewanimation-curve,,1,0,0,1,0,1,13,1
instagram-story,instagram-story,,7,4,0,11,0,11,13,1
vuedraggable,vuedraggable,,10,16,0,26,0,26,1,60
xsjs,xsjs,,3,1,0,4,0,4,5,1
nv12-nv21,nv12-nv21,,1,2,0,3,0,3,0,100
trackable-entities,trackable-entities,,1,0,0,1,0,1,8,1
xmlindex,xmlindex,,1,0,0,1,0,1,4,1
dataflex,dataflex,,1,0,0,1,0,1,8,1
vba6,vba6,,1,1,0,2,0,2,9,1
dladdr,dladdr,,1,0,0,1,0,1,9,1
mikro-orm,mikro-orm,,1,0,0,1,0,1,4,1
storybook-addon-specifications,storybook-addon-specifications,,3,3,0,6,0,6,1,1
named-constructor,named-constructor,,1,0,0,1,0,1,9,1
primefaces-7.0,primefaces-7.0,,1,1,0,2,0,2,3,1
azure-ad-v2,azure-ad-v2,,1,1,0,2,0,2,8,1
pelles-c,pelles-c,,2,0,0,2,0,2,9,1
dragonbone,dragonbone,,1,1,0,2,0,2,3,1
scalafxml,scalafxml,,1,0,0,1,0,1,2,1
shimmer,shimmer,,2,2,0,4,0,4,3,1
radupload,radupload,,1,0,0,1,0,1,8,1
compiled-query,compiled-query,,1,0,0,1,0,1,8,1
android-ble-library,android-ble-library,,1,0,0,1,0,1,3,1
cncontainer,cncontainer,,1,2,0,3,0,3,13,100
es5-compatiblity,es5-compatiblity,,3,5,0,8,0,8,1,66.666667
jdee,jdee,,1,0,0,1,0,1,9,1
automation-null,automation-null,,1,0,0,1,0,1,8,1
nsmeasurement,nsmeasurement,,1,0,0,1,0,1,13,1
nsmassformatter,nsmassformatter,,1,0,0,1,0,1,13,1
slickquiz,slickquiz,,1,0,0,1,0,1,1,1
cuttle,cuttle,,1,0,0,1,0,1,1,1
stackedit,stackedit,,2,2,0,4,0,4,1,1
angularjs-sce,angularjs-sce,,1,0,0,1,0,1,1,1
github-app,github-app,,3,3,0,6,0,6,6,1
github-check-run,github-check-run,,2,1,0,3,0,3,6,1
iformatprovider,iformatprovider,,2,0,0,2,0,2,8,1
chdk,chdk,,1,0,0,1,0,1,9,1
unmappedresourcehandler,unmappedresourcehandler,,1,0,0,1,0,1,3,1
windows-xp-sp2,windows-xp-sp2,,1,0,0,1,0,1,9,1
snowflake-connector-python,snowflake-connector-python,,3,1,0,4,0,4,4,1
kamus,kamus,,2,0,0,2,0,2,6,1
flutter-listview,flutter-listview,,8,22,0,30,0,30,13,175
uiworkintervaltiming,uiworkintervaltiming,,1,0,0,1,0,1,13,1
kafkajs,kafkajs,,2,0,0,2,0,2,2,1
rtcc,rtcc,,1,0,0,1,0,1,13,1
teamleader,teamleader,,1,0,0,1,0,1,4,1
amp-email,amp-email,,13,9,0,22,0,22,1,1
venia,venia,,3,0,0,3,0,3,4,1
logging-application-block,logging-application-block,,1,0,0,1,0,1,8,1
kustomize,kustomize,,7,7,0,14,0,14,6,1
forcing,forcing,,1,0,0,1,0,1,0,1
kumuluzee,kumuluzee,,2,1,0,3,0,3,3,1
repaintmanager,repaintmanager,,1,0,0,1,0,1,2,1
ssas-2017,ssas-2017,,1,0,0,1,0,1,4,1
platform-of-trust,platform-of-trust,,1,0,0,1,0,1,3,1
protobuf-python,protobuf-python,,4,4,0,8,0,8,0,1
google-cloud-ml-data,google-cloud-ml-data,,1,1,0,2,0,2,6,1
nextep,nextep,,1,1,0,2,0,2,4,1
oracle7,oracle7,,1,1,0,2,0,2,4,1
mule4,mule4,,31,19,0,50,0,50,14,1
pyblime,pyblime,,1,0,0,1,0,1,0,1
grails-4,grails-4,,4,11,0,15,0,15,3,175
pytorch-ignite,pytorch-ignite,,1,2,0,3,0,3,0,100
mpkg,mpkg,,2,0,0,2,0,2,13,1
libswresample,libswresample,,1,1,0,2,0,2,13,1
ema-workbench,ema-workbench,,1,0,0,1,0,1,0,1
floatbuffer,floatbuffer,,1,0,0,1,0,1,3,1
pivotal-crm,pivotal-crm,,1,0,0,1,0,1,8,1
xbl,xbl,,2,0,0,2,0,2,1,1
xournal,xournal,,1,0,0,1,0,1,9,1
operator-priority,operator-priority,,1,0,0,1,0,1,9,1
geom-area,geom-area,,6,0,0,6,0,6,0,1
aero-snap,aero-snap,,1,1,0,2,0,2,13,1
netbeans-11,netbeans-11,,14,33,0,47,0,47,3,135.714286
garden-runc,garden-runc,,1,0,0,1,0,1,3,1
facebook-checkins,facebook-checkins,,1,0,0,1,0,1,6,1
admin-interface,admin-interface,,1,1,0,2,0,2,3,1
java-launcher,java-launcher,,1,0,0,1,0,1,3,1
montemagno-media.plugin,montemagno-media.plugin,,1,1,0,2,0,2,8,1
takephotoasync,takephotoasync,,1,0,0,1,0,1,8,1
zend-lucene,zend-lucene,,1,0,0,1,0,1,4,1
snagit,snagit,,2,0,0,2,0,2,4,1
backbone-paginator,backbone-paginator,,1,0,0,1,0,1,1,1
django-ftpserver,django-ftpserver,,1,0,0,1,0,1,0,1
ardulink,ardulink,,1,0,0,1,0,1,9,1
node-schedule,node-schedule,,9,2,0,11,0,11,1,1
free-command,free-command,,1,0,0,1,0,1,9,1
intersystems-iris,intersystems-iris,,1,0,0,1,0,1,5,1
webpack-merge,webpack-merge,,2,0,0,2,0,2,1,1
nstableheaderview,nstableheaderview,,2,0,0,2,0,2,13,1
wcf-lob-adapter,wcf-lob-adapter,,2,0,0,2,0,2,8,1
object-position,object-position,,1,0,0,1,0,1,1,1
graphexp,graphexp,,2,1,0,3,0,3,2,1
kuyruk,kuyruk,,1,0,0,1,0,1,1,1
.net-fiddle,.net-fiddle,,1,0,0,1,0,1,8,1
infoset,infoset,,3,2,0,5,0,5,5,1
event-b,event-b,,1,0,0,1,0,1,0,1
iso-32000,iso-32000,,1,0,0,1,0,1,8,1
unnamed-parameter,unnamed-parameter,,1,0,0,1,0,1,9,1
httpserverutility,httpserverutility,,1,0,0,1,0,1,8,1
react-hooks-testing-library,react-hooks-testing-library,,4,10,0,14,0,14,1,150
logo-lang,logo-lang,,1,0,0,1,0,1,2,1
pybindgen,pybindgen,,1,0,0,1,0,1,0,1
motor-asyncio,motor-asyncio,,2,0,0,2,0,2,0,1
google-map-place,google-map-place,,2,1,0,3,0,3,1,1
yag,yag,,1,0,0,1,0,1,4,1
ts3phpframework,ts3phpframework,,1,0,0,1,0,1,4,1
compile-static,compile-static,,1,2,0,3,0,3,3,100
react-portal,react-portal,,5,8,0,13,0,13,1,60
pydroid,pydroid,,4,0,0,4,0,4,0,1
ming,ming,,2,3,0,5,0,5,0,50
django-hstore,django-hstore,,1,1,0,2,0,2,0,1
template-inheritance,template-inheritance,,2,1,0,3,0,3,9,1
trestle-admin,trestle-admin,,2,0,0,2,0,2,12,1
trestle,trestle,,1,0,0,1,0,1,12,1
secure-trading,secure-trading,,1,0,0,1,0,1,4,1
flowgorithm,flowgorithm,,1,0,0,1,0,1,0,1
response.addheader,response.addheader,,1,1,0,2,0,2,0,1
jgestures,jgestures,,1,0,0,1,0,1,1,1
airtelmoney,airtelmoney,,1,0,0,1,0,1,3,1
trifacta,trifacta,,2,2,0,4,0,4,6,1
laravel-route,laravel-route,,5,1,0,6,0,6,4,1
amazon-lwa,amazon-lwa,,1,0,0,1,0,1,6,1
rfc4627,rfc4627,,1,0,0,1,0,1,2,1
pix,pix,,1,0,0,1,0,1,1,1
osstatus,osstatus,,2,2,0,4,0,4,13,1
ksecclassgenericpassword,ksecclassgenericpassword,,1,0,0,1,0,1,13,1
ksecclassinternetpassword,ksecclassinternetpassword,,1,0,0,1,0,1,13,1
pongo2,pongo2,,2,0,0,2,0,2,6,1
fdb,fdb,,1,1,0,2,0,2,4,1
k3s,k3s,,2,8,0,10,0,10,6,300
flexmock,flexmock,,1,0,0,1,0,1,0,1
envoyer,envoyer,,1,0,0,1,0,1,4,1
re-encoding,re-encoding,,1,0,0,1,0,1,0,1
csrss,csrss,,1,0,0,1,0,1,9,1
node-fhir-server-core,node-fhir-server-core,,3,0,0,3,0,3,14,1
javascript-fhir,javascript-fhir,,2,0,0,2,0,2,14,1
ipropertystorage,ipropertystorage,,1,0,0,1,0,1,8,1
graphql-fhir,graphql-fhir,,1,0,0,1,0,1,14,1
attivio,attivio,,1,0,0,1,0,1,1,1
pomegranate,pomegranate,,1,2,0,3,0,3,0,100
azure-anomaly-detection,azure-anomaly-detection,,4,0,0,4,0,4,8,1
devirtualization,devirtualization,,2,0,0,2,0,2,9,1
omni-sci,omni-sci,,1,1,0,2,0,2,0,1
arviz,arviz,,1,2,0,3,0,3,0,100
xmlapi2,xmlapi2,,1,0,0,1,0,1,4,1
xamarin-entry,xamarin-entry,,3,1,0,4,0,4,8,1
parallel-extensions,parallel-extensions,,1,0,0,1,0,1,8,1
abstract-machine,abstract-machine,,2,0,0,2,0,2,0,1
cylon.js,cylon.js,,1,0,0,1,0,1,1,1
rsgislib,rsgislib,,1,0,0,1,0,1,0,1
metro-bundler,metro-bundler,,10,14,0,24,0,24,1,40
viewmatcher,viewmatcher,,1,0,0,1,0,1,3,1
scalafmt,scalafmt,,1,4,0,5,0,5,2,300
ppd,ppd,,1,0,0,1,0,1,9,1
parameterized-virtuality,parameterized-virtuality,,1,0,0,1,0,1,9,1
g1ant,g1ant,,1,6,0,7,0,7,5,500
apereo,apereo,,1,2,0,3,0,3,3,100
projectwise,projectwise,,1,0,0,1,0,1,0,1
urlstream,urlstream,,1,0,0,1,0,1,3,1
spring-cloud-deployer-kubernetes,spring-cloud-deployer-kubernetes,,1,0,0,1,0,1,3,1
isdn,isdn,,1,0,0,1,0,1,3,1
bento4,bento4,,1,1,0,2,0,2,13,1
android-biometric-prompt,android-biometric-prompt,,14,13,0,27,0,27,3,1
j#,j#,,1,0,0,1,0,1,3,1
fsharp-typeclasses,fsharp-typeclasses,,1,0,0,1,0,1,8,1
layout-page,layout-page,,1,0,0,1,0,1,8,1
runtimetypeadapterfactory,runtimetypeadapterfactory,,1,1,0,2,0,2,3,1
django-2.2,django-2.2,,72,123,0,195,0,195,0,70.833333
tsql100parser,tsql100parser,,1,0,0,1,0,1,8,1
journey,journey,,1,1,0,2,0,2,14,1
html-proofer,html-proofer,,1,0,0,1,0,1,6,1
tvm,tvm,,1,2,0,3,0,3,0,100
chropath,chropath,,1,2,0,3,0,3,3,100
com-server,com-server,,1,1,0,2,0,2,8,1
rhino-commons,rhino-commons,,1,0,0,1,0,1,8,1
svg-rect,svg-rect,,1,1,0,2,0,2,1,1
virtual-topic,virtual-topic,,1,3,0,4,0,4,3,200
ts-mockito,ts-mockito,,1,3,0,4,0,4,1,200
iso-639,iso-639,,1,0,0,1,0,1,1,1
flexibility,flexibility,,2,0,0,2,0,2,1,1
intellicode,intellicode,,1,2,0,3,0,3,8,100
kobo,kobo,,2,1,0,3,0,3,0,1
testing-strategies,testing-strategies,,1,1,0,2,0,2,3,1
virtual-drive,virtual-drive,,1,0,0,1,0,1,9,1
javascript-decorators,javascript-decorators,,1,4,0,5,0,5,1,300
ruby-parser,ruby-parser,,1,0,0,1,0,1,12,1
lockbox-2,lockbox-2,,1,0,0,1,0,1,9,1
tvos-simulator,tvos-simulator,,1,0,0,1,0,1,13,1
ning,ning,,1,0,0,1,0,1,2,1
cpuset,cpuset,,1,0,0,1,0,1,9,1
etcd-operator,etcd-operator,,1,0,0,1,0,1,6,1
enterprise-library-5,enterprise-library-5,,1,0,0,1,0,1,8,1
ffmpeg.js,ffmpeg.js,,2,0,0,2,0,2,13,1
brian,brian,,1,0,0,1,0,1,0,1
nsurlsessiontask,nsurlsessiontask,,1,2,0,3,0,3,13,100
angular-new-router,angular-new-router,,1,0,0,1,0,1,1,1
visdom,visdom,,1,1,0,2,0,2,0,1
kendo-ui-window,kendo-ui-window,,1,0,0,1,0,1,1,1
jvlc,jvlc,,1,0,0,1,0,1,3,1
preference-headers,preference-headers,,1,1,0,2,0,2,3,1
elmah.io,elmah.io,,1,1,0,2,0,2,8,1
dynamic-delivery,dynamic-delivery,,2,4,0,6,0,6,3,100
rightscale,rightscale,,1,0,0,1,0,1,6,1
mspgcc,mspgcc,,1,1,0,2,0,2,9,1
gcc3,gcc3,,2,0,0,2,0,2,9,1
alfresco-wqs,alfresco-wqs,,1,0,0,1,0,1,3,1
contentdm,contentdm,,1,0,0,1,0,1,6,1
alias-method,alias-method,,2,1,0,3,0,3,12,1
adjustable-array,adjustable-array,,1,0,0,1,0,1,0,1
microsoft-extensions-caching,microsoft-extensions-caching,,1,1,0,2,0,2,8,1
es2018,es2018,,2,2,0,4,0,4,1,1
hibernate-6.x,hibernate-6.x,,1,9,0,10,0,10,3,800
navigatetourl,navigatetourl,,2,2,0,4,0,4,8,1
sql-server-7,sql-server-7,,1,0,0,1,0,1,4,1
scalar-subquery,scalar-subquery,,4,0,0,4,0,4,4,1
mstor,mstor,,1,0,0,1,0,1,3,1
sproutcore-views,sproutcore-views,,1,0,0,1,0,1,19,1
sproutcore-controllers,sproutcore-controllers,,1,0,0,1,0,1,19,1
powerbuilder-2017,powerbuilder-2017,,1,3,0,4,0,4,8,200
tensorflow-agents,tensorflow-agents,,1,3,0,4,0,4,0,200
name-decoration,name-decoration,,1,0,0,1,0,1,9,1
grandchild,grandchild,,1,0,0,1,0,1,8,1
jsoneditor,jsoneditor,,2,0,0,2,0,2,1,1
kubernetes-jenkins-plugin,kubernetes-jenkins-plugin,,3,0,0,3,0,3,6,1
dlltool,dlltool,,1,0,0,1,0,1,9,1
biosppy,biosppy,,1,0,0,1,0,1,0,1
chaplinjs,chaplinjs,,2,0,0,2,0,2,1,1
treasure-data,treasure-data,,1,0,0,1,0,1,6,1
usersnap,usersnap,,1,0,0,1,0,1,1,1
bulk-mail,bulk-mail,,1,0,0,1,0,1,8,1
spigot-algorithm,spigot-algorithm,,1,0,0,1,0,1,9,1
type-graphql,type-graphql,,7,11,0,18,0,18,1,57.142857
racket-mode,racket-mode,,1,0,0,1,0,1,9,1
remote-assistance,remote-assistance,,1,1,0,2,0,2,8,1
catalano-framework,catalano-framework,,1,0,0,1,0,1,3,1
django-rest-framework-simplejwt,django-rest-framework-simplejwt,,5,7,0,12,0,12,0,40
skflow,skflow,,1,0,0,1,0,1,0,1
neuron-simulator,neuron-simulator,,1,0,0,1,0,1,8,1
hashlink,hashlink,,3,0,0,3,0,3,9,1
document-focus,document-focus,,1,0,0,1,0,1,1,1
floating-labels,floating-labels,,2,0,0,2,0,2,1,1
inodeservice,inodeservice,,1,0,0,1,0,1,8,1
xor-linkedlist,xor-linkedlist,,1,1,0,2,0,2,0,1
pytext,pytext,,2,2,0,4,0,4,0,1
html2ps,html2ps,,1,0,0,1,0,1,12,1
documents-provider,documents-provider,,1,0,0,1,0,1,3,1
hydrahon,hydrahon,,1,0,0,1,0,1,4,1
outlook-2011,outlook-2011,,1,0,0,1,0,1,5,1
spu,spu,,1,1,0,2,0,2,9,1
waterfox,waterfox,,1,0,0,1,0,1,1,1
logits,logits,,1,3,0,4,0,4,0,200
gloox,gloox,,2,0,0,2,0,2,9,1
pixastic,pixastic,,1,0,0,1,0,1,1,1
rexster,rexster,,1,0,0,1,0,1,2,1
heavy-class,heavy-class,,1,0,0,1,0,1,3,1
record-locking,record-locking,,1,0,0,1,0,1,4,1
avaya-dmcc-.net,avaya-dmcc-.net,,1,0,0,1,0,1,0,1
videojs-overlay,videojs-overlay,,2,0,0,2,0,2,1,1
libcrafter,libcrafter,,1,0,0,1,0,1,9,1
step-function-offline,step-function-offline,,1,0,0,1,0,1,6,1
pep8-checker,pep8-checker,,1,0,0,1,0,1,0,1
convertfrom-json,convertfrom-json,,1,1,0,2,0,2,8,1
keepalived,keepalived,,2,4,0,6,0,6,6,100
login-automation,login-automation,,1,0,0,1,0,1,3,1
apache-sshd,apache-sshd,,2,2,0,4,0,4,3,1
downsize,downsize,,1,0,0,1,0,1,1,1
jupyter-server-proxy,jupyter-server-proxy,,1,0,0,1,0,1,6,1
helidon,helidon,,2,0,0,2,0,2,3,1
digicert,digicert,,1,2,0,3,0,3,6,100
spock-spy,spock-spy,,2,0,0,2,0,2,3,1
digital-twin,digital-twin,,1,2,0,3,0,3,6,100
syndication,syndication,,1,1,0,2,0,2,8,1
syndication-item,syndication-item,,1,0,0,1,0,1,8,1
jbossmq,jbossmq,,1,0,0,1,0,1,3,1
profilestats,profilestats,,1,0,0,1,0,1,0,1
data-harvest,data-harvest,,1,1,0,2,0,2,8,1
nvidia-dali,nvidia-dali,,2,0,0,2,0,2,0,1
geotargetting,geotargetting,,2,0,0,2,0,2,1,1
frameit,frameit,,1,0,0,1,0,1,13,1
office-connectors,office-connectors,,1,0,0,1,0,1,8,1
envify,envify,,1,0,0,1,0,1,1,1
setup-factory,setup-factory,,1,0,0,1,0,1,9,1
google-cloud-run,google-cloud-run,,51,64,0,115,0,115,6,25.490196
errai-4,errai-4,,1,0,0,1,0,1,3,1
posix-select,posix-select,,1,0,0,1,0,1,9,1
jank,jank,,2,0,0,2,0,2,1,1
facebook-widgets,facebook-widgets,,1,0,0,1,0,1,13,1
material-table,material-table,,16,35,0,51,0,51,1,118.75
instana,instana,,2,2,0,4,0,4,9,1
thonny,thonny,,5,1,0,6,0,6,0,1
tom,tom,,1,0,0,1,0,1,1,1
python-moderngl,python-moderngl,,1,2,0,3,0,3,0,100
cmockery,cmockery,,1,0,0,1,0,1,9,1
qsignalmapper,qsignalmapper,,1,0,0,1,0,1,0,1
reconcile,reconcile,,1,2,0,3,0,3,9,100
onem2m-device-management,onem2m-device-management,,2,0,0,2,0,2,8,1
ruby2d,ruby2d,,1,4,0,5,0,5,12,300
roql,roql,,1,0,0,1,0,1,4,1
visual-studio-shortcuts,visual-studio-shortcuts,,1,0,0,1,0,1,8,1
brave-browser,brave-browser,,1,3,0,4,0,4,1,200
jquery-reel,jquery-reel,,1,0,0,1,0,1,1,1
jquery-filer,jquery-filer,,1,0,0,1,0,1,4,1
glslify,glslify,,1,0,0,1,0,1,1,1
google-cloud-data-fusion,google-cloud-data-fusion,,12,15,0,27,0,27,6,25
ember-cli-less,ember-cli-less,,1,0,0,1,0,1,1,1
angular-abstract-control,angular-abstract-control,,2,0,0,2,0,2,1,1
angular-custom-validators,angular-custom-validators,,2,10,0,12,0,12,1,400
materialpageroute,materialpageroute,,2,2,0,4,0,4,13,1
ssis-2005,ssis-2005,,1,0,0,1,0,1,4,1
agk-basic,agk-basic,,2,0,0,2,0,2,0,1
asp.net-mvc-custom-filter,asp.net-mvc-custom-filter,,1,1,0,2,0,2,0,1
google-bi-engine,google-bi-engine,,4,1,0,5,0,5,4,1
pyrq,pyrq,,1,0,0,1,0,1,0,1
aioredis,aioredis,,1,0,0,1,0,1,0,1
kotlin-also,kotlin-also,,1,0,0,1,0,1,7,1
vbcodeprovider,vbcodeprovider,,1,0,0,1,0,1,8,1
rcov,rcov,,1,0,0,1,0,1,12,1
kapt2,kapt2,,1,0,0,1,0,1,3,1
react-select-plus,react-select-plus,,1,1,0,2,0,2,1,1
rxsearchview,rxsearchview,,1,0,0,1,0,1,3,1
onem2m-security,onem2m-security,,2,0,0,2,0,2,8,1
openjdk-11,openjdk-11,,24,14,0,38,0,38,3,1
machine.fakes,machine.fakes,,1,0,0,1,0,1,1,1
aws-s3-sync,aws-s3-sync,,3,1,0,4,0,4,6,1
pfbc,pfbc,,1,0,0,1,0,1,1,1
windowing-functions,windowing-functions,,4,2,0,6,0,6,4,1
veriblock,veriblock,,1,0,0,1,0,1,6,1
proof-of-proof,proof-of-proof,,1,0,0,1,0,1,6,1
streamlink,streamlink,,3,3,0,6,0,6,9,1
google-anthos,google-anthos,,2,1,0,3,0,3,6,1
lighttable,lighttable,,1,1,0,2,0,2,2,1
salesforce-development,salesforce-development,,4,0,0,4,0,4,14,1
salesforce-developer,salesforce-developer,,3,0,0,3,0,3,14,1
datalife-engine,datalife-engine,,2,0,0,2,0,2,4,1
print-module,print-module,,1,0,0,1,0,1,4,1
gitpod,gitpod,,2,0,0,2,0,2,9,1
tronbox,tronbox,,2,0,0,2,0,2,6,1
tron-quickstart,tron-quickstart,,1,0,0,1,0,1,6,1
nonatomic,nonatomic,,1,1,0,2,0,2,2,1
symfony-4.3,symfony-4.3,,7,40,0,47,0,47,4,471.428571
continuous-forms,continuous-forms,,1,1,0,2,0,2,5,1
word-automation-service,word-automation-service,,1,0,0,1,0,1,8,1
react-native-paper,react-native-paper,,4,15,0,19,0,19,1,275
i18n-tasks,i18n-tasks,,1,0,0,1,0,1,12,1
esp-idf,esp-idf,,8,10,0,18,0,18,9,25
puremvc,puremvc,,1,0,0,1,0,1,1,1
customtabsintent,customtabsintent,,1,0,0,1,0,1,3,1
pyret,pyret,,1,0,0,1,0,1,1,1
snimpy,snimpy,,1,0,0,1,0,1,0,1
vb.net-module,vb.net-module,,1,1,0,2,0,2,8,1
shared-module,shared-module,,2,2,0,4,0,4,1,1
javax.sound.midi.sequence,javax.sound.midi.sequence,,1,0,0,1,0,1,3,1
lucene-highlighter,lucene-highlighter,,1,1,0,2,0,2,2,1
interaction-plot,interaction-plot,,1,1,0,2,0,2,0,1
visual-studio-97,visual-studio-97,,1,0,0,1,0,1,9,1
crossdev,crossdev,,1,1,0,2,0,2,9,1
libgpg-error,libgpg-error,,2,0,0,2,0,2,9,1
cometserver,cometserver,,1,0,0,1,0,1,4,1
react-select2-wrapper,react-select2-wrapper,,1,2,0,3,0,3,1,100
mongo-projection,mongo-projection,,1,0,0,1,0,1,1,1
php-language-server,php-language-server,,1,1,0,2,0,2,4,1
aws-media-convert,aws-media-convert,,5,7,0,12,0,12,6,40
pyosmium,pyosmium,,1,0,0,1,0,1,0,1
exact-synergy-enterprise,exact-synergy-enterprise,,2,0,0,2,0,2,9,1
controller-advice,controller-advice,,3,7,0,10,0,10,3,133.333333
sis,sis,,1,2,0,3,0,3,0,100
xtratreelist,xtratreelist,,1,0,0,1,0,1,8,1
spexception,spexception,,1,0,0,1,0,1,8,1
aspnet-api-versioning,aspnet-api-versioning,,1,3,0,4,0,4,8,200
wmplayer,wmplayer,,1,0,0,1,0,1,9,1
opensymphony,opensymphony,,1,0,0,1,0,1,4,1
scoring-profile,scoring-profile,,1,0,0,1,0,1,8,1
scoring-parameter,scoring-parameter,,1,0,0,1,0,1,8,1
bitmapshader,bitmapshader,,2,0,0,2,0,2,3,1
go-gtk,go-gtk,,2,0,0,2,0,2,6,1
networker,networker,,1,0,0,1,0,1,4,1
unfuddle,unfuddle,,1,0,0,1,0,1,6,1
buffer-manager,buffer-manager,,1,0,0,1,0,1,9,1
aws-lambda-layers,aws-lambda-layers,,7,17,0,24,0,24,6,142.857143
sql-med,sql-med,,1,0,0,1,0,1,4,1
angular-localized-router,angular-localized-router,,1,0,0,1,0,1,1,1
visreg,visreg,,3,2,0,5,0,5,0,1
shunit2,shunit2,,1,0,0,1,0,1,9,1
aws-cloudmap,aws-cloudmap,,1,0,0,1,0,1,6,1
brother-bpac,brother-bpac,,1,0,0,1,0,1,8,1
highcharts-cloud,highcharts-cloud,,1,0,0,1,0,1,1,1
iron-data-table,iron-data-table,,1,0,0,1,0,1,1,1
clienthttprequest,clienthttprequest,,2,0,0,2,0,2,3,1
pmix,pmix,,2,0,0,2,0,2,9,1
rust-racer,rust-racer,,1,0,0,1,0,1,9,1
neoclipse,neoclipse,,1,0,0,1,0,1,2,1
smalltalkx,smalltalkx,,3,0,0,3,0,3,13,1
webmatrix-3,webmatrix-3,,1,0,0,1,0,1,8,1
jwcrypto,jwcrypto,,1,0,0,1,0,1,0,1
webassets,webassets,,1,2,0,3,0,3,0,100
ckosshkey,ckosshkey,,1,0,0,1,0,1,4,1
octokit-js,octokit-js,,3,1,0,4,0,4,6,1
acm.graphics,acm.graphics,,1,0,0,1,0,1,3,1
openmcdf,openmcdf,,1,0,0,1,0,1,8,1
dynamic-finders,dynamic-finders,,1,0,0,1,0,1,3,1
jspresso,jspresso,,1,0,0,1,0,1,3,1
csproj-user,csproj-user,,1,1,0,2,0,2,8,1
cproto,cproto,,1,0,0,1,0,1,9,1
dynamiclayout,dynamiclayout,,2,1,0,3,0,3,3,1
jsrsasign,jsrsasign,,1,0,0,1,0,1,6,1
msmqbinding,msmqbinding,,1,0,0,1,0,1,8,1
jlroutes,jlroutes,,1,0,0,1,0,1,13,1
smtp4dev,smtp4dev,,1,0,0,1,0,1,4,1
vs-error,vs-error,,1,0,0,1,0,1,8,1
cxf-fediz,cxf-fediz,,1,2,0,3,0,3,3,100
google-jax,google-jax,,1,0,0,1,0,1,0,1
onauthorization,onauthorization,,1,0,0,1,0,1,8,1
scalably-typed,scalably-typed,,3,0,0,3,0,3,2,1
j2mepolish,j2mepolish,,1,0,0,1,0,1,3,1
tessy,tessy,,1,0,0,1,0,1,9,1
mediasession,mediasession,,2,2,0,4,0,4,3,1
donut-caching,donut-caching,,3,1,0,4,0,4,8,1
java.security,java.security,,1,1,0,2,0,2,3,1
outputformat,outputformat,,1,0,0,1,0,1,8,1
variable-font,variable-font,,1,0,0,1,0,1,1,1
font-feature-settings,font-feature-settings,,1,1,0,2,0,2,1,1
cloudwatch-alarms,cloudwatch-alarms,,3,5,0,8,0,8,6,66.666667
strong-customer-authentication,strong-customer-authentication,,1,1,0,2,0,2,4,1
amazon-dynamodb-data-modeling,amazon-dynamodb-data-modeling,,4,2,0,6,0,6,6,1
galib,galib,,3,0,0,3,0,3,9,1
v-navigation-drawer,v-navigation-drawer,,2,0,0,2,0,2,1,1
v-autocomplete,v-autocomplete,,1,2,0,3,0,3,1,100
spilo,spilo,,1,0,0,1,0,1,4,1
jscpd,jscpd,,1,0,0,1,0,1,1,1
syntex,syntex,,2,1,0,3,0,3,3,1
tikzjax,tikzjax,,1,0,0,1,0,1,1,1
fotoapparat,fotoapparat,,1,1,0,2,0,2,3,1
aspmenu-control,aspmenu-control,,1,0,0,1,0,1,8,1
xtraeditors,xtraeditors,,1,0,0,1,0,1,8,1
readinessprobe,readinessprobe,,3,5,0,8,0,8,6,66.666667
android-gradle-3.4.0,android-gradle-3.4.0,,4,1,0,5,0,5,3,1
microsoft-message-analyzer,microsoft-message-analyzer,,1,0,0,1,0,1,8,1
django-profiles,django-profiles,,1,0,0,1,0,1,0,1
kafka-records,kafka-records,,1,0,0,1,0,1,2,1
source-separation,source-separation,,1,0,0,1,0,1,0,1
powerpoint-addins,powerpoint-addins,,3,2,0,5,0,5,5,1
mouseleftbuttonup,mouseleftbuttonup,,1,0,0,1,0,1,8,1
feathers-vuex,feathers-vuex,,2,2,0,4,0,4,1,1
esp-12f,esp-12f,,1,1,0,2,0,2,9,1
drf-writable-nested,drf-writable-nested,,1,2,0,3,0,3,0,100
bosque,bosque,,1,0,0,1,0,1,8,1
delay-sign,delay-sign,,1,0,0,1,0,1,8,1
gen-event,gen-event,,1,0,0,1,0,1,2,1
azure-anomaly-detector,azure-anomaly-detector,,3,1,0,4,0,4,8,1
holidays-gem,holidays-gem,,1,2,0,3,0,3,0,100
opencl.net,opencl.net,,1,1,0,2,0,2,8,1
enrich-my-library,enrich-my-library,,1,0,0,1,0,1,2,1
microsoft-graph-files,microsoft-graph-files,,8,4,0,12,0,12,8,1
mysqldump-8,mysqldump-8,,1,0,0,1,0,1,4,1
mysqldump-client,mysqldump-client,,1,0,0,1,0,1,4,1
pcapy,pcapy,,1,3,0,4,0,4,0,200
stampedlock,stampedlock,,1,0,0,1,0,1,3,1
libgc,libgc,,1,0,0,1,0,1,9,1
ubuntu-19.04,ubuntu-19.04,,12,30,0,42,0,42,9,150
worldtimeapi,worldtimeapi,,1,0,0,1,0,1,3,1
quick-documentation,quick-documentation,,1,0,0,1,0,1,6,1
reflog,reflog,,1,0,0,1,0,1,6,1
python-help,python-help,,1,1,0,2,0,2,0,1
mali-400,mali-400,,1,2,0,3,0,3,3,100
ruby-1.9.2,ruby-1.9.2,,1,0,0,1,0,1,0,1
as3crypto,as3crypto,,1,1,0,2,0,2,6,1
iraf,iraf,,2,0,0,2,0,2,0,1
bookdownplus,bookdownplus,,1,0,0,1,0,1,0,1
exiflib,exiflib,,1,0,0,1,0,1,1,1
pyotherside,pyotherside,,1,0,0,1,0,1,0,1
colemak,colemak,,1,0,0,1,0,1,9,1
roauth,roauth,,1,0,0,1,0,1,0,1
sequential-composition,sequential-composition,,1,0,0,1,0,1,1,1
bambi,bambi,,1,1,0,2,0,2,0,1
highspeed,highspeed,,1,1,0,2,0,2,3,1
zimpl,zimpl,,1,0,0,1,0,1,0,1
logman,logman,,2,2,0,4,0,4,9,1
inserter,inserter,,1,2,0,3,0,3,9,100
boost-property-map,boost-property-map,,1,1,0,2,0,2,9,1
static-frame,static-frame,,1,0,0,1,0,1,0,1
range-view,range-view,,1,0,0,1,0,1,9,1
scipy-optimize,scipy-optimize,,28,73,0,101,0,101,0,160.714286
scipy-optimize-minimize,scipy-optimize-minimize,,15,37,0,52,0,52,0,146.666667
parsy,parsy,,1,0,0,1,0,1,0,1
ctp,ctp,,1,0,0,1,0,1,8,1
oracle-streams,oracle-streams,,1,0,0,1,0,1,4,1
symbolic-breakpoint,symbolic-breakpoint,,1,1,0,2,0,2,9,1
partial-postback,partial-postback,,1,0,0,1,0,1,8,1
spring-modules,spring-modules,,1,0,0,1,0,1,3,1
rikulo,rikulo,,1,0,0,1,0,1,3,1
octane-sdk,octane-sdk,,1,0,0,1,0,1,3,1
xchat2,xchat2,,1,0,0,1,0,1,9,1
imageareaselect,imageareaselect,,1,0,0,1,0,1,1,1
tsqlunit,tsqlunit,,1,0,0,1,0,1,8,1
s-maxage,s-maxage,,1,0,0,1,0,1,4,1
field-accessors,field-accessors,,1,0,0,1,0,1,8,1
python-vlc,python-vlc,,3,8,0,11,0,11,0,166.666667
discord-rpc,discord-rpc,,1,0,0,1,0,1,0,1
pixate,pixate,,1,0,0,1,0,1,13,1
controlled-component,controlled-component,,4,4,0,8,0,8,1,1
chilkat-sshkey,chilkat-sshkey,,1,0,0,1,0,1,4,1
indexedrdd,indexedrdd,,1,0,0,1,0,1,2,1
android-camerax,android-camerax,,16,38,0,54,0,54,3,137.5
itable,itable,,1,0,0,1,0,1,3,1
pyre-check,pyre-check,,1,1,0,2,0,2,0,1
azure-java-tools,azure-java-tools,,1,0,0,1,0,1,3,1
computed-values,computed-values,,1,0,0,1,0,1,4,1
controlleractioninvoker,controlleractioninvoker,,1,0,0,1,0,1,8,1
dispatchsemaphore,dispatchsemaphore,,2,1,0,3,0,3,13,1
pengwin,pengwin,,2,0,0,2,0,2,9,1
admob-cookieconsent,admob-cookieconsent,,2,0,0,2,0,2,3,1
plovr,plovr,,1,0,0,1,0,1,1,1
entgraiot,entgraiot,,1,0,0,1,0,1,14,1
entgraemm,entgraemm,,1,0,0,1,0,1,14,1
envobj,envobj,,1,0,0,1,0,1,9,1
paint.net,paint.net,,1,0,0,1,0,1,8,1
qt5.12,qt5.12,,6,8,0,14,0,14,9,33.333333
pymodbustcp,pymodbustcp,,1,2,0,3,0,3,0,100
warpscript,warpscript,,1,1,0,2,0,2,2,1
rendr,rendr,,1,0,0,1,0,1,3,1
inotify-tools,inotify-tools,,1,0,0,1,0,1,9,1
pengwin-enterprise,pengwin-enterprise,,1,0,0,1,0,1,9,1
interactive-session,interactive-session,,1,0,0,1,0,1,0,1
commandlet,commandlet,,1,1,0,2,0,2,8,1
nexus-prisma,nexus-prisma,,4,4,0,8,0,8,1,1
argparse4j,argparse4j,,1,0,0,1,0,1,3,1
pcmanfm,pcmanfm,,1,1,0,2,0,2,0,1
decltype-auto,decltype-auto,,1,2,0,3,0,3,9,100
dynamic-dll-import,dynamic-dll-import,,1,2,0,3,0,3,8,100
httpcontext.cache,httpcontext.cache,,1,0,0,1,0,1,2,1
mbeanexporter,mbeanexporter,,1,0,0,1,0,1,3,1
oracle-apex-plugin,oracle-apex-plugin,,2,0,0,2,0,2,4,1
widescreen,widescreen,,1,0,0,1,0,1,1,1
uvicorn,uvicorn,,2,4,0,6,0,6,0,100
version-tree,version-tree,,1,1,0,2,0,2,6,1
rebus-azureservicebus,rebus-azureservicebus,,15,0,0,15,0,15,8,1
logical-grouping,logical-grouping,,1,0,0,1,0,1,9,1
property-transfer,property-transfer,,1,0,0,1,0,1,3,1
smarthost,smarthost,,1,0,0,1,0,1,4,1
pathelement,pathelement,,1,0,0,1,0,1,1,1
celery-4,celery-4,,1,1,0,2,0,2,0,1
react-native-blur,react-native-blur,,1,0,0,1,0,1,1,1
cadence-workflow,cadence-workflow,,3,3,0,6,0,6,6,1
webrtc-android,webrtc-android,,8,7,0,15,0,15,1,1
webrtc-ios,webrtc-ios,,4,3,0,7,0,7,13,1
exynos,exynos,,1,1,0,2,0,2,3,1
android-gsi,android-gsi,,1,0,0,1,0,1,3,1
zero-pad,zero-pad,,1,0,0,1,0,1,0,1
svg-image,svg-image,,1,0,0,1,0,1,3,1
hana-cds,hana-cds,,1,0,0,1,0,1,5,1
xsltviewresolver,xsltviewresolver,,1,0,0,1,0,1,1,1
rras,rras,,1,0,0,1,0,1,8,1
mobilenet,mobilenet,,9,29,0,38,0,38,0,222.222222
adabas-natural,adabas-natural,,1,0,0,1,0,1,0,1
ondrawitem,ondrawitem,,1,1,0,2,0,2,9,1
microsoft-ocr,microsoft-ocr,,2,0,0,2,0,2,1,1
neteller,neteller,,1,0,0,1,0,1,8,1
xamdatachart,xamdatachart,,1,0,0,1,0,1,8,1
turbo-prolog,turbo-prolog,,1,0,0,1,0,1,0,1
envsubst,envsubst,,1,2,0,3,0,3,9,100
android-snapshot,android-snapshot,,1,0,0,1,0,1,13,1
pyspatialite,pyspatialite,,1,0,0,1,0,1,3,1
pygraphics,pygraphics,,1,0,0,1,0,1,1,1
offsite,offsite,,1,0,0,1,0,1,4,1
anti-piracy,anti-piracy,,1,2,0,3,0,3,3,100
wasi,wasi,,1,0,0,1,0,1,9,1
wasmtime,wasmtime,,1,0,0,1,0,1,9,1
wcf-authentication,wcf-authentication,,1,0,0,1,0,1,8,1
git-skip-worktree,git-skip-worktree,,1,0,0,1,0,1,6,1
qvd,qvd,,1,0,0,1,0,1,5,1
clpq,clpq,,1,0,0,1,0,1,0,1
darksky,darksky,,2,2,0,4,0,4,4,1
cocoa-scripting,cocoa-scripting,,1,0,0,1,0,1,13,1
rtrt,rtrt,,1,0,0,1,0,1,1,1
swc-compiler,swc-compiler,,1,0,0,1,0,1,1,1
alias-method-chain,alias-method-chain,,2,0,0,2,0,2,12,1
jdf,jdf,,1,0,0,1,0,1,8,1
angular7-router,angular7-router,,31,44,0,75,0,75,1,41.935484
fastapi,fastapi,,3,8,0,11,0,11,0,166.666667
ms-flow,ms-flow,,7,17,0,24,0,24,8,142.857143
kinesis,kinesis,,6,15,0,21,0,21,6,150
wildfly-15,wildfly-15,,5,7,0,12,0,12,3,40
jruby-openssl,jruby-openssl,,1,0,0,1,0,1,12,1
smart-on-fhir,smart-on-fhir,,1,2,0,3,0,3,14,100
webviewscaffold,webviewscaffold,,1,2,0,3,0,3,13,100
mongo-jdbc-driver,mongo-jdbc-driver,,1,1,0,2,0,2,3,1
revit-2015,revit-2015,,1,0,0,1,0,1,8,1
okta-signin-widget,okta-signin-widget,,2,0,0,2,0,2,1,1
wideimage,wideimage,,1,0,0,1,0,1,4,1
args4j,args4j,,1,1,0,2,0,2,3,1
lorenz-system,lorenz-system,,1,0,0,1,0,1,0,1
speedment,speedment,,2,1,0,3,0,3,3,1
nightwatch,nightwatch,,3,25,0,28,0,28,3,733.333333
htmlextensions,htmlextensions,,1,0,0,1,0,1,4,1
acaccountstore,acaccountstore,,1,0,0,1,0,1,13,1
grandnode,grandnode,,1,0,0,1,0,1,6,1
perf4j,perf4j,,1,0,0,1,0,1,3,1
bucket4j,bucket4j,,1,0,0,1,0,1,4,1
do178-b,do178-b,,1,0,0,1,0,1,9,1
tilt-sensor,tilt-sensor,,1,1,0,2,0,2,3,1
fbs,fbs,,3,3,0,6,0,6,0,1
monero,monero,,2,0,0,2,0,2,6,1
turtlecoin,turtlecoin,,1,0,0,1,0,1,6,1
ssis-2019,ssis-2019,,5,1,0,6,0,6,4,1
amalgamation,amalgamation,,1,0,0,1,0,1,9,1
azure-resource-explorer,azure-resource-explorer,,1,0,0,1,0,1,8,1
elastest,elastest,,1,0,0,1,0,1,6,1
kotlinx.coroutines.channels,kotlinx.coroutines.channels,,2,3,0,5,0,5,3,50
urlimageviewhelper,urlimageviewhelper,,2,1,0,3,0,3,3,1
postman-native-app,postman-native-app,,3,6,0,9,0,9,4,100
postman-proxy,postman-proxy,,1,0,0,1,0,1,4,1
avcontentkeysession,avcontentkeysession,,2,1,0,3,0,3,13,1
redquerybuilder,redquerybuilder,,1,0,0,1,0,1,4,1
docker-login,docker-login,,1,0,0,1,0,1,6,1
ibm-jsf,ibm-jsf,,1,0,0,1,0,1,3,1
ptxas,ptxas,,2,0,0,2,0,2,0,1
django-3.0,django-3.0,,2,0,0,2,0,2,0,1
apache-spark-1.5.2,apache-spark-1.5.2,,1,0,0,1,0,1,2,1
decrease-key,decrease-key,,1,0,0,1,0,1,3,1
azure-function-app,azure-function-app,,22,41,0,63,0,63,8,86.363636
ckquerysubscription,ckquerysubscription,,1,0,0,1,0,1,13,1
angular-load-children,angular-load-children,,3,1,0,4,0,4,1,1
konacha,konacha,,1,0,0,1,0,1,12,1
simpleconfigparser,simpleconfigparser,,1,0,0,1,0,1,0,1
graphql.net,graphql.net,,1,2,0,3,0,3,8,100
alamofire-request,alamofire-request,,3,10,0,13,0,13,13,233.333333
gradient-check,gradient-check,,1,0,0,1,0,1,0,1
angular-canload,angular-canload,,1,1,0,2,0,2,1,1
react-localize-redux,react-localize-redux,,3,3,0,6,0,6,1,1
linemanjs,linemanjs,,1,0,0,1,0,1,1,1
robotframework-swinglibrary,robotframework-swinglibrary,,2,0,0,2,0,2,3,1
geckoview,geckoview,,4,8,0,12,0,12,3,100
apache-royale,apache-royale,,7,2,0,9,0,9,13,1
table-partitioning,table-partitioning,,1,0,0,1,0,1,4,1
cameracapturesession,cameracapturesession,,1,1,0,2,0,2,3,1
drawertoggle,drawertoggle,,1,0,0,1,0,1,3,1
external-data-access,external-data-access,,1,1,0,2,0,2,4,1
refcell,refcell,,1,2,0,3,0,3,9,100
julia-studio,julia-studio,,6,0,0,6,0,6,0,1
easycwmp,easycwmp,,1,0,0,1,0,1,9,1
spdata,spdata,,1,0,0,1,0,1,0,1
geocomputation,geocomputation,,1,0,0,1,0,1,0,1
jwebassembly,jwebassembly,,1,0,0,1,0,1,9,1
hanami-router,hanami-router,,1,0,0,1,0,1,12,1
fc,fc,,1,0,0,1,0,1,9,1
couchbase-bucket,couchbase-bucket,,2,0,0,2,0,2,4,1
lexical-cast,lexical-cast,,1,1,0,2,0,2,9,1
annotations-processing-messager,annotations-processing-messager,,2,0,0,2,0,2,3,1
logminer,logminer,,2,0,0,2,0,2,4,1
trusted-types,trusted-types,,1,0,0,1,0,1,1,1
in-app-update,in-app-update,,9,23,0,32,0,32,3,155.555556
decision-composer,decision-composer,,1,0,0,1,0,1,3,1
openfeign,openfeign,,3,6,0,9,0,9,3,100
augury,augury,,1,2,0,3,0,3,1,100
sphinxcontrib.bibtex,sphinxcontrib.bibtex,,1,0,0,1,0,1,0,1
pybtex,pybtex,,1,0,0,1,0,1,0,1
electron-protocol,electron-protocol,,1,0,0,1,0,1,1,1
jsonforms,jsonforms,,1,1,0,2,0,2,1,1
crypt12,crypt12,,1,0,0,1,0,1,6,1
gemstone,gemstone,,1,0,0,1,0,1,13,1
graphene-django,graphene-django,,7,24,0,31,0,31,1,242.857143
mod-pywebsocket,mod-pywebsocket,,1,0,0,1,0,1,1,1
windows-sbs,windows-sbs,,1,0,0,1,0,1,9,1
elasticsearch-missing-aggregation,elasticsearch-missing-aggregation,,1,0,0,1,0,1,6,1
sqlcop,sqlcop,,1,0,0,1,0,1,4,1
formsy-semantic-ui-react,formsy-semantic-ui-react,,1,0,0,1,0,1,1,1
canactivatechild,canactivatechild,,1,1,0,2,0,2,1,1
logdna,logdna,,2,5,0,7,0,7,6,150
vscode-remote,vscode-remote,,33,46,0,79,0,79,9,39.393939
kaleidoscope,kaleidoscope,,1,0,0,1,0,1,9,1
expressiondebugger,expressiondebugger,,1,0,0,1,0,1,8,1
marvinproject,marvinproject,,1,0,0,1,0,1,1,1
concatenative-language,concatenative-language,,1,0,0,1,0,1,2,1
mork,mork,,1,0,0,1,0,1,9,1
renderless-component,renderless-component,,1,0,0,1,0,1,1,1
scoped-slot,scoped-slot,,1,0,0,1,0,1,1,1
usecallback,usecallback,,1,3,0,4,0,4,1,200
virocore,virocore,,1,1,0,2,0,2,3,1
optionaldataexception,optionaldataexception,,1,0,0,1,0,1,8,1
cordova9,cordova9,,1,2,0,3,0,3,1,100
ssha,ssha,,1,1,0,2,0,2,1,1
mind-manager,mind-manager,,1,0,0,1,0,1,5,1
bricscad,bricscad,,2,0,0,2,0,2,8,1
system-startup,system-startup,,1,1,0,2,0,2,8,1
exposure-time,exposure-time,,1,2,0,3,0,3,3,100
svelte-store,svelte-store,,2,5,0,7,0,7,1,150
servicecollection,servicecollection,,1,2,0,3,0,3,8,100
radpanelbar,radpanelbar,,1,0,0,1,0,1,8,1
github-api-v4,github-api-v4,,2,4,0,6,0,6,6,100
navigationwindow,navigationwindow,,1,0,0,1,0,1,8,1
oscache,oscache,,1,0,0,1,0,1,9,1
go-sqlmock,go-sqlmock,,1,4,0,5,0,5,6,300
umijs,umijs,,3,0,0,3,0,3,1,1
padding-oracle-attack,padding-oracle-attack,,1,0,0,1,0,1,6,1
custom-stories,custom-stories,,2,0,0,2,0,2,13,1
proftpd-mysql,proftpd-mysql,,1,1,0,2,0,2,4,1
reduxsauce,reduxsauce,,1,0,0,1,0,1,1,1
android-bottomnavigationview,android-bottomnavigationview,,2,6,0,8,0,8,3,200
scpsolver,scpsolver,,1,0,0,1,0,1,3,1
portacle,portacle,,1,0,0,1,0,1,0,1
grocer,grocer,,1,0,0,1,0,1,6,1
styled-jss,styled-jss,,1,0,0,1,0,1,1,1
redo-logs,redo-logs,,1,0,0,1,0,1,4,1
task-tracking,task-tracking,,1,0,0,1,0,1,2,1
deviantart-api,deviantart-api,,1,0,0,1,0,1,4,1
navagent,navagent,,1,0,0,1,0,1,8,1
django-oscar-paypal,django-oscar-paypal,,1,0,0,1,0,1,0,1
apache-fluent-api,apache-fluent-api,,1,0,0,1,0,1,3,1
effector,effector,,1,0,0,1,0,1,1,1
advanced-indexing,advanced-indexing,,1,0,0,1,0,1,0,1
django-rest-knox,django-rest-knox,,2,5,0,7,0,7,0,150
boxinsetlayout,boxinsetlayout,,1,0,0,1,0,1,3,1
loupe,loupe,,1,0,0,1,0,1,13,1
lsapplicationqueriesschemes,lsapplicationqueriesschemes,,1,0,0,1,0,1,13,1
apple-business-manager,apple-business-manager,,1,0,0,1,0,1,13,1
route-model-binding,route-model-binding,,1,1,0,2,0,2,4,1
serenata,serenata,,1,1,0,2,0,2,4,1
bully-algorithm,bully-algorithm,,1,0,0,1,0,1,1,1
r-ape,r-ape,,1,0,0,1,0,1,0,1
webauthenticationcoremanager,webauthenticationcoremanager,,1,0,0,1,0,1,8,1
rxjs-scheduler,rxjs-scheduler,,1,0,0,1,0,1,1,1
dynamic-linq-core,dynamic-linq-core,,3,0,0,3,0,3,8,1
amazon-textract,amazon-textract,,4,13,0,17,0,17,6,225
function-reference,function-reference,,2,2,0,4,0,4,1,1
kube-scheduler,kube-scheduler,,2,3,0,5,0,5,6,50
windows-terminal,windows-terminal,,2,10,0,12,0,12,9,400
iks,iks,,1,0,0,1,0,1,6,1
jquery-form-wizard,jquery-form-wizard,,1,0,0,1,0,1,1,1
executefetchrequest,executefetchrequest,,1,0,0,1,0,1,13,1
dapper.oracle,dapper.oracle,,1,0,0,1,0,1,8,1
gr32,gr32,,1,0,0,1,0,1,9,1
tbitmap32,tbitmap32,,1,0,0,1,0,1,9,1
variable-dump,variable-dump,,1,0,0,1,0,1,0,1
run-dashboard,run-dashboard,,1,1,0,2,0,2,3,1
easyblog,easyblog,,1,0,0,1,0,1,4,1
ngraphics,ngraphics,,1,0,0,1,0,1,8,1
one-class-classification,one-class-classification,,4,2,0,6,0,6,0,1
unsatcore,unsatcore,,1,0,0,1,0,1,0,1
rdap,rdap,,1,0,0,1,0,1,0,1
c2079,c2079,,1,0,0,1,0,1,9,1
large-query,large-query,,1,0,0,1,0,1,4,1
backbone-relational,backbone-relational,,1,0,0,1,0,1,12,1
ersatz,ersatz,,1,0,0,1,0,1,3,1
jdk-httpclient,jdk-httpclient,,1,0,0,1,0,1,3,1
bsondocument,bsondocument,,1,0,0,1,0,1,8,1
amazon-personalize,amazon-personalize,,1,4,0,5,0,5,6,300
.net-5,.net-5,,1,0,0,1,0,1,8,1
netburner,netburner,,1,0,0,1,0,1,3,1
teavm-flavour,teavm-flavour,,2,0,0,2,0,2,3,1
facebook-graph-api-v3.2,facebook-graph-api-v3.2,,1,0,0,1,0,1,13,1
duckyscript,duckyscript,,1,0,0,1,0,1,9,1
cirrus-ci,cirrus-ci,,1,2,0,3,0,3,6,100
cypher-shell,cypher-shell,,2,2,0,4,0,4,2,1
prom-client,prom-client,,1,0,0,1,0,1,6,1
ink,ink,,2,1,0,3,0,3,9,1
salat,salat,,1,0,0,1,0,1,2,1
virtualpathprovider,virtualpathprovider,,1,1,0,2,0,2,8,1
file-traversal,file-traversal,,1,0,0,1,0,1,8,1
amazon-kinesis-client,amazon-kinesis-client,,1,1,0,2,0,2,6,1
sylius-resource,sylius-resource,,1,1,0,2,0,2,4,1
eta-expansion,eta-expansion,,1,0,0,1,0,1,2,1
amazon-timestream,amazon-timestream,,1,0,0,1,0,1,6,1
tinypg,tinypg,,1,0,0,1,0,1,9,1
datetimerangefield,datetimerangefield,,3,1,0,4,0,4,0,1
chrono-tz,chrono-tz,,1,0,0,1,0,1,0,1
albpm,albpm,,1,0,0,1,0,1,4,1
adium,adium,,2,0,0,2,0,2,3,1
android-jetpack-compose,android-jetpack-compose,,2,3,0,5,0,5,3,50
gost28147,gost28147,,1,0,0,1,0,1,6,1
advagg,advagg,,1,0,0,1,0,1,4,1
fluxlang,fluxlang,,2,0,0,2,0,2,6,1
gattlib,gattlib,,1,0,0,1,0,1,0,1
bosch-iot-suite,bosch-iot-suite,,1,2,0,3,0,3,8,100
qgrid,qgrid,,1,0,0,1,0,1,0,1
zend-rest,zend-rest,,1,0,0,1,0,1,4,1
finger-tree,finger-tree,,1,0,0,1,0,1,2,1
.net-spark,.net-spark,,2,2,0,4,0,4,2,1
book-view,book-view,,1,0,0,1,0,1,0,1
ant4eclipse,ant4eclipse,,1,0,0,1,0,1,8,1
react-apollo-hooks,react-apollo-hooks,,2,10,0,12,0,12,1,400
image-mosaic,image-mosaic,,1,0,0,1,0,1,1,1
fast-android-networking,fast-android-networking,,1,2,0,3,0,3,3,100
django-ses,django-ses,,1,0,0,1,0,1,0,1
robohelp,robohelp,,1,1,0,2,0,2,1,1
kong-ingress,kong-ingress,,2,2,0,4,0,4,6,1
accent-color,accent-color,,1,0,0,1,0,1,3,1
edg,edg,,1,0,0,1,0,1,9,1
django-multiselectfield,django-multiselectfield,,1,2,0,3,0,3,0,100
class-designer,class-designer,,1,0,0,1,0,1,8,1
android-studio-3.5,android-studio-3.5,,2,39,0,41,0,41,3,1850
cfindex,cfindex,,1,0,0,1,0,1,4,1
asgard,asgard,,1,0,0,1,0,1,4,1
xspf,xspf,,1,0,0,1,0,1,13,1
foxyproxy,foxyproxy,,1,1,0,2,0,2,0,1
farmhash,farmhash,,1,0,0,1,0,1,12,1
gitleaks,gitleaks,,3,1,0,4,0,4,6,1
manipulate,manipulate,,1,3,0,4,0,4,0,200
bitbucket-cli,bitbucket-cli,,1,1,0,2,0,2,6,1
sfdc-migration-tool,sfdc-migration-tool,,2,0,0,2,0,2,14,1
azurekinect,azurekinect,,1,7,0,8,0,8,8,600
pytest-mock,pytest-mock,,3,5,0,8,0,8,0,66.666667
viro-react,viro-react,,3,4,0,7,0,7,1,33.333333
viro-media,viro-media,,2,0,0,2,0,2,1,1
neuroml-database,neuroml-database,,1,1,0,2,0,2,0,1
popsql,popsql,,1,1,0,2,0,2,4,1
ntruencrypt,ntruencrypt,,1,0,0,1,0,1,6,1
cyberneko,cyberneko,,1,0,0,1,0,1,3,1
jdenticon,jdenticon,,1,0,0,1,0,1,1,1
selectmanymenu,selectmanymenu,,1,1,0,2,0,2,3,1
malt-parser,malt-parser,,1,0,0,1,0,1,0,1
libsystem,libsystem,,1,0,0,1,0,1,13,1
ethereumj,ethereumj,,2,1,0,3,0,3,6,1
enable-shared-from-this,enable-shared-from-this,,1,7,0,8,0,8,9,600
spinnaker-cam,spinnaker-cam,,1,2,0,3,0,3,6,100
visualcron,visualcron,,2,0,0,2,0,2,9,1
elk,elk,,8,71,0,79,0,79,6,787.5
sentinl,sentinl,,1,0,0,1,0,1,6,1
surveyor-gem,surveyor-gem,,1,0,0,1,0,1,12,1
fanstatic,fanstatic,,1,0,0,1,0,1,3,1
use-effect,use-effect,,14,54,0,68,0,68,1,285.714286
rainbow-js,rainbow-js,,1,0,0,1,0,1,1,1
stellarium,stellarium,,1,0,0,1,0,1,9,1
stellarium-scripting,stellarium-scripting,,1,0,0,1,0,1,9,1
dmql,dmql,,1,1,0,2,0,2,4,1
postgresql.conf,postgresql.conf,,1,1,0,2,0,2,4,1
form-recognizer,form-recognizer,,4,12,0,16,0,16,8,200
svelte-transition,svelte-transition,,1,2,0,3,0,3,1,100
pageable,pageable,,6,6,0,12,0,12,3,1
autobean,autobean,,1,0,0,1,0,1,8,1
webvvt,webvvt,,1,0,0,1,0,1,13,1
bson.code,bson.code,,2,0,0,2,0,2,1,1
dynamic-data-site,dynamic-data-site,,1,0,0,1,0,1,8,1
decentralized-identity,decentralized-identity,,1,5,0,6,0,6,6,400
cinemachine,cinemachine,,2,1,0,3,0,3,8,1
process-exit,process-exit,,1,0,0,1,0,1,6,1
friday,friday,,1,0,0,1,0,1,5,1
iconnectionpoint,iconnectionpoint,,1,0,0,1,0,1,8,1
shopify-api-node,shopify-api-node,,2,4,0,6,0,6,1,100
ascii-8bit,ascii-8bit,,1,0,0,1,0,1,1,1
node-anchor,node-anchor,,1,0,0,1,0,1,6,1
merge-key,merge-key,,1,0,0,1,0,1,6,1
buzz.js,buzz.js,,1,0,0,1,0,1,1,1
swt-awt,swt-awt,,1,0,0,1,0,1,3,1
linkurious,linkurious,,1,0,0,1,0,1,1,1
el-date-picker,el-date-picker,,1,0,0,1,0,1,1,1
ewmh,ewmh,,1,0,0,1,0,1,9,1
microsoft-graph-toolkit,microsoft-graph-toolkit,,1,0,0,1,0,1,1,1
foreignobject,foreignobject,,2,3,0,5,0,5,1,50
ssh-keyscan,ssh-keyscan,,1,0,0,1,0,1,9,1
publisher-confirms,publisher-confirms,,1,0,0,1,0,1,3,1
nsmergepolicy,nsmergepolicy,,2,0,0,2,0,2,13,1
buddy-class,buddy-class,,1,0,0,1,0,1,8,1
libpg,libpg,,2,0,0,2,0,2,9,1
methodexpression,methodexpression,,1,0,0,1,0,1,3,1
comparegroups,comparegroups,,2,1,0,3,0,3,0,1
angular-pagination,angular-pagination,,1,2,0,3,0,3,1,100
contravariant,contravariant,,1,0,0,1,0,1,2,1
rctbridge,rctbridge,,1,1,0,2,0,2,1,1
oneplus6t,oneplus6t,,1,3,0,4,0,4,3,200
lock-mode-android,lock-mode-android,,1,0,0,1,0,1,3,1
android-app-quick-setting,android-app-quick-setting,,1,1,0,2,0,2,3,1
getcandy,getcandy,,2,0,0,2,0,2,6,1
zwcad,zwcad,,1,0,0,1,0,1,8,1
angular-view-encapsulation,angular-view-encapsulation,,1,0,0,1,0,1,1,1
graphql-compose,graphql-compose,,1,2,0,3,0,3,1,100
igx-drop-down,igx-drop-down,,1,0,0,1,0,1,1,1
igx-input-group,igx-input-group,,1,0,0,1,0,1,1,1
web-platforms,web-platforms,,1,0,0,1,0,1,1,1
motion-effect,motion-effect,,1,0,0,1,0,1,3,1
hudson-plugin-batch-task,hudson-plugin-batch-task,,1,0,0,1,0,1,6,1
gulp-imports,gulp-imports,,1,0,0,1,0,1,1,1
libsvmsharp,libsvmsharp,,1,0,0,1,0,1,0,1
uwp-js,uwp-js,,1,0,0,1,0,1,8,1
uwp-c#,uwp-c#,,1,1,0,2,0,2,8,1
jpdl,jpdl,,1,0,0,1,0,1,3,1
alphavantage-api,alphavantage-api,,1,4,0,5,0,5,5,300
vamp-plugin,vamp-plugin,,1,0,0,1,0,1,1,1
pibase,pibase,,1,1,0,2,0,2,4,1
codecharge,codecharge,,2,0,0,2,0,2,4,1
python-pulsar,python-pulsar,,1,3,0,4,0,4,2,200
mpi-rma,mpi-rma,,1,2,0,3,0,3,9,100
gaps-in-visuals,gaps-in-visuals,,1,1,0,2,0,2,1,1
cpu-mds,cpu-mds,,3,0,0,3,0,3,9,1
viewmodelowners,viewmodelowners,,1,0,0,1,0,1,13,1
aurelia-valueconverter,aurelia-valueconverter,,1,1,0,2,0,2,1,1
ngrx-reducers,ngrx-reducers,,1,2,0,3,0,3,1,100
listviewgroup,listviewgroup,,2,0,0,2,0,2,3,1
timefmt,timefmt,,1,0,0,1,0,1,0,1
createelementns,createelementns,,1,0,0,1,0,1,1,1
stochastic-gradient,stochastic-gradient,,2,5,0,7,0,7,0,150
readspeaker,readspeaker,,1,0,0,1,0,1,1,1
nsdraggingitem,nsdraggingitem,,1,0,0,1,0,1,13,1
loudnessenhancer,loudnessenhancer,,1,0,0,1,0,1,3,1
treepath,treepath,,1,1,0,2,0,2,0,1
ternary-representation,ternary-representation,,1,0,0,1,0,1,0,1
regi,regi,,1,0,0,1,0,1,5,1
coroutinescope,coroutinescope,,2,4,0,6,0,6,3,100
nsunitconverter,nsunitconverter,,1,0,0,1,0,1,27,1
nsunitconverterlinear,nsunitconverterlinear,,1,0,0,1,0,1,27,1
neomutt,neomutt,,1,1,0,2,0,2,4,1
php-traits,php-traits,,2,1,0,3,0,3,4,1
shady,shady,,3,1,0,4,0,4,0,1
abstract-interpretation,abstract-interpretation,,1,1,0,2,0,2,9,1
rosencrantz,rosencrantz,,1,0,0,1,0,1,9,1
redux-form-material-ui,redux-form-material-ui,,1,0,0,1,0,1,1,1
jstestrunner,jstestrunner,,1,0,0,1,0,1,1,1
dtype,dtype,,1,17,0,18,0,18,0,1600
cmake-js,cmake-js,,2,1,0,3,0,3,1,1
safe-stack,safe-stack,,1,0,0,1,0,1,8,1
pandas-bokeh,pandas-bokeh,,2,9,0,11,0,11,0,350
stumpy,stumpy,,1,0,0,1,0,1,0,1
ruby-2.1.5,ruby-2.1.5,,1,0,0,1,0,1,12,1
celleditingtemplate,celleditingtemplate,,1,0,0,1,0,1,8,1
dom-selection,dom-selection,,1,1,0,2,0,2,1,1
powerbi-paginated-reports,powerbi-paginated-reports,,1,0,0,1,0,1,5,1
dart-server,dart-server,,3,0,0,3,0,3,13,1
ggthemes,ggthemes,,1,3,0,4,0,4,0,200
scope-resolution-operator,scope-resolution-operator,,1,0,0,1,0,1,9,1
presentation-api,presentation-api,,1,2,0,3,0,3,8,100
alibaba-cloud-oss,alibaba-cloud-oss,,1,0,0,1,0,1,6,1
vanilla-picker,vanilla-picker,,1,0,0,1,0,1,1,1
butterfaces,butterfaces,,1,0,0,1,0,1,3,1
scoped-storage,scoped-storage,,2,1,0,3,0,3,3,1
pspad,pspad,,1,0,0,1,0,1,0,1
non-linear,non-linear,,2,2,0,4,0,4,0,1
mutual-friendship,mutual-friendship,,1,0,0,1,0,1,13,1
package-diagram,package-diagram,,1,0,0,1,0,1,3,1
lineageos,lineageos,,2,10,0,12,0,12,3,400
keras-metrics,keras-metrics,,1,0,0,1,0,1,0,1
table-data-gateway,table-data-gateway,,1,0,0,1,0,1,0,1
userland,userland,,1,0,0,1,0,1,6,1
hummingbird,hummingbird,,3,4,0,7,0,7,13,33.333333
hatchstyle,hatchstyle,,1,0,0,1,0,1,5,1
gcutil,gcutil,,1,0,0,1,0,1,6,1
genvar,genvar,,1,0,0,1,0,1,9,1
razzle,razzle,,1,7,0,8,0,8,1,600
partial-mocks,partial-mocks,,1,0,0,1,0,1,3,1
web-components-shards,web-components-shards,,1,1,0,2,0,2,1,1
privileged-functions,privileged-functions,,1,0,0,1,0,1,9,1
piet,piet,,1,0,0,1,0,1,3,1
email-reputation,email-reputation,,1,0,0,1,0,1,6,1
alamofireobjectmapper,alamofireobjectmapper,,2,2,0,4,0,4,13,1
softlock,softlock,,1,0,0,1,0,1,9,1
pdfdocument,pdfdocument,,2,3,0,5,0,5,13,50
django-inplaceedit,django-inplaceedit,,1,0,0,1,0,1,0,1
twitter-hbc,twitter-hbc,,1,0,0,1,0,1,3,1
product-development,product-development,,1,0,0,1,0,1,6,1
libavg,libavg,,1,0,0,1,0,1,13,1
auto-value-gson,auto-value-gson,,1,0,0,1,0,1,3,1
full-expression,full-expression,,1,1,0,2,0,2,9,1
hg-convert,hg-convert,,1,0,0,1,0,1,6,1
array-replace,array-replace,,1,0,0,1,0,1,1,1
ruby-build,ruby-build,,1,0,0,1,0,1,12,1
terraform-11,terraform-11,,1,0,0,1,0,1,6,1
native-maven-plugin,native-maven-plugin,,1,0,0,1,0,1,3,1
tasking,tasking,,1,0,0,1,0,1,9,1
tricore,tricore,,1,1,0,2,0,2,9,1
typescript-higher-order-types,typescript-higher-order-types,,1,0,0,1,0,1,1,1
react-window,react-window,,2,12,0,14,0,14,1,500
protocol-witness-table,protocol-witness-table,,1,0,0,1,0,1,9,1
mongodb-authentication,mongodb-authentication,,1,0,0,1,0,1,1,1
aws-iam-authenticator,aws-iam-authenticator,,1,2,0,3,0,3,6,100
tvuikit,tvuikit,,1,0,0,1,0,1,13,1
nstokenfieldcell,nstokenfieldcell,,1,0,0,1,0,1,13,1
elvish,elvish,,1,0,0,1,0,1,9,1
a2enmod,a2enmod,,1,1,0,2,0,2,4,1
v-debounce,v-debounce,,1,0,0,1,0,1,1,1
kibana-7,kibana-7,,4,21,0,25,0,25,6,425
gradle-tooling-api,gradle-tooling-api,,1,2,0,3,0,3,3,100
linq-to-ldap,linq-to-ldap,,1,0,0,1,0,1,8,1
matlabpool,matlabpool,,1,0,0,1,0,1,0,1
touch-location,touch-location,,1,0,0,1,0,1,8,1
qx11embedcontainer,qx11embedcontainer,,1,0,0,1,0,1,9,1
wicket-tester,wicket-tester,,2,0,0,2,0,2,3,1
sse3,sse3,,1,0,0,1,0,1,9,1
hddl,hddl,,1,1,0,2,0,2,0,1
movidius,movidius,,3,2,0,5,0,5,0,1
myriad-x,myriad-x,,1,0,0,1,0,1,0,1
domain-data-modelling,domain-data-modelling,,1,1,0,2,0,2,4,1
infi.docopt-completion,infi.docopt-completion,,1,0,0,1,0,1,9,1
array-explode,array-explode,,1,3,0,4,0,4,2,200
webspeed,webspeed,,1,0,0,1,0,1,4,1
fasttime,fasttime,,1,0,0,1,0,1,0,1
jbullet,jbullet,,1,1,0,2,0,2,8,1
odoo-rpc,odoo-rpc,,1,1,0,2,0,2,0,1
plumvoice,plumvoice,,1,1,0,2,0,2,13,1
acknowledgepurchase,acknowledgepurchase,,2,0,0,2,0,2,3,1
pregel,pregel,,2,1,0,3,0,3,2,1
azure-sentinel,azure-sentinel,,1,3,0,4,0,4,8,200
junit-vintage,junit-vintage,,2,0,0,2,0,2,3,1
spring-data-ignite,spring-data-ignite,,1,0,0,1,0,1,3,1
imgcache.0,imgcache.0,,1,0,0,1,0,1,4,1
flash-javascript-api,flash-javascript-api,,1,0,0,1,0,1,1,1
rxworker,rxworker,,1,0,0,1,0,1,3,1
android-bubbles,android-bubbles,,1,0,0,1,0,1,3,1
swift-snapshot-testing,swift-snapshot-testing,,1,0,0,1,0,1,13,1
leapp,leapp,,1,0,0,1,0,1,0,1
pd2ppt,pd2ppt,,1,0,0,1,0,1,0,1
rasterizehtml.js,rasterizehtml.js,,1,0,0,1,0,1,1,1
busy-loop,busy-loop,,1,0,0,1,0,1,9,1
boost-math,boost-math,,1,0,0,1,0,1,9,1
cinnameg,cinnameg,,1,0,0,1,0,1,9,1
jnlua,jnlua,,1,0,0,1,0,1,3,1
ng-html2js,ng-html2js,,1,1,0,2,0,2,1,1
incremental-load,incremental-load,,1,1,0,2,0,2,4,1
brisk,brisk,,1,0,0,1,0,1,0,1
bword2vec,bword2vec,,1,0,0,1,0,1,0,1
ucs-server,ucs-server,,1,0,0,1,0,1,8,1
univention,univention,,1,0,0,1,0,1,8,1
univention-management-console,univention-management-console,,1,0,0,1,0,1,8,1
univention-corporate-server,univention-corporate-server,,1,0,0,1,0,1,8,1
go-jennifer,go-jennifer,,1,0,0,1,0,1,6,1
pi-db,pi-db,,1,0,0,1,0,1,6,1
jest-webpack-alias,jest-webpack-alias,,1,0,0,1,0,1,1,1
cf-python-client,cf-python-client,,2,0,0,2,0,2,3,1
perl-globs,perl-globs,,1,0,0,1,0,1,9,1
winqual,winqual,,1,0,0,1,0,1,9,1
nginx-unit,nginx-unit,,1,0,0,1,0,1,6,1
unitd,unitd,,1,0,0,1,0,1,6,1
word-interop,word-interop,,1,12,0,13,0,13,8,1100
mockito-scala,mockito-scala,,1,2,0,3,0,3,2,100
razorpdf,razorpdf,,1,0,0,1,0,1,8,1
android-lazyloading,android-lazyloading,,1,0,0,1,0,1,3,1
rexray,rexray,,1,1,0,2,0,2,6,1
python-fabric-2,python-fabric-2,,1,2,0,3,0,3,0,100
imghdr,imghdr,,1,0,0,1,0,1,1,1
flow-project,flow-project,,1,28,0,29,0,29,9,2700
aws-acm,aws-acm,,2,2,0,4,0,4,6,1
lightblue,lightblue,,1,1,0,2,0,2,0,1
ecmascript-4,ecmascript-4,,2,0,0,2,0,2,1,1
wordpress-5,wordpress-5,,2,1,0,3,0,3,4,1
sequential-workflow,sequential-workflow,,1,0,0,1,0,1,8,1
deploy-keys,deploy-keys,,1,2,0,3,0,3,6,100
fsc,fsc,,1,1,0,2,0,2,8,1
posterization,posterization,,1,0,0,1,0,1,0,1
persistjs,persistjs,,1,0,0,1,0,1,1,1
komapping,komapping,,1,0,0,1,0,1,1,1
pkgsearch,pkgsearch,,1,0,0,1,0,1,0,1
pbcopy,pbcopy,,1,0,0,1,0,1,0,1
freefem++,freefem++,,2,0,0,2,0,2,9,1
android-resource-qualifiers,android-resource-qualifiers,,1,1,0,2,0,2,3,1
mr-spectatorview,mr-spectatorview,,1,1,0,2,0,2,8,1
headless-fragments,headless-fragments,,1,0,0,1,0,1,3,1
objective-c-framework,objective-c-framework,,1,0,0,1,0,1,8,1
sbt-git,sbt-git,,1,2,0,3,0,3,2,100
single-inheritance,single-inheritance,,1,0,0,1,0,1,9,1
slick-joda-mapper,slick-joda-mapper,,1,0,0,1,0,1,2,1
terraform0.12+,terraform0.12+,,1,10,0,11,0,11,6,900
cppyy,cppyy,,1,0,0,1,0,1,0,1
lstm-stateful,lstm-stateful,,2,11,0,13,0,13,0,450
vuelayers,vuelayers,,2,2,0,4,0,4,1,1
build-migration,build-migration,,1,0,0,1,0,1,6,1
alexa-account-linking,alexa-account-linking,,1,0,0,1,0,1,6,1
ngx-formly,ngx-formly,,1,4,0,5,0,5,1,300
wh-keyboard-ll,wh-keyboard-ll,,1,0,0,1,0,1,9,1
mget,mget,,1,2,0,3,0,3,4,100
hidl,hidl,,1,0,0,1,0,1,3,1
doctrine-native-query,doctrine-native-query,,1,0,0,1,0,1,4,1
nsurlerrordomain,nsurlerrordomain,,1,1,0,2,0,2,13,1
ton,ton,,1,0,0,1,0,1,9,1
python-bigquery,python-bigquery,,3,23,0,26,0,26,4,666.666667
vue-transitions,vue-transitions,,1,6,0,7,0,7,1,500
notifyitemrangeremoved,notifyitemrangeremoved,,1,0,0,1,0,1,3,1
decklink,decklink,,1,1,0,2,0,2,9,1
blackmagic,blackmagic,,1,2,0,3,0,3,9,100
xena-api,xena-api,,1,0,0,1,0,1,4,1
gomplate,gomplate,,1,0,0,1,0,1,6,1
xnamespace,xnamespace,,1,0,0,1,0,1,8,1
kuchiki,kuchiki,,1,1,0,2,0,2,9,1
bstr-t,bstr-t,,1,0,0,1,0,1,9,1
prestashop-modules,prestashop-modules,,3,4,0,7,0,7,4,33.333333
tensorflowjs,tensorflowjs,,5,15,0,20,0,20,0,200
mtkview,mtkview,,1,4,0,5,0,5,13,300
google-cloud-cdn-interconnect,google-cloud-cdn-interconnect,,1,0,0,1,0,1,6,1
azure-pipelines-tasks,azure-pipelines-tasks,,1,6,0,7,0,7,8,500
xamarin.forms.shell,xamarin.forms.shell,,1,10,0,11,0,11,8,900
codan,codan,,1,0,0,1,0,1,3,1
sql-smo,sql-smo,,1,0,0,1,0,1,4,1
softbody,softbody,,1,2,0,3,0,3,9,100
whole-module-optimization,whole-module-optimization,,1,0,0,1,0,1,13,1
bootstrap-styled,bootstrap-styled,,1,0,0,1,0,1,6,1
binders,binders,,1,0,0,1,0,1,3,1
union-join,union-join,,1,0,0,1,0,1,4,1
scgi,scgi,,1,0,0,1,0,1,6,1
w3c-pay,w3c-pay,,1,0,0,1,0,1,4,1
cairngorm,cairngorm,,1,0,0,1,0,1,13,1
sn.exe,sn.exe,,1,0,0,1,0,1,13,1
django-simple-menu,django-simple-menu,,1,0,0,1,0,1,0,1
extensible-storage-engine,extensible-storage-engine,,1,2,0,3,0,3,9,100
videoflow,videoflow,,1,0,0,1,0,1,0,1
araxis,araxis,,1,0,0,1,0,1,13,1
docker-push,docker-push,,1,1,0,2,0,2,6,1
docker-tag,docker-tag,,1,2,0,3,0,3,6,100
gvr-android-sdk,gvr-android-sdk,,1,2,0,3,0,3,8,100
pyftpsync,pyftpsync,,1,0,0,1,0,1,4,1
nstokenfield,nstokenfield,,1,0,0,1,0,1,13,1
cockpit-cms,cockpit-cms,,1,2,0,3,0,3,1,100
posthtml,posthtml,,1,1,0,2,0,2,1,1
expresscart,expresscart,,1,0,0,1,0,1,1,1
archive-file,archive-file,,1,1,0,2,0,2,2,1
umbraco-teacommerce,umbraco-teacommerce,,1,1,0,2,0,2,8,1
java2word,java2word,,2,0,0,2,0,2,3,1
etcdctl,etcdctl,,1,0,0,1,0,1,6,1
android-focus,android-focus,,1,0,0,1,0,1,3,1
spreadsheet-gem,spreadsheet-gem,,1,0,0,1,0,1,12,1
microsoft.web.administration,microsoft.web.administration,,1,0,0,1,0,1,8,1
sharepoint-alerts,sharepoint-alerts,,1,0,0,1,0,1,8,1
networkcomms.net,networkcomms.net,,1,0,0,1,0,1,9,1
dbxjson,dbxjson,,1,0,0,1,0,1,9,1
web-clips,web-clips,,1,0,0,1,0,1,1,1
lightbdd,lightbdd,,1,0,0,1,0,1,8,1
futhark,futhark,,1,0,0,1,0,1,2,1
eleventy,eleventy,,1,1,0,2,0,2,1,1
aws-stepfunctions-local,aws-stepfunctions-local,,1,0,0,1,0,1,6,1
duplicati,duplicati,,1,1,0,2,0,2,4,1
react-md,react-md,,2,0,0,2,0,2,1,1
google-maps-flutter,google-maps-flutter,,1,12,0,13,0,13,13,1100
rails-semantic-logger,rails-semantic-logger,,1,0,0,1,0,1,12,1
scientist.js,scientist.js,,1,0,0,1,0,1,1,1
asp.net-mvc-sitemap,asp.net-mvc-sitemap,,1,1,0,2,0,2,8,1
sitemapnode,sitemapnode,,1,0,0,1,0,1,8,1
flexmark,flexmark,,1,0,0,1,0,1,0,1
salvattore,salvattore,,1,0,0,1,0,1,1,1
copy-mode,copy-mode,,1,0,0,1,0,1,9,1
google-calendar-recurring-events,google-calendar-recurring-events,,1,5,0,6,0,6,5,400
ngx-loading,ngx-loading,,1,1,0,2,0,2,1,1
sapper,sapper,,2,28,0,30,0,30,1,1300
typescript-eslint,typescript-eslint,,1,9,0,10,0,10,1,800
flvplayer,flvplayer,,1,0,0,1,0,1,13,1
actiontext,actiontext,,1,11,0,12,0,12,12,1000
rem,rem,,1,5,0,6,0,6,1,400
abcjs,abcjs,,2,0,0,2,0,2,1,1
entity-framework-core-3.0,entity-framework-core-3.0,,1,2,0,3,0,3,8,100
terralang,terralang,,1,0,0,1,0,1,9,1
conditional-attribute,conditional-attribute,,1,0,0,1,0,1,8,1
border-collapse,border-collapse,,1,0,0,1,0,1,1,1
lua-4.0,lua-4.0,,1,0,0,1,0,1,9,1
multiple-alert-dialogs,multiple-alert-dialogs,,1,0,0,1,0,1,3,1
lazycache,lazycache,,1,0,0,1,0,1,8,1
dartdoc,dartdoc,,1,0,0,1,0,1,13,1
cextension,cextension,,1,1,0,2,0,2,0,1
resizegrip,resizegrip,,1,0,0,1,0,1,8,1
netbeans-7.3,netbeans-7.3,,1,0,0,1,0,1,4,1
herepy,herepy,,1,0,0,1,0,1,3,1
neventstore,neventstore,,1,0,0,1,0,1,8,1
libreactnativejni.so,libreactnativejni.so,,1,0,0,1,0,1,1,1
intel-tme,intel-tme,,1,0,0,1,0,1,9,1
cloudanalyst,cloudanalyst,,1,0,0,1,0,1,3,1
ef-core-3.0,ef-core-3.0,,1,15,0,16,0,16,8,1400
windows-95,windows-95,,1,0,0,1,0,1,0,1
samsung-internet,samsung-internet,,1,1,0,2,0,2,1,1
dwinshs,dwinshs,,2,0,0,2,0,2,8,1
r4mvc,r4mvc,,1,0,0,1,0,1,8,1
qabstractslider,qabstractslider,,1,0,0,1,0,1,9,1
three20,three20,,1,0,0,1,0,1,13,1
page-directives,page-directives,,1,0,0,1,0,1,8,1
slimv,slimv,,1,0,0,1,0,1,9,1
snackjs,snackjs,,1,0,0,1,0,1,1,1
parse.js,parse.js,,1,0,0,1,0,1,1,1
mat-drawer,mat-drawer,,1,0,0,1,0,1,1,1
metacontroller,metacontroller,,1,0,0,1,0,1,6,1
kubernetes-operator,kubernetes-operator,,1,7,0,8,0,8,6,600
workbox-window,workbox-window,,1,1,0,2,0,2,1,1
packed-structure,packed-structure,,1,0,0,1,0,1,9,1
acme,acme,,1,2,0,3,0,3,6,100
memoizee,memoizee,,1,1,0,2,0,2,1,1
solr7,solr7,,1,6,0,7,0,7,2,500
apollo-federation,apollo-federation,,1,3,0,4,0,4,1,200
hms,hms,,1,0,0,1,0,1,2,1
swiftui,swiftui,,5,1127,0,1132,0,1132,13,22440
ngx-resource,ngx-resource,,1,0,0,1,0,1,28,1
ngx-resource-core,ngx-resource-core,,1,0,0,1,0,1,28,1
swift5.1,swift5.1,,1,28,0,29,0,29,13,2700
simplicity-studio,simplicity-studio,,1,0,0,1,0,1,9,1
ansible-runner,ansible-runner,,1,1,0,2,0,2,6,1
xcode11,xcode11,,1,318,0,319,0,319,13,31700
ipados,ipados,,1,18,0,19,0,19,13,1700
ios-darkmode,ios-darkmode,,1,26,0,27,0,27,13,2500
ember-octane,ember-octane,,0,2,0,2,0,2,1,100
1password,1password,,0,1,0,1,0,1,1,1
react-native-voice,react-native-voice,,0,1,0,1,0,1,1,1
inno-tools-downloader,inno-tools-downloader,,0,1,0,1,0,1,8,1
secretsmanager,secretsmanager,,0,2,0,2,0,2,6,100
babelfor,babelfor,,0,1,0,1,0,1,8,1
tgridpanel,tgridpanel,,0,1,0,1,0,1,9,1
botpress,botpress,,0,7,0,7,0,7,8,600
apple-sign-in,apple-sign-in,,0,14,0,14,0,14,13,1300
tarantool-java,tarantool-java,,0,1,0,1,0,1,9,1
xanitizer,xanitizer,,0,1,0,1,0,1,3,1
simplewifi,simplewifi,,0,1,0,1,0,1,9,1
aws-fsx-windows,aws-fsx-windows,,0,3,0,3,0,3,6,200
typicms,typicms,,0,1,0,1,0,1,4,1
algebird,algebird,,0,1,0,1,0,1,2,1
ubuntu-14.10,ubuntu-14.10,,0,1,0,1,0,1,6,1
wrap-function,wrap-function,,0,1,0,1,0,1,13,1
sf-symbols,sf-symbols,,0,11,0,11,0,11,13,1000
oculus-runtime,oculus-runtime,,0,4,0,4,0,4,8,300
swaggen,swaggen,,0,1,0,1,0,1,3,1
scatter-matrix,scatter-matrix,,0,1,0,1,0,1,0,1
opcode-cache,opcode-cache,,0,1,0,1,0,1,4,1
php-opcode,php-opcode,,0,1,0,1,0,1,4,1
mergemap,mergemap,,0,2,0,2,0,2,1,100
descartes,descartes,,0,2,0,2,0,2,0,100
valums-file-uploader,valums-file-uploader,,0,1,0,1,0,1,8,1
pyscreeze,pyscreeze,,0,1,0,1,0,1,0,1
combine,combine,,0,94,0,94,0,94,13,9300
groovy-2.4,groovy-2.4,,0,1,0,1,0,1,3,1
eclipse-2019-06,eclipse-2019-06,,0,4,0,4,0,4,3,300
lightcase.js,lightcase.js,,0,1,0,1,0,1,1,1
embroidery,embroidery,,0,1,0,1,0,1,0,1
azure-rest-api,azure-rest-api,,0,24,0,24,0,24,8,2300
r6025,r6025,,0,1,0,1,0,1,5,1
os-trap,os-trap,,0,2,0,2,0,2,9,100
routific-api,routific-api,,0,2,0,2,0,2,8,100
jquery-end,jquery-end,,0,1,0,1,0,1,1,1
iowait,iowait,,0,1,0,1,0,1,9,1
handleerrorinfo,handleerrorinfo,,0,1,0,1,0,1,8,1
cozyroc,cozyroc,,0,2,0,2,0,2,4,100
messagesight,messagesight,,0,1,0,1,0,1,6,1
opaque-result-type,opaque-result-type,,0,2,0,2,0,2,13,100
responsive-nav,responsive-nav,,0,1,0,1,0,1,1,1
andengine-gles-2,andengine-gles-2,,0,1,0,1,0,1,3,1
google-tv,google-tv,,0,1,0,1,0,1,3,1
tableservicescontext,tableservicescontext,,0,1,0,1,0,1,8,1
tri-state-logic,tri-state-logic,,0,1,0,1,0,1,3,1
macos-catalina,macos-catalina,,0,54,0,54,0,54,13,5300
uikitformac,uikitformac,,0,18,0,18,0,18,13,1700
server-side-controls,server-side-controls,,0,1,0,1,0,1,8,1
react-native-cookies,react-native-cookies,,0,1,0,1,0,1,1,1
system.io.pipelines,system.io.pipelines,,0,1,0,1,0,1,8,1
html-manipulation,html-manipulation,,0,1,0,1,0,1,4,1
nsmutableparagraphstyle,nsmutableparagraphstyle,,0,1,0,1,0,1,13,1
wmode,wmode,,0,1,0,1,0,1,1,1
python-igraph,python-igraph,,0,1,0,1,0,1,2,1
schematron-quickfix,schematron-quickfix,,0,1,0,1,0,1,3,1
asp.net-core-scaffolding,asp.net-core-scaffolding,,0,4,0,4,0,4,8,300
visual-studio-app-center-build,visual-studio-app-center-build,,0,2,0,2,0,2,8,100
sisu,sisu,,0,1,0,1,0,1,3,1
chrome-devtools-protocol,chrome-devtools-protocol,,0,11,0,11,0,11,1,1000
pdf-java-toolkit,pdf-java-toolkit,,0,1,0,1,0,1,8,1
vstack,vstack,,0,4,0,4,0,4,13,300
hstack,hstack,,0,10,0,10,0,10,13,900
nipyapi,nipyapi,,0,2,0,2,0,2,2,100
qlik-expression,qlik-expression,,0,20,0,20,0,20,5,1900
r.rsp,r.rsp,,0,1,0,1,0,1,0,1
ora-00932,ora-00932,,0,1,0,1,0,1,4,1
supersonic,supersonic,,0,1,0,1,0,1,3,1
distributedpubsub,distributedpubsub,,0,1,0,1,0,1,1,1
ocr-php,ocr-php,,0,1,0,1,0,1,4,1
panzoom,panzoom,,0,4,0,4,0,4,1,300
gcc9,gcc9,,0,12,0,12,0,12,9,1100
gensym,gensym,,0,1,0,1,0,1,9,1
log4c,log4c,,0,1,0,1,0,1,9,1
rxjs-subscriptions,rxjs-subscriptions,,0,7,0,7,0,7,1,600
windows-sandbox,windows-sandbox,,0,2,0,2,0,2,8,100
cobra-lang,cobra-lang,,0,1,0,1,0,1,6,1
jaydata,jaydata,,0,2,0,2,0,2,8,100
swift5.2,swift5.2,,0,3,0,3,0,3,13,200
stario-sdk,stario-sdk,,0,1,0,1,0,1,3,1
gradle-multi-project-build,gradle-multi-project-build,,0,4,0,4,0,4,3,300
bks,bks,,0,1,0,1,0,1,6,1
flutter-scoped-model,flutter-scoped-model,,0,2,0,2,0,2,13,100
intellij-datagrip,intellij-datagrip,,0,5,0,5,0,5,4,400
kismet-wireless,kismet-wireless,,0,1,0,1,0,1,3,1
puma-worker-killer,puma-worker-killer,,0,2,0,2,0,2,12,100
preserve-3d,preserve-3d,,0,1,0,1,0,1,1,1
uiscenedelegate,uiscenedelegate,,0,5,0,5,0,5,13,400
phosphorjs,phosphorjs,,0,2,0,2,0,2,1,100
node-lame,node-lame,,0,1,0,1,0,1,1,1
postman-mocks,postman-mocks,,0,2,0,2,0,2,4,100
basename,basename,,0,4,0,4,0,4,9,300
bash3,bash3,,0,2,0,2,0,2,9,100
bashpid,bashpid,,0,1,0,1,0,1,9,1
c++-ios,c++-ios,,0,1,0,1,0,1,9,1
snakecasing,snakecasing,,0,3,0,3,0,3,1,200
google-sheets-charts,google-sheets-charts,,0,4,0,4,0,4,5,300
qvariantanimation,qvariantanimation,,0,3,0,3,0,3,0,200
jsctypes,jsctypes,,0,1,0,1,0,1,1,1
ruby-2.7,ruby-2.7,,0,1,0,1,0,1,12,1
psi+,psi+,,0,1,0,1,0,1,3,1
radialgradientbrush,radialgradientbrush,,0,1,0,1,0,1,8,1
wikimedia-android-data-client,wikimedia-android-data-client,,0,2,0,2,0,2,2,100
dragendjs,dragendjs,,0,1,0,1,0,1,1,1
sos-berlin,sos-berlin,,0,1,0,1,0,1,8,1
laravel-artisan,laravel-artisan,,0,9,0,9,0,9,4,800
cf-cli,cf-cli,,0,1,0,1,0,1,3,1
qsvgwidget,qsvgwidget,,0,1,0,1,0,1,0,1
saturation-arithmetic,saturation-arithmetic,,0,1,0,1,0,1,9,1
chargify,chargify,,0,1,0,1,0,1,8,1
calypso,calypso,,0,2,0,2,0,2,3,100
dashbuilder,dashbuilder,,0,1,0,1,0,1,4,1
rollup-plugin-sass,rollup-plugin-sass,,0,1,0,1,0,1,1,1
resource-ref,resource-ref,,0,2,0,2,0,2,3,100
react-native-sqlite-storage,react-native-sqlite-storage,,0,8,0,8,0,8,1,700
cyclic-coordinate-descent,cyclic-coordinate-descent,,0,1,0,1,0,1,8,1
solution-folders,solution-folders,,0,2,0,2,0,2,8,100
ose,ose,,0,1,0,1,0,1,9,1
react-input-autosize,react-input-autosize,,0,2,0,2,0,2,1,100
base85,base85,,0,1,0,1,0,1,0,1
webswing,webswing,,0,1,0,1,0,1,3,1
yeti,yeti,,0,2,0,2,0,2,4,100
tilelist,tilelist,,0,1,0,1,0,1,13,1
tslib,tslib,,0,1,0,1,0,1,9,1
cennznet,cennznet,,0,1,0,1,0,1,9,1
ngx-international-phone-number,ngx-international-phone-number,,0,3,0,3,0,3,1,200
matblaz,matblaz,,0,1,0,1,0,1,8,1
amoeba-gem,amoeba-gem,,0,4,0,4,0,4,12,300
arquicklook,arquicklook,,0,3,0,3,0,3,13,200
sightcall,sightcall,,0,1,0,1,0,1,8,1
ctfontref,ctfontref,,0,1,0,1,0,1,13,1
ios-webkit-debug-proxy,ios-webkit-debug-proxy,,0,2,0,2,0,2,3,100
ora-01861,ora-01861,,0,2,0,2,0,2,4,100
packagecloud.io,packagecloud.io,,0,1,0,1,0,1,1,1
getmem,getmem,,0,1,0,1,0,1,9,1
andand,andand,,0,1,0,1,0,1,0,1
workflow-rehosting,workflow-rehosting,,0,2,0,2,0,2,8,100
kendo-gantt,kendo-gantt,,0,3,0,3,0,3,1,200
contextual-binding,contextual-binding,,0,2,0,2,0,2,8,100
ldjson,ldjson,,0,2,0,2,0,2,2,100
xlsx2csv,xlsx2csv,,0,1,0,1,0,1,5,1
getaddrinfo-a,getaddrinfo-a,,0,1,0,1,0,1,9,1
dnu,dnu,,0,1,0,1,0,1,8,1
cropimage.net,cropimage.net,,0,1,0,1,0,1,1,1
java-spi,java-spi,,0,2,0,2,0,2,3,100
qlik-trigger,qlik-trigger,,0,1,0,1,0,1,5,1
watch-os-6,watch-os-6,,0,15,0,15,0,15,13,1400
amazon-translate,amazon-translate,,0,1,0,1,0,1,6,1
datechooser,datechooser,,0,2,0,2,0,2,3,100
angular-v7,angular-v7,,0,3,0,3,0,3,1,200
ansible-issue,ansible-issue,,0,5,0,5,0,5,6,400
restlet-2.3.1,restlet-2.3.1,,0,2,0,2,0,2,3,100
onexception,onexception,,0,1,0,1,0,1,3,1
tss-msr,tss-msr,,0,1,0,1,0,1,6,1
keytar,keytar,,0,1,0,1,0,1,1,1
acs-serviceidentity,acs-serviceidentity,,0,1,0,1,0,1,8,1
angular-input,angular-input,,0,6,0,6,0,6,1,500
s3client,s3client,,0,1,0,1,0,1,6,1
nsuuid,nsuuid,,0,1,0,1,0,1,1,1
texmacs,texmacs,,0,1,0,1,0,1,0,1
winapi-rs,winapi-rs,,0,1,0,1,0,1,9,1
android-dark-theme,android-dark-theme,,0,5,0,5,0,5,3,400
mysqlpump,mysqlpump,,0,1,0,1,0,1,4,1
ngu-carousel,ngu-carousel,,0,2,0,2,0,2,1,100
nmi,nmi,,0,4,0,4,0,4,0,300
type-switch,type-switch,,0,3,0,3,0,3,9,200
qradar,qradar,,0,3,0,3,0,3,8,200
browse-url,browse-url,,0,1,0,1,0,1,0,1
memoq,memoq,,0,1,0,1,0,1,0,1
pyodide,pyodide,,0,1,0,1,0,1,1,1
merge-request,merge-request,,0,1,0,1,0,1,6,1
program-transformation,program-transformation,,0,2,0,2,0,2,3,100
atmega32,atmega32,,0,3,0,3,0,3,9,200
style-resources-loader,style-resources-loader,,0,1,0,1,0,1,1,1
servemux,servemux,,0,2,0,2,0,2,6,100
guava-table,guava-table,,0,2,0,2,0,2,3,100
xfbml,xfbml,,0,1,0,1,0,1,13,1
aws-step-config,aws-step-config,,0,2,0,2,0,2,2,100
graphical-calcluation-view,graphical-calcluation-view,,0,1,0,1,0,1,5,1
star-join,star-join,,0,1,0,1,0,1,5,1
pgjdbc-ng,pgjdbc-ng,,0,2,0,2,0,2,3,100
directory.delete,directory.delete,,0,1,0,1,0,1,3,1
ibsegueaction,ibsegueaction,,0,2,0,2,0,2,13,100
geometrydrawing,geometrydrawing,,0,2,0,2,0,2,8,100
fast-csv,fast-csv,,0,1,0,1,0,1,1,1
cronet,cronet,,0,1,0,1,0,1,9,1
dependency-exclusion,dependency-exclusion,,0,1,0,1,0,1,3,1
outbox-pattern,outbox-pattern,,0,3,0,3,0,3,8,200
flutter-scaffold,flutter-scaffold,,0,1,0,1,0,1,13,1
nodejs-mobile-react-native,nodejs-mobile-react-native,,0,1,0,1,0,1,1,1
nodejs-mobile,nodejs-mobile,,0,1,0,1,0,1,1,1
ipworks,ipworks,,0,1,0,1,0,1,9,1
nspersistentcloudkitcontainer,nspersistentcloudkitcontainer,,0,6,0,6,0,6,13,500
nslogger,nslogger,,0,1,0,1,0,1,13,1
spyscope,spyscope,,0,1,0,1,0,1,2,1
alexa-dialog,alexa-dialog,,0,2,0,2,0,2,6,100
alexa-intent,alexa-intent,,0,5,0,5,0,5,6,400
nvtx,nvtx,,0,2,0,2,0,2,0,100
rack-contrib,rack-contrib,,0,1,0,1,0,1,12,1
external-methods,external-methods,,0,1,0,1,0,1,9,1
nearlyfreespeech,nearlyfreespeech,,0,1,0,1,0,1,4,1
shark-sql,shark-sql,,0,1,0,1,0,1,2,1
vexflow,vexflow,,0,2,0,2,0,2,1,100
sdl-opengl,sdl-opengl,,0,1,0,1,0,1,9,1
django-herald,django-herald,,0,1,0,1,0,1,0,1
client-side-prediction,client-side-prediction,,0,1,0,1,0,1,3,1
sql-server-graph,sql-server-graph,,0,1,0,1,0,1,2,1
scriptable-object,scriptable-object,,0,7,0,7,0,7,8,600
tensorly,tensorly,,0,1,0,1,0,1,0,1
openai-universe,openai-universe,,0,1,0,1,0,1,0,1
xmpppy,xmpppy,,0,1,0,1,0,1,3,1
nuklear,nuklear,,0,1,0,1,0,1,9,1
e1071,e1071,,0,2,0,2,0,2,0,100
emmake,emmake,,0,1,0,1,0,1,9,1
execute-script,execute-script,,0,5,0,5,0,5,1,400
logpoint,logpoint,,0,1,0,1,0,1,3,1
hybridizer,hybridizer,,0,3,0,3,0,3,8,200
apple-developer-account,apple-developer-account,,0,5,0,5,0,5,13,400
system.addin,system.addin,,0,2,0,2,0,2,8,100
x-dwm,x-dwm,,0,1,0,1,0,1,9,1
harp.gl,harp.gl,,0,1,0,1,0,1,3,1
preload-webpack-plugin,preload-webpack-plugin,,0,1,0,1,0,1,1,1
.emf,.emf,,0,1,0,1,0,1,5,1
pybricks-micropython,pybricks-micropython,,0,3,0,3,0,3,0,200
rabbitpy,rabbitpy,,0,2,0,2,0,2,3,100
g++-5,g++-5,,0,1,0,1,0,1,9,1
azure-sas,azure-sas,,0,8,0,8,0,8,8,700
alibaba-cloud-emapreduce,alibaba-cloud-emapreduce,,0,1,0,1,0,1,6,1
time-select,time-select,,0,2,0,2,0,2,8,100
imperva,imperva,,0,1,0,1,0,1,8,1
packer-builder,packer-builder,,0,3,0,3,0,3,6,200
conditional-conformance,conditional-conformance,,0,1,0,1,0,1,13,1
squel.js,squel.js,,0,2,0,2,0,2,1,100
lshash,lshash,,0,1,0,1,0,1,0,1
ondragstart,ondragstart,,0,2,0,2,0,2,1,100
sendmsg,sendmsg,,0,2,0,2,0,2,9,100
recvmsg,recvmsg,,0,2,0,2,0,2,9,100
libra,libra,,0,4,0,4,0,4,6,300
giflib,giflib,,0,1,0,1,0,1,9,1
typhoondefinition,typhoondefinition,,0,1,0,1,0,1,13,1
pymupdf,pymupdf,,0,8,0,8,0,8,0,700
mergeinfo,mergeinfo,,0,1,0,1,0,1,6,1
gpytorch,gpytorch,,0,2,0,2,0,2,0,100
backgroundrb,backgroundrb,,0,1,0,1,0,1,12,1
cumulative-min,cumulative-min,,0,1,0,1,0,1,0,1
embos,embos,,0,1,0,1,0,1,9,1
turning-point,turning-point,,0,1,0,1,0,1,0,1
typestyle,typestyle,,0,1,0,1,0,1,1,1
j2objc-gradle,j2objc-gradle,,0,1,0,1,0,1,13,1
tarantool-docker,tarantool-docker,,0,1,0,1,0,1,9,1
sorbet,sorbet,,0,29,0,29,0,29,12,2800
spring-data-redis-reactive,spring-data-redis-reactive,,0,4,0,4,0,4,3,300
fsharpx,fsharpx,,0,1,0,1,0,1,2,1
chromaticity,chromaticity,,0,2,0,2,0,2,0,100
perl5.30,perl5.30,,0,3,0,3,0,3,9,200
react-native-community-netinfo,react-native-community-netinfo,,0,6,0,6,0,6,1,500
prqa,prqa,,0,1,0,1,0,1,29,1
helix-qac,helix-qac,,0,1,0,1,0,1,29,1
convertigo,convertigo,,0,1,0,1,0,1,1,1
yardi,yardi,,0,1,0,1,0,1,4,1
capicom,capicom,,0,2,0,2,0,2,8,100
jstor,jstor,,0,1,0,1,0,1,0,1
atlas-data-lake,atlas-data-lake,,0,2,0,2,0,2,1,100
python-arango,python-arango,,0,2,0,2,0,2,2,100
warning-level,warning-level,,0,1,0,1,0,1,8,1
apple-profile-manager,apple-profile-manager,,0,1,0,1,0,1,13,1
tsconfig-paths,tsconfig-paths,,0,4,0,4,0,4,1,300
format-currency,format-currency,,0,2,0,2,0,2,4,100
normalize-space,normalize-space,,0,2,0,2,0,2,3,100
ace-plugin,ace-plugin,,0,1,0,1,0,1,1,1
yii-events,yii-events,,0,1,0,1,0,1,4,1
puppetlabs-aws,puppetlabs-aws,,0,1,0,1,0,1,6,1
ios-flexbox,ios-flexbox,,0,1,0,1,0,1,13,1
spring-boot-cloud-streams,spring-boot-cloud-streams,,0,3,0,3,0,3,3,200
bootstrap.min.css,bootstrap.min.css,,0,1,0,1,0,1,0,1
jaxb-episode,jaxb-episode,,0,1,0,1,0,1,3,1
office-2003,office-2003,,0,1,0,1,0,1,5,1
renviron,renviron,,0,3,0,3,0,3,0,200
nhibernate-hql,nhibernate-hql,,0,1,0,1,0,1,3,1
react-gtm-module,react-gtm-module,,0,1,0,1,0,1,5,1
kcd-scripts,kcd-scripts,,0,1,0,1,0,1,1,1
yawl,yawl,,0,3,0,3,0,3,3,200
swagger-jsdocs,swagger-jsdocs,,0,4,0,4,0,4,3,300
ng-flow,ng-flow,,0,1,0,1,0,1,1,1
nscolorspace,nscolorspace,,0,1,0,1,0,1,13,1
openwebanalytics,openwebanalytics,,0,1,0,1,0,1,4,1
hyperkit,hyperkit,,0,2,0,2,0,2,6,100
cxense,cxense,,0,1,0,1,0,1,3,1
s390x,s390x,,0,4,0,4,0,4,4,300
broad-phase,broad-phase,,0,1,0,1,0,1,0,1
area-chart,area-chart,,0,2,0,2,0,2,1,100
linkedin-gem,linkedin-gem,,0,1,0,1,0,1,4,1
aten,aten,,0,2,0,2,0,2,0,100
ngfactory,ngfactory,,0,2,0,2,0,2,1,100
primeng-spinner,primeng-spinner,,0,1,0,1,0,1,1,1
erlang-gun,erlang-gun,,0,1,0,1,0,1,2,1
concourse-s3-resource,concourse-s3-resource,,0,1,0,1,0,1,6,1
xip.io,xip.io,,0,1,0,1,0,1,4,1
pexcept,pexcept,,0,1,0,1,0,1,0,1
rxjs-observables,rxjs-observables,,0,11,0,11,0,11,1,1000
scorch,scorch,,0,1,0,1,0,1,6,1
google-app-engine-deploy,google-app-engine-deploy,,0,1,0,1,0,1,6,1
macos-system-extension,macos-system-extension,,0,1,0,1,0,1,13,1
web-template-studio,web-template-studio,,0,1,0,1,0,1,9,1
pixelmatch,pixelmatch,,0,1,0,1,0,1,1,1
pngjs,pngjs,,0,4,0,4,0,4,1,300
avcapturevideodataoutput,avcapturevideodataoutput,,0,4,0,4,0,4,13,300
aiosmtpd,aiosmtpd,,0,1,0,1,0,1,4,1
recordmydesktop,recordmydesktop,,0,1,0,1,0,1,3,1
google-groups-migration,google-groups-migration,,0,1,0,1,0,1,5,1
excel-2008,excel-2008,,0,1,0,1,0,1,5,1
angular-material-8,angular-material-8,,0,10,0,10,0,10,1,900
hypercorn,hypercorn,,0,3,0,3,0,3,0,200
freetype-py,freetype-py,,0,3,0,3,0,3,9,200
pdftools,pdftools,,0,3,0,3,0,3,0,200
fuel,fuel,,0,7,0,7,0,7,3,600
propertyhandler,propertyhandler,,0,1,0,1,0,1,9,1
xyz,xyz,,0,2,0,2,0,2,0,100
cie,cie,,0,1,0,1,0,1,0,1
lm-sensors,lm-sensors,,0,2,0,2,0,2,0,100
shouldstartload,shouldstartload,,0,1,0,1,0,1,13,1
generative-programming,generative-programming,,0,2,0,2,0,2,0,100
static-framework,static-framework,,0,1,0,1,0,1,13,1
on-lisp,on-lisp,,0,1,0,1,0,1,9,1
data-importer,data-importer,,0,1,0,1,0,1,4,1
coil,coil,,0,2,0,2,0,2,3,100
interledger,interledger,,0,1,0,1,0,1,3,1
google-play-core,google-play-core,,0,6,0,6,0,6,3,500
errexit,errexit,,0,1,0,1,0,1,9,1
bluedata,bluedata,,0,9,0,9,0,9,2,800
bluedata-3.7,bluedata-3.7,,0,9,0,9,0,9,2,800
childcontrol,childcontrol,,0,1,0,1,0,1,8,1
metadata-service,metadata-service,,0,1,0,1,0,1,8,1
python-jsons,python-jsons,,0,5,0,5,0,5,0,400
react-redux-toastr,react-redux-toastr,,0,1,0,1,0,1,1,1
imgscalr,imgscalr,,0,2,0,2,0,2,3,100
ariadne-graphql,ariadne-graphql,,0,3,0,3,0,3,1,200
kazam,kazam,,0,1,0,1,0,1,3,1
openshot,openshot,,0,2,0,2,0,2,3,100
vmstat,vmstat,,0,1,0,1,0,1,3,1
optional-capture-group,optional-capture-group,,0,1,0,1,0,1,0,1
materialize-stepper,materialize-stepper,,0,1,0,1,0,1,1,1
umbrello,umbrello,,0,1,0,1,0,1,3,1
phoenix-live-view,phoenix-live-view,,0,1,0,1,0,1,2,1
pyfpdf,pyfpdf,,0,3,0,3,0,3,0,200
trains,trains,,0,4,0,4,0,4,0,300
esb-toolkit-2.1,esb-toolkit-2.1,,0,1,0,1,0,1,8,1
fenv,fenv,,0,2,0,2,0,2,9,100
unused-functions,unused-functions,,0,1,0,1,0,1,3,1
takeif,takeif,,0,1,0,1,0,1,3,1
takeunless,takeunless,,0,1,0,1,0,1,3,1
continuation-local-storage,continuation-local-storage,,0,1,0,1,0,1,1,1
webengage,webengage,,0,1,0,1,0,1,3,1
sharing-violation,sharing-violation,,0,1,0,1,0,1,0,1
in-pktinfo,in-pktinfo,,0,1,0,1,0,1,9,1
zpt,zpt,,0,1,0,1,0,1,0,1
request-npm,request-npm,,0,2,0,2,0,2,1,100
node-crawler,node-crawler,,0,3,0,3,0,3,1,200
aws-datasync,aws-datasync,,0,3,0,3,0,3,6,200
bulletprooflib,bulletprooflib,,0,1,0,1,0,1,6,1
yocto-esdk,yocto-esdk,,0,2,0,2,0,2,9,100
collective-intelligence,collective-intelligence,,0,1,0,1,0,1,9,1
path-to-regexp,path-to-regexp,,0,2,0,2,0,2,1,100
removefromsuperview,removefromsuperview,,0,1,0,1,0,1,13,1
flot.tooltip,flot.tooltip,,0,1,0,1,0,1,1,1
dejagnu,dejagnu,,0,1,0,1,0,1,9,1
xamarin.webview,xamarin.webview,,0,1,0,1,0,1,8,1
jbloomberg,jbloomberg,,0,1,0,1,0,1,5,1
android-seek,android-seek,,0,1,0,1,0,1,3,1
primevue,primevue,,0,1,0,1,0,1,1,1
mod-perl-registry,mod-perl-registry,,0,1,0,1,0,1,4,1
apim,apim,,0,8,0,8,0,8,8,700
jaws-wordnet,jaws-wordnet,,0,1,0,1,0,1,0,1
implicit-constructor,implicit-constructor,,0,1,0,1,0,1,9,1
adroitlogic,adroitlogic,,0,1,0,1,0,1,2,1
ilogger,ilogger,,0,7,0,7,0,7,8,600
iorderedqueryable,iorderedqueryable,,0,1,0,1,0,1,8,1
sessiontracking,sessiontracking,,0,1,0,1,0,1,3,1
microsoft-common-controls,microsoft-common-controls,,0,1,0,1,0,1,9,1
polyamorous,polyamorous,,0,1,0,1,0,1,12,1
default-initialization,default-initialization,,0,1,0,1,0,1,9,1
eksctl,eksctl,,0,3,0,3,0,3,6,200
percentile-cont,percentile-cont,,0,1,0,1,0,1,4,1
mongolian-vertical-script,mongolian-vertical-script,,0,1,0,1,0,1,13,1
sqlcachedependency,sqlcachedependency,,0,2,0,2,0,2,8,100
ion-item,ion-item,,0,2,0,2,0,2,1,100
pget,pget,,0,1,0,1,0,1,9,1
locbaml,locbaml,,0,1,0,1,0,1,8,1
podo,podo,,0,1,0,1,0,1,1,1
propensity-score-matching,propensity-score-matching,,0,6,0,6,0,6,0,500
tokyo-cabinet,tokyo-cabinet,,0,1,0,1,0,1,9,1
ssms-2018,ssms-2018,,0,4,0,4,0,4,4,300
jboss-3.x,jboss-3.x,,0,1,0,1,0,1,3,1
sophoslabs-intelix,sophoslabs-intelix,,0,1,0,1,0,1,3,1
mongoid7,mongoid7,,0,1,0,1,0,1,12,1
boost-dll,boost-dll,,0,1,0,1,0,1,9,1
k-fold,k-fold,,0,15,0,15,0,15,0,1400
google-email-migration,google-email-migration,,0,1,0,1,0,1,8,1
android-exifinterface,android-exifinterface,,0,1,0,1,0,1,3,1
wiremock-record,wiremock-record,,0,1,0,1,0,1,3,1
applesimutils,applesimutils,,0,1,0,1,0,1,13,1
ruport,ruport,,0,1,0,1,0,1,12,1
hyperledger-fabric-sdk-java,hyperledger-fabric-sdk-java,,0,5,0,5,0,5,6,400
vlang,vlang,,0,2,0,2,0,2,1,100
clay,clay,,0,1,0,1,0,1,3,1
kubedb,kubedb,,0,1,0,1,0,1,6,1
tdxmemdata,tdxmemdata,,0,1,0,1,0,1,9,1
selly-api,selly-api,,0,3,0,3,0,3,4,200
braintree-vault,braintree-vault,,0,3,0,3,0,3,4,200
java-13,java-13,,0,2,0,2,0,2,3,100
ircdotnet,ircdotnet,,0,1,0,1,0,1,8,1
veins-lte,veins-lte,,0,1,0,1,0,1,9,1
v-validate,v-validate,,0,1,0,1,0,1,1,1
qxmpp,qxmpp,,0,1,0,1,0,1,3,1
xcp,xcp,,0,3,0,3,0,3,9,200
webext-redux,webext-redux,,0,1,0,1,0,1,1,1
cgdataprovider,cgdataprovider,,0,1,0,1,0,1,13,1
sampled-softmax,sampled-softmax,,0,3,0,3,0,3,0,200
azure-sql-server-managed-instance,azure-sql-server-managed-instance,,0,1,0,1,0,1,4,1
mariadb-10.1,mariadb-10.1,,0,8,0,8,0,8,4,700
apple-cryptokit,apple-cryptokit,,0,2,0,2,0,2,6,100
terraform-cli,terraform-cli,,0,1,0,1,0,1,6,1
terraform-remote-state,terraform-remote-state,,0,3,0,3,0,3,6,200
shopify-cart,shopify-cart,,0,1,0,1,0,1,1,1
decentralized-identifiers,decentralized-identifiers,,0,2,0,2,0,2,6,100
cgroupsv2,cgroupsv2,,0,1,0,1,0,1,9,1
customreflectable,customreflectable,,0,1,0,1,0,1,13,1
rcall,rcall,,0,1,0,1,0,1,0,1
compiz,compiz,,0,1,0,1,0,1,9,1
vue-render-function,vue-render-function,,0,3,0,3,0,3,1,200
docker-cp,docker-cp,,0,2,0,2,0,2,6,100
url-helper,url-helper,,0,2,0,2,0,2,12,100
soap-rpc-encoded,soap-rpc-encoded,,0,1,0,1,0,1,3,1
cfselect,cfselect,,0,1,0,1,0,1,4,1
mariadb-10.3,mariadb-10.3,,0,8,0,8,0,8,4,700
distributed-objects,distributed-objects,,0,1,0,1,0,1,13,1
nsconnection,nsconnection,,0,1,0,1,0,1,13,1
postgresql-common,postgresql-common,,0,1,0,1,0,1,9,1
cryengine,cryengine,,0,2,0,2,0,2,9,100
appmethod,appmethod,,0,1,0,1,0,1,8,1
dicomweb,dicomweb,,0,3,0,3,0,3,0,200
packetdotnet,packetdotnet,,0,1,0,1,0,1,9,1
inputbaraccessoryview,inputbaraccessoryview,,0,1,0,1,0,1,13,1
gist-index,gist-index,,0,1,0,1,0,1,4,1
telerik-words-processing,telerik-words-processing,,0,1,0,1,0,1,8,1
osmfilter,osmfilter,,0,2,0,2,0,2,1,100
zerotier,zerotier,,0,2,0,2,0,2,6,100
nsxmlparserdelegate,nsxmlparserdelegate,,0,1,0,1,0,1,13,1
umlgraph,umlgraph,,0,1,0,1,0,1,3,1
aws-backup,aws-backup,,0,1,0,1,0,1,6,1
slick-codegen,slick-codegen,,0,2,0,2,0,2,2,100
withcontext,withcontext,,0,2,0,2,0,2,3,100
remoter,remoter,,0,1,0,1,0,1,6,1
nce,nce,,0,1,0,1,0,1,0,1
swiftsvg,swiftsvg,,0,1,0,1,0,1,13,1
char8-t,char8-t,,0,1,0,1,0,1,9,1
nsolid,nsolid,,0,1,0,1,0,1,1,1
android-ffprobe,android-ffprobe,,0,1,0,1,0,1,13,1
notifyitemchanged,notifyitemchanged,,0,1,0,1,0,1,3,1
flutter-onpressed,flutter-onpressed,,0,3,0,3,0,3,13,200
.net-4.8,.net-4.8,,0,10,0,10,0,10,8,900
android-asset-studio,android-asset-studio,,0,3,0,3,0,3,3,200
graalvm-native-image,graalvm-native-image,,0,6,0,6,0,6,3,500
postgresql-parallel-query,postgresql-parallel-query,,0,1,0,1,0,1,4,1
perlguts,perlguts,,0,1,0,1,0,1,9,1
pseries,pseries,,0,1,0,1,0,1,0,1
clfs,clfs,,0,1,0,1,0,1,9,1
stripe-terminal,stripe-terminal,,0,1,0,1,0,1,4,1
wmake,wmake,,0,1,0,1,0,1,0,1
readdlm,readdlm,,0,1,0,1,0,1,0,1
linfu-dynamicproxy,linfu-dynamicproxy,,0,1,0,1,0,1,8,1
blender-2.49,blender-2.49,,0,1,0,1,0,1,1,1
vigra,vigra,,0,1,0,1,0,1,6,1
phpgacl,phpgacl,,0,1,0,1,0,1,4,1
typegoose,typegoose,,0,3,0,3,0,3,1,200
do-not-disturb,do-not-disturb,,0,4,0,4,0,4,3,300
so-reuseport,so-reuseport,,0,3,0,3,0,3,9,200
kstokenview,kstokenview,,0,1,0,1,0,1,13,1
uimodalpresentationcustom,uimodalpresentationcustom,,0,3,0,3,0,3,13,200
wxauitoolbar,wxauitoolbar,,0,1,0,1,0,1,0,1
wordpress-roles,wordpress-roles,,0,1,0,1,0,1,4,1
wordpress-capabilities,wordpress-capabilities,,0,1,0,1,0,1,4,1
ms-reports,ms-reports,,0,1,0,1,0,1,8,1
sns,sns,,0,12,0,12,0,12,6,1100
cfimage,cfimage,,0,1,0,1,0,1,4,1
flash-builder4.5,flash-builder4.5,,0,1,0,1,0,1,4,1
hoist,hoist,,0,1,0,1,0,1,1,1
gmplot,gmplot,,0,1,0,1,0,1,0,1
rockset,rockset,,0,1,0,1,0,1,1,1
microsoft-portal,microsoft-portal,,0,1,0,1,0,1,8,1
netchart,netchart,,0,2,0,2,0,2,1,100
react-mic,react-mic,,0,1,0,1,0,1,1,1
r-ranger,r-ranger,,0,3,0,3,0,3,0,200
exchange-server-2019,exchange-server-2019,,0,2,0,2,0,2,8,100
lcm-data-marshalling,lcm-data-marshalling,,0,1,0,1,0,1,9,1
autojump,autojump,,0,1,0,1,0,1,1,1
row-buffer,row-buffer,,0,1,0,1,0,1,9,1
oodb,oodb,,0,1,0,1,0,1,1,1
adanet,adanet,,0,2,0,2,0,2,0,100
aws-ec2-instance-connect,aws-ec2-instance-connect,,0,3,0,3,0,3,6,200
videodisplay,videodisplay,,0,1,0,1,0,1,3,1
vue-props,vue-props,,0,11,0,11,0,11,1,1000
functional-logic-progr,functional-logic-progr,,0,1,0,1,0,1,2,1
dbnary,dbnary,,0,1,0,1,0,1,2,1
eon,eon,,0,3,0,3,0,3,0,200
shoulda-matchers,shoulda-matchers,,0,1,0,1,0,1,12,1
openmediavault,openmediavault,,0,1,0,1,0,1,9,1
flask-superadmin,flask-superadmin,,0,1,0,1,0,1,4,1
svnlook,svnlook,,0,1,0,1,0,1,6,1
timespace,timespace,,0,1,0,1,0,1,0,1
ora-00972,ora-00972,,0,1,0,1,0,1,5,1
azure-pipelines-yaml,azure-pipelines-yaml,,0,1,0,1,0,1,8,1
aiortc,aiortc,,0,2,0,2,0,2,13,100
rebass,rebass,,0,3,0,3,0,3,1,200
pesapal,pesapal,,0,1,0,1,0,1,0,1
bban,bban,,0,1,0,1,0,1,4,1
assembly-name,assembly-name,,0,1,0,1,0,1,8,1
fakeit,fakeit,,0,1,0,1,0,1,1,1
abot,abot,,0,1,0,1,0,1,8,1
rfc1738,rfc1738,,0,1,0,1,0,1,0,1
randtoolbox,randtoolbox,,0,1,0,1,0,1,0,1
sinclair,sinclair,,0,1,0,1,0,1,9,1
guidance-automation-tool,guidance-automation-tool,,0,1,0,1,0,1,4,1
fbdialogs,fbdialogs,,0,1,0,1,0,1,9,1
google-api-services-jobs,google-api-services-jobs,,0,4,0,4,0,4,5,300
cdda,cdda,,0,1,0,1,0,1,13,1
servicestack-ioc,servicestack-ioc,,0,1,0,1,0,1,8,1
docsplit,docsplit,,0,1,0,1,0,1,8,1
flutter-typeahead,flutter-typeahead,,0,2,0,2,0,2,13,100
map-rotation,map-rotation,,0,1,0,1,0,1,13,1
guess.js,guess.js,,0,1,0,1,0,1,1,1
uvcharts,uvcharts,,0,1,0,1,0,1,1,1
tkintertable,tkintertable,,0,1,0,1,0,1,0,1
onserviceconnected,onserviceconnected,,0,1,0,1,0,1,3,1
android-notification.mediastyle,android-notification.mediastyle,,0,2,0,2,0,2,3,100
multistage,multistage,,0,1,0,1,0,1,8,1
urlhacks,urlhacks,,0,1,0,1,0,1,4,1
flow-diagram,flow-diagram,,0,1,0,1,0,1,8,1
unnotificationscontentextension,unnotificationscontentextension,,0,2,0,2,0,2,13,100
earth-movers-distance,earth-movers-distance,,0,3,0,3,0,3,0,200
terraform-0.11.7,terraform-0.11.7,,0,1,0,1,0,1,6,1
httptestingcontroller,httptestingcontroller,,0,1,0,1,0,1,1,1
strsafe,strsafe,,0,2,0,2,0,2,9,100
dmake,dmake,,0,1,0,1,0,1,9,1
vinstance,vinstance,,0,1,0,1,0,1,4,1
nearsphere,nearsphere,,0,2,0,2,0,2,1,100
nativescript-ui-listview,nativescript-ui-listview,,0,2,0,2,0,2,1,100
floating-action-menu-listener,floating-action-menu-listener,,0,3,0,3,0,3,3,200
beforeinstallprompt,beforeinstallprompt,,0,5,0,5,0,5,1,400
avatarjs,avatarjs,,0,1,0,1,0,1,3,1
apparition,apparition,,0,4,0,4,0,4,12,300
dollar-quoting,dollar-quoting,,0,3,0,3,0,3,4,200
contentproperty,contentproperty,,0,1,0,1,0,1,5,1
rasa,rasa,,0,33,0,33,0,33,0,3200
mobx-react-lite,mobx-react-lite,,0,2,0,2,0,2,1,100
hdrhistogram,hdrhistogram,,0,1,0,1,0,1,6,1
latencyutils,latencyutils,,0,1,0,1,0,1,6,1
sliderextender,sliderextender,,0,1,0,1,0,1,1,1
stylebundle,stylebundle,,0,1,0,1,0,1,8,1
decentraland,decentraland,,0,3,0,3,0,3,6,200
decentraland-ecs,decentraland-ecs,,0,2,0,2,0,2,6,100
core-js,core-js,,0,10,0,10,0,10,1,900
react-three-fiber,react-three-fiber,,0,1,0,1,0,1,1,1
de-casteljau,de-casteljau,,0,1,0,1,0,1,3,1
turbodbc,turbodbc,,0,4,0,4,0,4,0,300
prisma-binding,prisma-binding,,0,3,0,3,0,3,1,200
weave-ignite,weave-ignite,,0,1,0,1,0,1,6,1
cube.js,cube.js,,0,2,0,2,0,2,1,100
twiki,twiki,,0,1,0,1,0,1,8,1
aws-sso,aws-sso,,0,1,0,1,0,1,6,1
metallb,metallb,,0,7,0,7,0,7,6,600
ubuild,ubuild,,0,1,0,1,0,1,6,1
uiscene,uiscene,,0,7,0,7,0,7,13,600
ltsp,ltsp,,0,1,0,1,0,1,3,1
test-request-flush,test-request-flush,,0,1,0,1,0,1,1,1
azure-iot-dps,azure-iot-dps,,0,3,0,3,0,3,8,200
fab-speed-dial,fab-speed-dial,,0,1,0,1,0,1,3,1
postgresql-12,postgresql-12,,0,1,0,1,0,1,4,1
jboss-rules,jboss-rules,,0,1,0,1,0,1,3,1
html.checkbox,html.checkbox,,0,1,0,1,0,1,1,1
angular-language-service,angular-language-service,,0,1,0,1,0,1,9,1
jesque,jesque,,0,1,0,1,0,1,3,1
appinstaller,appinstaller,,0,3,0,3,0,3,8,200
conpty,conpty,,0,1,0,1,0,1,9,1
nickel,nickel,,0,1,0,1,0,1,9,1
mempoi,mempoi,,0,1,0,1,0,1,3,1
uibuilder,uibuilder,,0,2,0,2,0,2,1,100
vunit,vunit,,0,2,0,2,0,2,9,100
purify,purify,,0,1,0,1,0,1,30,1
rational-purify,rational-purify,,0,1,0,1,0,1,30,1
ibm-governance,ibm-governance,,0,2,0,2,0,2,4,100
decimal-float,decimal-float,,0,1,0,1,0,1,9,1
cookiebot,cookiebot,,0,1,0,1,0,1,5,1
swifty-draw,swifty-draw,,0,1,0,1,0,1,13,1
operator-sections,operator-sections,,0,1,0,1,0,1,2,1
styleswitching,styleswitching,,0,1,0,1,0,1,1,1
javax-inject,javax-inject,,0,1,0,1,0,1,3,1
boinc,boinc,,0,2,0,2,0,2,9,100
tuio,tuio,,0,1,0,1,0,1,8,1
python-3.7.4,python-3.7.4,,0,39,0,39,0,39,0,3800
pclzip,pclzip,,0,1,0,1,0,1,4,1
appengine-magic,appengine-magic,,0,1,0,1,0,1,6,1
p6opaque,p6opaque,,0,1,0,1,0,1,9,1
pyface,pyface,,0,1,0,1,0,1,0,1
bitcoinjs-lib,bitcoinjs-lib,,0,2,0,2,0,2,6,100
oracle-rest-data-services,oracle-rest-data-services,,0,2,0,2,0,2,4,100
worklight-appcenter,worklight-appcenter,,0,1,0,1,0,1,13,1
jenkins-spock,jenkins-spock,,0,1,0,1,0,1,6,1
wordpress-action,wordpress-action,,0,1,0,1,0,1,4,1
wdio-v5,wdio-v5,,0,5,0,5,0,5,3,400
clientscriptmanager,clientscriptmanager,,0,1,0,1,0,1,8,1
sql-server-ml-services,sql-server-ml-services,,0,1,0,1,0,1,0,1
protobuf-go,protobuf-go,,0,5,0,5,0,5,6,400
neo4j-graphql-js,neo4j-graphql-js,,0,2,0,2,0,2,1,100
nopcommerce-4.2,nopcommerce-4.2,,0,5,0,5,0,5,8,400
tidal-scheduler,tidal-scheduler,,0,2,0,2,0,2,4,100
ibm-information-server,ibm-information-server,,0,4,0,4,0,4,4,300
ibm-data-replication,ibm-data-replication,,0,1,0,1,0,1,4,1
amazon-s3-manifest,amazon-s3-manifest,,0,1,0,1,0,1,6,1
local-name,local-name,,0,1,0,1,0,1,3,1
matblazor,matblazor,,0,6,0,6,0,6,8,500
fleetboard,fleetboard,,0,1,0,1,0,1,8,1
griffin.mvccontrib,griffin.mvccontrib,,0,1,0,1,0,1,6,1
jest-client,jest-client,,0,2,0,2,0,2,1,100
ezdfx,ezdfx,,0,1,0,1,0,1,0,1
viewcontroller-lifecyle,viewcontroller-lifecyle,,0,2,0,2,0,2,13,100
redis-windows,redis-windows,,0,1,0,1,0,1,3,1
ionic-vue,ionic-vue,,0,3,0,3,0,3,1,200
rancher-rke,rancher-rke,,0,2,0,2,0,2,6,100
cake-bake,cake-bake,,0,2,0,2,0,2,4,100
pn532,pn532,,0,2,0,2,0,2,13,100
expo-33,expo-33,,0,1,0,1,0,1,1,1
swagger-net,swagger-net,,0,1,0,1,0,1,3,1
aerospike-index,aerospike-index,,0,1,0,1,0,1,3,1
aerospike-seconday-index,aerospike-seconday-index,,0,1,0,1,0,1,3,1
sendgrid-php,sendgrid-php,,0,1,0,1,0,1,4,1
wpf-textbox,wpf-textbox,,0,2,0,2,0,2,8,100
julia-gpu,julia-gpu,,0,1,0,1,0,1,0,1
html-treebuilder,html-treebuilder,,0,2,0,2,0,2,3,100
dataloader,dataloader,,0,22,0,22,0,22,0,2100
table-plus,table-plus,,0,3,0,3,0,3,4,200
outlook-graph-api,outlook-graph-api,,0,1,0,1,0,1,5,1
flask-autoindex,flask-autoindex,,0,1,0,1,0,1,0,1
polkadot-js,polkadot-js,,0,2,0,2,0,2,9,100
asynchronous-messaging-protocol,asynchronous-messaging-protocol,,0,1,0,1,0,1,0,1
xamarin.shell,xamarin.shell,,0,5,0,5,0,5,8,400
loadmodule,loadmodule,,0,1,0,1,0,1,9,1
fill-pointer,fill-pointer,,0,1,0,1,0,1,0,1
call-control,call-control,,0,1,0,1,0,1,3,1
kubernetes-psp,kubernetes-psp,,0,2,0,2,0,2,6,100
mill,mill,,0,4,0,4,0,4,2,300
operator-sdk,operator-sdk,,0,2,0,2,0,2,6,100
copy-local,copy-local,,0,3,0,3,0,3,8,200
qdatawidgetmapper,qdatawidgetmapper,,0,2,0,2,0,2,0,100
uicontextmenuinteraction,uicontextmenuinteraction,,0,1,0,1,0,1,13,1
machinist,machinist,,0,1,0,1,0,1,12,1
imglab,imglab,,0,1,0,1,0,1,0,1
sonar-android-plugin,sonar-android-plugin,,0,1,0,1,0,1,3,1
styleguidist,styleguidist,,0,1,0,1,0,1,1,1
mixerp,mixerp,,0,1,0,1,0,1,8,1
sip-stack,sip-stack,,0,3,0,3,0,3,13,200
launch-condition,launch-condition,,0,1,0,1,0,1,8,1
mat-video,mat-video,,0,1,0,1,0,1,1,1
cups4j,cups4j,,0,2,0,2,0,2,9,100
plplot,plplot,,0,1,0,1,0,1,9,1
leadbolt,leadbolt,,0,1,0,1,0,1,3,1
html-target,html-target,,0,1,0,1,0,1,1,1
hapi-good,hapi-good,,0,1,0,1,0,1,1,1
orchardcms-1.7,orchardcms-1.7,,0,1,0,1,0,1,8,1
coverlet,coverlet,,0,3,0,3,0,3,8,200
user-enrollment,user-enrollment,,0,1,0,1,0,1,13,1
mmwormhole,mmwormhole,,0,1,0,1,0,1,13,1
com-interp,com-interp,,0,1,0,1,0,1,8,1
urlsplit,urlsplit,,0,1,0,1,0,1,1,1
confluent-cloud,confluent-cloud,,0,2,0,2,0,2,2,100
netconf,netconf,,0,3,0,3,0,3,9,200
mongrel,mongrel,,0,1,0,1,0,1,4,1
durandal-navigation,durandal-navigation,,0,1,0,1,0,1,1,1
getdistance,getdistance,,0,1,0,1,0,1,1,1
messagewindow,messagewindow,,0,1,0,1,0,1,3,1
tagprefix,tagprefix,,0,1,0,1,0,1,8,1
cminpack,cminpack,,0,1,0,1,0,1,9,1
mru,mru,,0,1,0,1,0,1,8,1
haxml,haxml,,0,1,0,1,0,1,6,1
osmplotr,osmplotr,,0,1,0,1,0,1,0,1
framer-motion,framer-motion,,0,2,0,2,0,2,1,100
event-modifier,event-modifier,,0,1,0,1,0,1,1,1
selector-drawable,selector-drawable,,0,1,0,1,0,1,3,1
s3-object-tagging,s3-object-tagging,,0,2,0,2,0,2,6,100
react-native-template-typescript,react-native-template-typescript,,0,1,0,1,0,1,1,1
withtimeoutornull,withtimeoutornull,,0,1,0,1,0,1,3,1
ios-standalone-mode,ios-standalone-mode,,0,2,0,2,0,2,1,100
hacl,hacl,,0,1,0,1,0,1,3,1
ionic2-calendar,ionic2-calendar,,0,1,0,1,0,1,1,1
2-tier,2-tier,,0,1,0,1,0,1,6,1
moltenvk,moltenvk,,0,2,0,2,0,2,9,100
node-html-parser,node-html-parser,,0,1,0,1,0,1,1,1
caucho,caucho,,0,1,0,1,0,1,6,1
cve-2014-9390,cve-2014-9390,,0,1,0,1,0,1,4,1
clrprofiler,clrprofiler,,0,4,0,4,0,4,8,300
telerik-radmap,telerik-radmap,,0,1,0,1,0,1,8,1
intraweb-10,intraweb-10,,0,1,0,1,0,1,9,1
mysql-groovy,mysql-groovy,,0,1,0,1,0,1,3,1
dlx,dlx,,0,1,0,1,0,1,9,1
amazon-kinesis-analytics,amazon-kinesis-analytics,,0,2,0,2,0,2,6,100
amazon-kinesis-analytics-sql,amazon-kinesis-analytics-sql,,0,3,0,3,0,3,6,200
angular-json,angular-json,,0,3,0,3,0,3,1,200
podlove,podlove,,0,1,0,1,0,1,1,1
unitofworkapplication,unitofworkapplication,,0,1,0,1,0,1,8,1
searchmanager,searchmanager,,0,1,0,1,0,1,3,1
comeonin,comeonin,,0,1,0,1,0,1,2,1
argon2-elixir,argon2-elixir,,0,1,0,1,0,1,2,1
primary-interop-assembly,primary-interop-assembly,,0,1,0,1,0,1,8,1
react-key-index,react-key-index,,0,1,0,1,0,1,1,1
wikibase,wikibase,,0,6,0,6,0,6,2,500
highslide,highslide,,0,1,0,1,0,1,1,1
dlmdashboard,dlmdashboard,,0,1,0,1,0,1,4,1
http-message-converter,http-message-converter,,0,1,0,1,0,1,3,1
spring-boot-2,spring-boot-2,,0,11,0,11,0,11,3,1000
xcode10.3,xcode10.3,,0,27,0,27,0,27,13,2600
mongodb-rest,mongodb-rest,,0,1,0,1,0,1,3,1
trusted-vs-untrusted,trusted-vs-untrusted,,0,1,0,1,0,1,3,1
ngx-daterangepicker-material,ngx-daterangepicker-material,,0,2,0,2,0,2,1,100
rs,rs,,0,1,0,1,0,1,9,1
nvidia-jetson-nano,nvidia-jetson-nano,,0,6,0,6,0,6,0,500
ckeditor5-react,ckeditor5-react,,0,3,0,3,0,3,1,200
enforcement,enforcement,,0,2,0,2,0,2,6,100
browser-state,browser-state,,0,1,0,1,0,1,1,1
immutant,immutant,,0,1,0,1,0,1,2,1
functions-framework,functions-framework,,0,1,0,1,0,1,6,1
xcodecolor,xcodecolor,,0,1,0,1,0,1,13,1
iroutehandler,iroutehandler,,0,1,0,1,0,1,8,1
dnx50,dnx50,,0,1,0,1,0,1,8,1
stripe-sca,stripe-sca,,0,1,0,1,0,1,4,1
tax-rate,tax-rate,,0,1,0,1,0,1,4,1
stripe-subscriptions,stripe-subscriptions,,0,4,0,4,0,4,4,300
twitterapi-python,twitterapi-python,,0,11,0,11,0,11,0,1000
ngx-mask,ngx-mask,,0,1,0,1,0,1,1,1
wagtail-admin,wagtail-admin,,0,1,0,1,0,1,0,1
wagtail-customization,wagtail-customization,,0,1,0,1,0,1,0,1
tsung-recorder,tsung-recorder,,0,1,0,1,0,1,3,1
url-interception,url-interception,,0,1,0,1,0,1,6,1
tfs2019,tfs2019,,0,4,0,4,0,4,8,300
puppeteer-dart,puppeteer-dart,,0,1,0,1,0,1,13,1
anydesk,anydesk,,0,2,0,2,0,2,3,100
infor-eam,infor-eam,,0,2,0,2,0,2,3,100
treechart,treechart,,0,1,0,1,0,1,4,1
std-tie,std-tie,,0,1,0,1,0,1,9,1
kubernetes-networking,kubernetes-networking,,0,2,0,2,0,2,6,100
avro-ipc,avro-ipc,,0,1,0,1,0,1,2,1
qlistiterator,qlistiterator,,0,1,0,1,0,1,9,1
react-hoc,react-hoc,,0,1,0,1,0,1,1,1
sql-server-pdw,sql-server-pdw,,0,1,0,1,0,1,8,1
pre-commit.com,pre-commit.com,,0,1,0,1,0,1,6,1
allegro-pl,allegro-pl,,0,1,0,1,0,1,3,1
django-graphql-jwt,django-graphql-jwt,,0,3,0,3,0,3,1,200
csv-injection,csv-injection,,0,1,0,1,0,1,8,1
visual-material,visual-material,,0,1,0,1,0,1,8,1
flask-oidc,flask-oidc,,0,4,0,4,0,4,0,300
sematic-release,sematic-release,,0,1,0,1,0,1,6,1
pdf-utils,pdf-utils,,0,1,0,1,0,1,1,1
missingmethod,missingmethod,,0,1,0,1,0,1,8,1
module.exports,module.exports,,0,3,0,3,0,3,1,200
glblendfunc,glblendfunc,,0,1,0,1,0,1,1,1
plotly-express,plotly-express,,0,9,0,9,0,9,0,800
image-slicer,image-slicer,,0,1,0,1,0,1,0,1
angular-foundation,angular-foundation,,0,1,0,1,0,1,8,1
mysql-regexp,mysql-regexp,,0,1,0,1,0,1,4,1
android-navigation-graph,android-navigation-graph,,0,6,0,6,0,6,3,500
vuex-orm,vuex-orm,,0,1,0,1,0,1,1,1
adal-angular4,adal-angular4,,0,1,0,1,0,1,8,1
mongodb-kafka-connector,mongodb-kafka-connector,,0,1,0,1,0,1,2,1
dotnet-dev-certs,dotnet-dev-certs,,0,1,0,1,0,1,8,1
bch-code,bch-code,,0,1,0,1,0,1,9,1
qsequentialiterable,qsequentialiterable,,0,1,0,1,0,1,9,1
qassociativeiterable,qassociativeiterable,,0,1,0,1,0,1,9,1
rjgit,rjgit,,0,1,0,1,0,1,6,1
scroll-snap,scroll-snap,,0,1,0,1,0,1,1,1
am4maps,am4maps,,0,1,0,1,0,1,1,1
vector-auto-regression,vector-auto-regression,,0,1,0,1,0,1,0,1
s3-lifecycle-policy,s3-lifecycle-policy,,0,1,0,1,0,1,6,1
consteval,consteval,,0,1,0,1,0,1,9,1
envstats,envstats,,0,1,0,1,0,1,0,1
ascription,ascription,,0,1,0,1,0,1,2,1
paybox,paybox,,0,1,0,1,0,1,4,1
disco,disco,,0,1,0,1,0,1,8,1
terraform-v12,terraform-v12,,0,2,0,2,0,2,6,100
tf-hub,tf-hub,,0,1,0,1,0,1,0,1
skinlookandfeel,skinlookandfeel,,0,2,0,2,0,2,3,100
geospark,geospark,,0,1,0,1,0,1,2,1
supl,supl,,0,1,0,1,0,1,0,1
vsts-sync-migrator,vsts-sync-migrator,,0,1,0,1,0,1,8,1
xom,xom,,0,1,0,1,0,1,9,1
delayed-loading,delayed-loading,,0,1,0,1,0,1,9,1
dataviewmanager,dataviewmanager,,0,1,0,1,0,1,3,1
emacs-projectile,emacs-projectile,,0,1,0,1,0,1,9,1
ca65,ca65,,0,1,0,1,0,1,9,1
appengine-gradle-plugin,appengine-gradle-plugin,,0,1,0,1,0,1,6,1
twa,twa,,0,5,0,5,0,5,3,400
opensmtpd,opensmtpd,,0,1,0,1,0,1,9,1
android-work-profile,android-work-profile,,0,2,0,2,0,2,3,100
citymapper-api,citymapper-api,,0,1,0,1,0,1,1,1
telecom-manager,telecom-manager,,0,3,0,3,0,3,3,200
helo,helo,,0,1,0,1,0,1,4,1
ehlo,ehlo,,0,1,0,1,0,1,4,1
monday.com,monday.com,,0,1,0,1,0,1,4,1
prelink,prelink,,0,1,0,1,0,1,13,1
ivona,ivona,,0,1,0,1,0,1,3,1
sax-js,sax-js,,0,1,0,1,0,1,1,1
objectstatemanager,objectstatemanager,,0,1,0,1,0,1,8,1
ipatool,ipatool,,0,2,0,2,0,2,13,100
confluent-control-center,confluent-control-center,,0,2,0,2,0,2,2,100
node-promisify,node-promisify,,0,5,0,5,0,5,1,400
silverfrost-fortran,silverfrost-fortran,,0,1,0,1,0,1,9,1
taptic-engine,taptic-engine,,0,1,0,1,0,1,13,1
gstreamer-vaapi,gstreamer-vaapi,,0,1,0,1,0,1,13,1
chrome-addons,chrome-addons,,0,1,0,1,0,1,1,1
dbconnectionfactory,dbconnectionfactory,,0,2,0,2,0,2,8,100
mbunit,mbunit,,0,1,0,1,0,1,8,1
sap-bsp,sap-bsp,,0,1,0,1,0,1,5,1
behaviorrelay,behaviorrelay,,0,1,0,1,0,1,13,1
online-custom-record-form,online-custom-record-form,,0,1,0,1,0,1,14,1
rails-4-2-1,rails-4-2-1,,0,1,0,1,0,1,12,1
zfit,zfit,,0,2,0,2,0,2,0,100
google-maps-premium-plan,google-maps-premium-plan,,0,1,0,1,0,1,1,1
realtime-api,realtime-api,,0,1,0,1,0,1,5,1
android-websocket,android-websocket,,0,3,0,3,0,3,3,200
githttpclient,githttpclient,,0,2,0,2,0,2,8,100
instr,instr,,0,6,0,6,0,6,5,500
flare3d,flare3d,,0,2,0,2,0,2,13,100
google-vpc,google-vpc,,0,6,0,6,0,6,6,500
hyper-virtualization,hyper-virtualization,,0,1,0,1,0,1,6,1
browserfs,browserfs,,0,1,0,1,0,1,1,1
jqui,jqui,,0,1,0,1,0,1,0,1
eslint-plugin-react-hooks,eslint-plugin-react-hooks,,0,2,0,2,0,2,1,100
implicit-expansion,implicit-expansion,,0,1,0,1,0,1,0,1
cssedit,cssedit,,0,1,0,1,0,1,4,1
lzip,lzip,,0,1,0,1,0,1,0,1
number-crunching,number-crunching,,0,1,0,1,0,1,9,1
log-parser-lizard,log-parser-lizard,,0,1,0,1,0,1,4,1
coco2d-x,coco2d-x,,0,1,0,1,0,1,13,1
base62,base62,,0,1,0,1,0,1,1,1
mat-datepicker,mat-datepicker,,0,6,0,6,0,6,1,500
online-storage,online-storage,,0,1,0,1,0,1,4,1
keyboard-python,keyboard-python,,0,1,0,1,0,1,0,1
localehelper,localehelper,,0,1,0,1,0,1,3,1
ktable,ktable,,0,2,0,2,0,2,3,100
odometry,odometry,,0,2,0,2,0,2,0,100
holoviz,holoviz,,0,6,0,6,0,6,0,500
z3-fixedpoint,z3-fixedpoint,,0,2,0,2,0,2,0,100
svelte-3,svelte-3,,0,9,0,9,0,9,1,800
chunkypng,chunkypng,,0,1,0,1,0,1,1,1
agm-map,agm-map,,0,8,0,8,0,8,1,700
agm-core,agm-core,,0,2,0,2,0,2,1,100
msdeployserviceagent,msdeployserviceagent,,0,1,0,1,0,1,8,1
webhttprelaybinding,webhttprelaybinding,,0,1,0,1,0,1,8,1
ngx-logger,ngx-logger,,0,1,0,1,0,1,1,1
globalstorage,globalstorage,,0,1,0,1,0,1,1,1
astral-plane,astral-plane,,0,1,0,1,0,1,4,1
angular-cli-v8,angular-cli-v8,,0,10,0,10,0,10,1,900
defn,defn,,0,1,0,1,0,1,2,1
regexbuddy,regexbuddy,,0,1,0,1,0,1,5,1
schroot,schroot,,0,1,0,1,0,1,9,1
wpf-core,wpf-core,,0,1,0,1,0,1,8,1
wpf-core-3.0,wpf-core-3.0,,0,1,0,1,0,1,8,1
owlnext,owlnext,,0,1,0,1,0,1,9,1
excelr,excelr,,0,1,0,1,0,1,0,1
node-native-addon,node-native-addon,,0,1,0,1,0,1,1,1
git-history-rewrite,git-history-rewrite,,0,1,0,1,0,1,6,1
csvtojson,csvtojson,,0,3,0,3,0,3,1,200
fastcgi-mono-server,fastcgi-mono-server,,0,1,0,1,0,1,6,1
xml-nil,xml-nil,,0,1,0,1,0,1,8,1
odp.net-unmanaged,odp.net-unmanaged,,0,1,0,1,0,1,4,1
srfi,srfi,,0,2,0,2,0,2,0,100
chap,chap,,0,1,0,1,0,1,4,1
micronaut-data,micronaut-data,,0,1,0,1,0,1,3,1
easy-auth,easy-auth,,0,1,0,1,0,1,8,1
blazor-client-side,blazor-client-side,,0,20,0,20,0,20,8,1900
bq-load,bq-load,,0,1,0,1,0,1,4,1
qt5.1,qt5.1,,0,1,0,1,0,1,9,1
raspberry-pi4,raspberry-pi4,,0,7,0,7,0,7,0,600
nsuserautomatortask,nsuserautomatortask,,0,1,0,1,0,1,13,1
ora-00913,ora-00913,,0,1,0,1,0,1,4,1
angular-testing-library,angular-testing-library,,0,1,0,1,0,1,1,1
jora,jora,,0,2,0,2,0,2,1,100
bowser,bowser,,0,1,0,1,0,1,1,1
temple,temple,,0,1,0,1,0,1,2,1
royal-slider,royal-slider,,0,1,0,1,0,1,4,1
redux-socket.io,redux-socket.io,,0,1,0,1,0,1,1,1
oneplusfive,oneplusfive,,0,1,0,1,0,1,3,1
.net-core-framework-version,.net-core-framework-version,,0,1,0,1,0,1,8,1
.net-core-class-library,.net-core-class-library,,0,1,0,1,0,1,8,1
runumap,runumap,,0,1,0,1,0,1,0,1
bootsnap,bootsnap,,0,1,0,1,0,1,12,1
trusted-places,trusted-places,,0,1,0,1,0,1,3,1
wp-fastest-cache,wp-fastest-cache,,0,1,0,1,0,1,4,1
expo-calendar,expo-calendar,,0,1,0,1,0,1,1,1
boost-yap,boost-yap,,0,1,0,1,0,1,9,1
docx-wasm,docx-wasm,,0,2,0,2,0,2,1,100
cellinfogsm,cellinfogsm,,0,1,0,1,0,1,3,1
onpremises-gateway,onpremises-gateway,,0,1,0,1,0,1,4,1
arduinojson,arduinojson,,0,1,0,1,0,1,9,1
esp8266wifi,esp8266wifi,,0,5,0,5,0,5,9,400
mlr3,mlr3,,0,1,0,1,0,1,0,1
fluence,fluence,,0,1,0,1,0,1,1,1
xamarin.tizen,xamarin.tizen,,0,1,0,1,0,1,8,1
netsqlazman,netsqlazman,,0,2,0,2,0,2,8,100
uaappreviewmanager,uaappreviewmanager,,0,1,0,1,0,1,3,1
software-lifecycle,software-lifecycle,,0,1,0,1,0,1,3,1
kotlinx.coroutines.flow,kotlinx.coroutines.flow,,0,2,0,2,0,2,3,100
oracle19c,oracle19c,,0,5,0,5,0,5,4,400
common-information-model,common-information-model,,0,1,0,1,0,1,8,1
laika,laika,,0,1,0,1,0,1,2,1
ctad,ctad,,0,1,0,1,0,1,9,1
react-native-hermes,react-native-hermes,,0,1,0,1,0,1,1,1
pircbot,pircbot,,0,1,0,1,0,1,3,1
jsr203,jsr203,,0,2,0,2,0,2,3,100
threadx,threadx,,0,2,0,2,0,2,8,100
react-adopt,react-adopt,,0,2,0,2,0,2,1,100
testapp,testapp,,0,1,0,1,0,1,4,1
roaster,roaster,,0,1,0,1,0,1,3,1
pyreport,pyreport,,0,2,0,2,0,2,0,100
reference-implementation,reference-implementation,,0,1,0,1,0,1,13,1
ciwarpkernel,ciwarpkernel,,0,1,0,1,0,1,13,1
persistent-object-store,persistent-object-store,,0,1,0,1,0,1,6,1
best-buy-api,best-buy-api,,0,1,0,1,0,1,3,1
bartycrouch,bartycrouch,,0,1,0,1,0,1,13,1
django-rss,django-rss,,0,1,0,1,0,1,0,1
ios-navigationview,ios-navigationview,,0,5,0,5,0,5,13,400
navigationlink,navigationlink,,0,6,0,6,0,6,13,500
spring-starter,spring-starter,,0,1,0,1,0,1,3,1
google-place-picker,google-place-picker,,0,4,0,4,0,4,1,300
android-obfuscation,android-obfuscation,,0,1,0,1,0,1,3,1
github-oauth,github-oauth,,0,2,0,2,0,2,4,100
r2d2,r2d2,,0,1,0,1,0,1,9,1
github-package-registry,github-package-registry,,0,3,0,3,0,3,6,200
cpplinq,cpplinq,,0,1,0,1,0,1,9,1
application-dependency,application-dependency,,0,1,0,1,0,1,9,1
filenet-workplace,filenet-workplace,,0,2,0,2,0,2,15,100
flamelink-cms,flamelink-cms,,0,2,0,2,0,2,13,100
outlook-mac,outlook-mac,,0,2,0,2,0,2,5,100
glue42,glue42,,0,4,0,4,0,4,8,300
pymnet,pymnet,,0,1,0,1,0,1,0,1
py7zlib,py7zlib,,0,1,0,1,0,1,0,1
perldb,perldb,,0,1,0,1,0,1,9,1
ws-notification,ws-notification,,0,1,0,1,0,1,3,1
jamon,jamon,,0,1,0,1,0,1,3,1
number-recognition,number-recognition,,0,1,0,1,0,1,0,1
auto-delete,auto-delete,,0,1,0,1,0,1,4,1
riscv32,riscv32,,0,3,0,3,0,3,9,200
softmmu,softmmu,,0,1,0,1,0,1,9,1
sap-hana-cloud-connector,sap-hana-cloud-connector,,0,2,0,2,0,2,5,100
mainrunloop,mainrunloop,,0,1,0,1,0,1,13,1
.net-standard-2.1,.net-standard-2.1,,0,1,0,1,0,1,8,1
azure-data-share,azure-data-share,,0,1,0,1,0,1,8,1
partiql,partiql,,0,1,0,1,0,1,1,1
httperf,httperf,,0,2,0,2,0,2,3,100
touchtracking,touchtracking,,0,1,0,1,0,1,8,1
reflexil,reflexil,,0,1,0,1,0,1,8,1
onem2m-discovery,onem2m-discovery,,0,1,0,1,0,1,8,1
liferay-7.2,liferay-7.2,,0,3,0,3,0,3,3,200
aws-systems-manager,aws-systems-manager,,0,1,0,1,0,1,6,1
aws-session-manager,aws-session-manager,,0,1,0,1,0,1,6,1
radiance,radiance,,0,1,0,1,0,1,9,1
chrome76,chrome76,,0,3,0,3,0,3,1,200
simple.data,simple.data,,0,1,0,1,0,1,4,1
bosch-iot,bosch-iot,,0,1,0,1,0,1,8,1
uihostingcontroller,uihostingcontroller,,0,2,0,2,0,2,13,100
gulp-template,gulp-template,,0,1,0,1,0,1,9,1
picat,picat,,0,1,0,1,0,1,0,1
fzn2smt,fzn2smt,,0,1,0,1,0,1,0,1
autocreate,autocreate,,0,1,0,1,0,1,3,1
treeage,treeage,,0,1,0,1,0,1,3,1
authid,authid,,0,1,0,1,0,1,2,1
retrofit2.6,retrofit2.6,,0,6,0,6,0,6,3,500
fluentbootstrap,fluentbootstrap,,0,1,0,1,0,1,8,1
nitrokey,nitrokey,,0,1,0,1,0,1,6,1
streaming-video,streaming-video,,0,1,0,1,0,1,13,1
httpotion,httpotion,,0,1,0,1,0,1,2,1
playframework-json,playframework-json,,0,1,0,1,0,1,2,1
form-parser,form-parser,,0,1,0,1,0,1,1,1
mongodb-charts,mongodb-charts,,0,1,0,1,0,1,1,1
wcf-behaviour,wcf-behaviour,,0,1,0,1,0,1,8,1
wcf-sessions,wcf-sessions,,0,1,0,1,0,1,8,1
styleable,styleable,,0,1,0,1,0,1,3,1
swiftui-list,swiftui-list,,0,11,0,11,0,11,13,1000
mercurial-convert,mercurial-convert,,0,2,0,2,0,2,6,100
urlsessionwebsocket,urlsessionwebsocket,,0,1,0,1,0,1,13,1
zoomooz,zoomooz,,0,1,0,1,0,1,1,1
bindableproperty,bindableproperty,,0,3,0,3,0,3,8,200
pose,pose,,0,3,0,3,0,3,3,200
azure-blob-trigger,azure-blob-trigger,,0,1,0,1,0,1,8,1
localstack,localstack,,0,3,0,3,0,3,6,200
elixirls,elixirls,,0,1,0,1,0,1,2,1
network-framework,network-framework,,0,1,0,1,0,1,13,1
clicktale,clicktale,,0,1,0,1,0,1,1,1
libusb-win32,libusb-win32,,0,1,0,1,0,1,3,1
alien,alien,,0,1,0,1,0,1,9,1
syndesis,syndesis,,0,1,0,1,0,1,6,1
cchmac,cchmac,,0,1,0,1,0,1,13,1
expectedobjects,expectedobjects,,0,1,0,1,0,1,8,1
oculusquest,oculusquest,,0,2,0,2,0,2,8,100
zenodo,zenodo,,0,1,0,1,0,1,6,1
linkedin-cruise-control,linkedin-cruise-control,,0,1,0,1,0,1,2,1
vzaar-api,vzaar-api,,0,1,0,1,0,1,8,1
simplebar,simplebar,,0,2,0,2,0,2,1,100
core.match,core.match,,0,1,0,1,0,1,2,1
openjdk-12,openjdk-12,,0,3,0,3,0,3,3,200
smd,smd,,0,1,0,1,0,1,0,1
react-native-ui-components,react-native-ui-components,,0,1,0,1,0,1,1,1
nfft,nfft,,0,1,0,1,0,1,0,1
dscl,dscl,,0,1,0,1,0,1,9,1
react-google-recaptcha,react-google-recaptcha,,0,2,0,2,0,2,1,100
dynamically-generated-co,dynamically-generated-co,,0,1,0,1,0,1,8,1
cinterop,cinterop,,0,1,0,1,0,1,9,1
killbill,killbill,,0,1,0,1,0,1,6,1
mergecursor,mergecursor,,0,1,0,1,0,1,3,1
epson-plq-20,epson-plq-20,,0,1,0,1,0,1,3,1
hcr,hcr,,0,1,0,1,0,1,0,1
pcl6,pcl6,,0,1,0,1,0,1,8,1
nullable-context,nullable-context,,0,1,0,1,0,1,8,1
system.reflection.metadata,system.reflection.metadata,,0,1,0,1,0,1,8,1
jot,jot,,0,1,0,1,0,1,9,1
graphql-playground,graphql-playground,,0,2,0,2,0,2,1,100
apollo-gateway,apollo-gateway,,0,1,0,1,0,1,1,1
ovp,ovp,,0,1,0,1,0,1,9,1
carrier-lookup,carrier-lookup,,0,1,0,1,0,1,4,1
gitlabktl,gitlabktl,,0,1,0,1,0,1,6,1
flutter-theme,flutter-theme,,0,1,0,1,0,1,13,1
imbalanced-data,imbalanced-data,,0,5,0,5,0,5,0,400
fannj,fannj,,0,1,0,1,0,1,3,1
mxscrollview,mxscrollview,,0,1,0,1,0,1,13,1
anymap,anymap,,0,1,0,1,0,1,1,1
snyk,snyk,,0,3,0,3,0,3,1,200
rakudobrew,rakudobrew,,0,1,0,1,0,1,9,1
aws-sar,aws-sar,,0,1,0,1,0,1,6,1
private-header,private-header,,0,1,0,1,0,1,13,1
full-disk-access,full-disk-access,,0,1,0,1,0,1,13,1
switchresx,switchresx,,0,1,0,1,0,1,13,1
ajax-push,ajax-push,,0,1,0,1,0,1,4,1
rperl,rperl,,0,1,0,1,0,1,9,1
mixer-fixtures,mixer-fixtures,,0,1,0,1,0,1,0,1
icedtea-web,icedtea-web,,0,1,0,1,0,1,3,1
slim-4,slim-4,,0,6,0,6,0,6,4,500
syncml,syncml,,0,1,0,1,0,1,9,1
html-formfu,html-formfu,,0,1,0,1,0,1,9,1
fromkeys,fromkeys,,0,1,0,1,0,1,0,1
cleverreach,cleverreach,,0,1,0,1,0,1,4,1
jquery-dotdotdot,jquery-dotdotdot,,0,1,0,1,0,1,1,1
maccatalyst,maccatalyst,,0,3,0,3,0,3,13,200
andlabs-ui,andlabs-ui,,0,11,0,11,0,11,6,1000
airflow-operator,airflow-operator,,0,6,0,6,0,6,0,500
azure-waf,azure-waf,,0,1,0,1,0,1,8,1
android-fragmentscenario,android-fragmentscenario,,0,1,0,1,0,1,3,1
superpermutation,superpermutation,,0,1,0,1,0,1,0,1
malbolge,malbolge,,0,1,0,1,0,1,9,1
qpixmapcache,qpixmapcache,,0,1,0,1,0,1,0,1
threetenabp,threetenabp,,0,3,0,3,0,3,3,200
dart-unittest,dart-unittest,,0,1,0,1,0,1,13,1
dart-mock,dart-mock,,0,1,0,1,0,1,13,1
aleatk,aleatk,,0,1,0,1,0,1,8,1
aurelia-custom-element,aurelia-custom-element,,0,1,0,1,0,1,1,1
aurelia-dependency-injection,aurelia-dependency-injection,,0,1,0,1,0,1,1,1
irrklang,irrklang,,0,1,0,1,0,1,13,1
libmms,libmms,,0,1,0,1,0,1,0,1
context-broker,context-broker,,0,1,0,1,0,1,6,1
reqif,reqif,,0,1,0,1,0,1,3,1
in-display-fingerprint,in-display-fingerprint,,0,1,0,1,0,1,3,1
centrifuge,centrifuge,,0,1,0,1,0,1,9,1
irate,irate,,0,1,0,1,0,1,6,1
diffabledatasource,diffabledatasource,,0,1,0,1,0,1,13,1
pluto,pluto,,0,1,0,1,0,1,3,1
mediasoup,mediasoup,,0,2,0,2,0,2,1,100
cratejoy,cratejoy,,0,1,0,1,0,1,8,1
clearlinux,clearlinux,,0,1,0,1,0,1,6,1
purejs-onepage-scroll,purejs-onepage-scroll,,0,1,0,1,0,1,1,1
liquid-template,liquid-template,,0,1,0,1,0,1,8,1
fastclick.js,fastclick.js,,0,1,0,1,0,1,1,1
tivo,tivo,,0,1,0,1,0,1,6,1
firestorter,firestorter,,0,1,0,1,0,1,1,1
polymorphic-relationship,polymorphic-relationship,,0,3,0,3,0,3,4,200
where-on-relation,where-on-relation,,0,1,0,1,0,1,4,1
xmltocsv,xmltocsv,,0,1,0,1,0,1,0,1
github-ci,github-ci,,0,3,0,3,0,3,6,200
importdata,importdata,,0,3,0,3,0,3,5,200
ngrx-store-8.0,ngrx-store-8.0,,0,1,0,1,0,1,1,1
scaml,scaml,,0,1,0,1,0,1,4,1
sef,sef,,0,1,0,1,0,1,3,1
hush-shell,hush-shell,,0,1,0,1,0,1,9,1
variant-array,variant-array,,0,1,0,1,0,1,5,1
nuclio,nuclio,,0,1,0,1,0,1,6,1
xmlexception,xmlexception,,0,1,0,1,0,1,8,1
scatterplot3d,scatterplot3d,,0,2,0,2,0,2,0,100
rake-test,rake-test,,0,1,0,1,0,1,12,1
multistage-pipeline,multistage-pipeline,,0,2,0,2,0,2,8,100
unflatten,unflatten,,0,1,0,1,0,1,1,1
uiveri5,uiveri5,,0,2,0,2,0,2,1,100
yeogurt,yeogurt,,0,1,0,1,0,1,1,1
tachyon,tachyon,,0,1,0,1,0,1,6,1
android-webview-javascript,android-webview-javascript,,0,1,0,1,0,1,3,1
bowtie,bowtie,,0,1,0,1,0,1,0,1
glide,glide,,0,4,0,4,0,4,3,300
shared-elements,shared-elements,,0,1,0,1,0,1,3,1
importscripts,importscripts,,0,1,0,1,0,1,9,1
tensorflow-c++,tensorflow-c++,,0,1,0,1,0,1,0,1
flutter-widget,flutter-widget,,0,3,0,3,0,3,13,200
tlaps,tlaps,,0,1,0,1,0,1,2,1
iconify,iconify,,0,1,0,1,0,1,1,1
teletext,teletext,,0,1,0,1,0,1,13,1
alexa-interaction-model,alexa-interaction-model,,0,1,0,1,0,1,6,1
create-nuxt-app,create-nuxt-app,,0,2,0,2,0,2,1,100
realm-ios,realm-ios,,0,1,0,1,0,1,13,1
material-ui-dialog,material-ui-dialog,,0,2,0,2,0,2,1,100
node-emoji,node-emoji,,0,1,0,1,0,1,9,1
android-10.0-q,android-10.0-q,,0,4,0,4,0,4,3,300
executequerysegmentedasync,executequerysegmentedasync,,0,1,0,1,0,1,8,1
textformat,textformat,,0,1,0,1,0,1,8,1
craco,craco,,0,2,0,2,0,2,1,100
rfc4180,rfc4180,,0,1,0,1,0,1,3,1
row-value-expression,row-value-expression,,0,1,0,1,0,1,4,1
yew,yew,,0,1,0,1,0,1,9,1
inverse-relationship,inverse-relationship,,0,1,0,1,0,1,13,1
ghc-plugin,ghc-plugin,,0,1,0,1,0,1,2,1
oidc-client,oidc-client,,0,1,0,1,0,1,8,1
testng-annotation-test,testng-annotation-test,,0,1,0,1,0,1,3,1
linux-x32-abi,linux-x32-abi,,0,1,0,1,0,1,9,1
pcov,pcov,,0,1,0,1,0,1,4,1
incremental-linking,incremental-linking,,0,1,0,1,0,1,9,1
decorator-chaining,decorator-chaining,,0,1,0,1,0,1,1,1
quakec,quakec,,0,1,0,1,0,1,1,1
carter,carter,,0,1,0,1,0,1,8,1
vue-cookies,vue-cookies,,0,1,0,1,0,1,1,1
envelope-schema,envelope-schema,,0,1,0,1,0,1,8,1
vertica-plugin,vertica-plugin,,0,1,0,1,0,1,4,1
userpoints,userpoints,,0,1,0,1,0,1,4,1
android-rect,android-rect,,0,1,0,1,0,1,3,1
string-agg,string-agg,,0,1,0,1,0,1,4,1
raima,raima,,0,1,0,1,0,1,3,1
geofabrik,geofabrik,,0,2,0,2,0,2,1,100
otms,otms,,0,1,0,1,0,1,8,1
shinywidgets,shinywidgets,,0,3,0,3,0,3,0,200
mysqlpp,mysqlpp,,0,1,0,1,0,1,9,1
onetrust,onetrust,,0,1,0,1,0,1,4,1
spray-routing,spray-routing,,0,1,0,1,0,1,2,1
miva,miva,,0,1,0,1,0,1,1,1
vestacp,vestacp,,0,2,0,2,0,2,4,100
proximo,proximo,,0,1,0,1,0,1,1,1
compress-images,compress-images,,0,1,0,1,0,1,9,1
iser,iser,,0,1,0,1,0,1,9,1
nativescript-http-formdata,nativescript-http-formdata,,0,1,0,1,0,1,1,1
needle-python,needle-python,,0,1,0,1,0,1,0,1
evolus-pencil,evolus-pencil,,0,1,0,1,0,1,7,1
sql-masking,sql-masking,,0,1,0,1,0,1,4,1
avogadro,avogadro,,0,1,0,1,0,1,9,1
spring-boot-starter-parent,spring-boot-starter-parent,,0,1,0,1,0,1,3,1
ej2-angular-calendars,ej2-angular-calendars,,0,1,0,1,0,1,1,1
totara,totara,,0,2,0,2,0,2,4,100
spki,spki,,0,1,0,1,0,1,6,1
browsershot,browsershot,,0,1,0,1,0,1,1,1
ag-grid-grouping,ag-grid-grouping,,0,1,0,1,0,1,1,1
makecab,makecab,,0,1,0,1,0,1,9,1
xng-breadcrumb,xng-breadcrumb,,0,1,0,1,0,1,1,1
iab,iab,,0,1,0,1,0,1,3,1
invoke-obfuscation,invoke-obfuscation,,0,1,0,1,0,1,8,1
gnu-global,gnu-global,,0,2,0,2,0,2,9,100
gulp-clean,gulp-clean,,0,1,0,1,0,1,1,1
surroundscm,surroundscm,,0,1,0,1,0,1,6,1
ibm-event-store,ibm-event-store,,0,1,0,1,0,1,6,1
dateparser,dateparser,,0,2,0,2,0,2,0,100
map-edit,map-edit,,0,1,0,1,0,1,0,1
dst-embroidery,dst-embroidery,,0,1,0,1,0,1,1,1
unicorn-engine,unicorn-engine,,0,1,0,1,0,1,9,1
uiactionsheetdelegate,uiactionsheetdelegate,,0,1,0,1,0,1,13,1
update-inner-join,update-inner-join,,0,1,0,1,0,1,4,1
flutter-apns,flutter-apns,,0,1,0,1,0,1,13,1
flutter-apple-device-token,flutter-apple-device-token,,0,1,0,1,0,1,13,1
scnprogram,scnprogram,,0,1,0,1,0,1,13,1
nito.asyncex,nito.asyncex,,0,1,0,1,0,1,8,1
hibernate3-maven-plugin,hibernate3-maven-plugin,,0,1,0,1,0,1,3,1
acts-as-tree,acts-as-tree,,0,1,0,1,0,1,12,1
syspolicy-purge-history,syspolicy-purge-history,,0,1,0,1,0,1,4,1
openolat,openolat,,0,1,0,1,0,1,3,1
xsdk,xsdk,,0,4,0,4,0,4,9,300
ticketmaster,ticketmaster,,0,1,0,1,0,1,4,1
spotfire-analyst,spotfire-analyst,,0,2,0,2,0,2,3,100
espeasy,espeasy,,0,1,0,1,0,1,6,1
sqlprofileprovider,sqlprofileprovider,,0,1,0,1,0,1,2,1
jmapviewer,jmapviewer,,0,1,0,1,0,1,3,1
xplat,xplat,,0,1,0,1,0,1,1,1
google-drive-api-v3,google-drive-api-v3,,0,1,0,1,0,1,5,1
flutter-text,flutter-text,,0,1,0,1,0,1,13,1
grunt-build-control,grunt-build-control,,0,1,0,1,0,1,1,1
startup-folder,startup-folder,,0,1,0,1,0,1,8,1
tokenautocomplete,tokenautocomplete,,0,1,0,1,0,1,3,1
kidoz,kidoz,,0,1,0,1,0,1,8,1
registry-pattern,registry-pattern,,0,1,0,1,0,1,9,1
crecordset,crecordset,,0,3,0,3,0,3,9,200
string-building,string-building,,0,1,0,1,0,1,3,1
pyspark-dataframes,pyspark-dataframes,,0,16,0,16,0,16,2,1500
icecat,icecat,,0,1,0,1,0,1,4,1
oracle-apex-19.1,oracle-apex-19.1,,0,1,0,1,0,1,4,1
managedthreadfactory,managedthreadfactory,,0,1,0,1,0,1,3,1
hyperldger-fabric-peer,hyperldger-fabric-peer,,0,1,0,1,0,1,1,1
datagridtablestyle,datagridtablestyle,,0,1,0,1,0,1,4,1
statuspage-api,statuspage-api,,0,1,0,1,0,1,1,1
batman-adv,batman-adv,,0,1,0,1,0,1,0,1
iblazr,iblazr,,0,1,0,1,0,1,8,1
app-engine-modules,app-engine-modules,,0,1,0,1,0,1,6,1
icloud.developer.apple.com,icloud.developer.apple.com,,0,1,0,1,0,1,13,1
fyne,fyne,,0,3,0,3,0,3,6,200
libao,libao,,0,1,0,1,0,1,9,1
crowdin,crowdin,,0,1,0,1,0,1,4,1
bloc-provider,bloc-provider,,0,1,0,1,0,1,13,1
elm-lang,elm-lang,,0,1,0,1,0,1,1,1
powershell-6.0,powershell-6.0,,0,2,0,2,0,2,8,100
sslserversocket,sslserversocket,,0,1,0,1,0,1,6,1
line-messenger,line-messenger,,0,2,0,2,0,2,8,100
pkaddpassesviewcontroller,pkaddpassesviewcontroller,,0,1,0,1,0,1,13,1
gcp-ai-platform-training,gcp-ai-platform-training,,0,2,0,2,0,2,6,100
docker-cleanup,docker-cleanup,,0,1,0,1,0,1,8,1
redhat-rhoar,redhat-rhoar,,0,1,0,1,0,1,6,1
autocad-scripts,autocad-scripts,,0,1,0,1,0,1,5,1
javascript-1.8,javascript-1.8,,0,1,0,1,0,1,1,1
icicles,icicles,,0,1,0,1,0,1,1,1
android-biometric,android-biometric,,0,4,0,4,0,4,3,300
elasticsearch-6.8,elasticsearch-6.8,,0,3,0,3,0,3,6,200
control-bus,control-bus,,0,1,0,1,0,1,3,1
event-passthrough,event-passthrough,,0,1,0,1,0,1,3,1
crudcontroller,crudcontroller,,0,1,0,1,0,1,3,1
smpplib,smpplib,,0,1,0,1,0,1,0,1
mercury-mta,mercury-mta,,0,1,0,1,0,1,1,1
react-native-testing-library,react-native-testing-library,,0,1,0,1,0,1,1,1
assume-role,assume-role,,0,1,0,1,0,1,6,1
audiomath,audiomath,,0,1,0,1,0,1,13,1
nativescript-background-http,nativescript-background-http,,0,1,0,1,0,1,1,1
joomla-dbo,joomla-dbo,,0,1,0,1,0,1,4,1
toolstripcontainer,toolstripcontainer,,0,1,0,1,0,1,8,1
rcf,rcf,,0,1,0,1,0,1,9,1
swoopy,swoopy,,0,1,0,1,0,1,1,1
hcl-notes,hcl-notes,,0,1,0,1,0,1,5,1
xamarin-listview,xamarin-listview,,0,1,0,1,0,1,8,1
auto-lock,auto-lock,,0,1,0,1,0,1,13,1
archicad,archicad,,0,1,0,1,0,1,14,1
ribboncontrolslibrary,ribboncontrolslibrary,,0,1,0,1,0,1,8,1
enotary,enotary,,0,1,0,1,0,1,6,1
gd-graph,gd-graph,,0,1,0,1,0,1,9,1
contactgroups,contactgroups,,0,1,0,1,0,1,13,1
pycaption,pycaption,,0,1,0,1,0,1,0,1
event-timing-api,event-timing-api,,0,1,0,1,0,1,1,1
performanceeventtiming,performanceeventtiming,,0,1,0,1,0,1,1,1
save-dialog,save-dialog,,0,1,0,1,0,1,1,1
sourcegear-vault,sourcegear-vault,,0,1,0,1,0,1,6,1
isight,isight,,0,1,0,1,0,1,0,1
uipath-activity,uipath-activity,,0,1,0,1,0,1,5,1
laravel-6,laravel-6,,0,2,0,2,0,2,4,100
kafka-partition,kafka-partition,,0,1,0,1,0,1,2,1
caffeine-cache,caffeine-cache,,0,1,0,1,0,1,3,1
nimbus-jose-jwt,nimbus-jose-jwt,,0,1,0,1,0,1,3,1
embedded-language,embedded-language,,0,1,0,1,0,1,0,1
micronaut-client,micronaut-client,,0,2,0,2,0,2,3,100
datasplice,datasplice,,0,1,0,1,0,1,3,1
implicitcad,implicitcad,,0,1,0,1,0,1,2,1
tinytext,tinytext,,0,1,0,1,0,1,4,1
robotlegs,robotlegs,,0,1,0,1,0,1,1,1
json-arrayagg,json-arrayagg,,0,1,0,1,0,1,4,1
entitycollection,entitycollection,,0,1,0,1,0,1,8,1
swfupload,swfupload,,0,1,0,1,0,1,0,1
rup,rup,,0,1,0,1,0,1,7,1
concourse-fly,concourse-fly,,0,1,0,1,0,1,6,1
laravel-backpack,laravel-backpack,,0,1,0,1,0,1,4,1
cloudfront-log-parser,cloudfront-log-parser,,0,1,0,1,0,1,6,1
variable-width,variable-width,,0,1,0,1,0,1,2,1
visual-c++-2008-express,visual-c++-2008-express,,0,1,0,1,0,1,9,1
nalgebra,nalgebra,,0,1,0,1,0,1,9,1
grpc-tools,grpc-tools,,0,1,0,1,0,1,6,1
gy-521,gy-521,,0,1,0,1,0,1,3,1
std-ranges,std-ranges,,0,1,0,1,0,1,9,1
cstore-fdw,cstore-fdw,,0,1,0,1,0,1,6,1
albumentations,albumentations,,0,1,0,1,0,1,0,1
ansible-tasks,ansible-tasks,,0,1,0,1,0,1,6,1
bddfy,bddfy,,0,1,0,1,0,1,8,1
nt4,nt4,,0,1,0,1,0,1,8,1
uiop,uiop,,0,1,0,1,0,1,0,1
rvmrc,rvmrc,,0,1,0,1,0,1,12,1
asauthorizationcontroller,asauthorizationcontroller,,0,1,0,1,0,1,13,1
reg-free,reg-free,,0,1,0,1,0,1,3,1
loadable-component,loadable-component,,0,1,0,1,0,1,1,1
php-7.4,php-7.4,,0,1,0,1,0,1,0,1
mathics,mathics,,0,1,0,1,0,1,0,1
report-studio,report-studio,,0,1,0,1,0,1,4,1
boundbox,boundbox,,0,1,0,1,0,1,0,1
anjuta,anjuta,,0,1,0,1,0,1,9,1
arduino-every,arduino-every,,0,1,0,1,0,1,9,1
open3d,open3d,,0,1,0,1,0,1,0,1
openstack-autopilot,openstack-autopilot,,0,1,0,1,0,1,13,1
imagepicker,imagepicker,,0,2,0,2,0,2,1,100
warren-abstract-machine,warren-abstract-machine,,0,1,0,1,0,1,0,1
playbook,playbook,,0,1,0,1,0,1,6,1
guizero,guizero,,0,1,0,1,0,1,0,1
google-cloud-translate,google-cloud-translate,,0,1,0,1,0,1,6,1
atomic-constraints,atomic-constraints,,0,1,0,1,0,1,9,1
codea,codea,,0,1,0,1,0,1,9,1
rdrop2,rdrop2,,0,1,0,1,0,1,4,1
lumen-5.8,lumen-5.8,,0,1,0,1,0,1,4,1
cipixellate,cipixellate,,0,1,0,1,0,1,13,1
iweb,iweb,,0,1,0,1,0,1,0,1
data-request,data-request,,63,51,91,114,239,205,0,1
historical,historical,,5,1,12,6,17,18,0,1
biology,biology,,5,3,11,8,10,19,0,1
uk,uk,,1,4,3,5,15,8,0,300
usa,usa,,8,10,23,18,47,41,0,25
taxes,taxes,,0,0,0,0,1,0,0,1
data.gov,data.gov,,3,2,9,5,16,14,0,1
cambodia,cambodia,,0,0,0,0,2,0,0,1
hydrology,hydrology,,1,0,1,1,2,2,0,1
images,images,,8,10,5,18,19,23,0,25
oceanographic,oceanographic,,0,0,1,0,2,1,0,1
real-estate,real-estate,,1,0,2,1,6,3,0,1
us-census,us-census,,1,1,2,2,17,4,0,1
north-america,north-america,,0,1,1,1,1,2,0,1
social-process,social-process,,0,0,0,0,2,0,0,1
releasing-data,releasing-data,,1,1,1,2,4,3,0,1
cpi,cpi,,0,0,0,0,1,0,0,1
uses-of-open-data,uses-of-open-data,,7,6,7,13,23,20,0,1
europe,europe,,1,2,3,3,6,6,0,100
transportation,transportation,,2,2,4,4,12,8,0,1
agriculture,agriculture,,1,2,2,3,8,5,0,100
korea,korea,,0,0,0,0,1,0,0,1
russia,russia,,1,0,0,1,4,1,0,1
australia,australia,,0,0,1,0,5,1,0,1
asia,asia,,1,0,2,1,4,3,0,1
companies,companies,,4,0,2,4,5,6,0,1
land,land,,0,0,4,0,2,4,0,1
products,products,,2,1,2,3,3,5,0,1
public-transport,public-transport,,0,1,2,1,4,3,0,1
religion,religion,,0,0,0,0,2,0,0,1
industry,industry,,1,0,0,1,4,1,0,1
politics,politics,,2,2,1,4,3,5,0,1
food,food,,0,1,0,1,5,1,0,1
openfda,openfda,,8,4,6,12,9,18,0,1
elections,elections,,0,0,2,0,4,2,0,1
corpora,corpora,,0,0,0,0,7,0,0,1
web-crawling,web-crawling,,1,1,0,2,3,2,0,1
mimic-iii,mimic-iii,,0,0,1,0,3,1,0,1
military,military,,0,0,0,0,1,0,0,1
music,music,,0,3,1,3,2,4,0,200
network-structure,network-structure,,1,0,2,1,1,3,4,1
south-america,south-america,,0,0,1,0,2,1,0,1
labor,labor,,0,0,0,0,2,0,0,1
collegescorecard,collegescorecard,,1,3,4,4,8,8,0,200
india,india,,0,0,1,0,3,1,0,1
data-portal,data-portal,,0,0,1,0,2,1,0,1
canada,canada,,1,2,2,3,3,5,0,100
county,county,,0,0,1,0,6,1,0,1
literature,literature,,0,0,0,0,2,0,0,1
data-format,data-format,,1,0,3,1,2,4,0,1
football,football,,1,1,0,2,3,2,0,1
film,film,,2,0,0,2,1,2,0,1
photographs,photographs,,1,0,0,1,3,1,0,1
address,address,,1,0,0,1,2,1,0,1
txt,txt,,0,0,0,0,1,0,0,1
english,english,,1,2,3,3,3,6,0,100
ireland,ireland,,0,0,0,0,2,0,0,1
africa,africa,,0,1,1,1,2,2,0,1
worldbank,worldbank,,0,0,0,0,1,0,0,1
china,china,,0,1,1,1,3,2,0,1
france,france,,0,0,0,0,2,0,0,1
japan,japan,,0,2,0,2,1,2,0,100
extracting,extracting,,0,0,0,0,1,0,0,1
crime,crime,,0,1,4,1,2,5,0,1
climate,climate,,1,2,2,3,2,5,0,100
oecd,oecd,,0,0,0,0,1,0,0,1
drugs,drugs,,0,4,1,4,5,5,0,300
tool-request,tool-request,,0,0,1,0,1,1,0,1
geohazard,geohazard,,0,0,2,0,2,2,0,1
germany,germany,,1,1,1,2,2,3,0,1
ski,ski,,0,0,0,0,1,0,0,1
aerial-photography,aerial-photography,,0,0,1,0,3,1,0,1
gdp,gdp,,0,0,0,0,1,0,0,1
land-cover,land-cover,,0,0,0,0,2,0,0,1
healthcare-finder-api,healthcare-finder-api,,0,0,0,0,1,0,0,1
computing,computing,,0,0,1,0,1,1,2,1
income,income,,0,1,0,1,2,1,0,1
disease,disease,,2,0,0,2,2,2,0,1
mexico,mexico,,0,0,0,0,1,0,0,1
italy,italy,,0,0,0,0,2,0,0,1
cadastral,cadastral,,0,0,0,0,1,0,0,1
faces,faces,,3,0,0,3,2,3,0,1
cost,cost,,0,0,0,0,1,0,0,1
academia,academia,,3,1,5,4,6,9,0,1
creative-commons,creative-commons,,0,0,1,0,1,1,6,1
internet-of-things,internet-of-things,,0,0,0,0,1,0,0,1
inspire,inspire,,0,0,0,0,1,0,0,1
meteorology,meteorology,,0,0,1,0,1,1,0,1
chicago,chicago,,0,0,0,0,1,0,0,1
spending,spending,,1,0,0,1,1,1,0,1
bibliometrics,bibliometrics,,0,0,1,0,0,1,4,1
usaidopen,usaidopen,,0,0,2,0,0,2,0,1
argentina,argentina,,0,0,1,0,0,1,0,1
ages,ages,,1,0,1,1,0,2,0,1
glam,glam,,0,0,1,0,0,1,0,1
unstructured-data,unstructured-data,,0,0,1,0,0,1,0,1
trade,trade,,0,1,1,1,0,2,0,1
telecom,telecom,,1,1,1,2,0,3,0,1
federal,federal,,0,0,1,0,0,1,0,1
police,police,,0,0,2,0,0,2,0,1
open-access,open-access,,0,0,1,0,0,1,8,1
un,un,,0,1,3,1,0,4,0,1
district,district,,0,0,1,0,0,1,0,1
switzerland,switzerland,,0,0,1,0,0,1,0,1
economy,economy,,0,0,1,0,0,1,0,1
brazil,brazil,,1,0,0,1,0,1,0,1
journalism,journalism,,2,0,0,2,0,2,0,1
checksums,checksums,,1,0,0,1,0,1,0,1
google-play-store,google-play-store,,1,0,0,1,0,1,9,1
data-monitoring,data-monitoring,,1,1,0,2,0,2,9,1
japanese,japanese,,0,1,0,1,0,1,0,1
vandalism,vandalism,,0,1,0,1,0,1,0,1
beer,beer,,0,1,0,1,0,1,0,1
passports,passports,,0,1,0,1,0,1,0,1
latin-america,latin-america,,0,1,0,1,0,1,0,1
animals,animals,,0,1,0,1,0,1,0,1
precipitation,precipitation,,0,1,0,1,0,1,0,1
fashion,fashion,,0,1,0,1,0,1,0,1
datasets,datasets,,20,12,24,32,37,56,0,1
incremental-learning,incremental-learning,,2,5,1,7,2,8,0,150
strong-ai,strong-ai,,1,4,6,5,16,11,0,300
control-problem,control-problem,,2,1,5,3,4,8,0,1
superintelligence,superintelligence,,2,0,2,2,9,4,0,1
ai-community,ai-community,,4,0,6,4,10,10,0,1
incomplete-information,incomplete-information,,0,0,0,0,2,0,0,1
convolutional-neural-networks,convolutional-neural-networks,,77,86,93,163,107,256,0,11.688312
ai-design,ai-design,,18,27,43,45,78,88,0,50
gaming,gaming,,3,0,1,3,7,4,0,1
intelligent-agent,intelligent-agent,,2,3,15,5,12,20,0,50
ai-safety,ai-safety,,1,0,1,1,7,2,0,1
neo-luddism,neo-luddism,,1,0,2,1,4,3,0,1
htm,htm,,0,0,1,0,1,1,0,1
decision-theory,decision-theory,,0,1,5,1,4,6,0,1
markov-chain,markov-chain,,1,3,1,4,2,5,0,200
detecting-patterns,detecting-patterns,,3,1,3,4,9,7,0,1
trpo,trpo,,1,0,1,1,3,2,0,1
local-search,local-search,,1,0,1,1,1,2,0,1
combinatorial-games,combinatorial-games,,3,0,7,3,12,10,0,1
imperfect-information,imperfect-information,,0,0,1,0,4,1,0,1
friendly-ai,friendly-ai,,0,0,0,0,1,0,0,1
challenges,challenges,,1,0,1,1,1,2,0,1
hidden-layers,hidden-layers,,2,1,4,3,6,7,0,1
learning-algorithms,learning-algorithms,,1,3,9,4,20,13,0,200
recurrent-neural-networks,recurrent-neural-networks,,12,18,24,30,29,54,0,50
language-processing,language-processing,,0,1,1,1,2,2,0,1
cfg,cfg,,0,0,0,0,1,0,0,1
deepstack,deepstack,,0,0,0,0,1,0,0,1
autonomous-vehicles,autonomous-vehicles,,2,2,7,4,6,11,0,1
fitness-functions,fitness-functions,,0,1,4,1,3,5,0,1
multi-agent-systems,multi-agent-systems,,5,4,0,9,7,9,0,1
autoencoders,autoencoders,,10,10,7,20,6,27,0,1
text-summarization,text-summarization,,3,2,1,5,6,6,0,1
artificial-neuron,artificial-neuron,,2,6,10,8,10,18,0,200
swarm-intelligence,swarm-intelligence,,2,0,9,2,2,11,0,1
emotional-intelligence,emotional-intelligence,,3,1,6,4,7,10,0,1
human-like,human-like,,4,2,6,6,9,12,0,1
robots,robots,,0,1,3,1,6,4,0,1
neurons,neurons,,3,1,8,4,5,12,0,1
alphago-zero,alphago-zero,,3,3,4,6,2,10,0,1
russell-norvig,russell-norvig,,0,0,0,0,3,0,0,1
model-based,model-based,,4,2,2,6,2,8,0,1
model-free,model-free,,2,1,1,3,1,4,0,1
getting-started,getting-started,,3,5,14,8,42,22,0,66.666667
quality-control,quality-control,,1,0,0,1,1,1,0,1
artificial-consciousness,artificial-consciousness,,3,3,12,6,9,18,0,1
sentience,sentience,,0,0,0,0,2,0,0,1
new-ai,new-ai,,0,0,0,0,1,0,0,1
naive-bayes,naive-bayes,,1,1,0,2,1,2,0,1
bayes-theorem,bayes-theorem,,1,0,0,1,2,1,0,1
path-planning,path-planning,,0,0,5,0,5,5,0,1
scene-classification,scene-classification,,0,0,0,0,1,0,0,1
rul,rul,,0,0,0,0,1,0,0,1
ai-takeover,ai-takeover,,2,0,0,2,1,2,0,1
ai-basics,ai-basics,,23,11,39,34,57,73,0,1
embedded-design,embedded-design,,0,0,4,0,2,4,0,1
neuromorphic-engineering,neuromorphic-engineering,,1,1,2,2,3,4,0,1
praxis,praxis,,0,0,0,0,1,0,0,1
software-evaluation,software-evaluation,,3,5,8,8,13,16,0,66.666667
pathfinding,pathfinding,,1,0,1,1,3,2,0,1
hardware-evaluation,hardware-evaluation,,1,0,5,1,6,6,0,1
statistical-ai,statistical-ai,,2,3,8,5,8,13,0,50
chat-bots,chat-bots,,5,5,14,10,11,24,0,1
alphago,alphago,,5,0,3,5,5,8,0,1
alphazero,alphazero,,4,9,5,13,4,18,0,125
bayes,bayes,,0,0,9,0,4,9,0,1
brain,brain,,4,0,3,4,10,7,0,1
importance-sampling,importance-sampling,,1,0,1,1,1,2,0,1
gofai,gofai,,1,1,1,2,2,3,0,1
super-organism,super-organism,,0,0,0,0,1,0,0,1
papers,papers,,5,8,3,13,1,16,0,60
genes,genes,,0,0,0,0,1,0,0,1
world-knowledge,world-knowledge,,0,0,1,0,2,1,0,1
software-architecture,software-architecture,,0,0,0,0,1,0,0,1
self-awareness,self-awareness,,0,0,0,0,7,0,0,1
weak-ai,weak-ai,,0,0,0,0,1,0,0,1
symbolic-ai,symbolic-ai,,1,4,2,5,1,7,0,300
neuroevolution,neuroevolution,,5,3,3,8,2,11,0,1
deep-rl,deep-rl,,27,10,10,37,6,47,0,1
singularity,singularity,,0,0,4,0,6,4,0,1
generative-model,generative-model,,9,7,11,16,9,27,0,1
intelligence-testing,intelligence-testing,,2,0,1,2,3,3,0,1
ai-field,ai-field,,0,0,1,0,1,1,0,1
norvig-russell,norvig-russell,,0,0,0,0,1,0,0,1
emergence,emergence,,1,0,1,1,2,2,0,1
self-play,self-play,,0,0,2,0,3,2,0,1
perfect-play,perfect-play,,0,0,0,0,1,0,0,1
branching-factors,branching-factors,,0,0,1,0,2,1,0,1
feedforward,feedforward,,2,0,12,2,3,14,0,1
liquid-state-machine,liquid-state-machine,,0,0,0,0,1,0,0,1
wetware,wetware,,0,0,0,0,1,0,0,1
cognitive-science,cognitive-science,,4,1,2,5,5,7,0,1
teaching-concepts,teaching-concepts,,0,0,0,0,2,0,0,1
quantification,quantification,,0,0,2,0,1,2,0,1
ultraintelligent-machine,ultraintelligent-machine,,0,0,0,0,2,0,0,1
mythology-of-ai,mythology-of-ai,,4,1,5,5,2,10,0,1
loss-functions,loss-functions,,13,18,19,31,2,50,0,38.461538
lexical-recognition,lexical-recognition,,0,0,0,0,1,0,3,1
value-alignment,value-alignment,,0,0,2,0,1,2,0,1
rationality,rationality,,0,0,1,0,3,1,0,1
intelligence,intelligence,,2,0,2,2,2,4,0,1
on-policy,on-policy,,1,0,3,1,2,4,0,1
off-policy,off-policy,,2,1,3,3,1,6,0,1
conditional-probability,conditional-probability,,0,3,0,3,1,3,0,200
handwritten-characters,handwritten-characters,,0,1,1,1,1,2,0,1
open-ai,open-ai,,14,4,8,18,3,26,0,1
experience-replay,experience-replay,,9,0,1,9,2,10,0,1
atari-games,atari-games,,1,1,0,2,1,2,0,1
art-aesthetics,art-aesthetics,,1,1,0,2,1,2,0,1
ai-development,ai-development,,2,0,0,2,1,2,0,1
generative-adversarial-networks,generative-adversarial-networks,,9,16,8,25,5,33,0,77.777778
digital-rights,digital-rights,,0,0,0,0,3,0,6,1
google-cloud,google-cloud,,1,0,0,1,1,1,0,1
node-js,node-js,,0,0,0,0,2,0,0,1
profession,profession,,0,3,2,3,1,5,0,200
boltzmann-machine,boltzmann-machine,,0,1,0,1,3,1,0,1
action-recognition,action-recognition,,0,2,1,2,3,3,0,100
marketability,marketability,,0,0,0,0,1,0,0,1
discount-factor,discount-factor,,1,0,2,1,3,3,0,1
checkers,checkers,,0,0,1,0,1,1,0,1
analog-computing,analog-computing,,0,0,0,0,1,0,0,1
spiking-networks,spiking-networks,,0,0,2,0,1,2,0,1
dimensionality,dimensionality,,0,0,2,0,1,2,0,1
advantage-actor-critic,advantage-actor-critic,,1,0,0,1,1,1,0,1
human-inspired,human-inspired,,1,0,4,1,1,5,0,1
predicting-ai-milestones,predicting-ai-milestones,,0,0,0,0,1,0,0,1
long-short-term-memory,long-short-term-memory,,1,1,3,2,2,5,0,1
attention,attention,,4,5,3,9,1,12,0,25
sequence-modelling,sequence-modelling,,3,8,2,11,1,13,0,166.666667
resource-request,resource-request,,0,1,2,1,1,3,0,1
value-function,value-function,,3,0,2,3,1,5,0,1
optimal-policy,optimal-policy,,0,0,0,0,1,0,0,1
stationary-policy,stationary-policy,,0,1,0,1,1,1,0,1
rl-an-introduction,rl-an-introduction,,8,1,7,9,2,16,0,1
reinforce,reinforce,,2,3,3,5,1,8,0,50
rewards,rewards,,11,7,4,18,1,22,0,1
simple-reflex-agents,simple-reflex-agents,,0,0,1,0,1,1,0,1
ltsm,ltsm,,0,1,0,1,1,1,0,1
geometric-deep-learning,geometric-deep-learning,,6,13,0,19,1,19,0,116.666667
ai-complete,ai-complete,,1,1,1,2,0,3,0,1
hyper-parameters,hyper-parameters,,3,2,4,5,0,9,0,1
proximal-policy-optimization,proximal-policy-optimization,,4,6,2,10,0,12,0,50
symbolic-computing,symbolic-computing,,0,0,1,0,0,1,0,1
reward-clipping,reward-clipping,,1,0,2,1,0,3,0,1
collision-avoidance,collision-avoidance,,0,0,1,0,0,1,0,1
fallibility,fallibility,,0,0,1,0,0,1,0,1
self-replication,self-replication,,0,0,1,0,0,1,0,1
goal-based,goal-based,,1,1,1,2,0,3,0,1
utility-based,utility-based,,1,0,1,1,0,2,0,1
pomdp,pomdp,,3,0,2,3,0,5,0,1
semi-mdp,semi-mdp,,1,1,2,2,0,4,0,1
greedy-ai,greedy-ai,,2,1,2,3,0,5,0,1
gym,gym,,2,3,2,5,0,7,0,50
classical-ai,classical-ai,,1,0,1,1,0,2,0,1
iterative-deepening-a-star,iterative-deepening-a-star,,0,0,1,0,0,1,0,1
invention,invention,,0,0,1,0,0,1,0,1
rule-acquisition,rule-acquisition,,1,0,1,1,0,2,0,1
data-preprocessing,data-preprocessing,,1,3,2,4,0,6,0,200
feature-learning,feature-learning,,0,1,1,1,0,2,0,1
online-resources,online-resources,,0,1,2,1,0,3,0,1
asimovs-laws,asimovs-laws,,0,0,2,0,0,2,0,1
random-variable,random-variable,,1,1,2,2,0,4,0,1
latent-variable,latent-variable,,1,1,2,2,0,4,0,1
finite-markov-decision-process,finite-markov-decision-process,,0,0,2,0,0,2,0,1
anthropomorphism,anthropomorphism,,0,0,1,0,0,1,0,1
maximum-likelihood,maximum-likelihood,,1,0,1,1,0,2,0,1
mapping-space,mapping-space,,1,0,2,1,0,3,0,1
chinese-room-argument,chinese-room-argument,,0,0,1,0,0,1,0,1
real-world,real-world,,2,0,1,2,0,3,0,1
feature,feature,,4,3,2,7,0,9,0,1
deepfakes,deepfakes,,0,4,1,4,0,5,0,300
prioritized-sweeping,prioritized-sweeping,,0,1,2,1,0,3,0,1
meta-rules,meta-rules,,1,0,1,1,0,2,0,1
markov-property,markov-property,,1,2,1,3,0,4,0,100
computer-programming,computer-programming,,0,1,1,1,0,2,0,1
expectation,expectation,,0,1,2,1,0,3,0,1
eligibility-traces,eligibility-traces,,2,0,1,2,0,3,0,1
dyna,dyna,,0,1,1,1,0,2,0,1
ddpg,ddpg,,4,2,1,6,0,7,0,1
stochastic-policy,stochastic-policy,,1,0,2,1,0,3,0,1
deterministic-policy,deterministic-policy,,2,0,2,2,0,4,0,1
ai-a-modern-approach,ai-a-modern-approach,,1,0,1,1,0,2,0,1
cloud-services,cloud-services,,2,0,1,2,0,3,0,1
algorithmic-bias,algorithmic-bias,,0,1,1,1,0,2,0,1
self-supervised-learning,self-supervised-learning,,1,0,1,1,0,2,0,1
hierarchical-rl,hierarchical-rl,,0,2,1,2,0,3,0,100
policy-iteration,policy-iteration,,0,0,1,0,0,1,0,1
expected-sarsa,expected-sarsa,,0,0,1,0,0,1,0,1
constraint-satisfaction-problems,constraint-satisfaction-problems,,3,2,1,5,0,6,0,1
popular-culture,popular-culture,,1,0,0,1,0,1,0,1
incentivization,incentivization,,1,0,0,1,0,1,0,1
k-medoids,k-medoids,,1,0,0,1,0,1,0,1
curse-of-dimensionality,curse-of-dimensionality,,1,0,0,1,0,1,0,1
creativity,creativity,,1,0,0,1,0,1,6,1
open-cog,open-cog,,1,0,0,1,0,1,13,1
action-model-learning,action-model-learning,,1,1,0,2,0,2,0,1
hebbian-learning,hebbian-learning,,1,0,0,1,0,1,0,1
ai-hoaxes,ai-hoaxes,,1,0,0,1,0,1,0,1
fourier-approximation,fourier-approximation,,1,0,0,1,0,1,0,1
games-of-chance,games-of-chance,,1,1,0,2,0,2,0,1
underfitting,underfitting,,1,1,0,2,0,2,0,1
hyperparameter-optimization,hyperparameter-optimization,,1,8,0,9,0,9,0,700
neural-architecture-search,neural-architecture-search,,1,2,0,3,0,3,0,100
infinite-horizon,infinite-horizon,,1,0,0,1,0,1,0,1
rts,rts,,0,1,0,1,0,1,0,1
benchmarks,benchmarks,,0,1,0,1,0,1,0,1
hidden-markov-model,hidden-markov-model,,0,4,0,4,0,4,0,300
automated-reasoning,automated-reasoning,,0,1,0,1,0,1,0,1
pretrained-models,pretrained-models,,0,1,0,1,0,1,0,1
non-stationary-policy,non-stationary-policy,,0,1,0,1,0,1,0,1
common-sense-knowledge,common-sense-knowledge,,0,1,0,1,0,1,0,1
causation,causation,,0,2,0,2,0,2,0,100
catastrophic-forgetting,catastrophic-forgetting,,0,5,0,5,0,5,0,400
conditional-random-field,conditional-random-field,,0,3,0,3,0,3,0,200
learning-curve,learning-curve,,0,2,0,2,0,2,0,100
uct,uct,,0,1,0,1,0,1,0,1
gradient-boosting,gradient-boosting,,0,1,0,1,0,1,0,1
hopfield-network,hopfield-network,,0,1,0,1,0,1,0,1
cognitive-architecture,cognitive-architecture,,0,2,0,2,0,2,0,100
soar,soar,,0,1,0,1,0,1,0,1
strips,strips,,0,2,0,2,0,2,0,100
pretra,pretra,,0,1,0,1,0,1,0,1
ai-box,ai-box,,0,1,0,1,0,1,0,1
computational-complexity,computational-complexity,,0,2,0,2,0,2,0,100
samsung-smartthings,samsung-smartthings,,2,0,4,2,10,6,6,1
google-assistant,google-assistant,,2,6,7,8,15,15,13,200
home-security,home-security,,0,0,1,0,2,1,6,1
door-sensor,door-sensor,,1,0,2,1,3,3,6,1
power-consumption,power-consumption,,2,2,2,4,10,6,3,1
industry-4.0,industry-4.0,,1,0,0,1,4,1,6,1
web-sockets,web-sockets,,1,3,1,4,3,5,6,200
smart-home,smart-home,,4,10,27,14,57,41,6,150
microsoft-windows,microsoft-windows,,0,0,0,0,1,0,6,1
mesh-networks,mesh-networks,,2,1,0,3,6,3,6,1
6lowpan,6lowpan,,0,0,1,0,3,1,6,1
power-sources,power-sources,,0,0,2,0,5,2,3,1
microcontrollers,microcontrollers,,1,2,2,3,19,5,3,100
beacons,beacons,,0,0,0,0,2,0,3,1
microsoft-windows-iot,microsoft-windows-iot,,1,1,2,2,5,4,3,1
smart-plugs,smart-plugs,,2,1,9,3,9,12,6,1
actuators,actuators,,0,0,2,0,1,2,9,1
microphones,microphones,,0,0,1,0,2,1,6,1
connector-services,connector-services,,0,0,0,0,1,0,9,1
zwave,zwave,,3,1,0,4,8,4,6,1
wifi-halow,wifi-halow,,0,0,0,0,2,0,9,1
publish-subscriber,publish-subscriber,,2,0,1,2,5,3,6,1
over-the-air-updates,over-the-air-updates,,0,1,1,1,2,2,3,1
bluetooth-low-energy,bluetooth-low-energy,,1,3,3,4,10,7,3,200
routers,routers,,0,1,1,1,5,2,9,1
apple-homepod,apple-homepod,,0,0,0,0,2,0,6,1
wink-hub,wink-hub,,0,0,0,0,2,0,6,1
tracking-devices,tracking-devices,,0,0,1,0,2,1,3,1
wemo,wemo,,0,1,0,1,2,1,6,1
geo-tagging,geo-tagging,,0,0,1,0,1,1,9,1
tp-link,tp-link,,0,0,0,0,2,0,6,1
amazon-iot-button,amazon-iot-button,,0,0,1,0,4,1,6,1
logitech-harmony,logitech-harmony,,0,1,4,1,1,5,6,1
rest-api,rest-api,,0,0,2,0,4,2,6,1
aws-greengrass,aws-greengrass,,1,0,2,1,5,3,6,1
lpwan,lpwan,,0,0,3,0,1,3,9,1
sigfox,sigfox,,0,0,3,0,1,3,9,1
apple-homekit,apple-homekit,,2,1,3,3,2,6,6,1
ikea-tradfri,ikea-tradfri,,0,1,1,1,3,2,6,1
audio-dsp,audio-dsp,,0,0,0,0,1,0,3,1
smart-assistants,smart-assistants,,1,2,1,3,1,4,13,100
ubuntu-core,ubuntu-core,,0,0,0,0,1,0,9,1
mycroft,mycroft,,0,0,0,0,1,0,13,1
google-iot-core,google-iot-core,,1,1,0,2,2,2,3,1
ac-power,ac-power,,0,1,1,1,2,2,3,1
surveillance-cameras,surveillance-cameras,,2,1,1,3,3,4,9,1
digital-cameras,digital-cameras,,1,1,0,2,3,2,9,1
smart-lights,smart-lights,,2,2,6,4,3,10,6,1
heart-rate-monitors,heart-rate-monitors,,0,0,0,0,1,0,3,1
energy-monitoring-systems,energy-monitoring-systems,,1,1,1,2,1,3,3,1
tls,tls,,0,0,1,0,3,1,6,1
hvac,hvac,,0,0,0,0,1,0,6,1
blockchains,blockchains,,1,0,0,1,1,1,3,1
ti-cc3200,ti-cc3200,,0,0,1,0,1,1,6,1
edge,edge,,0,0,1,0,1,1,8,1
batteries,batteries,,0,0,0,0,1,0,6,1
mobile-applications,mobile-applications,,1,0,0,1,2,1,6,1
smart-watches,smart-watches,,1,0,1,1,1,2,3,1
nodejs,nodejs,,0,0,1,0,1,1,6,1
nest-cam,nest-cam,,0,0,0,0,1,0,9,1
thread,thread,,0,0,1,0,0,1,6,1
dimmer,dimmer,,0,0,1,0,0,1,6,1
sonoff,sonoff,,0,0,3,0,0,3,6,1
certifications,certifications,,1,0,2,1,0,3,6,1
xiaomi-mi,xiaomi-mi,,1,3,1,4,0,5,3,200
smart-lock,smart-lock,,1,0,1,1,0,2,6,1
smart-contracts,smart-contracts,,1,0,0,1,0,1,3,1
smart-cars,smart-cars,,1,0,0,1,0,1,6,1
fog-computing,fog-computing,,1,0,0,1,0,1,3,1
edge-computing,edge-computing,,1,0,0,1,0,1,3,1
data-portability,data-portability,,0,1,0,1,0,1,9,1
platform-io,platform-io,,0,2,0,2,0,2,9,100
lightwave-rf,lightwave-rf,,0,1,0,1,0,1,6,1
mediatek,mediatek,,0,1,0,1,0,1,9,1
job-dsl,job-dsl,,0,2,1,2,2,3,6,100
jenkinsfile,jenkinsfile,,8,7,9,15,15,24,6,1
devsecops,devsecops,,0,0,3,0,9,3,4,1
a2d,a2d,,0,0,0,0,1,0,4,1
titus,titus,,0,0,0,0,1,0,0,1
shell-script,shell-script,,6,1,7,7,6,14,9,1
infrastructure-as-code,infrastructure-as-code,,3,0,8,3,13,11,6,1
dotnet,dotnet,,1,0,2,1,4,3,6,1
jinja,jinja,,2,2,4,4,5,8,6,1
load-balance,load-balance,,3,6,4,9,14,13,6,100
linting,linting,,0,0,1,0,1,1,6,1
casc,casc,,0,0,0,0,2,0,6,1
platform-as-a-service,platform-as-a-service,,1,0,3,1,2,4,9,1
helm,helm,,9,4,14,13,6,27,6,1
servers,servers,,2,0,5,2,6,7,6,1
user-namespaces,user-namespaces,,0,0,0,0,2,0,6,1
bcbsn,bcbsn,,1,0,2,1,2,3,6,1
subversion,subversion,,0,0,1,0,3,1,6,1
immutable-servers,immutable-servers,,1,1,1,2,6,3,6,1
cattle-vs-pet,cattle-vs-pet,,0,0,0,0,1,0,6,1
elastic,elastic,,4,1,5,5,7,10,6,1
git-hooks,git-hooks,,0,3,0,3,2,3,6,200
team-role,team-role,,0,1,0,1,2,1,8,1
human-resources,human-resources,,0,0,0,0,2,0,8,1
sla,sla,,0,1,0,1,2,1,6,1
jenkins2,jenkins2,,1,0,1,1,7,2,6,1
apache-httpd,apache-httpd,,0,0,3,0,3,3,6,1
terraform-module,terraform-module,,1,2,3,3,2,6,6,100
terraform-workspace,terraform-workspace,,0,0,0,0,2,0,6,1
job-role,job-role,,0,0,0,0,1,0,7,1
practices,practices,,0,0,0,0,2,0,6,1
aws-codedeploy,aws-codedeploy,,3,1,0,4,3,4,6,1
kafka,kafka,,0,1,2,1,1,3,6,1
loadbalancing,loadbalancing,,0,1,2,1,3,3,6,1
scalr,scalr,,0,0,0,0,1,0,12,1
oracle-jdk,oracle-jdk,,0,0,0,0,1,0,3,1
zookeeper,zookeeper,,0,0,1,0,2,1,6,1
vcs,vcs,,0,0,0,0,1,0,6,1
cicd,cicd,,14,6,15,20,5,35,6,1
rproxy,rproxy,,0,0,0,0,2,0,6,1
amazon-guardduty,amazon-guardduty,,0,0,2,0,1,2,6,1
composer,composer,,0,0,2,0,2,2,6,1
secret-management,secret-management,,1,2,0,3,3,3,6,100
patterns,patterns,,1,1,0,2,1,2,0,1
dtap,dtap,,0,0,1,0,2,1,6,1
ingress,ingress,,3,2,4,5,2,9,6,1
feature-flags,feature-flags,,0,0,0,0,1,0,6,1
feature-toggles,feature-toggles,,0,0,0,0,1,0,6,1
jenkins-x,jenkins-x,,2,0,1,2,1,3,6,1
resilience-testing,resilience-testing,,0,1,1,1,2,2,6,1
disaster-recovery-plans,disaster-recovery-plans,,0,0,1,0,1,1,6,1
post-mortem,post-mortem,,0,0,0,0,1,0,8,1
aws-cloudformation,aws-cloudformation,,2,5,11,7,1,18,6,150
term-disambiguation,term-disambiguation,,0,0,3,0,0,3,0,1
bluegreen,bluegreen,,0,0,1,0,0,1,6,1
the-phoenix-project,the-phoenix-project,,0,0,1,0,0,1,8,1
ibm-bluemix,ibm-bluemix,,0,0,1,0,0,1,6,1
science,science,,1,0,0,1,0,1,8,1
gocd,gocd,,1,0,0,1,0,1,8,1
go-yq,go-yq,,1,0,0,1,0,1,3,1
vm,vm,,0,2,0,2,0,2,6,100
gce,gce,,0,2,0,2,0,2,6,100
quality-cotrol,quality-cotrol,,0,1,0,1,0,1,6,1
